PokerStars Hand #166667693852:  Hold'em No Limit ($0.05/$0.10 USD) - 2017/02/23 16:05:49 ET
Table 'Pulcova II' 6-max Seat #4 is the button
Seat 1: sexy_seagull ($13.40 in chips) 
Seat 2: Kazacha ($10 in chips) 
Seat 3: Lao Tsy ($14.52 in chips) 
Seat 4: VioXion ($10.25 in chips) 
Seat 5: mdelfin0 ($10 in chips) 
Seat 6: Ice_Isayev ($10.65 in chips) 
mdelfin0: posts small blind $0.05
Ice_Isayev: posts big blind $0.10
*** HOLE CARDS ***
sexy_seagull: folds 
Kazacha: folds 
Lao Tsy: folds 
VioXion: folds 
mdelfin0: calls $0.05
Ice_Isayev: checks 
*** FLOP *** [7s Js Ah]
mdelfin0: bets $0.10
Ice_Isayev: folds 
Uncalled bet ($0.10) returned to mdelfin0
mdelfin0 collected $0.19 from pot
*** SUMMARY ***
Total pot $0.20 | Rake $0.01 
Board [7s Js Ah]
Seat 1: sexy_seagull folded before Flop (didn't bet)
Seat 2: Kazacha folded before Flop (didn't bet)
Seat 3: Lao Tsy folded before Flop (didn't bet)
Seat 4: VioXion (button) folded before Flop (didn't bet)
Seat 5: mdelfin0 (small blind) collected ($0.19)
Seat 6: Ice_Isayev (big blind) folded on the Flop



PokerStars Hand #166667694428:  Hold'em No Limit ($0.05/$0.10 USD) - 2017/02/23 16:05:49 ET
Table 'Samitchell III' 6-max Seat #5 is the button
Seat 1: dr.goofy ($10.02 in chips) 
Seat 2: scorpionfish ($10.91 in chips) 
Seat 3: Vanne11 ($10 in chips) 
Seat 5: steepfell ($10 in chips) 
Seat 6: fedorka rus ($12.36 in chips) 
fedorka rus: posts small blind $0.05
dr.goofy: posts big blind $0.10
Vanne11: posts big blind $0.10
*** HOLE CARDS ***
scorpionfish: raises $0.20 to $0.30
Vanne11: folds 
steepfell: calls $0.30
fedorka rus: folds 
dr.goofy: calls $0.20
*** FLOP *** [4c 7h 8d]
dr.goofy: checks 
scorpionfish: bets $0.50
steepfell: calls $0.50
dr.goofy: folds 
*** TURN *** [4c 7h 8d] [6c]
scorpionfish: bets $1
steepfell: calls $1
*** RIVER *** [4c 7h 8d 6c] [6s]
scorpionfish: bets $2
steepfell: folds 
Uncalled bet ($2) returned to scorpionfish
scorpionfish collected $3.87 from pot
*** SUMMARY ***
Total pot $4.05 | Rake $0.18 
Board [4c 7h 8d 6c 6s]
Seat 1: dr.goofy (big blind) folded on the Flop
Seat 2: scorpionfish collected ($3.87)
Seat 3: Vanne11 folded before Flop
Seat 5: steepfell (button) folded on the River
Seat 6: fedorka rus (small blind) folded before Flop



PokerStars Hand #166667694539:  Hold'em No Limit ($0.05/$0.10 USD) - 2017/02/23 16:05:49 ET
Table 'Sheragul III' 6-max Seat #4 is the button
Seat 1: danky24 ($18.39 in chips) 
Seat 2: Bird et al ($10.47 in chips) 
Seat 4: maxiv608 ($11.24 in chips) 
Seat 5: Bandyaev ($16.37 in chips) 
Seat 6: Andrei ProFF ($10 in chips) 
Bandyaev: posts small blind $0.05
Andrei ProFF: posts big blind $0.10
FRAID358: sits out 
*** HOLE CARDS ***
danky24: calls $0.10
Bird et al: folds 
maxiv608: raises $0.30 to $0.40
Bandyaev: calls $0.35
Andrei ProFF: folds 
danky24: calls $0.30
*** FLOP *** [Kh 8h 5h]
Bandyaev: checks 
danky24: bets $0.20
maxiv608: calls $0.20
Bandyaev: folds 
*** TURN *** [Kh 8h 5h] [Jd]
danky24: bets $0.10
maxiv608: calls $0.10
*** RIVER *** [Kh 8h 5h Jd] [Th]
danky24: bets $0.10
maxiv608: calls $0.10
*** SHOW DOWN ***
danky24: shows [Ks 9h] (a flush, King high)
maxiv608: mucks hand 
danky24 collected $2.01 from pot
*** SUMMARY ***
Total pot $2.10 | Rake $0.09 
Board [Kh 8h 5h Jd Th]
Seat 1: danky24 showed [Ks 9h] and won ($2.01) with a flush, King high
Seat 2: Bird et al folded before Flop (didn't bet)
Seat 4: maxiv608 (button) mucked
Seat 5: Bandyaev (small blind) folded on the Flop
Seat 6: Andrei ProFF (big blind) folded before Flop



PokerStars Hand #166667694543:  Hold'em No Limit ($0.05/$0.10 USD) - 2017/02/23 16:05:49 ET
Table 'Azelfafage' 6-max Seat #2 is the button
Seat 1: Sbozzz ($15.61 in chips) 
Seat 2: tr41n3r12 ($10.15 in chips) 
Seat 3: todor1711 ($20.52 in chips) 
Seat 4: fedorka rus ($10 in chips) 
Seat 5: 8th wonders ($12.58 in chips) 
Seat 6: KA3AXCTAHEU, ($10.46 in chips) 
todor1711: posts small blind $0.05
fedorka rus: posts big blind $0.10
*** HOLE CARDS ***
8th wonders: raises $0.20 to $0.30
KA3AXCTAHEU,: folds 
Sbozzz: folds 
tr41n3r12: folds 
todor1711: calls $0.25
fedorka rus: folds 
*** FLOP *** [8d 8s 9h]
todor1711: checks 
8th wonders: bets $0.70
todor1711: folds 
Uncalled bet ($0.70) returned to 8th wonders
8th wonders collected $0.67 from pot
*** SUMMARY ***
Total pot $0.70 | Rake $0.03 
Board [8d 8s 9h]
Seat 1: Sbozzz folded before Flop (didn't bet)
Seat 2: tr41n3r12 (button) folded before Flop (didn't bet)
Seat 3: todor1711 (small blind) folded on the Flop
Seat 4: fedorka rus (big blind) folded before Flop
Seat 5: 8th wonders collected ($0.67)
Seat 6: KA3AXCTAHEU, folded before Flop (didn't bet)



PokerStars Hand #166667694564:  Hold'em No Limit ($0.05/$0.10 USD) - 2017/02/23 16:05:49 ET
Table 'Bootes' 6-max Seat #6 is the button
Seat 1: Namhkal ($13.02 in chips) 
Seat 2: Bird et al ($19.30 in chips) 
Seat 3: KA3AXCTAHEU, ($19.23 in chips) 
Seat 4: totonove ($5.02 in chips) 
Seat 6: cherep61987 ($10.22 in chips) 
Namhkal: posts small blind $0.05
Bird et al: posts big blind $0.10
*** HOLE CARDS ***
KA3AXCTAHEU,: folds 
totonove: raises $0.10 to $0.20
cherep61987: folds 
Namhkal: folds 
Bird et al: folds 
Uncalled bet ($0.10) returned to totonove
totonove collected $0.25 from pot
*** SUMMARY ***
Total pot $0.25 | Rake $0 
Seat 1: Namhkal (small blind) folded before Flop
Seat 2: Bird et al (big blind) folded before Flop
Seat 3: KA3AXCTAHEU, folded before Flop (didn't bet)
Seat 4: totonove collected ($0.25)
Seat 6: cherep61987 (button) folded before Flop (didn't bet)



PokerStars Hand #166667694594:  Hold'em No Limit ($0.05/$0.10 USD) - 2017/02/23 16:05:49 ET
Table 'Lorbach' 6-max Seat #6 is the button
Seat 1: LarryTheStar ($14.58 in chips) 
Seat 3: ArcticBearDK ($10.15 in chips) 
Seat 4: McCleans ($10 in chips) 
Seat 5: Cluckh ($14.47 in chips) 
Seat 6: Worlz ($15.73 in chips) 
LarryTheStar: posts small blind $0.05
ArcticBearDK: posts big blind $0.10
*** HOLE CARDS ***
McCleans: folds 
Cluckh: folds 
Worlz: folds 
LarryTheStar: raises $0.20 to $0.30
ArcticBearDK: calls $0.20
*** FLOP *** [5d 4s Ac]
LarryTheStar: bets $0.40
ArcticBearDK: raises $0.70 to $1.10
LarryTheStar: calls $0.70
*** TURN *** [5d 4s Ac] [5h]
LarryTheStar: checks 
ArcticBearDK: checks 
*** RIVER *** [5d 4s Ac 5h] [8s]
LarryTheStar: checks 
ArcticBearDK: checks 
*** SHOW DOWN ***
LarryTheStar: shows [As 6s] (two pair, Aces and Fives)
ArcticBearDK: mucks hand 
LarryTheStar collected $2.67 from pot
*** SUMMARY ***
Total pot $2.80 | Rake $0.13 
Board [5d 4s Ac 5h 8s]
Seat 1: LarryTheStar (small blind) showed [As 6s] and won ($2.67) with two pair, Aces and Fives
Seat 3: ArcticBearDK (big blind) mucked
Seat 4: McCleans folded before Flop (didn't bet)
Seat 5: Cluckh folded before Flop (didn't bet)
Seat 6: Worlz (button) folded before Flop (didn't bet)



PokerStars Hand #166667694644:  Hold'em No Limit ($0.05/$0.10 USD) - 2017/02/23 16:05:49 ET
Table 'Pirola III' 6-max Seat #1 is the button
Seat 1: bdixon_5 ($9.32 in chips) 
Seat 3: kingartur222 ($10.72 in chips) 
Seat 4: McCleans ($10.72 in chips) 
Seat 5: tequila_joop ($10.55 in chips) 
Seat 6: T9MS ($10 in chips) 
Chodemuncher will be allowed to play after the button
kingartur222: posts small blind $0.05
McCleans: posts big blind $0.10
*** HOLE CARDS ***
tequila_joop: folds 
T9MS: folds 
bdixon_5: raises $0.20 to $0.30
kingartur222: folds 
McCleans: folds 
Uncalled bet ($0.20) returned to bdixon_5
bdixon_5 collected $0.25 from pot
*** SUMMARY ***
Total pot $0.25 | Rake $0 
Seat 1: bdixon_5 (button) collected ($0.25)
Seat 3: kingartur222 (small blind) folded before Flop
Seat 4: McCleans (big blind) folded before Flop
Seat 5: tequila_joop folded before Flop (didn't bet)
Seat 6: T9MS folded before Flop (didn't bet)



PokerStars Hand #166667694789:  Hold'em No Limit ($0.05/$0.10 USD) - 2017/02/23 16:05:50 ET
Table 'Emma II' 6-max Seat #6 is the button
Seat 1: LarryTheStar ($10 in chips) 
Seat 2: T9MS ($11.79 in chips) 
Seat 3: oddshoff ($9.52 in chips) 
Seat 4: Jucatorul823 ($6.24 in chips) 
Seat 5: Scanner17 ($11.06 in chips) 
Seat 6: CHRO8 ($14.67 in chips) 
LarryTheStar: posts small blind $0.05
T9MS: posts big blind $0.10
*** HOLE CARDS ***
oddshoff: folds 
Jucatorul823: folds 
Scanner17: folds 
CHRO8: folds 
LarryTheStar: raises $0.20 to $0.30
T9MS: folds 
Uncalled bet ($0.20) returned to LarryTheStar
LarryTheStar collected $0.20 from pot
*** SUMMARY ***
Total pot $0.20 | Rake $0 
Seat 1: LarryTheStar (small blind) collected ($0.20)
Seat 2: T9MS (big blind) folded before Flop
Seat 3: oddshoff folded before Flop (didn't bet)
Seat 4: Jucatorul823 folded before Flop (didn't bet)
Seat 5: Scanner17 folded before Flop (didn't bet)
Seat 6: CHRO8 (button) folded before Flop (didn't bet)



PokerStars Hand #166667694790:  Hold'em No Limit ($0.05/$0.10 USD) - 2017/02/23 16:05:50 ET
Table 'Alzirr II' 6-max Seat #1 is the button
Seat 1: KA3AXCTAHEU, ($10.16 in chips) 
Seat 2: popypaleta ($10.22 in chips) 
Seat 3: devon_red ($8 in chips) 
Seat 5: yodzik ($5.37 in chips) 
Seat 6: AM-L-SL ($4.74 in chips) 
popypaleta: posts small blind $0.05
devon_red: posts big blind $0.10
*** HOLE CARDS ***
yodzik: folds 
AM-L-SL: folds 
KA3AXCTAHEU,: raises $0.15 to $0.25
popypaleta: folds 
devon_red: folds 
Uncalled bet ($0.15) returned to KA3AXCTAHEU,
KA3AXCTAHEU, collected $0.25 from pot
*** SUMMARY ***
Total pot $0.25 | Rake $0 
Seat 1: KA3AXCTAHEU, (button) collected ($0.25)
Seat 2: popypaleta (small blind) folded before Flop
Seat 3: devon_red (big blind) folded before Flop
Seat 5: yodzik folded before Flop (didn't bet)
Seat 6: AM-L-SL folded before Flop (didn't bet)



PokerStars Hand #166667695021:  Hold'em No Limit ($0.05/$0.10 USD) - 2017/02/23 16:05:50 ET
Table 'Eurydome II' 6-max Seat #6 is the button
Seat 1: rusu_rapid ($11.73 in chips) 
Seat 3: gaHy_HaXeP ($10 in chips) 
Seat 4: Smitty03300 ($10.32 in chips) 
Seat 5: kush-killa87 ($10.49 in chips) 
Seat 6: Jucatorul823 ($6.70 in chips) 
rusu_rapid: posts small blind $0.05
Elinaattor: is sitting out 
gaHy_HaXeP: posts big blind $0.10
*** HOLE CARDS ***
Smitty03300: folds 
kush-killa87: folds 
Jucatorul823: folds 
rusu_rapid: raises $0.20 to $0.30
gaHy_HaXeP: folds 
Uncalled bet ($0.20) returned to rusu_rapid
rusu_rapid collected $0.20 from pot
*** SUMMARY ***
Total pot $0.20 | Rake $0 
Seat 1: rusu_rapid (small blind) collected ($0.20)
Seat 3: gaHy_HaXeP (big blind) folded before Flop
Seat 4: Smitty03300 folded before Flop (didn't bet)
Seat 5: kush-killa87 folded before Flop (didn't bet)
Seat 6: Jucatorul823 (button) folded before Flop (didn't bet)



PokerStars Hand #166667695126:  Hold'em No Limit ($0.05/$0.10 USD) - 2017/02/23 16:05:50 ET
Table 'Stroobantia' 6-max Seat #5 is the button
Seat 1: mam9zyc ($8.59 in chips) 
Seat 2: XwinX25 ($10.30 in chips) 
Seat 3: Namhkal ($10 in chips) 
Seat 4: Yspenyanin ($10 in chips) 
Seat 5: boxer821 ($11.24 in chips) 
Seat 6: KokoulinV ($15.72 in chips) 
KokoulinV: posts small blind $0.05
mam9zyc: posts big blind $0.10
*** HOLE CARDS ***
XwinX25: folds 
Namhkal: folds 
Yspenyanin: folds 
boxer821: raises $0.15 to $0.25
KokoulinV: folds 
mam9zyc: calls $0.15
*** FLOP *** [2s 8h 9s]
mam9zyc: bets $0.10
boxer821: folds 
Uncalled bet ($0.10) returned to mam9zyc
mam9zyc collected $0.53 from pot
*** SUMMARY ***
Total pot $0.55 | Rake $0.02 
Board [2s 8h 9s]
Seat 1: mam9zyc (big blind) collected ($0.53)
Seat 2: XwinX25 folded before Flop (didn't bet)
Seat 3: Namhkal folded before Flop (didn't bet)
Seat 4: Yspenyanin folded before Flop (didn't bet)
Seat 5: boxer821 (button) folded on the Flop
Seat 6: KokoulinV (small blind) folded before Flop



PokerStars Hand #166667695147:  Hold'em No Limit ($0.05/$0.10 USD) - 2017/02/23 16:05:50 ET
Table 'Isberga' 6-max Seat #5 is the button
Seat 1: Feverhead ($18.32 in chips) 
Seat 2: GESPERIA ($10.27 in chips) 
Seat 4: THIMUCHIN ($10.69 in chips) 
Seat 5: YoungGriff86 ($18.87 in chips) 
Seat 6: Goroshkos88 ($21.28 in chips) 
Goroshkos88: posts small blind $0.05
Feverhead: posts big blind $0.10
*** HOLE CARDS ***
GESPERIA: folds 
THIMUCHIN: raises $0.15 to $0.25
YoungGriff86: folds 
Goroshkos88: folds 
Feverhead: folds 
Uncalled bet ($0.15) returned to THIMUCHIN
THIMUCHIN collected $0.25 from pot
*** SUMMARY ***
Total pot $0.25 | Rake $0 
Seat 1: Feverhead (big blind) folded before Flop
Seat 2: GESPERIA folded before Flop (didn't bet)
Seat 4: THIMUCHIN collected ($0.25)
Seat 5: YoungGriff86 (button) folded before Flop (didn't bet)
Seat 6: Goroshkos88 (small blind) folded before Flop



PokerStars Hand #166667695193:  Hold'em No Limit ($0.05/$0.10 USD) - 2017/02/23 16:05:50 ET
Table 'Virginia II' 6-max Seat #5 is the button
Seat 1: Iarlei ($11.56 in chips) 
Seat 2: Yspenyanin ($10 in chips) 
Seat 3: garigura ($15.26 in chips) 
Seat 4: onkelottoHH ($11.03 in chips) 
Seat 5: dr.goofy ($20.53 in chips) 
Seat 6: NvR.m1nD ($10 in chips) 
NvR.m1nD: posts small blind $0.05
Iarlei: posts big blind $0.10
*** HOLE CARDS ***
Yspenyanin: folds 
garigura: folds 
onkelottoHH: raises $0.20 to $0.30
dr.goofy: raises $0.60 to $0.90
NvR.m1nD: folds 
Iarlei: folds 
onkelottoHH: folds 
Uncalled bet ($0.60) returned to dr.goofy
dr.goofy collected $0.75 from pot
*** SUMMARY ***
Total pot $0.75 | Rake $0 
Seat 1: Iarlei (big blind) folded before Flop
Seat 2: Yspenyanin folded before Flop (didn't bet)
Seat 3: garigura folded before Flop (didn't bet)
Seat 4: onkelottoHH folded before Flop
Seat 5: dr.goofy (button) collected ($0.75)
Seat 6: NvR.m1nD (small blind) folded before Flop



PokerStars Hand #166667695238:  Hold'em No Limit ($0.05/$0.10 USD) - 2017/02/23 16:05:50 ET
Table 'Alnasl' 6-max Seat #6 is the button
Seat 1: KA3AXCTAHEU, ($10.97 in chips) 
Seat 2: saddur ($10.14 in chips) 
Seat 3: david_sara83 ($22.69 in chips) 
Seat 4: oddshoff ($9.83 in chips) 
Seat 6: Zooplack ($13.43 in chips) 
KA3AXCTAHEU,: posts small blind $0.05
saddur: posts big blind $0.10
6ePeMeHHa9: sits out 
*** HOLE CARDS ***
david_sara83: folds 
oddshoff: folds 
Zooplack: folds 
KA3AXCTAHEU,: raises $0.15 to $0.25
saddur: calls $0.15
*** FLOP *** [3s Kd 6h]
KA3AXCTAHEU,: bets $0.28
saddur: folds 
Uncalled bet ($0.28) returned to KA3AXCTAHEU,
KA3AXCTAHEU, collected $0.48 from pot
*** SUMMARY ***
Total pot $0.50 | Rake $0.02 
Board [3s Kd 6h]
Seat 1: KA3AXCTAHEU, (small blind) collected ($0.48)
Seat 2: saddur (big blind) folded on the Flop
Seat 3: david_sara83 folded before Flop (didn't bet)
Seat 4: oddshoff folded before Flop (didn't bet)
Seat 6: Zooplack (button) folded before Flop (didn't bet)



PokerStars Hand #166667695625:  Hold'em No Limit ($0.05/$0.10 USD) - 2017/02/23 16:05:50 ET
Table 'Eudora' 6-max Seat #4 is the button
Seat 1: archer2511 ($11.61 in chips) 
Seat 2: popypaleta ($10 in chips) 
Seat 3: Ice_Isayev ($10 in chips) 
Seat 4: yodzik ($5.30 in chips) 
Seat 5: chimera252 ($11.57 in chips) 
chimera252: posts small blind $0.05
archer2511: posts big blind $0.10
*** HOLE CARDS ***
popypaleta: folds 
Ice_Isayev: folds 
yodzik: folds 
chimera252: raises $0.20 to $0.30
archer2511: folds 
Uncalled bet ($0.20) returned to chimera252
chimera252 collected $0.20 from pot
*** SUMMARY ***
Total pot $0.20 | Rake $0 
Seat 1: archer2511 (big blind) folded before Flop
Seat 2: popypaleta folded before Flop (didn't bet)
Seat 3: Ice_Isayev folded before Flop (didn't bet)
Seat 4: yodzik (button) folded before Flop (didn't bet)
Seat 5: chimera252 (small blind) collected ($0.20)



PokerStars Hand #166667695746:  Hold'em No Limit ($0.05/$0.10 USD) - 2017/02/23 16:05:51 ET
Table 'Gelria' 6-max Seat #5 is the button
Seat 1: ab260414 ($10.57 in chips) 
Seat 2: fishhook5 ($10 in chips) 
Seat 3: Orlangoor ($11.78 in chips) 
Seat 5: apenvel ($7.80 in chips) 
Seat 6: Andrei ProFF ($10.32 in chips) 
Andrei ProFF: posts small blind $0.05
ab260414: posts big blind $0.10
eniksenik: sits out 
*** HOLE CARDS ***
fishhook5: folds 
Orlangoor: folds 
apenvel: folds 
Andrei ProFF: folds 
Uncalled bet ($0.05) returned to ab260414
ab260414 collected $0.10 from pot
*** SUMMARY ***
Total pot $0.10 | Rake $0 
Seat 1: ab260414 (big blind) collected ($0.10)
Seat 2: fishhook5 folded before Flop (didn't bet)
Seat 3: Orlangoor folded before Flop (didn't bet)
Seat 5: apenvel (button) folded before Flop (didn't bet)
Seat 6: Andrei ProFF (small blind) folded before Flop



PokerStars Hand #166667695891:  Hold'em No Limit ($0.05/$0.10 USD) - 2017/02/23 16:05:51 ET
Table 'Gaika' 6-max Seat #4 is the button
Seat 1: oddshoff ($15.53 in chips) 
Seat 2: NvR.m1nD ($22.05 in chips) 
Seat 3: david_sara83 ($10.17 in chips) 
Seat 4: fortieth ($11.35 in chips) 
Seat 5: fedorka rus ($10.70 in chips) 
Seat 6: dr.goofy ($10 in chips) 
fedorka rus: posts small blind $0.05
dr.goofy: posts big blind $0.10
*** HOLE CARDS ***
oddshoff: folds 
NvR.m1nD: folds 
david_sara83: raises $0.15 to $0.25
fortieth: folds 
fedorka rus: raises $0.65 to $0.90
dr.goofy: folds 
david_sara83: calls $0.65
*** FLOP *** [8d 6s Jh]
fedorka rus: checks 
david_sara83: checks 
*** TURN *** [8d 6s Jh] [6h]
fedorka rus: checks 
david_sara83: checks 
*** RIVER *** [8d 6s Jh 6h] [6d]
fedorka rus: checks 
david_sara83: checks 
*** SHOW DOWN ***
fedorka rus: shows [As Ks] (three of a kind, Sixes)
david_sara83: mucks hand 
fedorka rus collected $1.81 from pot
*** SUMMARY ***
Total pot $1.90 | Rake $0.09 
Board [8d 6s Jh 6h 6d]
Seat 1: oddshoff folded before Flop (didn't bet)
Seat 2: NvR.m1nD folded before Flop (didn't bet)
Seat 3: david_sara83 mucked
Seat 4: fortieth (button) folded before Flop (didn't bet)
Seat 5: fedorka rus (small blind) showed [As Ks] and won ($1.81) with three of a kind, Sixes
Seat 6: dr.goofy (big blind) folded before Flop



PokerStars Hand #166667695934:  Hold'em No Limit ($0.05/$0.10 USD) - 2017/02/23 16:05:51 ET
Table 'Garlena III' 6-max Seat #2 is the button
Seat 1: dittoro ($10 in chips) 
Seat 2: rusu_rapid ($10 in chips) 
Seat 3: Therodorus ($10.05 in chips) 
Therodorus: posts small blind $0.05
dittoro: posts big blind $0.10
*** HOLE CARDS ***
rusu_rapid: raises $0.15 to $0.25
iluzja12 joins the table at seat #6 
Therodorus: folds 
steepfell joins the table at seat #5 
dittoro: folds 
Uncalled bet ($0.15) returned to rusu_rapid
rusu_rapid collected $0.25 from pot
*** SUMMARY ***
Total pot $0.25 | Rake $0 
Seat 1: dittoro (big blind) folded before Flop
Seat 2: rusu_rapid (button) collected ($0.25)
Seat 3: Therodorus (small blind) folded before Flop



PokerStars Hand #166667696066:  Hold'em No Limit ($0.05/$0.10 USD) - 2017/02/23 16:05:51 ET
Table 'Rostia' 6-max Seat #1 is the button
Seat 1: paxit71 ($7.88 in chips) 
Seat 2: david_sara83 ($18.91 in chips) 
Seat 3: iThreeBarrel ($10 in chips) 
Seat 4: Hyd SK ($11.68 in chips) 
Seat 5: silsilviu ($7.37 in chips) 
Seat 6: Giyorod ($10.70 in chips) 
david_sara83: posts small blind $0.05
iThreeBarrel: posts big blind $0.10
*** HOLE CARDS ***
Hyd SK: folds 
silsilviu: folds 
Giyorod: folds 
paxit71: folds 
david_sara83: raises $0.20 to $0.30
iThreeBarrel: folds 
Uncalled bet ($0.20) returned to david_sara83
david_sara83 collected $0.20 from pot
*** SUMMARY ***
Total pot $0.20 | Rake $0 
Seat 1: paxit71 (button) folded before Flop (didn't bet)
Seat 2: david_sara83 (small blind) collected ($0.20)
Seat 3: iThreeBarrel (big blind) folded before Flop
Seat 4: Hyd SK folded before Flop (didn't bet)
Seat 5: silsilviu folded before Flop (didn't bet)
Seat 6: Giyorod folded before Flop (didn't bet)



PokerStars Hand #166667696389:  Hold'em No Limit ($0.05/$0.10 USD) - 2017/02/23 16:05:51 ET
Table 'Thia' 6-max Seat #2 is the button
Seat 1: Eddys Edge ($10.87 in chips) 
Seat 2: sugrob86 ($19.35 in chips) 
Seat 3: northug18 ($8.89 in chips) 
Seat 4: Bandyaev ($10.35 in chips) 
Seat 5: ab260414 ($10.57 in chips) 
Seat 6: ex3Lero86 ($15.45 in chips) 
northug18: posts small blind $0.05
Bandyaev: posts big blind $0.10
*** HOLE CARDS ***
ab260414: raises $0.20 to $0.30
ex3Lero86: folds 
Eddys Edge: folds 
sugrob86: calls $0.30
northug18: folds 
Bandyaev: folds 
*** FLOP *** [2s Jh 4s]
ab260414: checks 
sugrob86: checks 
*** TURN *** [2s Jh 4s] [Qc]
ab260414: bets $0.60
sugrob86: folds 
Uncalled bet ($0.60) returned to ab260414
ab260414 collected $0.72 from pot
*** SUMMARY ***
Total pot $0.75 | Rake $0.03 
Board [2s Jh 4s Qc]
Seat 1: Eddys Edge folded before Flop (didn't bet)
Seat 2: sugrob86 (button) folded on the Turn
Seat 3: northug18 (small blind) folded before Flop
Seat 4: Bandyaev (big blind) folded before Flop
Seat 5: ab260414 collected ($0.72)
Seat 6: ex3Lero86 folded before Flop (didn't bet)



PokerStars Hand #166667696550:  Hold'em No Limit ($0.05/$0.10 USD) - 2017/02/23 16:05:51 ET
Table 'Jokaste II' 6-max Seat #3 is the button
Seat 1: Hyd SK ($13.55 in chips) 
Seat 2: T9MS ($12.33 in chips) 
Seat 3: crazydevill ($10 in chips) 
Seat 4: FRAID358 ($15.26 in chips) 
Seat 5: Vrinni ($10.28 in chips) 
Seat 6: Adailton07 ($15.20 in chips) 
FRAID358: posts small blind $0.05
Vrinni: posts big blind $0.10
*** HOLE CARDS ***
Adailton07: raises $0.20 to $0.30
Hyd SK: folds 
T9MS: folds 
crazydevill: raises $0.60 to $0.90
FRAID358: folds 
Vrinni: folds 
Adailton07: calls $0.60
*** FLOP *** [Ks 8c 7h]
Adailton07: checks 
crazydevill: bets $1.50
Adailton07: folds 
Uncalled bet ($1.50) returned to crazydevill
crazydevill collected $1.86 from pot
*** SUMMARY ***
Total pot $1.95 | Rake $0.09 
Board [Ks 8c 7h]
Seat 1: Hyd SK folded before Flop (didn't bet)
Seat 2: T9MS folded before Flop (didn't bet)
Seat 3: crazydevill (button) collected ($1.86)
Seat 4: FRAID358 (small blind) folded before Flop
Seat 5: Vrinni (big blind) folded before Flop
Seat 6: Adailton07 folded on the Flop



PokerStars Hand #166667697049:  Hold'em No Limit ($0.05/$0.10 USD) - 2017/02/23 16:05:52 ET
Table 'Wingolfia II' 6-max Seat #2 is the button
Seat 1: BahiaMinhaP ($10.32 in chips) 
Seat 2: NvR.m1nD ($10.25 in chips) 
Seat 3: truck1234 ($10.41 in chips) 
Seat 4: zlobslob ($18.02 in chips) 
Seat 5: tr41n3r12 ($11.43 in chips) 
Seat 6: EphemeralBen ($11.84 in chips) 
truck1234: posts small blind $0.05
zlobslob: posts big blind $0.10
*** HOLE CARDS ***
tr41n3r12: folds 
EphemeralBen: raises $0.20 to $0.30
BahiaMinhaP: folds 
NvR.m1nD: folds 
truck1234: folds 
zlobslob: folds 
Uncalled bet ($0.20) returned to EphemeralBen
EphemeralBen collected $0.25 from pot
*** SUMMARY ***
Total pot $0.25 | Rake $0 
Seat 1: BahiaMinhaP folded before Flop (didn't bet)
Seat 2: NvR.m1nD (button) folded before Flop (didn't bet)
Seat 3: truck1234 (small blind) folded before Flop
Seat 4: zlobslob (big blind) folded before Flop
Seat 5: tr41n3r12 folded before Flop (didn't bet)
Seat 6: EphemeralBen collected ($0.25)



PokerStars Hand #166667697331:  Hold'em No Limit ($0.05/$0.10 USD) - 2017/02/23 16:05:52 ET
Table 'Lacroute' 6-max Seat #3 is the button
Seat 1: johnnyPieper ($3.97 in chips) 
Seat 2: Andy Wolf ($10 in chips) 
Seat 3: Croplayer1 ($14.75 in chips) 
Seat 4: st4tion ($17.42 in chips) 
Seat 5: steepfell ($11.29 in chips) 
Seat 6: IAntikI ($10.42 in chips) 
st4tion: posts small blind $0.05
steepfell: posts big blind $0.10
*** HOLE CARDS ***
IAntikI: raises $0.20 to $0.30
johnnyPieper: folds 
johnnyPieper leaves the table
Orlangoor joins the table at seat #1 
Andy Wolf: calls $0.30
Croplayer1: calls $0.30
st4tion: folds 
steepfell: raises $1.20 to $1.50
IAntikI: folds 
Andy Wolf: folds 
Croplayer1: folds 
Uncalled bet ($1.20) returned to steepfell
steepfell collected $1.25 from pot
*** SUMMARY ***
Total pot $1.25 | Rake $0 
Seat 1: johnnyPieper folded before Flop (didn't bet)
Seat 2: Andy Wolf folded before Flop
Seat 3: Croplayer1 (button) folded before Flop
Seat 4: st4tion (small blind) folded before Flop
Seat 5: steepfell (big blind) collected ($1.25)
Seat 6: IAntikI folded before Flop



PokerStars Hand #166667697414:  Hold'em No Limit ($0.05/$0.10 USD) - 2017/02/23 16:05:52 ET
Table 'Pallas II' 6-max Seat #3 is the button
Seat 1: mdelfin0 ($15.48 in chips) 
Seat 2: FRAID358 ($10.35 in chips) 
Seat 3: KRZuff ($10 in chips) 
Seat 5: Yspenyanin ($19.61 in chips) 
Seat 6: Asilvagoat ($10 in chips) 
MisterX413 will be allowed to play after the button
Yspenyanin: posts small blind $0.05
Asilvagoat: posts big blind $0.10
*** HOLE CARDS ***
mdelfin0: folds 
FRAID358: folds 
KRZuff: folds 
Yspenyanin: folds 
Uncalled bet ($0.05) returned to Asilvagoat
Asilvagoat collected $0.10 from pot
*** SUMMARY ***
Total pot $0.10 | Rake $0 
Seat 1: mdelfin0 folded before Flop (didn't bet)
Seat 2: FRAID358 folded before Flop (didn't bet)
Seat 3: KRZuff (button) folded before Flop (didn't bet)
Seat 5: Yspenyanin (small blind) folded before Flop
Seat 6: Asilvagoat (big blind) collected ($0.10)



PokerStars Hand #166667697717:  Hold'em No Limit ($0.05/$0.10 USD) - 2017/02/23 16:05:53 ET
Table 'Ebella II' 6-max Seat #1 is the button
Seat 1: gaHy_HaXeP ($10 in chips) 
Seat 2: Therodorus ($10 in chips) 
Seat 3: Torften2 ($16.48 in chips) 
Seat 4: ValdemorS ($11.50 in chips) 
Seat 5: Bird et al ($10 in chips) 
Seat 6: Joker51_wtf! ($11.24 in chips) 
Therodorus: posts small blind $0.05
Torften2: posts big blind $0.10
*** HOLE CARDS ***
ValdemorS: folds 
Bird et al: folds 
Joker51_wtf!: folds 
gaHy_HaXeP: raises $0.12 to $0.22
Therodorus: folds 
Torften2: calls $0.12
*** FLOP *** [2c Th 8s]
Torften2: checks 
gaHy_HaXeP: checks 
*** TURN *** [2c Th 8s] [9d]
Torften2: bets $0.30
gaHy_HaXeP: calls $0.30
*** RIVER *** [2c Th 8s 9d] [As]
Torften2: bets $0.70
gaHy_HaXeP: folds 
Uncalled bet ($0.70) returned to Torften2
Torften2 collected $1.04 from pot
*** SUMMARY ***
Total pot $1.09 | Rake $0.05 
Board [2c Th 8s 9d As]
Seat 1: gaHy_HaXeP (button) folded on the River
Seat 2: Therodorus (small blind) folded before Flop
Seat 3: Torften2 (big blind) collected ($1.04)
Seat 4: ValdemorS folded before Flop (didn't bet)
Seat 5: Bird et al folded before Flop (didn't bet)
Seat 6: Joker51_wtf! folded before Flop (didn't bet)



PokerStars Hand #166667697871:  Hold'em No Limit ($0.05/$0.10 USD) - 2017/02/23 16:05:53 ET
Table 'Lederle' 6-max Seat #3 is the button
Seat 2: truck1234 ($15.85 in chips) 
Seat 3: Kazacha ($10.15 in chips) 
Seat 4: Pokeaster ($13.81 in chips) 
Seat 5: 8th wonders ($14.33 in chips) 
Seat 6: pokekrk ($10.10 in chips) 
Pokeaster: posts small blind $0.05
8th wonders: posts big blind $0.10
*** HOLE CARDS ***
pokekrk: folds 
truck1234: raises $0.30 to $0.40
Kazacha: calls $0.40
Pokeaster: folds 
8th wonders: folds 
*** FLOP *** [6c Ad 8d]
truck1234: bets $0.60
Kazacha: calls $0.60
*** TURN *** [6c Ad 8d] [Qs]
truck1234: checks 
D3NyA leaves the table
Kazacha: bets $2.50
Sterjek joins the table at seat #1 
truck1234: folds 
Uncalled bet ($2.50) returned to Kazacha
Kazacha collected $2.05 from pot
*** SUMMARY ***
Total pot $2.15 | Rake $0.10 
Board [6c Ad 8d Qs]
Seat 2: truck1234 folded on the Turn
Seat 3: Kazacha (button) collected ($2.05)
Seat 4: Pokeaster (small blind) folded before Flop
Seat 5: 8th wonders (big blind) folded before Flop
Seat 6: pokekrk folded before Flop (didn't bet)



PokerStars Hand #166667697948:  Hold'em No Limit ($0.05/$0.10 USD) - 2017/02/23 16:05:53 ET
Table 'Atropos' 6-max Seat #1 is the button
Seat 1: ScorpionF39 ($1.92 in chips) 
Seat 2: yodzik ($5 in chips) 
Seat 3: NvR.m1nD ($10 in chips) 
Seat 4: iDecMate ($11.12 in chips) 
Seat 5: KokoulinV ($12.09 in chips) 
Seat 6: Iarlei ($12.58 in chips) 
yodzik: posts small blind $0.05
NvR.m1nD: posts big blind $0.10
*** HOLE CARDS ***
iDecMate: folds 
KokoulinV: folds 
Iarlei: folds 
ScorpionF39: raises $0.10 to $0.20
yodzik: folds 
NvR.m1nD: folds 
Uncalled bet ($0.10) returned to ScorpionF39
ScorpionF39 collected $0.25 from pot
*** SUMMARY ***
Total pot $0.25 | Rake $0 
Seat 1: ScorpionF39 (button) collected ($0.25)
Seat 2: yodzik (small blind) folded before Flop
Seat 3: NvR.m1nD (big blind) folded before Flop
Seat 4: iDecMate folded before Flop (didn't bet)
Seat 5: KokoulinV folded before Flop (didn't bet)
Seat 6: Iarlei folded before Flop (didn't bet)



PokerStars Hand #166667697977:  Hold'em No Limit ($0.05/$0.10 USD) - 2017/02/23 16:05:53 ET
Table 'Hajek III' 6-max Seat #3 is the button
Seat 1: MBen10 ($10.60 in chips) 
Seat 2: fortieth ($10.19 in chips) 
Seat 3: fedorka rus ($10.61 in chips) 
Seat 4: NvR.m1nD ($13.29 in chips) 
Seat 5: Croplayer1 ($14.90 in chips) 
NvR.m1nD: posts small blind $0.05
Croplayer1: posts big blind $0.10
*** HOLE CARDS ***
MBen10: folds 
fortieth: folds 
fedorka rus: folds 
NvR.m1nD: raises $0.15 to $0.25
Croplayer1: calls $0.15
*** FLOP *** [Kh Kc Qs]
NvR.m1nD: bets $0.25
Croplayer1: folds 
Uncalled bet ($0.25) returned to NvR.m1nD
NvR.m1nD collected $0.48 from pot
*** SUMMARY ***
Total pot $0.50 | Rake $0.02 
Board [Kh Kc Qs]
Seat 1: MBen10 folded before Flop (didn't bet)
Seat 2: fortieth folded before Flop (didn't bet)
Seat 3: fedorka rus (button) folded before Flop (didn't bet)
Seat 4: NvR.m1nD (small blind) collected ($0.48)
Seat 5: Croplayer1 (big blind) folded on the Flop



PokerStars Hand #166667698112:  Hold'em No Limit ($0.05/$0.10 USD) - 2017/02/23 16:05:53 ET
Table 'Hyakutake' 6-max Seat #1 is the button
Seat 1: Asilvagoat ($12.32 in chips) 
Seat 2: boxer821 ($10.69 in chips) 
Seat 3: lenboysprite ($5.94 in chips) 
Seat 4: eniksenik ($13.80 in chips) 
Seat 5: RoJ1 ($11.44 in chips) 
Seat 6: maxiv608 ($13.42 in chips) 
boxer821: posts small blind $0.05
lenboysprite: posts big blind $0.10
*** HOLE CARDS ***
eniksenik: raises $0.20 to $0.30
RoJ1: calls $0.30
maxiv608: folds 
Asilvagoat: folds 
boxer821: folds 
lenboysprite: calls $0.20
*** FLOP *** [6h Qh Th]
lenboysprite: checks 
eniksenik: checks 
RoJ1: checks 
*** TURN *** [6h Qh Th] [8c]
lenboysprite: checks 
eniksenik: checks 
RoJ1: checks 
*** RIVER *** [6h Qh Th 8c] [Jh]
lenboysprite: checks 
eniksenik: checks 
RoJ1: checks 
*** SHOW DOWN ***
lenboysprite: shows [Qd 4d] (a pair of Queens)
eniksenik: shows [2d 2h] (a flush, Queen high)
RoJ1: mucks hand 
eniksenik collected $0.91 from pot
*** SUMMARY ***
Total pot $0.95 | Rake $0.04 
Board [6h Qh Th 8c Jh]
Seat 1: Asilvagoat (button) folded before Flop (didn't bet)
Seat 2: boxer821 (small blind) folded before Flop
Seat 3: lenboysprite (big blind) showed [Qd 4d] and lost with a pair of Queens
Seat 4: eniksenik showed [2d 2h] and won ($0.91) with a flush, Queen high
Seat 5: RoJ1 mucked
Seat 6: maxiv608 folded before Flop (didn't bet)



PokerStars Hand #166667698235:  Hold'em No Limit ($0.05/$0.10 USD) - 2017/02/23 16:05:53 ET
Table 'Clavel' 6-max Seat #2 is the button
Seat 1: KRZuff ($14.51 in chips) 
Seat 2: Namhkal ($10 in chips) 
Seat 4: Dcaro31 ($11.88 in chips) 
Seat 5: Vrinni ($10.14 in chips) 
Seat 6: Gra_anD77 ($4.70 in chips) 
Dcaro31: posts small blind $0.05
Vrinni: posts big blind $0.10
*** HOLE CARDS ***
Gra_anD77: folds 
KRZuff: raises $0.20 to $0.30
Namhkal: folds 
Dcaro31: folds 
Vrinni: folds 
Uncalled bet ($0.20) returned to KRZuff
KRZuff collected $0.25 from pot
*** SUMMARY ***
Total pot $0.25 | Rake $0 
Seat 1: KRZuff collected ($0.25)
Seat 2: Namhkal (button) folded before Flop (didn't bet)
Seat 4: Dcaro31 (small blind) folded before Flop
Seat 5: Vrinni (big blind) folded before Flop
Seat 6: Gra_anD77 folded before Flop (didn't bet)



PokerStars Hand #166667698244:  Hold'em No Limit ($0.05/$0.10 USD) - 2017/02/23 16:05:53 ET
Table 'Rotraut' 6-max Seat #5 is the button
Seat 2: Newqbrown ($12.20 in chips) 
Seat 3: FlackoD ($11.22 in chips) 
Seat 5: Bird et al ($11.75 in chips) 
Seat 6: KokoulinV ($12.49 in chips) 
KokoulinV: posts small blind $0.05
Newqbrown: posts big blind $0.10
*** HOLE CARDS ***
FlackoD: folds 
Bird et al: folds 
KokoulinV: raises $0.20 to $0.30
Newqbrown: folds 
Uncalled bet ($0.20) returned to KokoulinV
KokoulinV collected $0.20 from pot
*** SUMMARY ***
Total pot $0.20 | Rake $0 
Seat 2: Newqbrown (big blind) folded before Flop
Seat 3: FlackoD folded before Flop (didn't bet)
Seat 5: Bird et al (button) folded before Flop (didn't bet)
Seat 6: KokoulinV (small blind) collected ($0.20)



PokerStars Hand #166667698359:  Hold'em No Limit ($0.05/$0.10 USD) - 2017/02/23 16:05:53 ET
Table 'Antinous' 6-max Seat #5 is the button
Seat 1: Andrei ProFF ($15.68 in chips) 
Seat 2: Nr847 ($13.60 in chips) 
Seat 3: dittoro ($10.15 in chips) 
Seat 5: Covetsoles ($3.58 in chips) 
Seat 6: coolisses111 ($10.10 in chips) 
coolisses111: posts small blind $0.05
Andrei ProFF: posts big blind $0.10
*** HOLE CARDS ***
Nr847: folds 
dittoro: folds 
Covetsoles: calls $0.10
coolisses111: calls $0.05
Andrei ProFF: raises $0.80 to $0.90
Covetsoles: folds 
coolisses111: folds 
Uncalled bet ($0.80) returned to Andrei ProFF
Andrei ProFF collected $0.30 from pot
*** SUMMARY ***
Total pot $0.30 | Rake $0 
Seat 1: Andrei ProFF (big blind) collected ($0.30)
Seat 2: Nr847 folded before Flop (didn't bet)
Seat 3: dittoro folded before Flop (didn't bet)
Seat 5: Covetsoles (button) folded before Flop
Seat 6: coolisses111 (small blind) folded before Flop



PokerStars Hand #166667698412:  Hold'em No Limit ($0.05/$0.10 USD) - 2017/02/23 16:05:53 ET
Table 'Crommelin II' 6-max Seat #2 is the button
Seat 1: THIMUCHIN ($11.62 in chips) 
Seat 2: Bird et al ($10.15 in chips) 
Seat 3: Strelok1974 ($21.70 in chips) 
Seat 4: Pequeño Clau ($13.12 in chips) 
Seat 5: Action_Gibi ($17.13 in chips) 
Strelok1974: posts small blind $0.05
Pequeño Clau: posts big blind $0.10
*** HOLE CARDS ***
Action_Gibi: folds 
THIMUCHIN: folds 
Bird et al: folds 
Strelok1974: raises $0.20 to $0.30
Pequeño Clau: folds 
Uncalled bet ($0.20) returned to Strelok1974
Strelok1974 collected $0.20 from pot
*** SUMMARY ***
Total pot $0.20 | Rake $0 
Seat 1: THIMUCHIN folded before Flop (didn't bet)
Seat 2: Bird et al (button) folded before Flop (didn't bet)
Seat 3: Strelok1974 (small blind) collected ($0.20)
Seat 4: Pequeño Clau (big blind) folded before Flop
Seat 5: Action_Gibi folded before Flop (didn't bet)



PokerStars Hand #166667698869:  Hold'em No Limit ($0.05/$0.10 USD) - 2017/02/23 16:05:54 ET
Table 'Syringa' 6-max Seat #6 is the button
Seat 1: bdixon_5 ($7.70 in chips) 
Seat 2: Goroshkos88 ($10.56 in chips) 
Seat 3: Yspenyanin ($13.52 in chips) 
Seat 4: tangler19 ($14.43 in chips) 
Seat 5: Andrei ProFF ($13.61 in chips) 
Seat 6: ibara000 ($16.28 in chips) 
bdixon_5: posts small blind $0.05
Goroshkos88: posts big blind $0.10
tangler19: posts small & big blinds $0.15
*** HOLE CARDS ***
Yspenyanin: folds 
tangler19: checks 
Andrei ProFF: raises $0.30 to $0.40
ibara000: calls $0.40
bdixon_5: folds 
Goroshkos88: folds 
tangler19: folds 
*** FLOP *** [4c 5h 6h]
Andrei ProFF: bets $0.60
ibara000: calls $0.60
*** TURN *** [4c 5h 6h] [Qs]
Andrei ProFF: bets $1.20
ibara000: folds 
Uncalled bet ($1.20) returned to Andrei ProFF
Andrei ProFF collected $2.20 from pot
*** SUMMARY ***
Total pot $2.30 | Rake $0.10 
Board [4c 5h 6h Qs]
Seat 1: bdixon_5 (small blind) folded before Flop
Seat 2: Goroshkos88 (big blind) folded before Flop
Seat 3: Yspenyanin folded before Flop (didn't bet)
Seat 4: tangler19 folded before Flop
Seat 5: Andrei ProFF collected ($2.20)
Seat 6: ibara000 (button) folded on the Turn



PokerStars Hand #166667699198:  Hold'em No Limit ($0.05/$0.10 USD) - 2017/02/23 16:05:54 ET
Table 'Kochera' 6-max Seat #4 is the button
Seat 1: chimera252 ($11.82 in chips) 
Seat 2: bartabs2 ($10.54 in chips) 
Seat 3: KA3AXCTAHEU, ($10 in chips) 
Seat 4: johkom ($5.95 in chips) 
Seat 5: univibe68 ($11.75 in chips) 
Seat 6: oddshoff ($9.63 in chips) 
univibe68: posts small blind $0.05
oddshoff: posts big blind $0.10
*** HOLE CARDS ***
chimera252: folds 
bartabs2: folds 
KA3AXCTAHEU,: folds 
johkom: folds 
univibe68: raises $0.20 to $0.30
oddshoff: folds 
Uncalled bet ($0.20) returned to univibe68
univibe68 collected $0.20 from pot
*** SUMMARY ***
Total pot $0.20 | Rake $0 
Seat 1: chimera252 folded before Flop (didn't bet)
Seat 2: bartabs2 folded before Flop (didn't bet)
Seat 3: KA3AXCTAHEU, folded before Flop (didn't bet)
Seat 4: johkom (button) folded before Flop (didn't bet)
Seat 5: univibe68 (small blind) collected ($0.20)
Seat 6: oddshoff (big blind) folded before Flop



PokerStars Hand #166667699368:  Hold'em No Limit ($0.05/$0.10 USD) - 2017/02/23 16:05:54 ET
Table 'Vesta II' 6-max Seat #6 is the button
Seat 1: Yabidooo ($13.06 in chips) 
Seat 2: Dimka4 ($10.15 in chips) 
Seat 3: Pokeaster ($12.38 in chips) 
Seat 4: Dcaro31 ($10 in chips) 
Seat 6: XaXaTyH4uK ($11.31 in chips) 
Yabidooo: posts small blind $0.05
Dimka4: posts big blind $0.10
ChuikaPridi: sits out 
*** HOLE CARDS ***
Pokeaster: folds 
Dcaro31: folds 
XaXaTyH4uK: folds 
Yabidooo: raises $0.15 to $0.25
Dimka4: folds 
Uncalled bet ($0.15) returned to Yabidooo
Yabidooo collected $0.20 from pot
*** SUMMARY ***
Total pot $0.20 | Rake $0 
Seat 1: Yabidooo (small blind) collected ($0.20)
Seat 2: Dimka4 (big blind) folded before Flop
Seat 3: Pokeaster folded before Flop (didn't bet)
Seat 4: Dcaro31 folded before Flop (didn't bet)
Seat 6: XaXaTyH4uK (button) folded before Flop (didn't bet)



PokerStars Hand #166667699392:  Hold'em No Limit ($0.05/$0.10 USD) - 2017/02/23 16:05:54 ET
Table 'Tirela' 6-max Seat #2 is the button
Seat 1: Smitty03300 ($10 in chips) 
Seat 2: Andrei ProFF ($17.64 in chips) 
Seat 3: aim444 ($15.47 in chips) 
Seat 4: ArcticBearDK ($10.01 in chips) 
Seat 5: KRZuff ($11.76 in chips) 
Seat 6: coolisses111 ($9.95 in chips) 
aim444: posts small blind $0.05
ArcticBearDK: posts big blind $0.10
*** HOLE CARDS ***
KRZuff: folds 
coolisses111: folds 
Smitty03300: folds 
Andrei ProFF: raises $0.20 to $0.30
aim444: calls $0.25
ArcticBearDK: folds 
*** FLOP *** [8d 8c 7c]
aim444: bets $0.10
Andrei ProFF: folds 
Uncalled bet ($0.10) returned to aim444
aim444 collected $0.67 from pot
*** SUMMARY ***
Total pot $0.70 | Rake $0.03 
Board [8d 8c 7c]
Seat 1: Smitty03300 folded before Flop (didn't bet)
Seat 2: Andrei ProFF (button) folded on the Flop
Seat 3: aim444 (small blind) collected ($0.67)
Seat 4: ArcticBearDK (big blind) folded before Flop
Seat 5: KRZuff folded before Flop (didn't bet)
Seat 6: coolisses111 folded before Flop (didn't bet)



PokerStars Hand #166667700032:  Hold'em No Limit ($0.05/$0.10 USD) - 2017/02/23 16:05:55 ET
Table 'Huberta II' 6-max Seat #3 is the button
Seat 1: tr41n3r12 ($10 in chips) 
Seat 2: Ice_Isayev ($12.08 in chips) 
Seat 3: patrick19111 ($10.60 in chips) 
Seat 4: VAD21 ($12.01 in chips) 
Seat 5: Feverhead ($27.80 in chips) 
VAD21: posts small blind $0.05
Feverhead: posts big blind $0.10
yodzik: sits out 
*** HOLE CARDS ***
tr41n3r12: folds 
Ice_Isayev: folds 
patrick19111: folds 
VAD21: folds 
Uncalled bet ($0.05) returned to Feverhead
Feverhead collected $0.10 from pot
*** SUMMARY ***
Total pot $0.10 | Rake $0 
Seat 1: tr41n3r12 folded before Flop (didn't bet)
Seat 2: Ice_Isayev folded before Flop (didn't bet)
Seat 3: patrick19111 (button) folded before Flop (didn't bet)
Seat 4: VAD21 (small blind) folded before Flop
Seat 5: Feverhead (big blind) collected ($0.10)



PokerStars Hand #166667700154:  Hold'em No Limit ($0.05/$0.10 USD) - 2017/02/23 16:05:55 ET
Table 'Nerthus II' 6-max Seat #6 is the button
Seat 1: mdelfin0 ($10.82 in chips) 
Seat 2: Hovhannes990 ($9.63 in chips) 
Seat 3: Mamm0nism ($18.67 in chips) 
Seat 5: Hyd SK ($12.15 in chips) 
Seat 6: Lucky HoBBiT ($10 in chips) 
mdelfin0: posts small blind $0.05
Hovhannes990: posts big blind $0.10
myevc: sits out 
*** HOLE CARDS ***
Mamm0nism: folds 
Hyd SK: folds 
Lucky HoBBiT: folds 
mdelfin0: folds 
Uncalled bet ($0.05) returned to Hovhannes990
Hovhannes990 collected $0.10 from pot
*** SUMMARY ***
Total pot $0.10 | Rake $0 
Seat 1: mdelfin0 (small blind) folded before Flop
Seat 2: Hovhannes990 (big blind) collected ($0.10)
Seat 3: Mamm0nism folded before Flop (didn't bet)
Seat 5: Hyd SK folded before Flop (didn't bet)
Seat 6: Lucky HoBBiT (button) folded before Flop (didn't bet)



PokerStars Hand #166667700258:  Hold'em No Limit ($0.05/$0.10 USD) - 2017/02/23 16:05:55 ET
Table 'Nemo III' 6-max Seat #4 is the button
Seat 1: Kow6oy ($10 in chips) 
Seat 2: Bandyaev ($12.16 in chips) 
Seat 3: Dimka4 ($10 in chips) 
Seat 4: vtalian ($9.70 in chips) 
Seat 5: Joker51_wtf! ($11.33 in chips) 
Seat 6: maxiv608 ($10 in chips) 
Joker51_wtf!: posts small blind $0.05
maxiv608: posts big blind $0.10
*** HOLE CARDS ***
Kow6oy: folds 
Bandyaev: folds 
Dimka4: folds 
vtalian: folds 
Joker51_wtf!: folds 
Uncalled bet ($0.05) returned to maxiv608
maxiv608 collected $0.10 from pot
*** SUMMARY ***
Total pot $0.10 | Rake $0 
Seat 1: Kow6oy folded before Flop (didn't bet)
Seat 2: Bandyaev folded before Flop (didn't bet)
Seat 3: Dimka4 folded before Flop (didn't bet)
Seat 4: vtalian (button) folded before Flop (didn't bet)
Seat 5: Joker51_wtf! (small blind) folded before Flop
Seat 6: maxiv608 (big blind) collected ($0.10)



PokerStars Hand #166667700587:  Hold'em No Limit ($0.05/$0.10 USD) - 2017/02/23 16:05:56 ET
Table 'Lobelia II' 6-max Seat #3 is the button
Seat 1: facewald ($21.22 in chips) 
Seat 2: Dcaro31 ($17.61 in chips) 
Seat 3: oddshoff ($19.25 in chips) 
Seat 5: Feverhead ($20.33 in chips) 
Seat 6: NvR.m1nD ($10.02 in chips) 
Feverhead: posts small blind $0.05
NvR.m1nD: posts big blind $0.10
*** HOLE CARDS ***
facewald: raises $0.19 to $0.29
Dcaro31: folds 
oddshoff: folds 
Feverhead: folds 
NvR.m1nD: folds 
Uncalled bet ($0.19) returned to facewald
facewald collected $0.25 from pot
*** SUMMARY ***
Total pot $0.25 | Rake $0 
Seat 1: facewald collected ($0.25)
Seat 2: Dcaro31 folded before Flop (didn't bet)
Seat 3: oddshoff (button) folded before Flop (didn't bet)
Seat 5: Feverhead (small blind) folded before Flop
Seat 6: NvR.m1nD (big blind) folded before Flop



PokerStars Hand #166667700699:  Hold'em No Limit ($0.05/$0.10 USD) - 2017/02/23 16:05:56 ET
Table 'Alnasl II' 6-max Seat #3 is the button
Seat 1: dragonste89 ($14.05 in chips) 
Seat 2: Therodorus ($10.86 in chips) 
Seat 3: ICBM-RS26 ($8.13 in chips) 
Seat 4: Eddys Edge ($10 in chips) 
Seat 5: mdelfin0 ($12.46 in chips) 
Seat 6: Bommer78 ($4.76 in chips) 
Eddys Edge: posts small blind $0.05
mdelfin0: posts big blind $0.10
*** HOLE CARDS ***
Bommer78: calls $0.10
dragonste89: folds 
Therodorus: folds 
ICBM-RS26: raises $0.10 to $0.20
Eddys Edge: raises $0.50 to $0.70
mdelfin0: folds 
Bommer78: folds 
ICBM-RS26: calls $0.50
*** FLOP *** [2c Jc 6d]
Eddys Edge: bets $1.15
ICBM-RS26: calls $1.15
*** TURN *** [2c Jc 6d] [3d]
Eddys Edge: bets $2.79
ICBM-RS26: raises $3.49 to $6.28 and is all-in
Eddys Edge: calls $3.49
*** RIVER *** [2c Jc 6d 3d] [7d]
*** SHOW DOWN ***
Eddys Edge: shows [Jh Kc] (a pair of Jacks)
ICBM-RS26: shows [2d 2h] (three of a kind, Deuces)
ICBM-RS26 collected $15.72 from pot
*** SUMMARY ***
Total pot $16.46 | Rake $0.74 
Board [2c Jc 6d 3d 7d]
Seat 1: dragonste89 folded before Flop (didn't bet)
Seat 2: Therodorus folded before Flop (didn't bet)
Seat 3: ICBM-RS26 (button) showed [2d 2h] and won ($15.72) with three of a kind, Deuces
Seat 4: Eddys Edge (small blind) showed [Jh Kc] and lost with a pair of Jacks
Seat 5: mdelfin0 (big blind) folded before Flop
Seat 6: Bommer78 folded before Flop



PokerStars Hand #166667700854:  Hold'em No Limit ($0.05/$0.10 USD) - 2017/02/23 16:05:56 ET
Table 'Amalia' 6-max Seat #3 is the button
Seat 1: voledy ($12.59 in chips) 
Seat 2: DamDatsAnAce ($10.55 in chips) 
Seat 3: kickereens ($10.08 in chips) 
Seat 4: Rodik002 ($16.18 in chips) 
Seat 5: coolisses111 ($11.10 in chips) 
Seat 6: oktomber778 ($23.76 in chips) 
Rodik002: posts small blind $0.05
coolisses111: posts big blind $0.10
*** HOLE CARDS ***
oktomber778: calls $0.10
voledy: folds 
DamDatsAnAce: raises $0.35 to $0.45
kickereens: folds 
Rodik002: folds 
coolisses111: folds 
oktomber778: calls $0.35
*** FLOP *** [4s Kh 4h]
oktomber778: checks 
DamDatsAnAce: bets $0.55
oktomber778: folds 
Uncalled bet ($0.55) returned to DamDatsAnAce
DamDatsAnAce collected $1 from pot
*** SUMMARY ***
Total pot $1.05 | Rake $0.05 
Board [4s Kh 4h]
Seat 1: voledy folded before Flop (didn't bet)
Seat 2: DamDatsAnAce collected ($1)
Seat 3: kickereens (button) folded before Flop (didn't bet)
Seat 4: Rodik002 (small blind) folded before Flop
Seat 5: coolisses111 (big blind) folded before Flop
Seat 6: oktomber778 folded on the Flop



PokerStars Hand #166667700924:  Hold'em No Limit ($0.05/$0.10 USD) - 2017/02/23 16:05:56 ET
Table 'Iapetus III' 6-max Seat #1 is the button
Seat 1: Czezar Life ($7.85 in chips) 
Seat 2: Crafty23@PS ($10 in chips) 
Seat 3: Goroshkos88 ($10 in chips) 
Seat 4: Raggibest ($6.80 in chips) 
Seat 5: homelessdan ($14.93 in chips) 
Seat 6: tauronex ($10.33 in chips) 
Crafty23@PS: posts small blind $0.05
Goroshkos88: posts big blind $0.10
*** HOLE CARDS ***
Raggibest: calls $0.10
homelessdan: folds 
tauronex: folds 
Czezar Life: raises $0.30 to $0.40
Crafty23@PS: folds 
Goroshkos88: calls $0.30
Raggibest: calls $0.30
*** FLOP *** [Qc 5d 8d]
Goroshkos88: checks 
Raggibest: bets $0.10
Czezar Life: raises $0.50 to $0.60
Goroshkos88: folds 
Raggibest: calls $0.50
*** TURN *** [Qc 5d 8d] [Jc]
Raggibest: bets $0.10
Czezar Life: calls $0.10
*** RIVER *** [Qc 5d 8d Jc] [2h]
Raggibest: bets $0.10
Czezar Life: calls $0.10
*** SHOW DOWN ***
Raggibest: shows [Td Qs] (a pair of Queens)
Czezar Life: mucks hand 
Raggibest collected $2.72 from pot
*** SUMMARY ***
Total pot $2.85 | Rake $0.13 
Board [Qc 5d 8d Jc 2h]
Seat 1: Czezar Life (button) mucked
Seat 2: Crafty23@PS (small blind) folded before Flop
Seat 3: Goroshkos88 (big blind) folded on the Flop
Seat 4: Raggibest showed [Td Qs] and won ($2.72) with a pair of Queens
Seat 5: homelessdan folded before Flop (didn't bet)
Seat 6: tauronex folded before Flop (didn't bet)



PokerStars Hand #166667700983:  Hold'em No Limit ($0.05/$0.10 USD) - 2017/02/23 16:05:56 ET
Table 'Landi II' 6-max Seat #1 is the button
Seat 1: dersiemer ($12.03 in chips) 
Seat 2: Aescul@pius ($10.85 in chips) 
Seat 3: dr.goofy ($21.44 in chips) 
Seat 4: alesi13 ($6.40 in chips) 
Seat 5: Bird et al ($10.10 in chips) 
Aescul@pius: posts small blind $0.05
dr.goofy: posts big blind $0.10
*** HOLE CARDS ***
alesi13: raises $0.10 to $0.20
Bird et al: folds 
dersiemer: calls $0.20
Aescul@pius: folds 
dr.goofy: folds 
*** FLOP *** [9c 6d 9d]
alesi13: bets $0.27
dersiemer: folds 
Uncalled bet ($0.27) returned to alesi13
alesi13 collected $0.53 from pot
*** SUMMARY ***
Total pot $0.55 | Rake $0.02 
Board [9c 6d 9d]
Seat 1: dersiemer (button) folded on the Flop
Seat 2: Aescul@pius (small blind) folded before Flop
Seat 3: dr.goofy (big blind) folded before Flop
Seat 4: alesi13 collected ($0.53)
Seat 5: Bird et al folded before Flop (didn't bet)



PokerStars Hand #166667701398:  Hold'em No Limit ($0.05/$0.10 USD) - 2017/02/23 16:05:57 ET
Table 'Iduberga II' 6-max Seat #1 is the button
Seat 1: mhonielsen ($11.06 in chips) 
Seat 2: popypaleta ($12.85 in chips) 
Seat 3: scorpionfish ($11.58 in chips) 
Seat 4: Peter0087 ($9.88 in chips) 
Seat 5: Pokeaster ($10.47 in chips) 
Seat 6: tblocos ($12.03 in chips) 
popypaleta: posts small blind $0.05
scorpionfish: posts big blind $0.10
*** HOLE CARDS ***
Peter0087: folds 
Pokeaster: raises $0.20 to $0.30
tblocos: calls $0.30
mhonielsen: folds 
popypaleta: folds 
scorpionfish: folds 
*** FLOP *** [9h Qs 4h]
Pokeaster: checks 
tblocos: checks 
*** TURN *** [9h Qs 4h] [5d]
Pokeaster: bets $0.54
tblocos: calls $0.54
*** RIVER *** [9h Qs 4h 5d] [Th]
Pokeaster: bets $2
tblocos: folds 
Uncalled bet ($2) returned to Pokeaster
Pokeaster collected $1.75 from pot
*** SUMMARY ***
Total pot $1.83 | Rake $0.08 
Board [9h Qs 4h 5d Th]
Seat 1: mhonielsen (button) folded before Flop (didn't bet)
Seat 2: popypaleta (small blind) folded before Flop
Seat 3: scorpionfish (big blind) folded before Flop
Seat 4: Peter0087 folded before Flop (didn't bet)
Seat 5: Pokeaster collected ($1.75)
Seat 6: tblocos folded on the River



PokerStars Hand #166667701624:  Hold'em No Limit ($0.05/$0.10 USD) - 2017/02/23 16:05:57 ET
Table 'Nekkar' 6-max Seat #3 is the button
Seat 2: Bird et al ($11.02 in chips) 
Seat 3: Zemz_Ru ($15.20 in chips) 
Seat 4: kingartur222 ($13.24 in chips) 
Seat 5: Vrinni ($11.70 in chips) 
Seat 6: Eddys Edge ($10.48 in chips) 
kingartur222: posts small blind $0.05
Vrinni: posts big blind $0.10
*** HOLE CARDS ***
Eddys Edge: folds 
Bird et al: folds 
Zemz_Ru: folds 
kingartur222: raises $0.19 to $0.29
Vrinni: calls $0.19
*** FLOP *** [9d Ad 3c]
kingartur222: bets $0.30
Vrinni: calls $0.30
*** TURN *** [9d Ad 3c] [Ah]
kingartur222: checks 
Vrinni: checks 
*** RIVER *** [9d Ad 3c Ah] [3h]
kingartur222: checks 
Vrinni: bets $0.37
kingartur222: folds 
Uncalled bet ($0.37) returned to Vrinni
Vrinni collected $1.13 from pot
*** SUMMARY ***
Total pot $1.18 | Rake $0.05 
Board [9d Ad 3c Ah 3h]
Seat 2: Bird et al folded before Flop (didn't bet)
Seat 3: Zemz_Ru (button) folded before Flop (didn't bet)
Seat 4: kingartur222 (small blind) folded on the River
Seat 5: Vrinni (big blind) collected ($1.13)
Seat 6: Eddys Edge folded before Flop (didn't bet)



PokerStars Hand #166667702245:  Hold'em No Limit ($0.05/$0.10 USD) - 2017/02/23 16:05:58 ET
Table 'Laetitia II' 6-max Seat #4 is the button
Seat 1: Cluckh ($10.96 in chips) 
Seat 2: manashov ($10 in chips) 
Seat 3: 6ePeMeHHa9 ($10.14 in chips) 
Seat 4: Feverhead ($16.66 in chips) 
Seat 5: D3NyA ($16.53 in chips) 
Seat 6: Dima91360 ($6.14 in chips) 
D3NyA: posts small blind $0.05
Dima91360: posts big blind $0.10
*** HOLE CARDS ***
Cluckh: raises $0.20 to $0.30
manashov: folds 
6ePeMeHHa9: folds 
Feverhead: folds 
D3NyA: folds 
Dima91360: calls $0.20
*** FLOP *** [5h 4h Qh]
Dima91360: checks 
Cluckh: bets $0.30
Dima91360: folds 
Uncalled bet ($0.30) returned to Cluckh
Cluckh collected $0.62 from pot
*** SUMMARY ***
Total pot $0.65 | Rake $0.03 
Board [5h 4h Qh]
Seat 1: Cluckh collected ($0.62)
Seat 2: manashov folded before Flop (didn't bet)
Seat 3: 6ePeMeHHa9 folded before Flop (didn't bet)
Seat 4: Feverhead (button) folded before Flop (didn't bet)
Seat 5: D3NyA (small blind) folded before Flop
Seat 6: Dima91360 (big blind) folded on the Flop



PokerStars Hand #166667702417:  Hold'em No Limit ($0.05/$0.10 USD) - 2017/02/23 16:05:58 ET
Table 'Juliet II' 6-max Seat #1 is the button
Seat 1: alexpolevaja ($11.17 in chips) 
Seat 2: KA3AXCTAHEU, ($14.98 in chips) 
Seat 3: patrick19111 ($11.57 in chips) 
Seat 4: x3ultimate ($10.55 in chips) 
Seat 5: Dcaro31 ($19.12 in chips) 
Seat 6: BookWorm78 ($32.95 in chips) 
KA3AXCTAHEU,: posts small blind $0.05
patrick19111: posts big blind $0.10
*** HOLE CARDS ***
x3ultimate: folds 
Dcaro31: folds 
BookWorm78: raises $0.20 to $0.30
alexpolevaja: calls $0.30
KA3AXCTAHEU,: folds 
patrick19111: folds 
*** FLOP *** [4h Kh 9h]
BookWorm78: checks 
alexpolevaja: checks 
*** TURN *** [4h Kh 9h] [Ad]
BookWorm78: bets $0.55
alexpolevaja: calls $0.55
*** RIVER *** [4h Kh 9h Ad] [5d]
BookWorm78: bets $0.62
alexpolevaja: calls $0.62
*** SHOW DOWN ***
BookWorm78: shows [Tc Ac] (a pair of Aces)
alexpolevaja: shows [Jd Ah] (a pair of Aces - King+Jack kicker)
alexpolevaja collected $2.95 from pot
*** SUMMARY ***
Total pot $3.09 | Rake $0.14 
Board [4h Kh 9h Ad 5d]
Seat 1: alexpolevaja (button) showed [Jd Ah] and won ($2.95) with a pair of Aces
Seat 2: KA3AXCTAHEU, (small blind) folded before Flop
Seat 3: patrick19111 (big blind) folded before Flop
Seat 4: x3ultimate folded before Flop (didn't bet)
Seat 5: Dcaro31 folded before Flop (didn't bet)
Seat 6: BookWorm78 showed [Tc Ac] and lost with a pair of Aces



PokerStars Hand #166667702637:  Hold'em No Limit ($0.05/$0.10 USD) - 2017/02/23 16:05:58 ET
Table 'Sirius II' 6-max Seat #2 is the button
Seat 1: Ampped87 ($13.88 in chips) 
Seat 2: Buddy8711 ($7.85 in chips) 
Seat 3: Spud014 ($10.30 in chips) 
Seat 5: pokekrk ($10.62 in chips) 
Seat 6: MihaGr ($10 in chips) 
Spud014: posts small blind $0.05
pokekrk: posts big blind $0.10
*** HOLE CARDS ***
MihaGr: folds 
Ampped87: folds 
Buddy8711: raises $0.10 to $0.20
Spud014: folds 
pokekrk: calls $0.10
*** FLOP *** [As 9c 4h]
pokekrk: checks 
Buddy8711: bets $0.40
pokekrk: folds 
Uncalled bet ($0.40) returned to Buddy8711
Buddy8711 collected $0.43 from pot
*** SUMMARY ***
Total pot $0.45 | Rake $0.02 
Board [As 9c 4h]
Seat 1: Ampped87 folded before Flop (didn't bet)
Seat 2: Buddy8711 (button) collected ($0.43)
Seat 3: Spud014 (small blind) folded before Flop
Seat 5: pokekrk (big blind) folded on the Flop
Seat 6: MihaGr folded before Flop (didn't bet)



PokerStars Hand #166667702706:  Hold'em No Limit ($0.05/$0.10 USD) - 2017/02/23 16:05:58 ET
Table 'Epimetheus' 6-max Seat #5 is the button
Seat 1: 6ePeMeHHa9 ($10.29 in chips) 
Seat 2: patrick19111 ($15.51 in chips) 
Seat 3: dineldidi ($9.84 in chips) 
Seat 5: afca128 ($23.68 in chips) 
Seat 6: voledy ($10.65 in chips) 
voledy: posts small blind $0.05
6ePeMeHHa9: posts big blind $0.10
Namhkal: sits out 
*** HOLE CARDS ***
patrick19111: folds 
dineldidi: folds 
afca128 has timed out
afca128: folds 
voledy: folds 
Uncalled bet ($0.05) returned to 6ePeMeHHa9
6ePeMeHHa9 collected $0.10 from pot
*** SUMMARY ***
Total pot $0.10 | Rake $0 
Seat 1: 6ePeMeHHa9 (big blind) collected ($0.10)
Seat 2: patrick19111 folded before Flop (didn't bet)
Seat 3: dineldidi folded before Flop (didn't bet)
Seat 5: afca128 (button) folded before Flop (didn't bet)
Seat 6: voledy (small blind) folded before Flop



PokerStars Hand #166667702713:  Hold'em No Limit ($0.05/$0.10 USD) - 2017/02/23 16:05:58 ET
Table 'Wabash' 6-max Seat #1 is the button
Seat 1: pivanki11 ($10 in chips) 
Seat 2: ex3Lero86 ($32.53 in chips) 
Seat 4: Nr847 ($10 in chips) 
Seat 5: popypaleta ($14.29 in chips) 
Seat 6: weez3r ($10.52 in chips) 
ex3Lero86: posts small blind $0.05
Nr847: posts big blind $0.10
*** HOLE CARDS ***
popypaleta: folds 
sszabi28 leaves the table
weez3r: folds 
pivanki11: raises $0.20 to $0.30
ex3Lero86: folds 
Nr847: folds 
Uncalled bet ($0.20) returned to pivanki11
pivanki11 collected $0.25 from pot
*** SUMMARY ***
Total pot $0.25 | Rake $0 
Seat 1: pivanki11 (button) collected ($0.25)
Seat 2: ex3Lero86 (small blind) folded before Flop
Seat 4: Nr847 (big blind) folded before Flop
Seat 5: popypaleta folded before Flop (didn't bet)
Seat 6: weez3r folded before Flop (didn't bet)



PokerStars Hand #166667702962:  Hold'em No Limit ($0.05/$0.10 USD) - 2017/02/23 16:05:58 ET
Table 'Peiroos III' 6-max Seat #4 is the button
Seat 1: tequila_joop ($10 in chips) 
Seat 3: nabatov.m ($7.27 in chips) 
Seat 4: pivanki11 ($10.94 in chips) 
Seat 5: ChuikaPridi ($10 in chips) 
Seat 6: CHRO8 ($9.43 in chips) 
ChuikaPridi: posts small blind $0.05
CHRO8: posts big blind $0.10
tequila_joop: posts the ante $0.02
nabatov.m: posts the ante $0.02
pivanki11: posts the ante $0.02
ChuikaPridi: posts the ante $0.02
CHRO8: posts the ante $0.02
*** HOLE CARDS ***
tequila_joop: folds 
nabatov.m: calls $0.10
pivanki11: folds 
ChuikaPridi: folds 
CHRO8: checks 
*** FLOP *** [Kh 9c Qs]
CHRO8: checks 
nabatov.m: bets $0.10
CHRO8: calls $0.10
*** TURN *** [Kh 9c Qs] [5h]
CHRO8: checks 
nabatov.m: checks 
*** RIVER *** [Kh 9c Qs 5h] [Ks]
CHRO8: bets $0.40
nabatov.m: calls $0.40
*** SHOW DOWN ***
CHRO8: shows [8c Kc] (three of a kind, Kings)
nabatov.m: mucks hand 
CHRO8 collected $1.29 from pot
*** SUMMARY ***
Total pot $1.35 | Rake $0.06 
Board [Kh 9c Qs 5h Ks]
Seat 1: tequila_joop folded before Flop (didn't bet)
Seat 3: nabatov.m mucked
Seat 4: pivanki11 (button) folded before Flop (didn't bet)
Seat 5: ChuikaPridi (small blind) folded before Flop
Seat 6: CHRO8 (big blind) showed [8c Kc] and won ($1.29) with three of a kind, Kings



PokerStars Hand #166667703298:  Hold'em No Limit ($0.05/$0.10 USD) - 2017/02/23 16:05:59 ET
Table 'Kraz II' 6-max Seat #1 is the button
Seat 1: bdixon_5 ($9.55 in chips) 
Seat 2: shellyld ($10.05 in chips) 
Seat 3: Eddys Edge ($10 in chips) 
Seat 4: WinninBikini ($12.43 in chips) 
Seat 5: Joker51_wtf! ($10.15 in chips) 
Seat 6: tr41n3r12 ($10 in chips) 
shellyld: posts small blind $0.05
Eddys Edge: posts big blind $0.10
*** HOLE CARDS ***
WinninBikini: folds 
Joker51_wtf!: folds 
tr41n3r12: folds 
bdixon_5: folds 
shellyld: folds 
Uncalled bet ($0.05) returned to Eddys Edge
Eddys Edge collected $0.10 from pot
*** SUMMARY ***
Total pot $0.10 | Rake $0 
Seat 1: bdixon_5 (button) folded before Flop (didn't bet)
Seat 2: shellyld (small blind) folded before Flop
Seat 3: Eddys Edge (big blind) collected ($0.10)
Seat 4: WinninBikini folded before Flop (didn't bet)
Seat 5: Joker51_wtf! folded before Flop (didn't bet)
Seat 6: tr41n3r12 folded before Flop (didn't bet)



PokerStars Hand #166667703530:  Hold'em No Limit ($0.05/$0.10 USD) - 2017/02/23 16:05:59 ET
Table 'Camilla II' 6-max Seat #5 is the button
Seat 1: paxit71 ($8.15 in chips) 
Seat 2: Giyorod ($16.11 in chips) 
Seat 3: Andy Wolf ($10 in chips) 
Seat 4: chimera252 ($12.41 in chips) 
Seat 5: LarryTheStar ($11.19 in chips) 
Seat 6: david_sara83 ($10.05 in chips) 
david_sara83: posts small blind $0.05
paxit71: posts big blind $0.10
*** HOLE CARDS ***
Giyorod: folds 
Andy Wolf: folds 
chimera252: folds 
LarryTheStar: raises $0.10 to $0.20
david_sara83: folds 
paxit71: calls $0.10
*** FLOP *** [5c Qs 3d]
paxit71: checks 
LarryTheStar: checks 
*** TURN *** [5c Qs 3d] [Js]
paxit71: checks 
LarryTheStar: checks 
*** RIVER *** [5c Qs 3d Js] [4s]
paxit71: checks 
LarryTheStar: checks 
*** SHOW DOWN ***
paxit71: shows [6h Kc] (high card King)
LarryTheStar: shows [9c As] (high card Ace)
LarryTheStar collected $0.43 from pot
*** SUMMARY ***
Total pot $0.45 | Rake $0.02 
Board [5c Qs 3d Js 4s]
Seat 1: paxit71 (big blind) showed [6h Kc] and lost with high card King
Seat 2: Giyorod folded before Flop (didn't bet)
Seat 3: Andy Wolf folded before Flop (didn't bet)
Seat 4: chimera252 folded before Flop (didn't bet)
Seat 5: LarryTheStar (button) showed [9c As] and won ($0.43) with high card Ace
Seat 6: david_sara83 (small blind) folded before Flop



PokerStars Hand #166667703595:  Hold'em No Limit ($0.05/$0.10 USD) - 2017/02/23 16:05:59 ET
Table 'Goto II' 6-max Seat #3 is the button
Seat 1: FRAID358 ($12.46 in chips) 
Seat 2: 6ePeMeHHa9 ($11.82 in chips) 
Seat 3: Goroshkos88 ($10.44 in chips) 
Seat 4: KRZuff ($13.49 in chips) 
Seat 5: RoJ1 ($14.50 in chips) 
Seat 6: ermananb93 ($11.69 in chips) 
KRZuff: posts small blind $0.05
RoJ1: posts big blind $0.10
*** HOLE CARDS ***
ermananb93: calls $0.10
FRAID358: folds 
6ePeMeHHa9: folds 
Goroshkos88: calls $0.10
KRZuff: calls $0.05
RoJ1: checks 
*** FLOP *** [8h 9s 6s]
KRZuff: checks 
RoJ1: checks 
ermananb93: bets $0.10
Goroshkos88: raises $0.37 to $0.47
KRZuff: folds 
RoJ1: folds 
ermananb93: folds 
Uncalled bet ($0.37) returned to Goroshkos88
Goroshkos88 collected $0.57 from pot
*** SUMMARY ***
Total pot $0.60 | Rake $0.03 
Board [8h 9s 6s]
Seat 1: FRAID358 folded before Flop (didn't bet)
Seat 2: 6ePeMeHHa9 folded before Flop (didn't bet)
Seat 3: Goroshkos88 (button) collected ($0.57)
Seat 4: KRZuff (small blind) folded on the Flop
Seat 5: RoJ1 (big blind) folded on the Flop
Seat 6: ermananb93 folded on the Flop



PokerStars Hand #166667703709:  Hold'em No Limit ($0.05/$0.10 USD) - 2017/02/23 16:05:59 ET
Table 'Grietje' 6-max Seat #2 is the button
Seat 1: dragonste89 ($10.15 in chips) 
Seat 2: Feverhead ($12.57 in chips) 
Seat 3: GitoValdivia ($6.71 in chips) 
Seat 4: MihaGr ($10.50 in chips) 
Seat 5: iThreeBarrel ($10.15 in chips) 
Seat 6: Prometheu$8 ($21.70 in chips) 
GitoValdivia: posts small blind $0.05
MihaGr: posts big blind $0.10
*** HOLE CARDS ***
iThreeBarrel: folds 
Prometheu$8: folds 
dragonste89: folds 
Feverhead: folds 
GitoValdivia: calls $0.05
MihaGr: checks 
*** FLOP *** [Kd 4s As]
GitoValdivia: bets $0.19
MihaGr: calls $0.19
*** TURN *** [Kd 4s As] [2c]
GitoValdivia: checks 
MihaGr: bets $0.41
GitoValdivia: folds 
Uncalled bet ($0.41) returned to MihaGr
MihaGr collected $0.55 from pot
*** SUMMARY ***
Total pot $0.58 | Rake $0.03 
Board [Kd 4s As 2c]
Seat 1: dragonste89 folded before Flop (didn't bet)
Seat 2: Feverhead (button) folded before Flop (didn't bet)
Seat 3: GitoValdivia (small blind) folded on the Turn
Seat 4: MihaGr (big blind) collected ($0.55)
Seat 5: iThreeBarrel folded before Flop (didn't bet)
Seat 6: Prometheu$8 folded before Flop (didn't bet)



PokerStars Hand #166667703832:  Hold'em No Limit ($0.05/$0.10 USD) - 2017/02/23 16:05:59 ET
Table 'Martha' 6-max Seat #2 is the button
Seat 1: Peter0087 ($10.44 in chips) 
Seat 2: pauli95 ($9.19 in chips) 
Seat 3: Hyd SK ($12.25 in chips) 
Seat 4: dittoro ($10 in chips) 
Seat 5: MihaGr ($10 in chips) 
Seat 6: 8th wonders ($10 in chips) 
Hyd SK: posts small blind $0.05
dittoro: posts big blind $0.10
*** HOLE CARDS ***
MihaGr: folds 
8th wonders: folds 
Peter0087: folds 
pauli95: raises $0.20 to $0.30
Hyd SK: folds 
dittoro: calls $0.20
*** FLOP *** [3d 4c Js]
dittoro: checks 
pauli95: checks 
*** TURN *** [3d 4c Js] [2s]
dittoro: bets $0.21
pauli95: calls $0.21
*** RIVER *** [3d 4c Js 2s] [4d]
dittoro: bets $0.36
pauli95: calls $0.36
*** SHOW DOWN ***
dittoro: shows [5s 5d] (two pair, Fives and Fours)
pauli95: shows [Kc Jc] (two pair, Jacks and Fours)
pauli95 collected $1.71 from pot
*** SUMMARY ***
Total pot $1.79 | Rake $0.08 
Board [3d 4c Js 2s 4d]
Seat 1: Peter0087 folded before Flop (didn't bet)
Seat 2: pauli95 (button) showed [Kc Jc] and won ($1.71) with two pair, Jacks and Fours
Seat 3: Hyd SK (small blind) folded before Flop
Seat 4: dittoro (big blind) showed [5s 5d] and lost with two pair, Fives and Fours
Seat 5: MihaGr folded before Flop (didn't bet)
Seat 6: 8th wonders folded before Flop (didn't bet)



PokerStars Hand #166667703957:  Hold'em No Limit ($0.05/$0.10 USD) - 2017/02/23 16:05:59 ET
Table 'Nauheima II' 6-max Seat #2 is the button
Seat 2: Peter0087 ($10.47 in chips) 
Seat 3: KokoulinV ($13.19 in chips) 
Seat 4: Innerwuss ($10.22 in chips) 
Seat 5: Kow6oy ($10.05 in chips) 
Seat 6: bonyo71 ($5.04 in chips) 
KokoulinV: posts small blind $0.05
Innerwuss: posts big blind $0.10
*** HOLE CARDS ***
Kow6oy: raises $0.25 to $0.35
bonyo71: folds 
Peter0087: folds 
KokoulinV: folds 
Innerwuss: folds 
Uncalled bet ($0.25) returned to Kow6oy
Kow6oy collected $0.25 from pot
*** SUMMARY ***
Total pot $0.25 | Rake $0 
Seat 2: Peter0087 (button) folded before Flop (didn't bet)
Seat 3: KokoulinV (small blind) folded before Flop
Seat 4: Innerwuss (big blind) folded before Flop
Seat 5: Kow6oy collected ($0.25)
Seat 6: bonyo71 folded before Flop (didn't bet)



PokerStars Hand #166667704064:  Hold'em No Limit ($0.05/$0.10 USD) - 2017/02/23 16:06:00 ET
Table 'Girtab II' 6-max Seat #1 is the button
Seat 1: marianoboni ($11.31 in chips) 
Seat 2: Pokeaster ($13.34 in chips) 
Seat 3: chimera252 ($10 in chips) 
Seat 4: Hyd SK ($27.03 in chips) 
Seat 6: DamDatsAnAce ($10 in chips) 
Pokeaster: posts small blind $0.05
chimera252: posts big blind $0.10
*** HOLE CARDS ***
Hyd SK: raises $0.25 to $0.35
DamDatsAnAce: folds 
marianoboni: folds 
Pokeaster: folds 
chimera252: folds 
Uncalled bet ($0.25) returned to Hyd SK
Hyd SK collected $0.25 from pot
*** SUMMARY ***
Total pot $0.25 | Rake $0 
Seat 1: marianoboni (button) folded before Flop (didn't bet)
Seat 2: Pokeaster (small blind) folded before Flop
Seat 3: chimera252 (big blind) folded before Flop
Seat 4: Hyd SK collected ($0.25)
Seat 6: DamDatsAnAce folded before Flop (didn't bet)



PokerStars Hand #166667704121:  Hold'em No Limit ($0.05/$0.10 USD) - 2017/02/23 16:06:00 ET
Table 'Ostara III' 6-max Seat #1 is the button
Seat 1: MühliJr ($10.30 in chips) 
Seat 2: Action_Gibi ($9.94 in chips) 
Seat 3: vtalian ($13.13 in chips) 
Seat 6: FlopsterGB ($10 in chips) 
Action_Gibi: posts small blind $0.05
vtalian: posts big blind $0.10
*** HOLE CARDS ***
FlopsterGB: raises $0.20 to $0.30
MühliJr: folds 
Action_Gibi: folds 
vtalian: folds 
Uncalled bet ($0.20) returned to FlopsterGB
FlopsterGB collected $0.25 from pot
*** SUMMARY ***
Total pot $0.25 | Rake $0 
Seat 1: MühliJr (button) folded before Flop (didn't bet)
Seat 2: Action_Gibi (small blind) folded before Flop
Seat 3: vtalian (big blind) folded before Flop
Seat 6: FlopsterGB collected ($0.25)



PokerStars Hand #166667704177:  Hold'em No Limit ($0.05/$0.10 USD) - 2017/02/23 16:06:00 ET
Table 'Pallas II' 6-max Seat #5 is the button
Seat 1: mdelfin0 ($15.48 in chips) 
Seat 4: MisterX413 ($10 in chips) 
Seat 5: Yspenyanin ($19.56 in chips) 
WinninBikini joins the table at seat #6 
mdelfin0: posts small blind $0.05
FRAID358: is sitting out 
KRZuff: is sitting out 
mdelfin0 said, "<'))><(^^^)"
MisterX413: posts big blind $0.10
*** HOLE CARDS ***
KRZuff leaves the table
Yspenyanin: folds 
FRAID358 leaves the table
Yspenyanin leaves the table
mdelfin0: calls $0.05
Smitty03300 joins the table at seat #2 
WinninBikini leaves the table
Kow6oy joins the table at seat #5 
Kow6oy leaves the table
Smitty03300 leaves the table
MisterX413 has timed out
MisterX413: checks 
*** FLOP *** [Jd Kd 9d]
mdelfin0: checks 
gaHy_HaXeP joins the table at seat #5 
MisterX413 has timed out
MisterX413: checks 
*** TURN *** [Jd Kd 9d] [3c]
mdelfin0: checks 
popypaleta joins the table at seat #3 
MisterX413: checks 
*** RIVER *** [Jd Kd 9d 3c] [6c]
JahSoldier69 joins the table at seat #6 
DEraser joins the table at seat #2 
JahSoldier69 leaves the table
Smitty03300 joins the table at seat #6 
mdelfin0: bets $0.10
MisterX413: folds 
Uncalled bet ($0.10) returned to mdelfin0
mdelfin0 collected $0.19 from pot
*** SUMMARY ***
Total pot $0.20 | Rake $0.01 
Board [Jd Kd 9d 3c 6c]
Seat 1: mdelfin0 (small blind) collected ($0.19)
Seat 4: MisterX413 (big blind) folded on the River
Seat 5: Yspenyanin (button) folded before Flop (didn't bet)



PokerStars Hand #166667704277:  Hold'em No Limit ($0.05/$0.10 USD) - 2017/02/23 16:06:00 ET
Table 'Brendelia II' 6-max Seat #2 is the button
Seat 2: Crimsonr ($4.99 in chips) 
Seat 6: luckyPositiv ($10.36 in chips) 
Crimsonr: posts small blind $0.05
luckyPositiv: posts big blind $0.10
Crimsonr: posts the ante $0.02
luckyPositiv: posts the ante $0.02
*** HOLE CARDS ***
ValdemorS leaves the table
Crimsonr: raises $0.20 to $0.30
luckyPositiv: folds 
Uncalled bet ($0.20) returned to Crimsonr
Crimsonr collected $0.24 from pot
*** SUMMARY ***
Total pot $0.24 | Rake $0 
Seat 2: Crimsonr (button) (small blind) collected ($0.24)
Seat 6: luckyPositiv (big blind) folded before Flop



PokerStars Hand #166667704787:  Hold'em No Limit ($0.05/$0.10 USD) - 2017/02/23 16:06:00 ET
Table 'Heka II' 6-max Seat #2 is the button
Seat 1: Mamm0nism ($15.91 in chips) 
Seat 2: oddshoff ($11.42 in chips) 
Seat 3: MühliJr ($10 in chips) 
Seat 4: theNot0r1ous ($10.45 in chips) 
Seat 5: ArcticBearDK ($12.53 in chips) 
Seat 6: MonteCris92 ($10 in chips) 
MühliJr: posts small blind $0.05
theNot0r1ous: posts big blind $0.10
*** HOLE CARDS ***
ArcticBearDK: folds 
MonteCris92: folds 
Mamm0nism: folds 
oddshoff: raises $0.10 to $0.20
MühliJr: folds 
theNot0r1ous: calls $0.10
*** FLOP *** [Qd As 2s]
theNot0r1ous: checks 
oddshoff: checks 
*** TURN *** [Qd As 2s] [3c]
theNot0r1ous: bets $0.32
oddshoff: folds 
Uncalled bet ($0.32) returned to theNot0r1ous
theNot0r1ous collected $0.43 from pot
*** SUMMARY ***
Total pot $0.45 | Rake $0.02 
Board [Qd As 2s 3c]
Seat 1: Mamm0nism folded before Flop (didn't bet)
Seat 2: oddshoff (button) folded on the Turn
Seat 3: MühliJr (small blind) folded before Flop
Seat 4: theNot0r1ous (big blind) collected ($0.43)
Seat 5: ArcticBearDK folded before Flop (didn't bet)
Seat 6: MonteCris92 folded before Flop (didn't bet)



PokerStars Hand #166667704876:  Hold'em No Limit ($0.05/$0.10 USD) - 2017/02/23 16:06:00 ET
Table 'Kanda' 6-max Seat #3 is the button
Seat 1: Andy Wolf ($11.27 in chips) 
Seat 2: Pelotín ($5.15 in chips) 
Seat 3: XaXaTyH4uK ($10 in chips) 
Seat 4: Orlangoor ($10.24 in chips) 
Seat 5: Dimka4 ($10 in chips) 
Seat 6: oddshoff ($9.21 in chips) 
Orlangoor: posts small blind $0.05
Dimka4: posts big blind $0.10
*** HOLE CARDS ***
oddshoff: raises $0.20 to $0.30
Andy Wolf: folds 
Pelotín: folds 
XaXaTyH4uK: folds 
Orlangoor: folds 
Dimka4: folds 
Uncalled bet ($0.20) returned to oddshoff
oddshoff collected $0.25 from pot
*** SUMMARY ***
Total pot $0.25 | Rake $0 
Seat 1: Andy Wolf folded before Flop (didn't bet)
Seat 2: Pelotín folded before Flop (didn't bet)
Seat 3: XaXaTyH4uK (button) folded before Flop (didn't bet)
Seat 4: Orlangoor (small blind) folded before Flop
Seat 5: Dimka4 (big blind) folded before Flop
Seat 6: oddshoff collected ($0.25)



PokerStars Hand #166667705104:  Hold'em No Limit ($0.05/$0.10 USD) - 2017/02/23 16:06:01 ET
Table 'Phereclos II' 6-max Seat #4 is the button
Seat 1: Croplayer1 ($10 in chips) 
Seat 2: Kazacha ($10.40 in chips) 
Seat 3: BJamesB2014 ($8 in chips) 
Seat 4: DamDatsAnAce ($10.53 in chips) 
Seat 5: crazydevill ($10 in chips) 
Seat 6: mhonielsen ($16.30 in chips) 
crazydevill: posts small blind $0.05
mhonielsen: posts big blind $0.10
BJamesB2014: posts big blind $0.10
*** HOLE CARDS ***
Croplayer1: folds 
Kazacha: folds 
BJamesB2014: checks 
DamDatsAnAce: folds 
crazydevill: raises $0.30 to $0.40
mhonielsen: folds 
BJamesB2014: calls $0.30
*** FLOP *** [6h 3h 5c]
crazydevill: bets $0.50
BJamesB2014: calls $0.50
*** TURN *** [6h 3h 5c] [Kc]
crazydevill: bets $1.40
BJamesB2014: calls $1.40
*** RIVER *** [6h 3h 5c Kc] [Qd]
crazydevill: checks 
BJamesB2014: checks 
*** SHOW DOWN ***
crazydevill: shows [Ks 7s] (a pair of Kings)
BJamesB2014: mucks hand 
crazydevill collected $4.49 from pot
*** SUMMARY ***
Total pot $4.70 | Rake $0.21 
Board [6h 3h 5c Kc Qd]
Seat 1: Croplayer1 folded before Flop (didn't bet)
Seat 2: Kazacha folded before Flop (didn't bet)
Seat 3: BJamesB2014 mucked
Seat 4: DamDatsAnAce (button) folded before Flop (didn't bet)
Seat 5: crazydevill (small blind) showed [Ks 7s] and won ($4.49) with a pair of Kings
Seat 6: mhonielsen (big blind) folded before Flop



PokerStars Hand #166667705111:  Hold'em No Limit ($0.05/$0.10 USD) - 2017/02/23 16:06:01 ET
Table 'Bengt' 6-max Seat #3 is the button
Seat 1: Lucky HoBBiT ($12.35 in chips) 
Seat 2: ChefRocco ($21.01 in chips) 
Seat 3: nantes15 ($13.23 in chips) 
Seat 4: 8th wonders ($10.14 in chips) 
Seat 5: RoJ1 ($10.31 in chips) 
Seat 6: Goroshkos88 ($10.28 in chips) 
8th wonders: posts small blind $0.05
RoJ1: posts big blind $0.10
*** HOLE CARDS ***
Goroshkos88: folds 
Lucky HoBBiT: raises $0.20 to $0.30
ChefRocco: folds 
nantes15: folds 
8th wonders: folds 
RoJ1: folds 
Uncalled bet ($0.20) returned to Lucky HoBBiT
Lucky HoBBiT collected $0.25 from pot
*** SUMMARY ***
Total pot $0.25 | Rake $0 
Seat 1: Lucky HoBBiT collected ($0.25)
Seat 2: ChefRocco folded before Flop (didn't bet)
Seat 3: nantes15 (button) folded before Flop (didn't bet)
Seat 4: 8th wonders (small blind) folded before Flop
Seat 5: RoJ1 (big blind) folded before Flop
Seat 6: Goroshkos88 folded before Flop (didn't bet)



PokerStars Hand #166667705151:  Hold'em No Limit ($0.05/$0.10 USD) - 2017/02/23 16:06:01 ET
Table 'Hamal II' 6-max Seat #4 is the button
Seat 1: saxoalto2011 ($7.79 in chips) 
Seat 2: pancernik21 ($10.15 in chips) 
Seat 3: Cluckh ($11.24 in chips) 
Seat 4: ArcticBearDK ($10.66 in chips) 
Seat 5: eniksenik ($10.79 in chips) 
Seat 6: LarryTheStar ($11.69 in chips) 
eniksenik: posts small blind $0.05
LarryTheStar: posts big blind $0.10
*** HOLE CARDS ***
saxoalto2011: folds 
pancernik21: folds 
Cluckh: raises $0.15 to $0.25
ArcticBearDK: raises $0.55 to $0.80
eniksenik: folds 
LarryTheStar: folds 
Cluckh: folds 
Uncalled bet ($0.55) returned to ArcticBearDK
ArcticBearDK collected $0.65 from pot
*** SUMMARY ***
Total pot $0.65 | Rake $0 
Seat 1: saxoalto2011 folded before Flop (didn't bet)
Seat 2: pancernik21 folded before Flop (didn't bet)
Seat 3: Cluckh folded before Flop
Seat 4: ArcticBearDK (button) collected ($0.65)
Seat 5: eniksenik (small blind) folded before Flop
Seat 6: LarryTheStar (big blind) folded before Flop



PokerStars Hand #166667705630:  Hold'em No Limit ($0.05/$0.10 USD) - 2017/02/23 16:06:01 ET
Table 'Gelria' 6-max Seat #6 is the button
Seat 1: ab260414 ($10.62 in chips) 
Seat 2: fishhook5 ($10 in chips) 
Seat 3: Orlangoor ($11.78 in chips) 
Seat 5: apenvel ($7.80 in chips) 
Seat 6: Andrei ProFF ($10.27 in chips) 
ab260414: posts small blind $0.05
fishhook5: posts big blind $0.10
eniksenik: sits out 
*** HOLE CARDS ***
Orlangoor: folds 
apenvel: raises $0.10 to $0.20
Andrei ProFF: folds 
ab260414: folds 
fishhook5: folds 
Uncalled bet ($0.10) returned to apenvel
apenvel collected $0.25 from pot
*** SUMMARY ***
Total pot $0.25 | Rake $0 
Seat 1: ab260414 (small blind) folded before Flop
Seat 2: fishhook5 (big blind) folded before Flop
Seat 3: Orlangoor folded before Flop (didn't bet)
Seat 5: apenvel collected ($0.25)
Seat 6: Andrei ProFF (button) folded before Flop (didn't bet)



PokerStars Hand #166667705752:  Hold'em No Limit ($0.05/$0.10 USD) - 2017/02/23 16:06:01 ET
Table 'Ophelia' 6-max Seat #6 is the button
Seat 1: ralfi37 ($9.58 in chips) 
Seat 2: popypaleta ($16.63 in chips) 
Seat 3: mvp0013 ($11.60 in chips) 
Seat 4: Cluckh ($12.14 in chips) 
Seat 5: truck1234 ($13.86 in chips) 
Seat 6: Yabidooo ($11.13 in chips) 
ralfi37: posts small blind $0.05
popypaleta: posts big blind $0.10
*** HOLE CARDS ***
mvp0013: raises $0.20 to $0.30
Cluckh: folds 
truck1234: folds 
Yabidooo: folds 
ralfi37: calls $0.25
popypaleta: folds 
*** FLOP *** [7s 4s Js]
ralfi37: checks 
mvp0013: checks 
*** TURN *** [7s 4s Js] [9s]
ralfi37: checks 
mvp0013: bets $0.10
ralfi37: raises $0.40 to $0.50
mvp0013: calls $0.40
*** RIVER *** [7s 4s Js 9s] [2c]
ralfi37: bets $0.80
mvp0013: folds 
Uncalled bet ($0.80) returned to ralfi37
ralfi37 collected $1.62 from pot
*** SUMMARY ***
Total pot $1.70 | Rake $0.08 
Board [7s 4s Js 9s 2c]
Seat 1: ralfi37 (small blind) collected ($1.62)
Seat 2: popypaleta (big blind) folded before Flop
Seat 3: mvp0013 folded on the River
Seat 4: Cluckh folded before Flop (didn't bet)
Seat 5: truck1234 folded before Flop (didn't bet)
Seat 6: Yabidooo (button) folded before Flop (didn't bet)



PokerStars Hand #166667705847:  Hold'em No Limit ($0.05/$0.10 USD) - 2017/02/23 16:06:01 ET
Table 'Garlena III' 6-max Seat #3 is the button
Seat 1: dittoro ($10 in chips) 
Seat 2: rusu_rapid ($10.15 in chips) 
Seat 3: Therodorus ($10 in chips) 
steepfell will be allowed to play after the button
iluzja12 will be allowed to play after the button
dittoro: posts small blind $0.05
mbkongstad joins the table at seat #4 
rusu_rapid: posts big blind $0.10
*** HOLE CARDS ***
Therodorus: folds 
dittoro: folds 
Uncalled bet ($0.05) returned to rusu_rapid
rusu_rapid collected $0.10 from pot
*** SUMMARY ***
Total pot $0.10 | Rake $0 
Seat 1: dittoro (small blind) folded before Flop
Seat 2: rusu_rapid (big blind) collected ($0.10)
Seat 3: Therodorus (button) folded before Flop (didn't bet)



PokerStars Hand #166667705887:  Hold'em No Limit ($0.05/$0.10 USD) - 2017/02/23 16:06:02 ET
Table 'Nephthys II' 6-max Seat #3 is the button
Seat 1: DamDatsAnAce ($11.37 in chips) 
Seat 2: Ju$tD0it ($8 in chips) 
Seat 3: Newqbrown ($20.76 in chips) 
Seat 4: MihaGr ($10 in chips) 
Seat 5: kingartur222 ($8.76 in chips) 
Seat 6: CHRO8 ($14.34 in chips) 
MihaGr: posts small blind $0.05
kingartur222: posts big blind $0.10
Ju$tD0it: posts big blind $0.10
*** HOLE CARDS ***
CHRO8: folds 
DamDatsAnAce: folds 
Ju$tD0it: checks 
Newqbrown: folds 
MihaGr: folds 
kingartur222: checks 
*** FLOP *** [Js 7s As]
kingartur222: checks 
Ju$tD0it: checks 
*** TURN *** [Js 7s As] [4c]
kingartur222: checks 
Ju$tD0it: bets $0.24
kingartur222: folds 
Uncalled bet ($0.24) returned to Ju$tD0it
Ju$tD0it collected $0.24 from pot
*** SUMMARY ***
Total pot $0.25 | Rake $0.01 
Board [Js 7s As 4c]
Seat 1: DamDatsAnAce folded before Flop (didn't bet)
Seat 2: Ju$tD0it collected ($0.24)
Seat 3: Newqbrown (button) folded before Flop (didn't bet)
Seat 4: MihaGr (small blind) folded before Flop
Seat 5: kingartur222 (big blind) folded on the Turn
Seat 6: CHRO8 folded before Flop (didn't bet)



PokerStars Hand #166667705983:  Hold'em No Limit ($0.05/$0.10 USD) - 2017/02/23 16:06:02 ET
Table 'Lampetia III' 6-max Seat #1 is the button
Seat 1: gaHy_HaXeP ($10.55 in chips) 
Seat 2: DamDatsAnAce ($10.05 in chips) 
Seat 3: Kow6oy ($10 in chips) 
Seat 4: IAntikI ($11.41 in chips) 
Seat 5: robson1235 ($19.88 in chips) 
Seat 6: bdixon_5 ($9.20 in chips) 
DamDatsAnAce: posts small blind $0.05
Kow6oy: posts big blind $0.10
*** HOLE CARDS ***
IAntikI: raises $0.20 to $0.30
robson1235: calls $0.30
bdixon_5: folds 
gaHy_HaXeP: folds 
DamDatsAnAce: folds 
Kow6oy: folds 
*** FLOP *** [3d 6d Td]
IAntikI: checks 
robson1235: bets $0.36
IAntikI: calls $0.36
*** TURN *** [3d 6d Td] [2h]
IAntikI: checks 
robson1235: checks 
*** RIVER *** [3d 6d Td 2h] [Kh]
IAntikI: checks 
robson1235: checks 
*** SHOW DOWN ***
IAntikI: shows [8d 8s] (a pair of Eights)
robson1235: shows [Ts Ad] (a pair of Tens)
robson1235 collected $1.40 from pot
*** SUMMARY ***
Total pot $1.47 | Rake $0.07 
Board [3d 6d Td 2h Kh]
Seat 1: gaHy_HaXeP (button) folded before Flop (didn't bet)
Seat 2: DamDatsAnAce (small blind) folded before Flop
Seat 3: Kow6oy (big blind) folded before Flop
Seat 4: IAntikI showed [8d 8s] and lost with a pair of Eights
Seat 5: robson1235 showed [Ts Ad] and won ($1.40) with a pair of Tens
Seat 6: bdixon_5 folded before Flop (didn't bet)



PokerStars Hand #166667705987:  Hold'em No Limit ($0.05/$0.10 USD) - 2017/02/23 16:06:02 ET
Table 'Fechtig III' 6-max Seat #4 is the button
Seat 1: Scanner17 ($12.24 in chips) 
Seat 2: GV82 ($16.83 in chips) 
Seat 3: eniksenik ($10 in chips) 
Seat 4: Kow6oy ($10 in chips) 
Seat 5: ksandr_hom ($10.15 in chips) 
Seat 6: Glatzemandse ($17.94 in chips) 
ksandr_hom: posts small blind $0.05
Glatzemandse: posts big blind $0.10
*** HOLE CARDS ***
Scanner17: folds 
GV82: folds 
eniksenik: folds 
Kow6oy: raises $0.15 to $0.25
ksandr_hom: folds 
Glatzemandse: calls $0.15
*** FLOP *** [4c 6c 7c]
Glatzemandse: bets $0.10
Kow6oy: calls $0.10
*** TURN *** [4c 6c 7c] [3h]
Glatzemandse: checks 
Kow6oy: checks 
*** RIVER *** [4c 6c 7c 3h] [6s]
Glatzemandse: bets $0.36
Kow6oy: folds 
Uncalled bet ($0.36) returned to Glatzemandse
Glatzemandse collected $0.72 from pot
*** SUMMARY ***
Total pot $0.75 | Rake $0.03 
Board [4c 6c 7c 3h 6s]
Seat 1: Scanner17 folded before Flop (didn't bet)
Seat 2: GV82 folded before Flop (didn't bet)
Seat 3: eniksenik folded before Flop (didn't bet)
Seat 4: Kow6oy (button) folded on the River
Seat 5: ksandr_hom (small blind) folded before Flop
Seat 6: Glatzemandse (big blind) collected ($0.72)



PokerStars Hand #166667706312:  Hold'em No Limit ($0.05/$0.10 USD) - 2017/02/23 16:06:02 ET
Table 'Syringa II' 6-max Seat #3 is the button
Seat 1: GiveTwoMe ($15.47 in chips) 
Seat 2: Cluckh ($10.14 in chips) 
Seat 3: gaHy_HaXeP ($10.58 in chips) 
Seat 4: MBen10 ($10 in chips) 
Seat 5: Mishapok196 ($7.40 in chips) 
Seat 6: WinninBikini ($10 in chips) 
MBen10: posts small blind $0.05
Mishapok196: posts big blind $0.10
*** HOLE CARDS ***
WinninBikini: raises $0.20 to $0.30
GiveTwoMe: calls $0.30
Cluckh: folds 
gaHy_HaXeP: folds 
MBen10: calls $0.25
Mishapok196: calls $0.20
*** FLOP *** [Ad 8d Ts]
MBen10: checks 
Mishapok196: checks 
WinninBikini: bets $0.80
GiveTwoMe: folds 
MBen10: raises $1.29 to $2.09
Mishapok196: folds 
WinninBikini: calls $1.29
*** TURN *** [Ad 8d Ts] [Jd]
MBen10: bets $3.14
WinninBikini: folds 
Uncalled bet ($3.14) returned to MBen10
MBen10 collected $5.14 from pot
*** SUMMARY ***
Total pot $5.38 | Rake $0.24 
Board [Ad 8d Ts Jd]
Seat 1: GiveTwoMe folded on the Flop
Seat 2: Cluckh folded before Flop (didn't bet)
Seat 3: gaHy_HaXeP (button) folded before Flop (didn't bet)
Seat 4: MBen10 (small blind) collected ($5.14)
Seat 5: Mishapok196 (big blind) folded on the Flop
Seat 6: WinninBikini folded on the Turn



PokerStars Hand #166667706426:  Hold'em No Limit ($0.05/$0.10 USD) - 2017/02/23 16:06:02 ET
Table 'Isberga' 6-max Seat #6 is the button
Seat 1: Feverhead ($18.22 in chips) 
Seat 2: GESPERIA ($10.27 in chips) 
Seat 4: THIMUCHIN ($10.84 in chips) 
Seat 5: YoungGriff86 ($18.87 in chips) 
Seat 6: Goroshkos88 ($21.23 in chips) 
Feverhead: posts small blind $0.05
GESPERIA: posts big blind $0.10
*** HOLE CARDS ***
THIMUCHIN: folds 
YoungGriff86: folds 
Goroshkos88: raises $0.20 to $0.30
Feverhead: folds 
GESPERIA: folds 
Uncalled bet ($0.20) returned to Goroshkos88
Goroshkos88 collected $0.25 from pot
*** SUMMARY ***
Total pot $0.25 | Rake $0 
Seat 1: Feverhead (small blind) folded before Flop
Seat 2: GESPERIA (big blind) folded before Flop
Seat 4: THIMUCHIN folded before Flop (didn't bet)
Seat 5: YoungGriff86 folded before Flop (didn't bet)
Seat 6: Goroshkos88 (button) collected ($0.25)



PokerStars Hand #166667706569:  Hold'em No Limit ($0.05/$0.10 USD) - 2017/02/23 16:06:02 ET
Table 'Siebohme' 6-max Seat #2 is the button
Seat 1: kusa4ki ($11.53 in chips) 
Seat 2: el toro 1507 ($11.53 in chips) 
Seat 3: ex3Lero86 ($10.46 in chips) 
Seat 4: Innerwuss ($10.15 in chips) 
Seat 5: Kazacha ($10 in chips) 
Seat 6: townerz1991 ($10.53 in chips) 
ex3Lero86: posts small blind $0.05
Innerwuss: posts big blind $0.10
*** HOLE CARDS ***
Kazacha: folds 
townerz1991: folds 
kusa4ki: folds 
el toro 1507: folds 
ex3Lero86: folds 
Uncalled bet ($0.05) returned to Innerwuss
Innerwuss collected $0.10 from pot
*** SUMMARY ***
Total pot $0.10 | Rake $0 
Seat 1: kusa4ki folded before Flop (didn't bet)
Seat 2: el toro 1507 (button) folded before Flop (didn't bet)
Seat 3: ex3Lero86 (small blind) folded before Flop
Seat 4: Innerwuss (big blind) collected ($0.10)
Seat 5: Kazacha folded before Flop (didn't bet)
Seat 6: townerz1991 folded before Flop (didn't bet)



PokerStars Hand #166667707144:  Hold'em No Limit ($0.05/$0.10 USD) - 2017/02/23 16:06:03 ET
Table 'Nikko II' 6-max Seat #2 is the button
Seat 1: bdixon_5 ($10.37 in chips) 
Seat 2: popypaleta ($10.10 in chips) 
Seat 3: Hyd SK ($12.06 in chips) 
Seat 4: Peter0087 ($10 in chips) 
Seat 5: Aescul@pius ($12.18 in chips) 
Seat 6: JahSoldier69 ($10 in chips) 
Hyd SK: posts small blind $0.05
Peter0087: posts big blind $0.10
*** HOLE CARDS ***
Aescul@pius: raises $0.20 to $0.30
JahSoldier69: folds 
bdixon_5: folds 
popypaleta: folds 
Hyd SK: folds 
Peter0087: folds 
Uncalled bet ($0.20) returned to Aescul@pius
Aescul@pius collected $0.25 from pot
*** SUMMARY ***
Total pot $0.25 | Rake $0 
Seat 1: bdixon_5 folded before Flop (didn't bet)
Seat 2: popypaleta (button) folded before Flop (didn't bet)
Seat 3: Hyd SK (small blind) folded before Flop
Seat 4: Peter0087 (big blind) folded before Flop
Seat 5: Aescul@pius collected ($0.25)
Seat 6: JahSoldier69 folded before Flop (didn't bet)



PokerStars Hand #166667707189:  Hold'em No Limit ($0.05/$0.10 USD) - 2017/02/23 16:06:03 ET
Table 'Caupolican' 6-max Seat #6 is the button
Seat 1: kingartur222 ($11.54 in chips) 
Seat 2: garigura ($18.90 in chips) 
Seat 4: mhonielsen ($15.79 in chips) 
Seat 5: Kazacha ($10.56 in chips) 
Seat 6: crazydevill ($10.62 in chips) 
kingartur222: posts small blind $0.05
garigura: posts big blind $0.10
*** HOLE CARDS ***
mhonielsen: folds 
Kazacha: raises $0.14 to $0.24
crazydevill: raises $0.56 to $0.80
kingartur222: folds 
garigura: folds 
Kazacha: raises $1.40 to $2.20
crazydevill: folds 
Uncalled bet ($1.40) returned to Kazacha
Kazacha collected $1.75 from pot
*** SUMMARY ***
Total pot $1.75 | Rake $0 
Seat 1: kingartur222 (small blind) folded before Flop
Seat 2: garigura (big blind) folded before Flop
Seat 4: mhonielsen folded before Flop (didn't bet)
Seat 5: Kazacha collected ($1.75)
Seat 6: crazydevill (button) folded before Flop



PokerStars Hand #166667707202:  Hold'em No Limit ($0.05/$0.10 USD) - 2017/02/23 16:06:03 ET
Table 'Kunigunde II' 6-max Seat #5 is the button
Seat 1: facewald ($5.94 in chips) 
Seat 3: pancernik21 ($18.71 in chips) 
Seat 4: david_sara83 ($12.83 in chips) 
Seat 5: mdelfin0 ($11.44 in chips) 
Seat 6: Zooplack ($10 in chips) 
Zooplack: posts small blind $0.05
facewald: posts big blind $0.10
eniksenik: sits out 
*** HOLE CARDS ***
pancernik21: folds 
david_sara83: raises $0.15 to $0.25
mdelfin0: folds 
Zooplack: folds 
facewald: calls $0.15
*** FLOP *** [3c Th Jc]
facewald: checks 
david_sara83: bets $0.35
facewald: calls $0.35
*** TURN *** [3c Th Jc] [4h]
eniksenik leaves the table
Namhkal joins the table at seat #2 
facewald: checks 
Namhkal leaves the table
david_sara83: bets $0.81
facewald: folds 
Uncalled bet ($0.81) returned to david_sara83
david_sara83 collected $1.19 from pot
*** SUMMARY ***
Total pot $1.25 | Rake $0.06 
Board [3c Th Jc 4h]
Seat 1: facewald (big blind) folded on the Turn
Seat 3: pancernik21 folded before Flop (didn't bet)
Seat 4: david_sara83 collected ($1.19)
Seat 5: mdelfin0 (button) folded before Flop (didn't bet)
Seat 6: Zooplack (small blind) folded before Flop



PokerStars Hand #166667707297:  Hold'em No Limit ($0.05/$0.10 USD) - 2017/02/23 16:06:03 ET
Table 'Union' 6-max Seat #4 is the button
Seat 2: Zooplack ($10 in chips) 
Seat 3: Rodik002 ($12.01 in chips) 
Seat 4: Croplayer1 ($14.80 in chips) 
Seat 5: Chodemuncher ($16.05 in chips) 
Seat 6: bonyo71 ($3.85 in chips) 
Chodemuncher: posts small blind $0.05
bonyo71: posts big blind $0.10
IAntikI: sits out 
*** HOLE CARDS ***
Zooplack: folds 
Rodik002: folds 
Croplayer1: raises $0.10 to $0.20
Chodemuncher: folds 
bonyo71: folds 
Uncalled bet ($0.10) returned to Croplayer1
Croplayer1 collected $0.25 from pot
*** SUMMARY ***
Total pot $0.25 | Rake $0 
Seat 2: Zooplack folded before Flop (didn't bet)
Seat 3: Rodik002 folded before Flop (didn't bet)
Seat 4: Croplayer1 (button) collected ($0.25)
Seat 5: Chodemuncher (small blind) folded before Flop
Seat 6: bonyo71 (big blind) folded before Flop



PokerStars Hand #166667707446:  Hold'em No Limit ($0.05/$0.10 USD) - 2017/02/23 16:06:03 ET
Table 'Pandora III' 6-max Seat #4 is the button
Seat 1: Pokeaster ($10.84 in chips) 
Seat 2: garigura ($11.54 in chips) 
Seat 4: mhonielsen ($10 in chips) 
Seat 5: MühliJr ($10.47 in chips) 
Seat 6: yodzik ($5 in chips) 
MühliJr: posts small blind $0.05
yodzik: posts big blind $0.10
Chodemuncher: sits out 
*** HOLE CARDS ***
Pokeaster: folds 
garigura: folds 
mhonielsen: raises $0.10 to $0.20
MühliJr: folds 
yodzik: folds 
Uncalled bet ($0.10) returned to mhonielsen
mhonielsen collected $0.25 from pot
*** SUMMARY ***
Total pot $0.25 | Rake $0 
Seat 1: Pokeaster folded before Flop (didn't bet)
Seat 2: garigura folded before Flop (didn't bet)
Seat 4: mhonielsen (button) collected ($0.25)
Seat 5: MühliJr (small blind) folded before Flop
Seat 6: yodzik (big blind) folded before Flop



PokerStars Hand #166667707476:  Hold'em No Limit ($0.05/$0.10 USD) - 2017/02/23 16:06:03 ET
Table 'Nymphe II' 6-max Seat #4 is the button
Seat 1: jacktayra ($1.56 in chips) 
Seat 2: Newqbrown ($10.90 in chips) 
Seat 3: THIMUCHIN ($16.61 in chips) 
Seat 4: coolisses111 ($18 in chips) 
Seat 5: Yspenyanin ($10.84 in chips) 
Seat 6: Xander188 ($18.08 in chips) 
Yspenyanin: posts small blind $0.05
Xander188: posts big blind $0.10
*** HOLE CARDS ***
jacktayra: folds 
Newqbrown: raises $0.20 to $0.30
THIMUCHIN: folds 
coolisses111: folds 
Yspenyanin: raises $0.70 to $1
Xander188: calls $0.90
Newqbrown: calls $0.70
*** FLOP *** [Qs 5c 3s]
Yspenyanin: bets $1.43
Xander188: calls $1.43
Newqbrown: folds 
*** TURN *** [Qs 5c 3s] [6c]
Yspenyanin: bets $4.20
Xander188: raises $11.45 to $15.65 and is all-in
Yspenyanin: calls $4.21 and is all-in
Uncalled bet ($7.24) returned to Xander188
*** RIVER *** [Qs 5c 3s 6c] [8c]
*** SHOW DOWN ***
Yspenyanin: shows [Ad As] (a pair of Aces)
Xander188: shows [Kc Kd] (a pair of Kings)
Yspenyanin collected $21.66 from pot
*** SUMMARY ***
Total pot $22.68 | Rake $1.02 
Board [Qs 5c 3s 6c 8c]
Seat 1: jacktayra folded before Flop (didn't bet)
Seat 2: Newqbrown folded on the Flop
Seat 3: THIMUCHIN folded before Flop (didn't bet)
Seat 4: coolisses111 (button) folded before Flop (didn't bet)
Seat 5: Yspenyanin (small blind) showed [Ad As] and won ($21.66) with a pair of Aces
Seat 6: Xander188 (big blind) showed [Kc Kd] and lost with a pair of Kings



PokerStars Hand #166667707551:  Hold'em No Limit ($0.05/$0.10 USD) - 2017/02/23 16:06:03 ET
Table 'Markab II' 6-max Seat #5 is the button
Seat 1: david_sara83 ($10.37 in chips) 
Seat 2: truck1234 ($11.05 in chips) 
Seat 3: sexy_seagull ($10 in chips) 
Seat 4: Crafty23@PS ($11.54 in chips) 
Seat 5: Rodik002 ($19.77 in chips) 
Seat 6: Comeback3392 ($10 in chips) 
Comeback3392: posts small blind $0.05
david_sara83: posts big blind $0.10
*** HOLE CARDS ***
truck1234: folds 
sexy_seagull: raises $0.20 to $0.30
Crafty23@PS: folds 
Rodik002: folds 
Comeback3392: folds 
david_sara83: folds 
Uncalled bet ($0.20) returned to sexy_seagull
sexy_seagull collected $0.25 from pot
*** SUMMARY ***
Total pot $0.25 | Rake $0 
Seat 1: david_sara83 (big blind) folded before Flop
Seat 2: truck1234 folded before Flop (didn't bet)
Seat 3: sexy_seagull collected ($0.25)
Seat 4: Crafty23@PS folded before Flop (didn't bet)
Seat 5: Rodik002 (button) folded before Flop (didn't bet)
Seat 6: Comeback3392 (small blind) folded before Flop



PokerStars Hand #166667707605:  Hold'em No Limit ($0.05/$0.10 USD) - 2017/02/23 16:06:03 ET
Table 'Risha II' 6-max Seat #3 is the button
Seat 1: R. Lemonte ($13.42 in chips) 
Seat 2: KA3AXCTAHEU, ($12.65 in chips) 
Seat 3: steepfell ($10 in chips) 
Seat 4: Comeback3392 ($20.71 in chips) 
Seat 5: m.c-alkatraz ($10.20 in chips) 
Seat 6: univibe68 ($10.61 in chips) 
Comeback3392: posts small blind $0.05
m.c-alkatraz: posts big blind $0.10
*** HOLE CARDS ***
univibe68: folds 
R. Lemonte: folds 
KA3AXCTAHEU,: folds 
steepfell: raises $0.15 to $0.25
Comeback3392: folds 
m.c-alkatraz: folds 
Uncalled bet ($0.15) returned to steepfell
steepfell collected $0.25 from pot
*** SUMMARY ***
Total pot $0.25 | Rake $0 
Seat 1: R. Lemonte folded before Flop (didn't bet)
Seat 2: KA3AXCTAHEU, folded before Flop (didn't bet)
Seat 3: steepfell (button) collected ($0.25)
Seat 4: Comeback3392 (small blind) folded before Flop
Seat 5: m.c-alkatraz (big blind) folded before Flop
Seat 6: univibe68 folded before Flop (didn't bet)



PokerStars Hand #166667707866:  Hold'em No Limit ($0.05/$0.10 USD) - 2017/02/23 16:06:04 ET
Table 'Hirons' 6-max Seat #6 is the button
Seat 1: RoJ1 ($11.58 in chips) 
Seat 2: coolisses111 ($7.79 in chips) 
Seat 3: czeczen7 ($14.51 in chips) 
Seat 4: Smitty03300 ($10 in chips) 
Seat 6: garigura ($14.53 in chips) 
RoJ1: posts small blind $0.05
coolisses111: posts big blind $0.10
Pekaml: sits out 
*** HOLE CARDS ***
czeczen7: folds 
Smitty03300: raises $0.15 to $0.25
garigura: raises $0.65 to $0.90
RoJ1: folds 
coolisses111: folds 
Smitty03300: raises $1.30 to $2.20
garigura: folds 
Uncalled bet ($1.30) returned to Smitty03300
Smitty03300 collected $1.95 from pot
*** SUMMARY ***
Total pot $1.95 | Rake $0 
Seat 1: RoJ1 (small blind) folded before Flop
Seat 2: coolisses111 (big blind) folded before Flop
Seat 3: czeczen7 folded before Flop (didn't bet)
Seat 4: Smitty03300 collected ($1.95)
Seat 6: garigura (button) folded before Flop



PokerStars Hand #166667707867:  Hold'em No Limit ($0.05/$0.10 USD) - 2017/02/23 16:06:04 ET
Table 'Themisto II' 6-max Seat #5 is the button
Seat 2: CA225 ($10.55 in chips) 
Seat 3: eniksenik ($15.53 in chips) 
Seat 4: Innerwuss ($10 in chips) 
Seat 5: ex3Lero86 ($11.12 in chips) 
Seat 6: noobigrok ($4.05 in chips) 
noobigrok: posts small blind $0.05
kickereens: is sitting out 
kickereens leaves the table
CA225: posts big blind $0.10
*** HOLE CARDS ***
eniksenik: raises $0.20 to $0.30
ChuikaPridi joins the table at seat #1 
Innerwuss: calls $0.30
ex3Lero86: folds 
noobigrok: folds 
CA225: calls $0.20
*** FLOP *** [Tc 5h Jh]
CA225: checks 
eniksenik: bets $0.70
Innerwuss: folds 
CA225: folds 
Uncalled bet ($0.70) returned to eniksenik
eniksenik collected $0.91 from pot
*** SUMMARY ***
Total pot $0.95 | Rake $0.04 
Board [Tc 5h Jh]
Seat 2: CA225 (big blind) folded on the Flop
Seat 3: eniksenik collected ($0.91)
Seat 4: Innerwuss folded on the Flop
Seat 5: ex3Lero86 (button) folded before Flop (didn't bet)
Seat 6: noobigrok (small blind) folded before Flop



PokerStars Hand #166667707888:  Hold'em No Limit ($0.05/$0.10 USD) - 2017/02/23 16:06:04 ET
Table 'Bootes' 6-max Seat #1 is the button
Seat 1: Namhkal ($12.97 in chips) 
Seat 2: Bird et al ($19.20 in chips) 
Seat 3: KA3AXCTAHEU, ($19.23 in chips) 
Seat 4: totonove ($5.17 in chips) 
Seat 6: cherep61987 ($10.22 in chips) 
Bird et al: posts small blind $0.05
KA3AXCTAHEU,: posts big blind $0.10
Pekaml: sits out 
*** HOLE CARDS ***
totonove: calls $0.10
cherep61987: folds 
Namhkal: raises $0.30 to $0.40
Bird et al: folds 
KA3AXCTAHEU,: folds 
totonove: calls $0.30
*** FLOP *** [Jh 3h 4h]
totonove: checks 
Namhkal: checks 
*** TURN *** [Jh 3h 4h] [6h]
totonove: bets $0.30
Namhkal: calls $0.30
*** RIVER *** [Jh 3h 4h 6h] [Ks]
totonove: bets $0.50
Namhkal: calls $0.50
*** SHOW DOWN ***
totonove: shows [7h Th] (a flush, Jack high)
Namhkal: mucks hand 
totonove collected $2.44 from pot
*** SUMMARY ***
Total pot $2.55 | Rake $0.11 
Board [Jh 3h 4h 6h Ks]
Seat 1: Namhkal (button) mucked
Seat 2: Bird et al (small blind) folded before Flop
Seat 3: KA3AXCTAHEU, (big blind) folded before Flop
Seat 4: totonove showed [7h Th] and won ($2.44) with a flush, Jack high
Seat 6: cherep61987 folded before Flop (didn't bet)



PokerStars Hand #166667708188:  Hold'em No Limit ($0.05/$0.10 USD) - 2017/02/23 16:06:04 ET
Table 'Torrence II' 6-max Seat #5 is the button
Seat 1: Starbooks ($6.84 in chips) 
Seat 2: scorpionfish ($15.80 in chips) 
Seat 3: coolisses111 ($9.80 in chips) 
Seat 4: Zooplack ($10 in chips) 
Seat 5: Kow6oy ($12.18 in chips) 
Seat 6: mhonielsen ($10 in chips) 
mhonielsen: posts small blind $0.05
Starbooks: posts big blind $0.10
*** HOLE CARDS ***
scorpionfish: folds 
coolisses111: folds 
Zooplack: raises $0.15 to $0.25
Kow6oy: folds 
mhonielsen: folds 
Starbooks: calls $0.15
*** FLOP *** [7h 7d 2s]
Starbooks: checks 
Zooplack: bets $0.27
Starbooks: calls $0.27
*** TURN *** [7h 7d 2s] [5h]
Starbooks: checks 
Zooplack: checks 
*** RIVER *** [7h 7d 2s 5h] [5s]
Starbooks: bets $1.10
Zooplack: folds 
Uncalled bet ($1.10) returned to Starbooks
Starbooks collected $1.04 from pot
*** SUMMARY ***
Total pot $1.09 | Rake $0.05 
Board [7h 7d 2s 5h 5s]
Seat 1: Starbooks (big blind) collected ($1.04)
Seat 2: scorpionfish folded before Flop (didn't bet)
Seat 3: coolisses111 folded before Flop (didn't bet)
Seat 4: Zooplack folded on the River
Seat 5: Kow6oy (button) folded before Flop (didn't bet)
Seat 6: mhonielsen (small blind) folded before Flop



PokerStars Hand #166667708243:  Hold'em No Limit ($0.05/$0.10 USD) - 2017/02/23 16:06:04 ET
Table 'Pyrrhus III' 6-max Seat #6 is the button
Seat 1: skatejeff ($13.60 in chips) 
Seat 2: univibe68 ($20.30 in chips) 
Seat 3: coolisses111 ($9.87 in chips) 
Seat 4: ex3Lero86 ($23.36 in chips) 
Seat 6: MLPlayer16 ($19.71 in chips) 
skatejeff: posts small blind $0.05
univibe68: posts big blind $0.10
skatejeff: posts the ante $0.02
univibe68: posts the ante $0.02
coolisses111: posts the ante $0.02
ex3Lero86: posts the ante $0.02
MLPlayer16: posts the ante $0.02
*** HOLE CARDS ***
coolisses111: folds 
eniksenik joins the table at seat #5 
ex3Lero86: folds 
MLPlayer16: raises $0.15 to $0.25
skatejeff: calls $0.20
univibe68: folds 
*** FLOP *** [Qs 5h Th]
skatejeff: checks 
MLPlayer16: bets $0.37
skatejeff: calls $0.37
*** TURN *** [Qs 5h Th] [3s]
skatejeff: checks 
MLPlayer16: checks 
*** RIVER *** [Qs 5h Th 3s] [5d]
skatejeff: checks 
MLPlayer16: checks 
*** SHOW DOWN ***
skatejeff: shows [4h 2h] (a pair of Fives)
MLPlayer16: shows [9d Ks] (a pair of Fives - King kicker)
MLPlayer16 collected $1.38 from pot
*** SUMMARY ***
Total pot $1.44 | Rake $0.06 
Board [Qs 5h Th 3s 5d]
Seat 1: skatejeff (small blind) showed [4h 2h] and lost with a pair of Fives
Seat 2: univibe68 (big blind) folded before Flop
Seat 3: coolisses111 folded before Flop (didn't bet)
Seat 4: ex3Lero86 folded before Flop (didn't bet)
Seat 6: MLPlayer16 (button) showed [9d Ks] and won ($1.38) with a pair of Fives



PokerStars Hand #166667708380:  Hold'em No Limit ($0.05/$0.10 USD) - 2017/02/23 16:06:04 ET
Table 'Aludra II' 6-max Seat #1 is the button
Seat 1: voledy ($10.23 in chips) 
Seat 2: JahSoldier69 ($14.10 in chips) 
Seat 3: mbkongstad ($10 in chips) 
Seat 4: MihaGr ($10.74 in chips) 
Seat 5: kingartur222 ($15.45 in chips) 
Seat 6: call me haaa ($13.98 in chips) 
JahSoldier69: posts small blind $0.05
mbkongstad: posts big blind $0.10
*** HOLE CARDS ***
MihaGr: folds 
kingartur222: raises $0.20 to $0.30
call me haaa: calls $0.30
voledy: folds 
JahSoldier69: folds 
mbkongstad: folds 
*** FLOP *** [7c Qd 5c]
kingartur222: checks 
call me haaa: checks 
*** TURN *** [7c Qd 5c] [Qh]
kingartur222: checks 
call me haaa: checks 
*** RIVER *** [7c Qd 5c Qh] [6s]
kingartur222: checks 
call me haaa: checks 
*** SHOW DOWN ***
kingartur222: shows [3s 3d] (two pair, Queens and Threes)
call me haaa: mucks hand 
kingartur222 collected $0.72 from pot
*** SUMMARY ***
Total pot $0.75 | Rake $0.03 
Board [7c Qd 5c Qh 6s]
Seat 1: voledy (button) folded before Flop (didn't bet)
Seat 2: JahSoldier69 (small blind) folded before Flop
Seat 3: mbkongstad (big blind) folded before Flop
Seat 4: MihaGr folded before Flop (didn't bet)
Seat 5: kingartur222 showed [3s 3d] and won ($0.72) with two pair, Queens and Threes
Seat 6: call me haaa mucked



PokerStars Hand #166667708390:  Hold'em No Limit ($0.05/$0.10 USD) - 2017/02/23 16:06:04 ET
Table 'Pompeja III' 6-max Seat #6 is the button
Seat 1: Iarlei ($11.99 in chips) 
Seat 2: steepfell ($10 in chips) 
Seat 3: Yspenyanin ($11.85 in chips) 
Seat 4: Cluckh ($13.87 in chips) 
Seat 5: Spud014 ($12.22 in chips) 
Seat 6: mega spasser ($4.80 in chips) 
Iarlei: posts small blind $0.05
steepfell: posts big blind $0.10
*** HOLE CARDS ***
Yspenyanin: folds 
Cluckh: folds 
Spud014: raises $0.15 to $0.25
mega spasser: folds 
Iarlei: folds 
steepfell: folds 
Uncalled bet ($0.15) returned to Spud014
Spud014 collected $0.25 from pot
*** SUMMARY ***
Total pot $0.25 | Rake $0 
Seat 1: Iarlei (small blind) folded before Flop
Seat 2: steepfell (big blind) folded before Flop
Seat 3: Yspenyanin folded before Flop (didn't bet)
Seat 4: Cluckh folded before Flop (didn't bet)
Seat 5: Spud014 collected ($0.25)
Seat 6: mega spasser (button) folded before Flop (didn't bet)



PokerStars Hand #166667708431:  Hold'em No Limit ($0.05/$0.10 USD) - 2017/02/23 16:06:04 ET
Table 'Reginhild' 6-max Seat #6 is the button
Seat 1: iamkakaroto ($11.30 in chips) 
Seat 2: Kow6oy ($10.30 in chips) 
Seat 3: ARCHITECT83 ($6.39 in chips) 
Seat 4: Raymondo21 ($23.63 in chips) 
Seat 5: XCarlos610 ($29.78 in chips) 
Seat 6: eniksenik ($10 in chips) 
iamkakaroto: posts small blind $0.05
Kow6oy: posts big blind $0.10
*** HOLE CARDS ***
ARCHITECT83: folds 
Raymondo21: raises $0.10 to $0.20
XCarlos610: folds 
eniksenik: folds 
iamkakaroto: folds 
Kow6oy: folds 
Uncalled bet ($0.10) returned to Raymondo21
Raymondo21 collected $0.25 from pot
*** SUMMARY ***
Total pot $0.25 | Rake $0 
Seat 1: iamkakaroto (small blind) folded before Flop
Seat 2: Kow6oy (big blind) folded before Flop
Seat 3: ARCHITECT83 folded before Flop (didn't bet)
Seat 4: Raymondo21 collected ($0.25)
Seat 5: XCarlos610 folded before Flop (didn't bet)
Seat 6: eniksenik (button) folded before Flop (didn't bet)



PokerStars Hand #166667708432:  Hold'em No Limit ($0.05/$0.10 USD) - 2017/02/23 16:06:04 ET
Table 'Luanda' 6-max Seat #1 is the button
Seat 1: AM-L-SL ($4.65 in chips) 
Seat 2: Xander188 ($10.09 in chips) 
Seat 3: DamDatsAnAce ($10.15 in chips) 
Seat 5: st4tion ($13.03 in chips) 
Seat 6: KA3AXCTAHEU, ($11.58 in chips) 
Xander188: posts small blind $0.05
DamDatsAnAce: posts big blind $0.10
*** HOLE CARDS ***
st4tion: raises $0.15 to $0.25
KA3AXCTAHEU,: folds 
AM-L-SL: calls $0.25
Xander188: folds 
DamDatsAnAce: folds 
*** FLOP *** [5s 8s 3h]
st4tion: checks 
AM-L-SL: checks 
*** TURN *** [5s 8s 3h] [9c]
st4tion: bets $0.22
AM-L-SL: calls $0.22
*** RIVER *** [5s 8s 3h 9c] [Kd]
st4tion: checks 
AM-L-SL: checks 
*** SHOW DOWN ***
st4tion: shows [Qh Ad] (high card Ace)
AM-L-SL: shows [Jd As] (high card Ace - lower kicker)
st4tion collected $1.04 from pot
*** SUMMARY ***
Total pot $1.09 | Rake $0.05 
Board [5s 8s 3h 9c Kd]
Seat 1: AM-L-SL (button) showed [Jd As] and lost with high card Ace
Seat 2: Xander188 (small blind) folded before Flop
Seat 3: DamDatsAnAce (big blind) folded before Flop
Seat 5: st4tion showed [Qh Ad] and won ($1.04) with high card Ace
Seat 6: KA3AXCTAHEU, folded before Flop (didn't bet)



PokerStars Hand #166667708468:  Hold'em No Limit ($0.05/$0.10 USD) - 2017/02/23 16:06:04 ET
Table 'Glarona' 6-max Seat #3 is the button
Seat 1: LarryTheStar ($10.35 in chips) 
Seat 2: BookWorm78 ($10 in chips) 
Seat 3: hoedje72 ($3.71 in chips) 
Seat 4: CrippledGod ($7.19 in chips) 
Seat 5: david_sara83 ($10.25 in chips) 
Seat 6: Namhkal ($11.33 in chips) 
CrippledGod: posts small blind $0.05
david_sara83: posts big blind $0.10
*** HOLE CARDS ***
Namhkal: raises $0.15 to $0.25
LarryTheStar: folds 
BookWorm78: folds 
hoedje72: folds 
CrippledGod: folds 
david_sara83: folds 
Uncalled bet ($0.15) returned to Namhkal
Namhkal collected $0.25 from pot
*** SUMMARY ***
Total pot $0.25 | Rake $0 
Seat 1: LarryTheStar folded before Flop (didn't bet)
Seat 2: BookWorm78 folded before Flop (didn't bet)
Seat 3: hoedje72 (button) folded before Flop (didn't bet)
Seat 4: CrippledGod (small blind) folded before Flop
Seat 5: david_sara83 (big blind) folded before Flop
Seat 6: Namhkal collected ($0.25)



PokerStars Hand #166667708481:  Hold'em No Limit ($0.05/$0.10 USD) - 2017/02/23 16:06:04 ET
Table 'Apollonia' 6-max Seat #2 is the button
Seat 1: ex3Lero86 ($10.11 in chips) 
Seat 2: ibara000 ($18.43 in chips) 
Seat 3: steepfell ($10 in chips) 
Seat 4: Goroshkos88 ($17.87 in chips) 
Seat 5: EphemeralBen ($22.42 in chips) 
Seat 6: Namhkal ($10 in chips) 
steepfell: posts small blind $0.05
Goroshkos88: posts big blind $0.10
*** HOLE CARDS ***
EphemeralBen: folds 
Namhkal: folds 
ex3Lero86: folds 
ibara000: folds 
EphemeralBen leaves the table
steepfell: raises $0.15 to $0.25
x3ultimate joins the table at seat #5 
Goroshkos88: folds 
Uncalled bet ($0.15) returned to steepfell
steepfell collected $0.20 from pot
*** SUMMARY ***
Total pot $0.20 | Rake $0 
Seat 1: ex3Lero86 folded before Flop (didn't bet)
Seat 2: ibara000 (button) folded before Flop (didn't bet)
Seat 3: steepfell (small blind) collected ($0.20)
Seat 4: Goroshkos88 (big blind) folded before Flop
Seat 5: EphemeralBen folded before Flop (didn't bet)
Seat 6: Namhkal folded before Flop (didn't bet)



PokerStars Hand #166667708763:  Hold'em No Limit ($0.05/$0.10 USD) - 2017/02/23 16:06:05 ET
Table 'Esperanto II' 6-max Seat #6 is the button
Seat 1: kurasd ($11 in chips) 
Seat 2: MihaGr ($10.04 in chips) 
Seat 3: Namhkal ($12.10 in chips) 
Seat 4: Andrei ProFF ($10.20 in chips) 
Seat 5: FRAID358 ($9.85 in chips) 
Seat 6: ArcticBearDK ($13.13 in chips) 
kurasd: posts small blind $0.05
MihaGr: posts big blind $0.10
*** HOLE CARDS ***
Namhkal: folds 
Andrei ProFF: raises $0.20 to $0.30
FRAID358: folds 
ArcticBearDK: folds 
kurasd: folds 
MihaGr: folds 
Uncalled bet ($0.20) returned to Andrei ProFF
Andrei ProFF collected $0.25 from pot
*** SUMMARY ***
Total pot $0.25 | Rake $0 
Seat 1: kurasd (small blind) folded before Flop
Seat 2: MihaGr (big blind) folded before Flop
Seat 3: Namhkal folded before Flop (didn't bet)
Seat 4: Andrei ProFF collected ($0.25)
Seat 5: FRAID358 folded before Flop (didn't bet)
Seat 6: ArcticBearDK (button) folded before Flop (didn't bet)



PokerStars Hand #166667709271:  Hold'em No Limit ($0.05/$0.10 USD) - 2017/02/23 16:06:05 ET
Table 'Deflotte' 6-max Seat #6 is the button
Seat 1: Zooplack ($15.69 in chips) 
Seat 2: MonteCris92 ($10.23 in chips) 
Seat 3: Croplayer1 ($10.15 in chips) 
Seat 4: 8th wonders ($10.17 in chips) 
Seat 5: Pokeaster ($11.47 in chips) 
Seat 6: Iarlei ($11.85 in chips) 
Zooplack: posts small blind $0.05
MonteCris92: posts big blind $0.10
*** HOLE CARDS ***
Croplayer1: folds 
8th wonders: folds 
Pokeaster: folds 
Iarlei: raises $0.15 to $0.25
Zooplack: calls $0.20
MonteCris92: calls $0.15
*** FLOP *** [Jd As Ts]
Zooplack: checks 
MonteCris92: checks 
Iarlei: checks 
*** TURN *** [Jd As Ts] [Tc]
Zooplack: bets $0.36
MonteCris92: folds 
Iarlei: folds 
Uncalled bet ($0.36) returned to Zooplack
Zooplack collected $0.72 from pot
*** SUMMARY ***
Total pot $0.75 | Rake $0.03 
Board [Jd As Ts Tc]
Seat 1: Zooplack (small blind) collected ($0.72)
Seat 2: MonteCris92 (big blind) folded on the Turn
Seat 3: Croplayer1 folded before Flop (didn't bet)
Seat 4: 8th wonders folded before Flop (didn't bet)
Seat 5: Pokeaster folded before Flop (didn't bet)
Seat 6: Iarlei (button) folded on the Turn



PokerStars Hand #166667709585:  Hold'em No Limit ($0.05/$0.10 USD) - 2017/02/23 16:06:06 ET
Table 'Arduina' 6-max Seat #6 is the button
Seat 1: tauronex ($10 in chips) 
Seat 2: Andy Wolf ($14.45 in chips) 
Seat 3: Dcaro31 ($13.11 in chips) 
Seat 4: ChuikaPridi ($29.23 in chips) 
Seat 5: ettedallas ($7.36 in chips) 
Seat 6: dierri ($9.25 in chips) 
tauronex: posts small blind $0.05
Andy Wolf: posts big blind $0.10
*** HOLE CARDS ***
Dcaro31: folds 
ChuikaPridi: folds 
ettedallas: folds 
dierri: folds 
tauronex: folds 
Uncalled bet ($0.05) returned to Andy Wolf
Andy Wolf collected $0.10 from pot
*** SUMMARY ***
Total pot $0.10 | Rake $0 
Seat 1: tauronex (small blind) folded before Flop
Seat 2: Andy Wolf (big blind) collected ($0.10)
Seat 3: Dcaro31 folded before Flop (didn't bet)
Seat 4: ChuikaPridi folded before Flop (didn't bet)
Seat 5: ettedallas folded before Flop (didn't bet)
Seat 6: dierri (button) folded before Flop (didn't bet)



PokerStars Hand #166667709876:  Hold'em No Limit ($0.05/$0.10 USD) - 2017/02/23 16:06:06 ET
Table 'Krethon' 6-max Seat #3 is the button
Seat 1: boxer821 ($10.92 in chips) 
Seat 2: manashov ($12.21 in chips) 
Seat 3: D3NyA ($10 in chips) 
Seat 4: chimera252 ($14.84 in chips) 
Seat 5: popypaleta ($10.10 in chips) 
chimera252: posts small blind $0.05
popypaleta: posts big blind $0.10
*** HOLE CARDS ***
boxer821: folds 
manashov: folds 
D3NyA: folds 
chimera252: folds 
Uncalled bet ($0.05) returned to popypaleta
popypaleta collected $0.10 from pot
*** SUMMARY ***
Total pot $0.10 | Rake $0 
Seat 1: boxer821 folded before Flop (didn't bet)
Seat 2: manashov folded before Flop (didn't bet)
Seat 3: D3NyA (button) folded before Flop (didn't bet)
Seat 4: chimera252 (small blind) folded before Flop
Seat 5: popypaleta (big blind) collected ($0.10)



PokerStars Hand #166667710169:  Hold'em No Limit ($0.05/$0.10 USD) - 2017/02/23 16:06:06 ET
Table 'Cassini' 6-max Seat #1 is the button
Seat 1: Pokeaster ($10.77 in chips) 
Seat 2: mhonielsen ($12.46 in chips) 
Seat 4: fortieth ($13.72 in chips) 
Seat 5: johkom ($7.55 in chips) 
Seat 6: JahSoldier69 ($10.17 in chips) 
mhonielsen: posts small blind $0.05
fortieth: posts big blind $0.10
*** HOLE CARDS ***
johkom: folds 
JahSoldier69: folds 
Pokeaster: raises $0.15 to $0.25
mhonielsen: folds 
fortieth: raises $0.55 to $0.80
Pokeaster: folds 
Uncalled bet ($0.55) returned to fortieth
fortieth collected $0.55 from pot
*** SUMMARY ***
Total pot $0.55 | Rake $0 
Seat 1: Pokeaster (button) folded before Flop
Seat 2: mhonielsen (small blind) folded before Flop
Seat 4: fortieth (big blind) collected ($0.55)
Seat 5: johkom folded before Flop (didn't bet)
Seat 6: JahSoldier69 folded before Flop (didn't bet)



PokerStars Hand #166667710226:  Hold'em No Limit ($0.05/$0.10 USD) - 2017/02/23 16:06:06 ET
Table 'Stroobantia II' 6-max Seat #3 is the button
Seat 1: XBrosh ($7.69 in chips) 
Seat 2: IAntikI ($10 in chips) 
Seat 3: 8th wonders ($11.19 in chips) 
Seat 5: Zooplack ($12.38 in chips) 
Seat 6: CHRO8 ($12.97 in chips) 
Punzzzer will be allowed to play after the button
Zooplack: posts small blind $0.05
CHRO8: posts big blind $0.10
*** HOLE CARDS ***
XBrosh: folds 
IAntikI: folds 
8th wonders: folds 
Zooplack: raises $0.15 to $0.25
CHRO8: calls $0.15
*** FLOP *** [9c 7c Kd]
Zooplack: bets $0.29
CHRO8: folds 
Uncalled bet ($0.29) returned to Zooplack
Zooplack collected $0.48 from pot
*** SUMMARY ***
Total pot $0.50 | Rake $0.02 
Board [9c 7c Kd]
Seat 1: XBrosh folded before Flop (didn't bet)
Seat 2: IAntikI folded before Flop (didn't bet)
Seat 3: 8th wonders (button) folded before Flop (didn't bet)
Seat 5: Zooplack (small blind) collected ($0.48)
Seat 6: CHRO8 (big blind) folded on the Flop



PokerStars Hand #166667710277:  Hold'em No Limit ($0.05/$0.10 USD) - 2017/02/23 16:06:06 ET
Table 'Vaisala' 6-max Seat #5 is the button
Seat 1: Pekaml ($10 in chips) 
Seat 2: XaXaTyH4uK ($12.14 in chips) 
Seat 3: x3ultimate ($10.10 in chips) 
Seat 4: sexy_seagull ($11.38 in chips) 
Seat 5: AIONCMA1988 ($4.31 in chips) 
Seat 6: Aleksey K228 ($14.93 in chips) 
Aleksey K228: posts small blind $0.05
Pekaml: posts big blind $0.10
*** HOLE CARDS ***
XaXaTyH4uK: folds 
x3ultimate: folds 
sexy_seagull: raises $0.20 to $0.30
AIONCMA1988: calls $0.30
Aleksey K228: folds 
Pekaml: folds 
*** FLOP *** [2h Kh 8h]
sexy_seagull: checks 
AIONCMA1988: bets $0.36
sexy_seagull: calls $0.36
*** TURN *** [2h Kh 8h] [6c]
sexy_seagull: checks 
AIONCMA1988: bets $0.70
sexy_seagull: calls $0.70
*** RIVER *** [2h Kh 8h 6c] [3d]
sexy_seagull: checks 
AIONCMA1988: bets $2.95 and is all-in
sexy_seagull: folds 
Uncalled bet ($2.95) returned to AIONCMA1988
AIONCMA1988 collected $2.74 from pot
*** SUMMARY ***
Total pot $2.87 | Rake $0.13 
Board [2h Kh 8h 6c 3d]
Seat 1: Pekaml (big blind) folded before Flop
Seat 2: XaXaTyH4uK folded before Flop (didn't bet)
Seat 3: x3ultimate folded before Flop (didn't bet)
Seat 4: sexy_seagull folded on the River
Seat 5: AIONCMA1988 (button) collected ($2.74)
Seat 6: Aleksey K228 (small blind) folded before Flop



PokerStars Hand #166667710519:  Hold'em No Limit ($0.05/$0.10 USD) - 2017/02/23 16:06:07 ET
Table 'Crommelin II' 6-max Seat #3 is the button
Seat 1: THIMUCHIN ($11.62 in chips) 
Seat 2: Bird et al ($10.15 in chips) 
Seat 3: Strelok1974 ($21.80 in chips) 
Seat 4: Pequeño Clau ($13.02 in chips) 
Seat 5: Action_Gibi ($17.13 in chips) 
Pequeño Clau: posts small blind $0.05
Action_Gibi: posts big blind $0.10
*** HOLE CARDS ***
THIMUCHIN: folds 
Bird et al: folds 
Strelok1974: folds 
Pequeño Clau: folds 
Uncalled bet ($0.05) returned to Action_Gibi
Action_Gibi collected $0.10 from pot
*** SUMMARY ***
Total pot $0.10 | Rake $0 
Seat 1: THIMUCHIN folded before Flop (didn't bet)
Seat 2: Bird et al folded before Flop (didn't bet)
Seat 3: Strelok1974 (button) folded before Flop (didn't bet)
Seat 4: Pequeño Clau (small blind) folded before Flop
Seat 5: Action_Gibi (big blind) collected ($0.10)



PokerStars Hand #166667710680:  Hold'em No Limit ($0.05/$0.10 USD) - 2017/02/23 16:06:07 ET
Table 'Joella' 6-max Seat #2 is the button
Seat 1: Dcaro31 ($13.10 in chips) 
Seat 2: Kaelyns_Bark ($7.15 in chips) 
Seat 3: Joker51_wtf! ($11.25 in chips) 
Seat 5: Anestakis777 ($6.04 in chips) 
Seat 6: dr.goofy ($10.85 in chips) 
Joker51_wtf!: posts small blind $0.05
arti192837 was removed from the table for failing to post
Anestakis777: posts big blind $0.10
*** HOLE CARDS ***
KRZuff joins the table at seat #4 
dr.goofy: folds 
Dcaro31: raises $0.20 to $0.30
Kaelyns_Bark: folds 
Joker51_wtf!: folds 
Anestakis777: calls $0.20
*** FLOP *** [6h 9h 2d]
Anestakis777: bets $0.20
Dcaro31: folds 
Uncalled bet ($0.20) returned to Anestakis777
Anestakis777 collected $0.62 from pot
*** SUMMARY ***
Total pot $0.65 | Rake $0.03 
Board [6h 9h 2d]
Seat 1: Dcaro31 folded on the Flop
Seat 2: Kaelyns_Bark (button) folded before Flop (didn't bet)
Seat 3: Joker51_wtf! (small blind) folded before Flop
Seat 5: Anestakis777 (big blind) collected ($0.62)
Seat 6: dr.goofy folded before Flop (didn't bet)



PokerStars Hand #166667710683:  Hold'em No Limit ($0.05/$0.10 USD) - 2017/02/23 16:06:07 ET
Table 'Peiroos' 6-max Seat #3 is the button
Seat 1: ksandr_hom ($10 in chips) 
Seat 2: Nr847 ($10 in chips) 
Seat 3: atlx0711 ($26.37 in chips) 
Seat 4: Peter0087 ($9.90 in chips) 
Seat 5: sergio-cb164 ($8.80 in chips) 
Seat 6: DevonMiles88 ($5.57 in chips) 
Peter0087: posts small blind $0.05
sergio-cb164: posts big blind $0.10
*** HOLE CARDS ***
DevonMiles88: raises $0.10 to $0.20
ksandr_hom: folds 
Nr847: calls $0.20
atlx0711: calls $0.20
Peter0087: folds 
sergio-cb164: folds 
*** FLOP *** [Jh 7c 9d]
DevonMiles88: checks 
Nr847: bets $0.48
atlx0711: calls $0.48
DevonMiles88: folds 
*** TURN *** [Jh 7c 9d] [5s]
Nr847: bets $1.09
atlx0711: folds 
Uncalled bet ($1.09) returned to Nr847
Nr847 collected $1.63 from pot
*** SUMMARY ***
Total pot $1.71 | Rake $0.08 
Board [Jh 7c 9d 5s]
Seat 1: ksandr_hom folded before Flop (didn't bet)
Seat 2: Nr847 collected ($1.63)
Seat 3: atlx0711 (button) folded on the Turn
Seat 4: Peter0087 (small blind) folded before Flop
Seat 5: sergio-cb164 (big blind) folded before Flop
Seat 6: DevonMiles88 folded on the Flop



PokerStars Hand #166667710999:  Hold'em No Limit ($0.05/$0.10 USD) - 2017/02/23 16:06:07 ET
Table 'Garlena III' 6-max Seat #1 is the button
Seat 1: dittoro ($10 in chips) 
Seat 2: rusu_rapid ($10.20 in chips) 
Seat 4: mbkongstad ($10 in chips) 
rusu_rapid: posts small blind $0.05
mbkongstad: posts big blind $0.10
steepfell: sits out 
iluzja12: sits out 
*** HOLE CARDS ***
dittoro: raises $0.20 to $0.30
rusu_rapid: folds 
mbkongstad: folds 
Uncalled bet ($0.20) returned to dittoro
dittoro collected $0.25 from pot
*** SUMMARY ***
Total pot $0.25 | Rake $0 
Seat 1: dittoro (button) collected ($0.25)
Seat 2: rusu_rapid (small blind) folded before Flop
Seat 4: mbkongstad (big blind) folded before Flop



PokerStars Hand #166667711178:  Hold'em No Limit ($0.05/$0.10 USD) - 2017/02/23 16:06:07 ET
Table 'Sinon II' 6-max Seat #4 is the button
Seat 1: Aescul@pius ($10.37 in chips) 
Seat 2: ÄissesHai ($17.04 in chips) 
Seat 3: crazydevill ($10.63 in chips) 
Seat 4: Bandyaev ($15.33 in chips) 
Seat 5: ab260414 ($10.96 in chips) 
ab260414: posts small blind $0.05
Aescul@pius: posts big blind $0.10
*** HOLE CARDS ***
ÄissesHai: calls $0.10
crazydevill: raises $0.30 to $0.40
Bandyaev: folds 
ab260414: folds 
Aescul@pius: folds 
ÄissesHai: folds 
Uncalled bet ($0.30) returned to crazydevill
crazydevill collected $0.35 from pot
*** SUMMARY ***
Total pot $0.35 | Rake $0 
Seat 1: Aescul@pius (big blind) folded before Flop
Seat 2: ÄissesHai folded before Flop
Seat 3: crazydevill collected ($0.35)
Seat 4: Bandyaev (button) folded before Flop (didn't bet)
Seat 5: ab260414 (small blind) folded before Flop



PokerStars Hand #166667711211:  Hold'em No Limit ($0.05/$0.10 USD) - 2017/02/23 16:06:07 ET
Table 'Euryalos II' 6-max Seat #1 is the button
Seat 1: acekid403 ($9.50 in chips) 
Seat 2: silsilviu ($6.95 in chips) 
Seat 3: Hyd SK ($10.65 in chips) 
Seat 4: popypaleta ($15.62 in chips) 
Seat 5: horang2 ($8.25 in chips) 
Seat 6: MihaGr ($10.37 in chips) 
silsilviu: posts small blind $0.05
Hyd SK: posts big blind $0.10
*** HOLE CARDS ***
popypaleta: folds 
horang2: raises $0.20 to $0.30
MihaGr: folds 
acekid403: folds 
acekid403 leaves the table
voledy joins the table at seat #1 
silsilviu: calls $0.25
Hyd SK: folds 
*** FLOP *** [8h 6c 4c]
silsilviu: checks 
horang2: checks 
*** TURN *** [8h 6c 4c] [Ks]
silsilviu: checks 
horang2: bets $0.40
silsilviu: folds 
Uncalled bet ($0.40) returned to horang2
horang2 collected $0.67 from pot
*** SUMMARY ***
Total pot $0.70 | Rake $0.03 
Board [8h 6c 4c Ks]
Seat 1: acekid403 (button) folded before Flop (didn't bet)
Seat 2: silsilviu (small blind) folded on the Turn
Seat 3: Hyd SK (big blind) folded before Flop
Seat 4: popypaleta folded before Flop (didn't bet)
Seat 5: horang2 collected ($0.67)
Seat 6: MihaGr folded before Flop (didn't bet)



PokerStars Hand #166667711440:  Hold'em No Limit ($0.05/$0.10 USD) - 2017/02/23 16:06:08 ET
Table 'Crocus' 6-max Seat #1 is the button
Seat 1: truck1234 ($25 in chips) 
Seat 2: garigura ($10.99 in chips) 
Seat 3: Limpa Meza ($0.78 in chips) 
Seat 4: patrick19111 ($12.26 in chips) 
Seat 5: Golsuorsi ($10 in chips) 
Seat 6: Rodik002 ($10.23 in chips) 
garigura: posts small blind $0.05
Limpa Meza: posts big blind $0.10
*** HOLE CARDS ***
patrick19111: folds 
Golsuorsi: folds 
Rodik002: folds 
truck1234: raises $0.20 to $0.30
garigura: folds 
Limpa Meza: raises $0.20 to $0.50
truck1234: raises $1.05 to $1.55
Limpa Meza: calls $0.28 and is all-in
Uncalled bet ($0.77) returned to truck1234
*** FLOP *** [2c Kc 4d]
*** TURN *** [2c Kc 4d] [Js]
*** RIVER *** [2c Kc 4d Js] [Td]
*** SHOW DOWN ***
Limpa Meza: shows [As 8h] (high card Ace)
truck1234: shows [9h Tc] (a pair of Tens)
truck1234 collected $1.54 from pot
*** SUMMARY ***
Total pot $1.61 | Rake $0.07 
Board [2c Kc 4d Js Td]
Seat 1: truck1234 (button) showed [9h Tc] and won ($1.54) with a pair of Tens
Seat 2: garigura (small blind) folded before Flop
Seat 3: Limpa Meza (big blind) showed [As 8h] and lost with high card Ace
Seat 4: patrick19111 folded before Flop (didn't bet)
Seat 5: Golsuorsi folded before Flop (didn't bet)
Seat 6: Rodik002 folded before Flop (didn't bet)



PokerStars Hand #166667712087:  Hold'em No Limit ($0.05/$0.10 USD) - 2017/02/23 16:06:08 ET
Table 'Halawe II' 6-max Seat #4 is the button
Seat 1: DIGOR100 ($7.01 in chips) 
Seat 3: cherep61987 ($10.79 in chips) 
Seat 4: voledy ($12.45 in chips) 
Seat 5: takis nik ($12.33 in chips) 
Seat 6: Rodik002 ($20.37 in chips) 
takis nik: posts small blind $0.05
Rodik002: posts big blind $0.10
*** HOLE CARDS ***
DIGOR100: raises $0.10 to $0.20
cherep61987: folds 
voledy: folds 
takis nik: folds 
Rodik002: calls $0.10
*** FLOP *** [Th 8c Td]
Rodik002: checks 
DIGOR100: checks 
*** TURN *** [Th 8c Td] [3s]
Rodik002: bets $0.27
DIGOR100: folds 
Uncalled bet ($0.27) returned to Rodik002
Rodik002 collected $0.43 from pot
*** SUMMARY ***
Total pot $0.45 | Rake $0.02 
Board [Th 8c Td 3s]
Seat 1: DIGOR100 folded on the Turn
Seat 3: cherep61987 folded before Flop (didn't bet)
Seat 4: voledy (button) folded before Flop (didn't bet)
Seat 5: takis nik (small blind) folded before Flop
Seat 6: Rodik002 (big blind) collected ($0.43)



PokerStars Hand #166667712267:  Hold'em No Limit ($0.05/$0.10 USD) - 2017/02/23 16:06:08 ET
Table 'Nemo III' 6-max Seat #5 is the button
Seat 1: Kow6oy ($10 in chips) 
Seat 2: Bandyaev ($12.16 in chips) 
Seat 3: Dimka4 ($10 in chips) 
Seat 4: vtalian ($9.70 in chips) 
Seat 5: Joker51_wtf! ($11.28 in chips) 
Seat 6: maxiv608 ($10.05 in chips) 
maxiv608: posts small blind $0.05
Kow6oy: posts big blind $0.10
*** HOLE CARDS ***
Bandyaev: folds 
Dimka4: raises $0.15 to $0.25
vtalian: folds 
Joker51_wtf!: folds 
maxiv608: folds 
Kow6oy: folds 
Uncalled bet ($0.15) returned to Dimka4
Dimka4 collected $0.25 from pot
*** SUMMARY ***
Total pot $0.25 | Rake $0 
Seat 1: Kow6oy (big blind) folded before Flop
Seat 2: Bandyaev folded before Flop (didn't bet)
Seat 3: Dimka4 collected ($0.25)
Seat 4: vtalian folded before Flop (didn't bet)
Seat 5: Joker51_wtf! (button) folded before Flop (didn't bet)
Seat 6: maxiv608 (small blind) folded before Flop



PokerStars Hand #166667712275:  Hold'em No Limit ($0.05/$0.10 USD) - 2017/02/23 16:06:09 ET
Table 'Duhr II' 6-max Seat #1 is the button
Seat 1: Lucky HoBBiT ($10 in chips) 
Seat 2: Feverhead ($37.79 in chips) 
Seat 4: CHRO8 ($8.90 in chips) 
Seat 6: townerz1991 ($11.01 in chips) 
Feverhead: posts small blind $0.05
Innerwuss: is sitting out 
CHRO8: posts big blind $0.10
Dimka4: sits out 
*** HOLE CARDS ***
townerz1991: folds 
Innerwuss leaves the table
Lucky HoBBiT: folds 
Feverhead: folds 
Uncalled bet ($0.05) returned to CHRO8
Smitty03300 joins the table at seat #3 
CHRO8 collected $0.10 from pot
*** SUMMARY ***
Total pot $0.10 | Rake $0 
Seat 1: Lucky HoBBiT (button) folded before Flop (didn't bet)
Seat 2: Feverhead (small blind) folded before Flop
Seat 4: CHRO8 (big blind) collected ($0.10)
Seat 6: townerz1991 folded before Flop (didn't bet)



PokerStars Hand #166667712342:  Hold'em No Limit ($0.05/$0.10 USD) - 2017/02/23 16:06:09 ET
Table 'Eurykleia' 6-max Seat #4 is the button
Seat 1: Giyorod ($10.15 in chips) 
Seat 2: x3ultimate ($10.74 in chips) 
Seat 3: boxer821 ($20.41 in chips) 
Seat 4: 6ePeMeHHa9 ($16.87 in chips) 
Seat 5: fishhook5 ($10.05 in chips) 
Seat 6: afca128 ($6.57 in chips) 
fishhook5: posts small blind $0.05
afca128: posts big blind $0.10
*** HOLE CARDS ***
Giyorod: folds 
x3ultimate: folds 
boxer821: folds 
6ePeMeHHa9: folds 
fishhook5: raises $0.14 to $0.24
afca128: raises $0.48 to $0.72
fishhook5: folds 
Uncalled bet ($0.48) returned to afca128
afca128 collected $0.48 from pot
*** SUMMARY ***
Total pot $0.48 | Rake $0 
Seat 1: Giyorod folded before Flop (didn't bet)
Seat 2: x3ultimate folded before Flop (didn't bet)
Seat 3: boxer821 folded before Flop (didn't bet)
Seat 4: 6ePeMeHHa9 (button) folded before Flop (didn't bet)
Seat 5: fishhook5 (small blind) folded before Flop
Seat 6: afca128 (big blind) collected ($0.48)



PokerStars Hand #166667712395:  Hold'em No Limit ($0.05/$0.10 USD) - 2017/02/23 16:06:09 ET
Table 'Unitas II' 6-max Seat #2 is the button
Seat 1: Peter0087 ($9.70 in chips) 
Seat 2: steepfell ($10.10 in chips) 
Seat 4: truck1234 ($10.84 in chips) 
Seat 5: chimera252 ($24.63 in chips) 
Seat 6: paxit71 ($9.73 in chips) 
truck1234: posts small blind $0.05
chimera252: posts big blind $0.10
*** HOLE CARDS ***
paxit71: folds 
Peter0087: folds 
steepfell: raises $0.15 to $0.25
truck1234: folds 
chimera252: folds 
Uncalled bet ($0.15) returned to steepfell
steepfell collected $0.25 from pot
*** SUMMARY ***
Total pot $0.25 | Rake $0 
Seat 1: Peter0087 folded before Flop (didn't bet)
Seat 2: steepfell (button) collected ($0.25)
Seat 4: truck1234 (small blind) folded before Flop
Seat 5: chimera252 (big blind) folded before Flop
Seat 6: paxit71 folded before Flop (didn't bet)



PokerStars Hand #166667712654:  Hold'em No Limit ($0.05/$0.10 USD) - 2017/02/23 16:06:09 ET
Table 'Wingolfia II' 6-max Seat #3 is the button
Seat 1: BahiaMinhaP ($10.32 in chips) 
Seat 2: NvR.m1nD ($10.25 in chips) 
Seat 3: truck1234 ($10.36 in chips) 
Seat 4: zlobslob ($17.92 in chips) 
Seat 5: tr41n3r12 ($11.43 in chips) 
Seat 6: EphemeralBen ($11.99 in chips) 
zlobslob: posts small blind $0.05
tr41n3r12: posts big blind $0.10
*** HOLE CARDS ***
EphemeralBen: folds 
BahiaMinhaP: folds 
NvR.m1nD: folds 
truck1234: folds 
zlobslob: folds 
Uncalled bet ($0.05) returned to tr41n3r12
tr41n3r12 collected $0.10 from pot
*** SUMMARY ***
Total pot $0.10 | Rake $0 
Seat 1: BahiaMinhaP folded before Flop (didn't bet)
Seat 2: NvR.m1nD folded before Flop (didn't bet)
Seat 3: truck1234 (button) folded before Flop (didn't bet)
Seat 4: zlobslob (small blind) folded before Flop
Seat 5: tr41n3r12 (big blind) collected ($0.10)
Seat 6: EphemeralBen folded before Flop (didn't bet)



PokerStars Hand #166667712905:  Hold'em No Limit ($0.05/$0.10 USD) - 2017/02/23 16:06:09 ET
Table 'Atalante' 6-max Seat #5 is the button
Seat 1: OceanBlue100 ($5.09 in chips) 
Seat 2: CiisCi ($20.20 in chips) 
Seat 3: Kow6oy ($10 in chips) 
Seat 4: Dcaro31 ($24.92 in chips) 
Seat 5: eniksenik ($10.14 in chips) 
Seat 6: FlopsterGB ($30.28 in chips) 
FlopsterGB: posts small blind $0.05
OceanBlue100: posts big blind $0.10
*** HOLE CARDS ***
CiisCi: folds 
Kow6oy: folds 
Dcaro31: raises $0.20 to $0.30
eniksenik: folds 
FlopsterGB: raises $0.60 to $0.90
OceanBlue100: folds 
Dcaro31: calls $0.60
*** FLOP *** [4c Jc Th]
FlopsterGB: checks 
Dcaro31: checks 
*** TURN *** [4c Jc Th] [Ac]
FlopsterGB: bets $0.87
Dcaro31: folds 
Uncalled bet ($0.87) returned to FlopsterGB
FlopsterGB collected $1.81 from pot
*** SUMMARY ***
Total pot $1.90 | Rake $0.09 
Board [4c Jc Th Ac]
Seat 1: OceanBlue100 (big blind) folded before Flop
Seat 2: CiisCi folded before Flop (didn't bet)
Seat 3: Kow6oy folded before Flop (didn't bet)
Seat 4: Dcaro31 folded on the Turn
Seat 5: eniksenik (button) folded before Flop (didn't bet)
Seat 6: FlopsterGB (small blind) collected ($1.81)



PokerStars Hand #166667712982:  Hold'em No Limit ($0.05/$0.10 USD) - 2017/02/23 16:06:09 ET
Table 'Rotraut' 6-max Seat #6 is the button
Seat 2: Newqbrown ($12.10 in chips) 
Seat 3: FlackoD ($11.22 in chips) 
Seat 5: Bird et al ($11.75 in chips) 
Seat 6: KokoulinV ($12.59 in chips) 
Newqbrown: posts small blind $0.05
FlackoD: posts big blind $0.10
*** HOLE CARDS ***
Bird et al: raises $0.21 to $0.31
KokoulinV: calls $0.31
Newqbrown: folds 
FlackoD: calls $0.21
*** FLOP *** [2h 2c Ad]
FlackoD: checks 
Bird et al: bets $0.56
KokoulinV: folds 
FlackoD: folds 
Uncalled bet ($0.56) returned to Bird et al
Bird et al collected $0.94 from pot
*** SUMMARY ***
Total pot $0.98 | Rake $0.04 
Board [2h 2c Ad]
Seat 2: Newqbrown (small blind) folded before Flop
Seat 3: FlackoD (big blind) folded on the Flop
Seat 5: Bird et al collected ($0.94)
Seat 6: KokoulinV (button) folded on the Flop



PokerStars Hand #166667713226:  Hold'em No Limit ($0.05/$0.10 USD) - 2017/02/23 16:06:10 ET
Table 'Selinur' 6-max Seat #1 is the button
Seat 1: KA3AXCTAHEU, ($10 in chips) 
Seat 2: hoedje72 ($8.04 in chips) 
Seat 3: bambolejro ($11.07 in chips) 
Seat 4: freezing666 ($11.63 in chips) 
Seat 5: IAntikI ($10.07 in chips) 
Seat 6: homelessdan ($18.08 in chips) 
hoedje72: posts small blind $0.05
bambolejro: posts big blind $0.10
*** HOLE CARDS ***
freezing666: folds 
IAntikI: folds 
homelessdan: folds 
KA3AXCTAHEU,: folds 
hoedje72: folds 
Uncalled bet ($0.05) returned to bambolejro
bambolejro collected $0.10 from pot
*** SUMMARY ***
Total pot $0.10 | Rake $0 
Seat 1: KA3AXCTAHEU, (button) folded before Flop (didn't bet)
Seat 2: hoedje72 (small blind) folded before Flop
Seat 3: bambolejro (big blind) collected ($0.10)
Seat 4: freezing666 folded before Flop (didn't bet)
Seat 5: IAntikI folded before Flop (didn't bet)
Seat 6: homelessdan folded before Flop (didn't bet)



PokerStars Hand #166667713247:  Hold'em No Limit ($0.05/$0.10 USD) - 2017/02/23 16:06:10 ET
Table 'Thoas' 6-max Seat #4 is the button
Seat 1: Pekaml ($11.43 in chips) 
Seat 2: themacer24 ($8.52 in chips) 
Seat 3: iamkakaroto ($10 in chips) 
Seat 4: Morris_Chair ($18.52 in chips) 
Seat 5: Kow6oy ($10.22 in chips) 
Seat 6: takis nik ($10 in chips) 
Kow6oy: posts small blind $0.05
takis nik: posts big blind $0.10
*** HOLE CARDS ***
Pekaml: folds 
themacer24: folds 
iamkakaroto: folds 
Morris_Chair: folds 
Kow6oy: folds 
Uncalled bet ($0.05) returned to takis nik
takis nik collected $0.10 from pot
*** SUMMARY ***
Total pot $0.10 | Rake $0 
Seat 1: Pekaml folded before Flop (didn't bet)
Seat 2: themacer24 folded before Flop (didn't bet)
Seat 3: iamkakaroto folded before Flop (didn't bet)
Seat 4: Morris_Chair (button) folded before Flop (didn't bet)
Seat 5: Kow6oy (small blind) folded before Flop
Seat 6: takis nik (big blind) collected ($0.10)



PokerStars Hand #166667713613:  Hold'em No Limit ($0.05/$0.10 USD) - 2017/02/23 16:06:10 ET
Table 'Pirola III' 6-max Seat #3 is the button
Seat 1: bdixon_5 ($9.47 in chips) 
Seat 3: kingartur222 ($10.67 in chips) 
Seat 4: McCleans ($10.62 in chips) 
Seat 5: tequila_joop ($10.55 in chips) 
Seat 6: T9MS ($10 in chips) 
McCleans: posts small blind $0.05
tequila_joop: posts big blind $0.10
Chodemuncher: sits out 
*** HOLE CARDS ***
T9MS: folds 
bdixon_5: folds 
kingartur222: raises $0.15 to $0.25
McCleans: folds 
tequila_joop: folds 
Uncalled bet ($0.15) returned to kingartur222
kingartur222 collected $0.25 from pot
*** SUMMARY ***
Total pot $0.25 | Rake $0 
Seat 1: bdixon_5 folded before Flop (didn't bet)
Seat 3: kingartur222 (button) collected ($0.25)
Seat 4: McCleans (small blind) folded before Flop
Seat 5: tequila_joop (big blind) folded before Flop
Seat 6: T9MS folded before Flop (didn't bet)



PokerStars Hand #166667713677:  Hold'em No Limit ($0.05/$0.10 USD) - 2017/02/23 16:06:10 ET
Table 'Tyndareus II' 6-max Seat #4 is the button
Seat 1: Makc1705 ($3.65 in chips) 
Seat 3: McCleans ($11.90 in chips) 
Seat 4: gaHy_HaXeP ($10.61 in chips) 
Seat 5: vtalian ($9.90 in chips) 
Seat 6: sexy_seagull ($10.30 in chips) 
vtalian: posts small blind $0.05
sexy_seagull: posts big blind $0.10
fishhook5: sits out 
*** HOLE CARDS ***
Makc1705: folds 
McCleans: folds 
gaHy_HaXeP: folds 
vtalian: folds 
Uncalled bet ($0.05) returned to sexy_seagull
sexy_seagull collected $0.10 from pot
*** SUMMARY ***
Total pot $0.10 | Rake $0 
Seat 1: Makc1705 folded before Flop (didn't bet)
Seat 3: McCleans folded before Flop (didn't bet)
Seat 4: gaHy_HaXeP (button) folded before Flop (didn't bet)
Seat 5: vtalian (small blind) folded before Flop
Seat 6: sexy_seagull (big blind) collected ($0.10)



PokerStars Hand #166667713910:  Hold'em No Limit ($0.05/$0.10 USD) - 2017/02/23 16:06:10 ET
Table 'Lesath III' 6-max Seat #4 is the button
Seat 1: Gogeta26 ($6.99 in chips) 
Seat 2: WinninBikini ($10 in chips) 
Seat 3: Giyorod ($10 in chips) 
Seat 4: Eddys Edge ($10.51 in chips) 
Seat 5: eniksenik ($16.05 in chips) 
Seat 6: patrick19111 ($10.56 in chips) 
eniksenik: posts small blind $0.05
patrick19111: posts big blind $0.10
*** HOLE CARDS ***
Gogeta26: folds 
WinninBikini: raises $0.20 to $0.30
Giyorod: folds 
Eddys Edge: folds 
eniksenik: folds 
patrick19111: calls $0.20
*** FLOP *** [4c 8h 4d]
patrick19111: checks 
WinninBikini: bets $0.43
patrick19111: folds 
Uncalled bet ($0.43) returned to WinninBikini
WinninBikini collected $0.62 from pot
*** SUMMARY ***
Total pot $0.65 | Rake $0.03 
Board [4c 8h 4d]
Seat 1: Gogeta26 folded before Flop (didn't bet)
Seat 2: WinninBikini collected ($0.62)
Seat 3: Giyorod folded before Flop (didn't bet)
Seat 4: Eddys Edge (button) folded before Flop (didn't bet)
Seat 5: eniksenik (small blind) folded before Flop
Seat 6: patrick19111 (big blind) folded on the Flop



PokerStars Hand #166667714070:  Hold'em No Limit ($0.05/$0.10 USD) - 2017/02/23 16:06:10 ET
Table 'Veniakaverin' 6-max Seat #3 is the button
Seat 1: pivanki11 ($10.21 in chips) 
Seat 2: david_sara83 ($10 in chips) 
Seat 3: Hyd SK ($30.03 in chips) 
Seat 6: bdixon_5 ($9.35 in chips) 
Tox1cel will be allowed to play after the button
bdixon_5: posts small blind $0.05
pivanki11: posts big blind $0.10
*** HOLE CARDS ***
Ampped87 leaves the table
david_sara83: raises $0.20 to $0.30
FRAID358 joins the table at seat #4 
Hyd SK: calls $0.30
bdixon_5: folds 
pivanki11: folds 
*** FLOP *** [Jh 3d 7c]
david_sara83: bets $0.38
Hyd SK: folds 
Uncalled bet ($0.38) returned to david_sara83
david_sara83 collected $0.72 from pot
*** SUMMARY ***
Total pot $0.75 | Rake $0.03 
Board [Jh 3d 7c]
Seat 1: pivanki11 (big blind) folded before Flop
Seat 2: david_sara83 collected ($0.72)
Seat 3: Hyd SK (button) folded on the Flop
Seat 6: bdixon_5 (small blind) folded before Flop



PokerStars Hand #166667714382:  Hold'em No Limit ($0.05/$0.10 USD) - 2017/02/23 16:06:11 ET
Table 'Alzirr II' 6-max Seat #2 is the button
Seat 1: KA3AXCTAHEU, ($10.31 in chips) 
Seat 2: popypaleta ($10.17 in chips) 
Seat 3: devon_red ($7.90 in chips) 
Seat 5: yodzik ($5.37 in chips) 
Seat 6: AM-L-SL ($4.74 in chips) 
devon_red: posts small blind $0.05
yodzik: posts big blind $0.10
*** HOLE CARDS ***
AM-L-SL: calls $0.10
KA3AXCTAHEU,: folds 
popypaleta: folds 
devon_red: calls $0.05
yodzik: checks 
*** FLOP *** [4d Tc Jh]
devon_red: checks 
yodzik: checks 
AM-L-SL: bets $0.20
devon_red: folds 
yodzik: folds 
Uncalled bet ($0.20) returned to AM-L-SL
AM-L-SL collected $0.29 from pot
*** SUMMARY ***
Total pot $0.30 | Rake $0.01 
Board [4d Tc Jh]
Seat 1: KA3AXCTAHEU, folded before Flop (didn't bet)
Seat 2: popypaleta (button) folded before Flop (didn't bet)
Seat 3: devon_red (small blind) folded on the Flop
Seat 5: yodzik (big blind) folded on the Flop
Seat 6: AM-L-SL collected ($0.29)



PokerStars Hand #166667714476:  Hold'em No Limit ($0.05/$0.10 USD) - 2017/02/23 16:06:11 ET
Table 'Girtab' 6-max Seat #4 is the button
Seat 1: pokekrk ($13.56 in chips) 
Seat 2: MühliJr ($10 in chips) 
Seat 3: kingartur222 ($10.45 in chips) 
Seat 4: Hyd SK ($11.23 in chips) 
Seat 5: sexy_seagull ($10.95 in chips) 
Seat 6: iluzja12 ($10 in chips) 
sexy_seagull: posts small blind $0.05
iluzja12: posts big blind $0.10
*** HOLE CARDS ***
pokekrk: folds 
MühliJr: folds 
kingartur222: folds 
Hyd SK: folds 
sexy_seagull: raises $0.20 to $0.30
iluzja12: folds 
Uncalled bet ($0.20) returned to sexy_seagull
sexy_seagull collected $0.20 from pot
*** SUMMARY ***
Total pot $0.20 | Rake $0 
Seat 1: pokekrk folded before Flop (didn't bet)
Seat 2: MühliJr folded before Flop (didn't bet)
Seat 3: kingartur222 folded before Flop (didn't bet)
Seat 4: Hyd SK (button) folded before Flop (didn't bet)
Seat 5: sexy_seagull (small blind) collected ($0.20)
Seat 6: iluzja12 (big blind) folded before Flop



PokerStars Hand #166667714552:  Hold'em No Limit ($0.05/$0.10 USD) - 2017/02/23 16:06:11 ET
Table 'Oongaq' 6-max Seat #2 is the button
Seat 1: Dmitrij218 ($13.35 in chips) 
Seat 2: homelessdan ($18.40 in chips) 
Seat 3: iDecMate ($10.14 in chips) 
Seat 4: Bird et al ($10.15 in chips) 
Seat 5: Dizzler1991 ($5.58 in chips) 
Seat 6: boxer821 ($10 in chips) 
iDecMate: posts small blind $0.05
Bird et al: posts big blind $0.10
*** HOLE CARDS ***
Dizzler1991: folds 
boxer821: folds 
Dmitrij218: calls $0.10
homelessdan: folds 
iDecMate has timed out
iDecMate: folds 
Bird et al: checks 
*** FLOP *** [2s Ac Qh]
Bird et al: checks 
Dmitrij218: bets $0.10
Bird et al: folds 
Uncalled bet ($0.10) returned to Dmitrij218
Dmitrij218 collected $0.24 from pot
*** SUMMARY ***
Total pot $0.25 | Rake $0.01 
Board [2s Ac Qh]
Seat 1: Dmitrij218 collected ($0.24)
Seat 2: homelessdan (button) folded before Flop (didn't bet)
Seat 3: iDecMate (small blind) folded before Flop
Seat 4: Bird et al (big blind) folded on the Flop
Seat 5: Dizzler1991 folded before Flop (didn't bet)
Seat 6: boxer821 folded before Flop (didn't bet)



PokerStars Hand #166667714623:  Hold'em No Limit ($0.05/$0.10 USD) - 2017/02/23 16:06:11 ET
Table 'Serpens' 6-max Seat #1 is the button
Seat 1: Namhkal ($10.15 in chips) 
Seat 2: KA3AXCTAHEU, ($19.25 in chips) 
Seat 3: homelessdan ($29.44 in chips) 
Seat 4: Ragazzi3 ($9.60 in chips) 
Seat 5: XwinX25 ($12.32 in chips) 
Seat 6: Croplayer1 ($10 in chips) 
KA3AXCTAHEU,: posts small blind $0.05
homelessdan: posts big blind $0.10
*** HOLE CARDS ***
Ragazzi3: folds 
XwinX25: folds 
Croplayer1: folds 
Namhkal: raises $0.10 to $0.20
KA3AXCTAHEU,: folds 
homelessdan: folds 
Uncalled bet ($0.10) returned to Namhkal
Namhkal collected $0.25 from pot
*** SUMMARY ***
Total pot $0.25 | Rake $0 
Seat 1: Namhkal (button) collected ($0.25)
Seat 2: KA3AXCTAHEU, (small blind) folded before Flop
Seat 3: homelessdan (big blind) folded before Flop
Seat 4: Ragazzi3 folded before Flop (didn't bet)
Seat 5: XwinX25 folded before Flop (didn't bet)
Seat 6: Croplayer1 folded before Flop (didn't bet)



PokerStars Hand #166667715142:  Hold'em No Limit ($0.05/$0.10 USD) - 2017/02/23 16:06:12 ET
Table 'Mesarthim' 6-max Seat #5 is the button
Seat 1: Mancuso2010 ($16 in chips) 
Seat 2: MühliJr ($11.53 in chips) 
Seat 3: Damage514 ($9.55 in chips) 
Seat 4: Strelok1974 ($10.11 in chips) 
Seat 5: Iarlei ($10.90 in chips) 
Seat 6: bdixon_5 ($8.86 in chips) 
bdixon_5: posts small blind $0.05
Mancuso2010: posts big blind $0.10
*** HOLE CARDS ***
MühliJr: folds 
Damage514: calls $0.10
Strelok1974: folds 
Iarlei: folds 
bdixon_5: folds 
Mancuso2010: checks 
*** FLOP *** [6s Ks 5c]
Mancuso2010: checks 
Damage514: checks 
*** TURN *** [6s Ks 5c] [Td]
Mancuso2010: checks 
Damage514: bets $0.50
Mancuso2010: folds 
Uncalled bet ($0.50) returned to Damage514
Damage514 collected $0.24 from pot
*** SUMMARY ***
Total pot $0.25 | Rake $0.01 
Board [6s Ks 5c Td]
Seat 1: Mancuso2010 (big blind) folded on the Turn
Seat 2: MühliJr folded before Flop (didn't bet)
Seat 3: Damage514 collected ($0.24)
Seat 4: Strelok1974 folded before Flop (didn't bet)
Seat 5: Iarlei (button) folded before Flop (didn't bet)
Seat 6: bdixon_5 (small blind) folded before Flop



PokerStars Hand #166667715551:  Hold'em No Limit ($0.05/$0.10 USD) - 2017/02/23 16:06:12 ET
Table 'Cyane' 6-max Seat #2 is the button
Seat 1: KA3AXCTAHEU, ($10.15 in chips) 
Seat 2: sashi18 ($8.16 in chips) 
Seat 3: Mamm0nism ($12.94 in chips) 
Seat 4: truck1234 ($20.81 in chips) 
Seat 6: 8th wonders ($11.60 in chips) 
Mamm0nism: posts small blind $0.05
truck1234: posts big blind $0.10
RoJ1: sits out 
*** HOLE CARDS ***
8th wonders: folds 
KA3AXCTAHEU,: raises $0.15 to $0.25
sashi18: folds 
Mamm0nism: folds 
truck1234: folds 
Uncalled bet ($0.15) returned to KA3AXCTAHEU,
KA3AXCTAHEU, collected $0.25 from pot
*** SUMMARY ***
Total pot $0.25 | Rake $0 
Seat 1: KA3AXCTAHEU, collected ($0.25)
Seat 2: sashi18 (button) folded before Flop (didn't bet)
Seat 3: Mamm0nism (small blind) folded before Flop
Seat 4: truck1234 (big blind) folded before Flop
Seat 6: 8th wonders folded before Flop (didn't bet)



PokerStars Hand #166667716229:  Hold'em No Limit ($0.05/$0.10 USD) - 2017/02/23 16:06:13 ET
Table 'Huberta II' 6-max Seat #4 is the button
Seat 1: tr41n3r12 ($10 in chips) 
Seat 2: Ice_Isayev ($12.08 in chips) 
Seat 3: patrick19111 ($10.60 in chips) 
Seat 4: VAD21 ($11.96 in chips) 
Seat 5: Feverhead ($27.85 in chips) 
Seat 6: yodzik ($5 in chips) 
Feverhead: posts small blind $0.05
yodzik: posts big blind $0.10
*** HOLE CARDS ***
tr41n3r12: folds 
Ice_Isayev: folds 
patrick19111: folds 
VAD21: folds 
Feverhead: folds 
Uncalled bet ($0.05) returned to yodzik
yodzik collected $0.10 from pot
*** SUMMARY ***
Total pot $0.10 | Rake $0 
Seat 1: tr41n3r12 folded before Flop (didn't bet)
Seat 2: Ice_Isayev folded before Flop (didn't bet)
Seat 3: patrick19111 folded before Flop (didn't bet)
Seat 4: VAD21 (button) folded before Flop (didn't bet)
Seat 5: Feverhead (small blind) folded before Flop
Seat 6: yodzik (big blind) collected ($0.10)



PokerStars Hand #166667716462:  Hold'em No Limit ($0.05/$0.10 USD) - 2017/02/23 16:06:13 ET
Table 'Gelria' 6-max Seat #1 is the button
Seat 1: ab260414 ($10.57 in chips) 
Seat 2: fishhook5 ($10 in chips) 
Seat 3: Orlangoor ($11.78 in chips) 
Seat 5: apenvel ($7.95 in chips) 
Seat 6: Andrei ProFF ($10.27 in chips) 
fishhook5: posts small blind $0.05
Orlangoor: posts big blind $0.10
eniksenik: sits out 
*** HOLE CARDS ***
apenvel: folds 
Andrei ProFF: folds 
ab260414: folds 
fishhook5: folds 
Uncalled bet ($0.05) returned to Orlangoor
Orlangoor collected $0.10 from pot
*** SUMMARY ***
Total pot $0.10 | Rake $0 
Seat 1: ab260414 (button) folded before Flop (didn't bet)
Seat 2: fishhook5 (small blind) folded before Flop
Seat 3: Orlangoor (big blind) collected ($0.10)
Seat 5: apenvel folded before Flop (didn't bet)
Seat 6: Andrei ProFF folded before Flop (didn't bet)



PokerStars Hand #166667716536:  Hold'em No Limit ($0.05/$0.10 USD) - 2017/02/23 16:06:13 ET
Table 'Gyldenia II' 6-max Seat #2 is the button
Seat 1: KokoulinV ($10.48 in chips) 
Seat 2: Bandyaev ($10.94 in chips) 
Seat 5: CHRO8 ($15.52 in chips) 
Seat 6: 8th wonders ($11.53 in chips) 
CHRO8: posts small blind $0.05
8th wonders: posts big blind $0.10
*** HOLE CARDS ***
KokoulinV: folds 
Bandyaev: folds 
magdan206 is disconnected 
CHRO8: folds 
Uncalled bet ($0.05) returned to 8th wonders
8th wonders collected $0.10 from pot
*** SUMMARY ***
Total pot $0.10 | Rake $0 
Seat 1: KokoulinV folded before Flop (didn't bet)
Seat 2: Bandyaev (button) folded before Flop (didn't bet)
Seat 5: CHRO8 (small blind) folded before Flop
Seat 6: 8th wonders (big blind) collected ($0.10)



PokerStars Hand #166667716778:  Hold'em No Limit ($0.05/$0.10 USD) - 2017/02/23 16:06:13 ET
Table 'Hestia' 6-max Seat #2 is the button
Seat 2: Kow6oy ($10.32 in chips) 
Seat 3: MBen10 ($13.47 in chips) 
Seat 4: Lucky HoBBiT ($10 in chips) 
Seat 5: CiisCi ($16.45 in chips) 
Seat 6: Smitty03300 ($10 in chips) 
MBen10: posts small blind $0.05
Lucky HoBBiT: posts big blind $0.10
Pekaml: sits out 
*** HOLE CARDS ***
CiisCi: folds 
Smitty03300: folds 
Kow6oy: folds 
MBen10: calls $0.05
Lucky HoBBiT: checks 
*** FLOP *** [Ah 2c 4h]
MBen10: checks 
Lucky HoBBiT: checks 
*** TURN *** [Ah 2c 4h] [7c]
MBen10: checks 
Lucky HoBBiT: checks 
*** RIVER *** [Ah 2c 4h 7c] [9c]
MBen10: bets $0.17
Lucky HoBBiT: folds 
Uncalled bet ($0.17) returned to MBen10
MBen10 collected $0.19 from pot
*** SUMMARY ***
Total pot $0.20 | Rake $0.01 
Board [Ah 2c 4h 7c 9c]
Seat 2: Kow6oy (button) folded before Flop (didn't bet)
Seat 3: MBen10 (small blind) collected ($0.19)
Seat 4: Lucky HoBBiT (big blind) folded on the River
Seat 5: CiisCi folded before Flop (didn't bet)
Seat 6: Smitty03300 folded before Flop (didn't bet)



PokerStars Hand #166667716910:  Hold'em No Limit ($0.05/$0.10 USD) - 2017/02/23 16:06:13 ET
Table 'Marghanna II' 6-max Seat #5 is the button
Seat 1: Goroshkos88 ($10 in chips) 
Seat 2: Namhkal ($11.41 in chips) 
Seat 3: Innerwuss ($12.65 in chips) 
Seat 4: D3NyA ($12.22 in chips) 
Seat 5: ofl21189 ($6.63 in chips) 
Seat 6: VAD21 ($13.01 in chips) 
VAD21: posts small blind $0.05
Goroshkos88: posts big blind $0.10
*** HOLE CARDS ***
Namhkal: folds 
Innerwuss: folds 
D3NyA: folds 
ofl21189: raises $0.20 to $0.30
VAD21: folds 
Goroshkos88: calls $0.20
*** FLOP *** [7h 2h As]
Goroshkos88: checks 
ofl21189: bets $0.30
Goroshkos88: folds 
Uncalled bet ($0.30) returned to ofl21189
ofl21189 collected $0.62 from pot
*** SUMMARY ***
Total pot $0.65 | Rake $0.03 
Board [7h 2h As]
Seat 1: Goroshkos88 (big blind) folded on the Flop
Seat 2: Namhkal folded before Flop (didn't bet)
Seat 3: Innerwuss folded before Flop (didn't bet)
Seat 4: D3NyA folded before Flop (didn't bet)
Seat 5: ofl21189 (button) collected ($0.62)
Seat 6: VAD21 (small blind) folded before Flop



PokerStars Hand #166667717417:  Hold'em No Limit ($0.05/$0.10 USD) - 2017/02/23 16:06:14 ET
Table 'Walpurga' 6-max Seat #6 is the button
Seat 1: chimera252 ($12.12 in chips) 
Seat 2: paxit71 ($6.05 in chips) 
Seat 3: marianoboni ($10 in chips) 
Seat 4: oddshoff ($13.04 in chips) 
Seat 6: AIONCMA1988 ($5.58 in chips) 
chimera252: posts small blind $0.05
paxit71: posts big blind $0.10
Fremara: sits out 
*** HOLE CARDS ***
marianoboni: raises $0.24 to $0.34
oddshoff: folds 
AIONCMA1988: folds 
chimera252: folds 
paxit71: folds 
Uncalled bet ($0.24) returned to marianoboni
marianoboni collected $0.25 from pot
*** SUMMARY ***
Total pot $0.25 | Rake $0 
Seat 1: chimera252 (small blind) folded before Flop
Seat 2: paxit71 (big blind) folded before Flop
Seat 3: marianoboni collected ($0.25)
Seat 4: oddshoff folded before Flop (didn't bet)
Seat 6: AIONCMA1988 (button) folded before Flop (didn't bet)



PokerStars Hand #166667717485:  Hold'em No Limit ($0.05/$0.10 USD) - 2017/02/23 16:06:14 ET
Table 'Cuyo' 6-max Seat #1 is the button
Seat 1: Bandyaev ($10 in chips) 
Seat 2: Therodorus ($10 in chips) 
Seat 5: Kpeti01 ($10 in chips) 
Seat 6: iluzja12 ($10 in chips) 
Therodorus: posts small blind $0.05
Kpeti01: posts big blind $0.10
*** HOLE CARDS ***
iluzja12: raises $0.20 to $0.30
bambolejro joins the table at seat #4 
Bandyaev: folds 
Therodorus: folds 
Kpeti01: folds 
Uncalled bet ($0.20) returned to iluzja12
JahSoldier69 joins the table at seat #3 
iluzja12 collected $0.25 from pot
*** SUMMARY ***
Total pot $0.25 | Rake $0 
Seat 1: Bandyaev (button) folded before Flop (didn't bet)
Seat 2: Therodorus (small blind) folded before Flop
Seat 5: Kpeti01 (big blind) folded before Flop
Seat 6: iluzja12 collected ($0.25)



PokerStars Hand #166667717899:  Hold'em No Limit ($0.05/$0.10 USD) - 2017/02/23 16:06:15 ET
Table 'Antielus II' 6-max Seat #6 is the button
Seat 1: Dcaro31 ($18.54 in chips) 
Seat 2: Orlangoor ($10.15 in chips) 
Seat 3: mcyi3at2 ($12.16 in chips) 
Seat 4: XwinX25 ($10 in chips) 
Seat 5: Hyd SK ($10.89 in chips) 
Seat 6: GiveTwoMe ($12.25 in chips) 
Dcaro31: posts small blind $0.05
Orlangoor: posts big blind $0.10
*** HOLE CARDS ***
mcyi3at2: raises $0.20 to $0.30
XwinX25: folds 
Hyd SK: folds 
GiveTwoMe: folds 
Dcaro31: folds 
Orlangoor: folds 
Uncalled bet ($0.20) returned to mcyi3at2
mcyi3at2 collected $0.25 from pot
*** SUMMARY ***
Total pot $0.25 | Rake $0 
Seat 1: Dcaro31 (small blind) folded before Flop
Seat 2: Orlangoor (big blind) folded before Flop
Seat 3: mcyi3at2 collected ($0.25)
Seat 4: XwinX25 folded before Flop (didn't bet)
Seat 5: Hyd SK folded before Flop (didn't bet)
Seat 6: GiveTwoMe (button) folded before Flop (didn't bet)



PokerStars Hand #166667718219:  Hold'em No Limit ($0.05/$0.10 USD) - 2017/02/23 16:06:15 ET
Table 'Giclas' 6-max Seat #4 is the button
Seat 1: david_sara83 ($10 in chips) 
Seat 2: Crafty23@PS ($10.41 in chips) 
Seat 3: fidas1972 ($6.21 in chips) 
Seat 4: Eddys Edge ($13.94 in chips) 
Seat 5: dedea1989 ($24.90 in chips) 
Seat 6: eniksenik ($14.63 in chips) 
dedea1989: posts small blind $0.05
eniksenik: posts big blind $0.10
*** HOLE CARDS ***
david_sara83: raises $0.20 to $0.30
Crafty23@PS: folds 
fidas1972: folds 
Eddys Edge: folds 
dedea1989: calls $0.25
eniksenik: folds 
*** FLOP *** [5c Ac 4h]
dedea1989: bets $0.60
david_sara83: folds 
Uncalled bet ($0.60) returned to dedea1989
dedea1989 collected $0.67 from pot
*** SUMMARY ***
Total pot $0.70 | Rake $0.03 
Board [5c Ac 4h]
Seat 1: david_sara83 folded on the Flop
Seat 2: Crafty23@PS folded before Flop (didn't bet)
Seat 3: fidas1972 folded before Flop (didn't bet)
Seat 4: Eddys Edge (button) folded before Flop (didn't bet)
Seat 5: dedea1989 (small blind) collected ($0.67)
Seat 6: eniksenik (big blind) folded before Flop



PokerStars Hand #166667718726:  Hold'em No Limit ($0.05/$0.10 USD) - 2017/02/23 16:06:15 ET
Table 'Vesta II' 6-max Seat #1 is the button
Seat 1: Yabidooo ($13.16 in chips) 
Seat 2: Dimka4 ($10.05 in chips) 
Seat 3: Pokeaster ($12.38 in chips) 
Seat 4: Dcaro31 ($10 in chips) 
Seat 6: XaXaTyH4uK ($11.31 in chips) 
Dimka4: posts small blind $0.05
Pokeaster: posts big blind $0.10
ChuikaPridi: sits out 
*** HOLE CARDS ***
Dcaro31: folds 
XaXaTyH4uK: folds 
Yabidooo: folds 
Dimka4: raises $0.15 to $0.25
Pokeaster: calls $0.15
*** FLOP *** [8s 8h 4c]
Dimka4: checks 
Pokeaster: checks 
*** TURN *** [8s 8h 4c] [Kc]
Dimka4: checks 
Pokeaster: bets $0.36
Dimka4: folds 
Uncalled bet ($0.36) returned to Pokeaster
Pokeaster collected $0.48 from pot
*** SUMMARY ***
Total pot $0.50 | Rake $0.02 
Board [8s 8h 4c Kc]
Seat 1: Yabidooo (button) folded before Flop (didn't bet)
Seat 2: Dimka4 (small blind) folded on the Turn
Seat 3: Pokeaster (big blind) collected ($0.48)
Seat 4: Dcaro31 folded before Flop (didn't bet)
Seat 6: XaXaTyH4uK folded before Flop (didn't bet)



PokerStars Hand #166667718785:  Hold'em No Limit ($0.05/$0.10 USD) - 2017/02/23 16:06:16 ET
Table 'Girtab II' 6-max Seat #2 is the button
Seat 1: marianoboni ($11.31 in chips) 
Seat 2: Pokeaster ($13.29 in chips) 
Seat 3: chimera252 ($10 in chips) 
Seat 4: Hyd SK ($27.18 in chips) 
Seat 6: DamDatsAnAce ($10 in chips) 
chimera252: posts small blind $0.05
Hyd SK: posts big blind $0.10
*** HOLE CARDS ***
DamDatsAnAce: folds 
marianoboni: folds 
Pokeaster: raises $0.15 to $0.25
chimera252: folds 
Hyd SK: folds 
Uncalled bet ($0.15) returned to Pokeaster
Pokeaster collected $0.25 from pot
*** SUMMARY ***
Total pot $0.25 | Rake $0 
Seat 1: marianoboni folded before Flop (didn't bet)
Seat 2: Pokeaster (button) collected ($0.25)
Seat 3: chimera252 (small blind) folded before Flop
Seat 4: Hyd SK (big blind) folded before Flop
Seat 6: DamDatsAnAce folded before Flop (didn't bet)



PokerStars Hand #166667718816:  Hold'em No Limit ($0.05/$0.10 USD) - 2017/02/23 16:06:16 ET
Table 'Garlena III' 6-max Seat #2 is the button
Seat 1: dittoro ($10.15 in chips) 
Seat 2: rusu_rapid ($10.15 in chips) 
Seat 4: mbkongstad ($9.90 in chips) 
Seat 5: steepfell ($10 in chips) 
mbkongstad: posts small blind $0.05
steepfell: posts big blind $0.10
iluzja12: sits out 
*** HOLE CARDS ***
dittoro: folds 
rusu_rapid: folds 
mbkongstad: folds 
Uncalled bet ($0.05) returned to steepfell
steepfell collected $0.10 from pot
*** SUMMARY ***
Total pot $0.10 | Rake $0 
Seat 1: dittoro folded before Flop (didn't bet)
Seat 2: rusu_rapid (button) folded before Flop (didn't bet)
Seat 4: mbkongstad (small blind) folded before Flop
Seat 5: steepfell (big blind) collected ($0.10)



PokerStars Hand #166667718896:  Hold'em No Limit ($0.05/$0.10 USD) - 2017/02/23 16:06:16 ET
Table 'Eurydome II' 6-max Seat #1 is the button
Seat 1: rusu_rapid ($11.83 in chips) 
Seat 3: gaHy_HaXeP ($10 in chips) 
Seat 4: Smitty03300 ($10.32 in chips) 
Seat 5: kush-killa87 ($10.49 in chips) 
Seat 6: Jucatorul823 ($6.70 in chips) 
gaHy_HaXeP: posts small blind $0.05
Smitty03300: posts big blind $0.10
*** HOLE CARDS ***
kush-killa87: folds 
Jucatorul823: folds 
rusu_rapid: folds 
gaHy_HaXeP: folds 
Uncalled bet ($0.05) returned to Smitty03300
Smitty03300 collected $0.10 from pot
*** SUMMARY ***
Total pot $0.10 | Rake $0 
Seat 1: rusu_rapid (button) folded before Flop (didn't bet)
Seat 3: gaHy_HaXeP (small blind) folded before Flop
Seat 4: Smitty03300 (big blind) collected ($0.10)
Seat 5: kush-killa87 folded before Flop (didn't bet)
Seat 6: Jucatorul823 folded before Flop (didn't bet)



PokerStars Hand #166667719171:  Hold'em No Limit ($0.05/$0.10 USD) - 2017/02/23 16:06:16 ET
Table 'Postrema' 6-max Seat #1 is the button
Seat 1: CHRO8 ($13.32 in chips) 
Seat 2: pancernik21 ($12.66 in chips) 
Seat 3: edcc19 ($2.81 in chips) 
Seat 4: ChuikaPridi ($13.63 in chips) 
Seat 5: Comeback3392 ($12.42 in chips) 
Seat 6: Scanner17 ($10 in chips) 
pancernik21: posts small blind $0.05
edcc19: posts big blind $0.10
*** HOLE CARDS ***
ChuikaPridi: folds 
Comeback3392: raises $0.20 to $0.30
Scanner17: folds 
CHRO8: raises $0.75 to $1.05
pancernik21: folds 
edcc19: raises $1.76 to $2.81 and is all-in
Comeback3392: folds 
CHRO8: calls $1.76
*** FLOP *** [5s Th Tc]
*** TURN *** [5s Th Tc] [3d]
*** RIVER *** [5s Th Tc 3d] [8c]
*** SHOW DOWN ***
edcc19: shows [As 5c] (two pair, Tens and Fives)
CHRO8: shows [9c Kc] (a pair of Tens)
edcc19 collected $5.70 from pot
*** SUMMARY ***
Total pot $5.97 | Rake $0.27 
Board [5s Th Tc 3d 8c]
Seat 1: CHRO8 (button) showed [9c Kc] and lost with a pair of Tens
Seat 2: pancernik21 (small blind) folded before Flop
Seat 3: edcc19 (big blind) showed [As 5c] and won ($5.70) with two pair, Tens and Fives
Seat 4: ChuikaPridi folded before Flop (didn't bet)
Seat 5: Comeback3392 folded before Flop
Seat 6: Scanner17 folded before Flop (didn't bet)



PokerStars Hand #166667719304:  Hold'em No Limit ($0.05/$0.10 USD) - 2017/02/23 16:06:16 ET
Table 'Hercynia III' 6-max Seat #5 is the button
Seat 1: Bird et al ($14.58 in chips) 
Seat 2: Action_Gibi ($7.14 in chips) 
Seat 3: Dcaro31 ($20.17 in chips) 
Seat 5: THIMUCHIN ($15.22 in chips) 
Seat 6: bdixon_5 ($11.64 in chips) 
bdixon_5: posts small blind $0.05
Bird et al: posts big blind $0.10
*** HOLE CARDS ***
Action_Gibi: folds 
Dcaro31: folds 
THIMUCHIN: raises $0.10 to $0.20
bdixon_5: folds 
Bird et al: calls $0.10
*** FLOP *** [8h Th 6s]
Bird et al: checks 
THIMUCHIN: bets $0.25
Bird et al: folds 
Uncalled bet ($0.25) returned to THIMUCHIN
THIMUCHIN collected $0.43 from pot
*** SUMMARY ***
Total pot $0.45 | Rake $0.02 
Board [8h Th 6s]
Seat 1: Bird et al (big blind) folded on the Flop
Seat 2: Action_Gibi folded before Flop (didn't bet)
Seat 3: Dcaro31 folded before Flop (didn't bet)
Seat 5: THIMUCHIN (button) collected ($0.43)
Seat 6: bdixon_5 (small blind) folded before Flop



PokerStars Hand #166667720257:  Hold'em No Limit ($0.05/$0.10 USD) - 2017/02/23 16:06:17 ET
Table 'Anhui II' 6-max Seat #1 is the button
Seat 1: kingartur222 ($12.87 in chips) 
Seat 2: kikus334 ($12.26 in chips) 
Seat 3: lochniak556 ($26.79 in chips) 
Seat 4: dragonste89 ($10 in chips) 
Seat 5: Bandyaev ($10 in chips) 
Seat 6: .BaRReL.1122 ($4.65 in chips) 
kikus334: posts small blind $0.05
lochniak556: posts big blind $0.10
*** HOLE CARDS ***
dragonste89: folds 
Bandyaev: folds 
.BaRReL.1122: folds 
kingartur222: folds 
kikus334: calls $0.05
lochniak556: raises $0.30 to $0.40
kikus334: calls $0.30
*** FLOP *** [Kd Js 7d]
kikus334: bets $0.10
.BaRReL.1122 said, "mysle ze 8 by wystrxzyla"
lochniak556: calls $0.10
*** TURN *** [Kd Js 7d] [6c]
kikus334: bets $0.10
lochniak556: calls $0.10
*** RIVER *** [Kd Js 7d 6c] [Qh]
kikus334: bets $1.20
lochniak556: folds 
Uncalled bet ($1.20) returned to kikus334
kikus334 collected $1.15 from pot
*** SUMMARY ***
Total pot $1.20 | Rake $0.05 
Board [Kd Js 7d 6c Qh]
Seat 1: kingartur222 (button) folded before Flop (didn't bet)
Seat 2: kikus334 (small blind) collected ($1.15)
Seat 3: lochniak556 (big blind) folded on the River
Seat 4: dragonste89 folded before Flop (didn't bet)
Seat 5: Bandyaev folded before Flop (didn't bet)
Seat 6: .BaRReL.1122 folded before Flop (didn't bet)



PokerStars Hand #166667720409:  Hold'em No Limit ($0.05/$0.10 USD) - 2017/02/23 16:06:17 ET
Table 'Kochera' 6-max Seat #5 is the button
Seat 1: chimera252 ($11.82 in chips) 
Seat 2: bartabs2 ($10.54 in chips) 
Seat 3: KA3AXCTAHEU, ($10 in chips) 
Seat 4: johkom ($5.95 in chips) 
Seat 5: univibe68 ($11.85 in chips) 
Seat 6: oddshoff ($9.53 in chips) 
oddshoff: posts small blind $0.05
chimera252: posts big blind $0.10
*** HOLE CARDS ***
bartabs2: folds 
KA3AXCTAHEU,: raises $0.15 to $0.25
johkom: folds 
univibe68: calls $0.25
oddshoff: folds 
chimera252: folds 
*** FLOP *** [6s 8d 5h]
KA3AXCTAHEU,: checks 
univibe68: checks 
*** TURN *** [6s 8d 5h] [Kh]
KA3AXCTAHEU,: checks 
univibe68: checks 
*** RIVER *** [6s 8d 5h Kh] [Qh]
KA3AXCTAHEU,: bets $0.10
univibe68: calls $0.10
*** SHOW DOWN ***
KA3AXCTAHEU,: shows [Jc Qc] (a pair of Queens)
univibe68: mucks hand 
KA3AXCTAHEU, collected $0.81 from pot
*** SUMMARY ***
Total pot $0.85 | Rake $0.04 
Board [6s 8d 5h Kh Qh]
Seat 1: chimera252 (big blind) folded before Flop
Seat 2: bartabs2 folded before Flop (didn't bet)
Seat 3: KA3AXCTAHEU, showed [Jc Qc] and won ($0.81) with a pair of Queens
Seat 4: johkom folded before Flop (didn't bet)
Seat 5: univibe68 (button) mucked
Seat 6: oddshoff (small blind) folded before Flop



PokerStars Hand #166667720558:  Hold'em No Limit ($0.05/$0.10 USD) - 2017/02/23 16:06:18 ET
Table 'Eudora' 6-max Seat #5 is the button
Seat 1: archer2511 ($11.51 in chips) 
Seat 2: popypaleta ($10 in chips) 
Seat 3: Ice_Isayev ($10 in chips) 
Seat 4: yodzik ($5.30 in chips) 
Seat 5: chimera252 ($11.67 in chips) 
archer2511: posts small blind $0.05
popypaleta: posts big blind $0.10
*** HOLE CARDS ***
Ice_Isayev: raises $0.20 to $0.30
yodzik: folds 
chimera252: folds 
archer2511: folds 
popypaleta: calls $0.20
*** FLOP *** [Ah Th Ac]
popypaleta: checks 
Ice_Isayev: bets $0.31
popypaleta: calls $0.31
*** TURN *** [Ah Th Ac] [7d]
popypaleta: checks 
Ice_Isayev: checks 
*** RIVER *** [Ah Th Ac 7d] [6s]
popypaleta: checks 
Ice_Isayev: bets $0.70
popypaleta: folds 
Uncalled bet ($0.70) returned to Ice_Isayev
Ice_Isayev collected $1.21 from pot
*** SUMMARY ***
Total pot $1.27 | Rake $0.06 
Board [Ah Th Ac 7d 6s]
Seat 1: archer2511 (small blind) folded before Flop
Seat 2: popypaleta (big blind) folded on the River
Seat 3: Ice_Isayev collected ($1.21)
Seat 4: yodzik folded before Flop (didn't bet)
Seat 5: chimera252 (button) folded before Flop (didn't bet)



PokerStars Hand #166667720825:  Hold'em No Limit ($0.05/$0.10 USD) - 2017/02/23 16:06:18 ET
Table 'Jacchia' 6-max Seat #6 is the button
Seat 1: viklundm ($34.92 in chips) 
Seat 2: VAD21 ($20.21 in chips) 
Seat 4: paterthomas ($10 in chips) 
Seat 6: RoJ1 ($12.11 in chips) 
viklundm: posts small blind $0.05
VAD21: posts big blind $0.10
maxiv608: sits out 
*** HOLE CARDS ***
paterthomas: raises $0.15 to $0.25
RoJ1: folds 
viklundm: calls $0.20
VAD21: folds 
*** FLOP *** [7s As Jc]
viklundm: checks 
paterthomas: bets $0.38
viklundm: calls $0.38
*** TURN *** [7s As Jc] [3s]
viklundm: checks 
paterthomas: checks 
*** RIVER *** [7s As Jc 3s] [Js]
viklundm: bets $1.30
paterthomas: folds 
Uncalled bet ($1.30) returned to viklundm
viklundm collected $1.30 from pot
*** SUMMARY ***
Total pot $1.36 | Rake $0.06 
Board [7s As Jc 3s Js]
Seat 1: viklundm (small blind) collected ($1.30)
Seat 2: VAD21 (big blind) folded before Flop
Seat 4: paterthomas folded on the River
Seat 6: RoJ1 (button) folded before Flop (didn't bet)



PokerStars Hand #166667720860:  Hold'em No Limit ($0.05/$0.10 USD) - 2017/02/23 16:06:18 ET
Table 'Clavel' 6-max Seat #4 is the button
Seat 1: KRZuff ($14.66 in chips) 
Seat 2: Namhkal ($10 in chips) 
Seat 4: Dcaro31 ($11.83 in chips) 
Seat 5: Vrinni ($10.04 in chips) 
Seat 6: Gra_anD77 ($4.70 in chips) 
Vrinni: posts small blind $0.05
Gra_anD77: posts big blind $0.10
*** HOLE CARDS ***
KRZuff: folds 
Namhkal: folds 
Dcaro31: folds 
Vrinni: folds 
Uncalled bet ($0.05) returned to Gra_anD77
Gra_anD77 collected $0.10 from pot
*** SUMMARY ***
Total pot $0.10 | Rake $0 
Seat 1: KRZuff folded before Flop (didn't bet)
Seat 2: Namhkal folded before Flop (didn't bet)
Seat 4: Dcaro31 (button) folded before Flop (didn't bet)
Seat 5: Vrinni (small blind) folded before Flop
Seat 6: Gra_anD77 (big blind) collected ($0.10)



PokerStars Hand #166667720861:  Hold'em No Limit ($0.05/$0.10 USD) - 2017/02/23 16:06:18 ET
Table 'Caprera III' 6-max Seat #6 is the button
Seat 1: Vrinni ($18.63 in chips) 
Seat 2: hg123454321 ($10.87 in chips) 
Seat 5: fedorka rus ($49.53 in chips) 
Seat 6: GESPERIA ($17.19 in chips) 
Vrinni: posts small blind $0.05
hg123454321: posts big blind $0.10
*** HOLE CARDS ***
fedorka rus: raises $0.20 to $0.30
GESPERIA: calls $0.30
Vrinni: calls $0.25
hg123454321: folds 
*** FLOP *** [9s 9d 5d]
hg123454321 is disconnected 
Vrinni: checks 
fedorka rus: checks 
GESPERIA: checks 
*** TURN *** [9s 9d 5d] [8d]
Vrinni: checks 
fedorka rus: checks 
GESPERIA: checks 
*** RIVER *** [9s 9d 5d 8d] [2h]
Vrinni: checks 
fedorka rus: checks 
GESPERIA: checks 
*** SHOW DOWN ***
Vrinni: shows [6c 5c] (two pair, Nines and Fives)
fedorka rus: mucks hand 
GESPERIA: mucks hand 
Vrinni collected $0.96 from pot
*** SUMMARY ***
Total pot $1 | Rake $0.04 
Board [9s 9d 5d 8d 2h]
Seat 1: Vrinni (small blind) showed [6c 5c] and won ($0.96) with two pair, Nines and Fives
Seat 2: hg123454321 (big blind) folded before Flop
Seat 5: fedorka rus mucked
Seat 6: GESPERIA (button) mucked



PokerStars Hand #166667721225:  Hold'em No Limit ($0.05/$0.10 USD) - 2017/02/23 16:06:19 ET
Table 'Lampetia' 6-max Seat #4 is the button
Seat 1: WinninBikini ($10.29 in chips) 
Seat 2: ex3Lero86 ($10.30 in chips) 
Seat 3: Ice_Isayev ($19.89 in chips) 
Seat 4: Rodik002 ($10 in chips) 
Seat 5: luisantrs ($9.23 in chips) 
Seat 6: Scanner17 ($12.44 in chips) 
luisantrs: posts small blind $0.05
Scanner17: posts big blind $0.10
*** HOLE CARDS ***
WinninBikini: raises $0.20 to $0.30
ex3Lero86: folds 
Ice_Isayev: folds 
Rodik002: folds 
luisantrs: calls $0.25
Scanner17: calls $0.20
*** FLOP *** [Kd 8d 9h]
luisantrs: checks 
Scanner17: checks 
WinninBikini: checks 
*** TURN *** [Kd 8d 9h] [2s]
luisantrs: bets $0.86
Scanner17: folds 
WinninBikini: calls $0.86
*** RIVER *** [Kd 8d 9h 2s] [6s]
luisantrs: bets $2.50
WinninBikini: folds 
Uncalled bet ($2.50) returned to luisantrs
luisantrs collected $2.50 from pot
*** SUMMARY ***
Total pot $2.62 | Rake $0.12 
Board [Kd 8d 9h 2s 6s]
Seat 1: WinninBikini folded on the River
Seat 2: ex3Lero86 folded before Flop (didn't bet)
Seat 3: Ice_Isayev folded before Flop (didn't bet)
Seat 4: Rodik002 (button) folded before Flop (didn't bet)
Seat 5: luisantrs (small blind) collected ($2.50)
Seat 6: Scanner17 (big blind) folded on the Turn



PokerStars Hand #166667721876:  Hold'em No Limit ($0.05/$0.10 USD) - 2017/02/23 16:06:20 ET
Table 'Nata II' 6-max Seat #2 is the button
Seat 1: luisantrs ($8.95 in chips) 
Seat 2: CHRO8 ($15.70 in chips) 
Seat 3: 8th wonders ($10 in chips) 
Seat 4: Comeback3392 ($10 in chips) 
Seat 5: RoJ1 ($12.08 in chips) 
Seat 6: IAntikI ($10 in chips) 
8th wonders: posts small blind $0.05
Comeback3392: posts big blind $0.10
*** HOLE CARDS ***
RoJ1: folds 
IAntikI: folds 
luisantrs: folds 
CHRO8: folds 
8th wonders: folds 
Uncalled bet ($0.05) returned to Comeback3392
Comeback3392 collected $0.10 from pot
*** SUMMARY ***
Total pot $0.10 | Rake $0 
Seat 1: luisantrs folded before Flop (didn't bet)
Seat 2: CHRO8 (button) folded before Flop (didn't bet)
Seat 3: 8th wonders (small blind) folded before Flop
Seat 4: Comeback3392 (big blind) collected ($0.10)
Seat 5: RoJ1 folded before Flop (didn't bet)
Seat 6: IAntikI folded before Flop (didn't bet)



PokerStars Hand #166667722063:  Hold'em No Limit ($0.05/$0.10 USD) - 2017/02/23 16:06:20 ET
Table 'Kraz II' 6-max Seat #2 is the button
Seat 1: bdixon_5 ($9.55 in chips) 
Seat 2: shellyld ($10 in chips) 
Seat 3: Eddys Edge ($10.05 in chips) 
Seat 5: Joker51_wtf! ($10.15 in chips) 
Seat 6: tr41n3r12 ($10 in chips) 
Eddys Edge: posts small blind $0.05
WinninBikini: is sitting out 
Joker51_wtf!: posts big blind $0.10
*** HOLE CARDS ***
WinninBikini leaves the table
tr41n3r12: folds 
bdixon_5: folds 
shellyld: raises $0.20 to $0.30
Eddys Edge: folds 
Joker51_wtf!: folds 
Uncalled bet ($0.20) returned to shellyld
shellyld collected $0.25 from pot
*** SUMMARY ***
Total pot $0.25 | Rake $0 
Seat 1: bdixon_5 folded before Flop (didn't bet)
Seat 2: shellyld (button) collected ($0.25)
Seat 3: Eddys Edge (small blind) folded before Flop
Seat 5: Joker51_wtf! (big blind) folded before Flop
Seat 6: tr41n3r12 folded before Flop (didn't bet)



PokerStars Hand #166667722474:  Hold'em No Limit ($0.05/$0.10 USD) - 2017/02/23 16:06:20 ET
Table 'Brendelia II' 6-max Seat #6 is the button
Seat 2: Crimsonr ($5.11 in chips) 
Seat 6: luckyPositiv ($10.24 in chips) 
luckyPositiv: posts small blind $0.05
Crimsonr: posts big blind $0.10
Crimsonr: posts the ante $0.02
luckyPositiv: posts the ante $0.02
*** HOLE CARDS ***
luckyPositiv: raises $0.20 to $0.30
Crimsonr: folds 
Uncalled bet ($0.20) returned to luckyPositiv
luckyPositiv collected $0.24 from pot
*** SUMMARY ***
Total pot $0.24 | Rake $0 
Seat 2: Crimsonr (big blind) folded before Flop
Seat 6: luckyPositiv (button) (small blind) collected ($0.24)



PokerStars Hand #166667722801:  Hold'em No Limit ($0.05/$0.10 USD) - 2017/02/23 16:06:21 ET
Table 'Orthos III' 6-max Seat #5 is the button
Seat 1: sexy_seagull ($10 in chips) 
Seat 2: Xander188 ($19.46 in chips) 
Seat 3: koka4cs ($5.75 in chips) 
Seat 4: FlopsterGB ($15.42 in chips) 
Seat 5: Bird et al ($20.47 in chips) 
Seat 6: RoJ1 ($10.69 in chips) 
RoJ1: posts small blind $0.05
sexy_seagull: posts big blind $0.10
*** HOLE CARDS ***
Xander188: folds 
koka4cs: folds 
FlopsterGB: folds 
Bird et al: raises $0.15 to $0.25
RoJ1: folds 
sexy_seagull: calls $0.15
*** FLOP *** [5h Ts As]
sexy_seagull: checks 
Bird et al: bets $0.31
sexy_seagull: calls $0.31
*** TURN *** [5h Ts As] [Qh]
sexy_seagull: checks 
Bird et al: checks 
*** RIVER *** [5h Ts As Qh] [Ad]
sexy_seagull: checks 
Bird et al: bets $0.67
sexy_seagull: calls $0.67
*** SHOW DOWN ***
Bird et al: shows [Ah 6s] (three of a kind, Aces)
sexy_seagull: shows [Ks Jc] (a straight, Ten to Ace)
sexy_seagull collected $2.40 from pot
*** SUMMARY ***
Total pot $2.51 | Rake $0.11 
Board [5h Ts As Qh Ad]
Seat 1: sexy_seagull (big blind) showed [Ks Jc] and won ($2.40) with a straight, Ten to Ace
Seat 2: Xander188 folded before Flop (didn't bet)
Seat 3: koka4cs folded before Flop (didn't bet)
Seat 4: FlopsterGB folded before Flop (didn't bet)
Seat 5: Bird et al (button) showed [Ah 6s] and lost with three of a kind, Aces
Seat 6: RoJ1 (small blind) folded before Flop



PokerStars Hand #166667723028:  Hold'em No Limit ($0.05/$0.10 USD) - 2017/02/23 16:06:21 ET
Table 'Rosalia' 6-max Seat #3 is the button
Seat 1: Hyd SK ($10 in chips) 
Seat 2: Bandyaev ($11.69 in chips) 
Seat 3: Andy Wolf ($11.98 in chips) 
Seat 4: THIMUCHIN ($10.05 in chips) 
Seat 5: miron762 ($18.90 in chips) 
Seat 6: facewald ($16.78 in chips) 
THIMUCHIN: posts small blind $0.05
miron762: posts big blind $0.10
*** HOLE CARDS ***
facewald: folds 
Hyd SK: raises $0.25 to $0.35
Bandyaev: raises $0.75 to $1.10
Andy Wolf: folds 
THIMUCHIN: folds 
miron762: folds 
Hyd SK: folds 
Uncalled bet ($0.75) returned to Bandyaev
Bandyaev collected $0.85 from pot
*** SUMMARY ***
Total pot $0.85 | Rake $0 
Seat 1: Hyd SK folded before Flop
Seat 2: Bandyaev collected ($0.85)
Seat 3: Andy Wolf (button) folded before Flop (didn't bet)
Seat 4: THIMUCHIN (small blind) folded before Flop
Seat 5: miron762 (big blind) folded before Flop
Seat 6: facewald folded before Flop (didn't bet)



PokerStars Hand #166667723222:  Hold'em No Limit ($0.05/$0.10 USD) - 2017/02/23 16:06:21 ET
Table 'Lobelia II' 6-max Seat #5 is the button
Seat 1: facewald ($21.37 in chips) 
Seat 2: Dcaro31 ($17.61 in chips) 
Seat 3: oddshoff ($19.25 in chips) 
Seat 5: Feverhead ($20.28 in chips) 
Seat 6: NvR.m1nD ($10 in chips) 
NvR.m1nD: posts small blind $0.05
facewald: posts big blind $0.10
*** HOLE CARDS ***
Dcaro31: folds 
oddshoff: folds 
Feverhead: folds 
NvR.m1nD: raises $0.15 to $0.25
facewald: folds 
Uncalled bet ($0.15) returned to NvR.m1nD
NvR.m1nD collected $0.20 from pot
*** SUMMARY ***
Total pot $0.20 | Rake $0 
Seat 1: facewald (big blind) folded before Flop
Seat 2: Dcaro31 folded before Flop (didn't bet)
Seat 3: oddshoff folded before Flop (didn't bet)
Seat 5: Feverhead (button) folded before Flop (didn't bet)
Seat 6: NvR.m1nD (small blind) collected ($0.20)



PokerStars Hand #166667723345:  Hold'em No Limit ($0.05/$0.10 USD) - 2017/02/23 16:06:22 ET
Table 'Arpola' 6-max Seat #1 is the button
Seat 1: dincimus ($10.37 in chips) 
Seat 2: patrick19111 ($10 in chips) 
Seat 3: simaryk ($10 in chips) 
Seat 4: Orlangoor ($19.20 in chips) 
Seat 5: truck1234 ($11.66 in chips) 
Seat 6: Andrei ProFF ($10.22 in chips) 
patrick19111: posts small blind $0.05
simaryk: posts big blind $0.10
*** HOLE CARDS ***
Orlangoor: raises $0.15 to $0.25
truck1234: calls $0.25
Andrei ProFF: folds 
dincimus: calls $0.25
patrick19111: folds 
simaryk: calls $0.15
*** FLOP *** [Ac 8s 3c]
simaryk: checks 
Orlangoor: checks 
truck1234: checks 
dincimus: bets $0.50
simaryk: folds 
Orlangoor: folds 
truck1234: folds 
Uncalled bet ($0.50) returned to dincimus
dincimus collected $1 from pot
*** SUMMARY ***
Total pot $1.05 | Rake $0.05 
Board [Ac 8s 3c]
Seat 1: dincimus (button) collected ($1)
Seat 2: patrick19111 (small blind) folded before Flop
Seat 3: simaryk (big blind) folded on the Flop
Seat 4: Orlangoor folded on the Flop
Seat 5: truck1234 folded on the Flop
Seat 6: Andrei ProFF folded before Flop (didn't bet)



PokerStars Hand #166667723438:  Hold'em No Limit ($0.05/$0.10 USD) - 2017/02/23 16:06:22 ET
Table 'Ostara III' 6-max Seat #2 is the button
Seat 1: MühliJr ($10.30 in chips) 
Seat 2: Action_Gibi ($9.89 in chips) 
Seat 3: vtalian ($13.03 in chips) 
Seat 6: FlopsterGB ($10.15 in chips) 
vtalian: posts small blind $0.05
FlopsterGB: posts big blind $0.10
*** HOLE CARDS ***
MühliJr: raises $0.20 to $0.30
Action_Gibi: calls $0.30
vtalian: folds 
FlopsterGB: folds 
*** FLOP *** [8c 3c As]
MühliJr: bets $0.42
Action_Gibi: calls $0.42
*** TURN *** [8c 3c As] [9s]
MühliJr: bets $1
Action_Gibi: calls $1
*** RIVER *** [8c 3c As 9s] [6s]
MühliJr: bets $1.80
Action_Gibi: calls $1.80
*** SHOW DOWN ***
MühliJr: shows [Ks Ad] (a pair of Aces)
Action_Gibi: mucks hand 
MühliJr collected $6.87 from pot
*** SUMMARY ***
Total pot $7.19 | Rake $0.32 
Board [8c 3c As 9s 6s]
Seat 1: MühliJr showed [Ks Ad] and won ($6.87) with a pair of Aces
Seat 2: Action_Gibi (button) mucked
Seat 3: vtalian (small blind) folded before Flop
Seat 6: FlopsterGB (big blind) folded before Flop



PokerStars Hand #166667723615:  Hold'em No Limit ($0.05/$0.10 USD) - 2017/02/23 16:06:22 ET
Table 'Isberga' 6-max Seat #1 is the button
Seat 1: Feverhead ($18.17 in chips) 
Seat 2: GESPERIA ($10.17 in chips) 
Seat 4: THIMUCHIN ($10.84 in chips) 
Seat 5: YoungGriff86 ($18.87 in chips) 
Seat 6: Goroshkos88 ($21.38 in chips) 
GESPERIA: posts small blind $0.05
THIMUCHIN: posts big blind $0.10
*** HOLE CARDS ***
YoungGriff86: raises $0.20 to $0.30
Goroshkos88: folds 
Feverhead: folds 
GESPERIA: folds 
THIMUCHIN: folds 
Uncalled bet ($0.20) returned to YoungGriff86
YoungGriff86 collected $0.25 from pot
*** SUMMARY ***
Total pot $0.25 | Rake $0 
Seat 1: Feverhead (button) folded before Flop (didn't bet)
Seat 2: GESPERIA (small blind) folded before Flop
Seat 4: THIMUCHIN (big blind) folded before Flop
Seat 5: YoungGriff86 collected ($0.25)
Seat 6: Goroshkos88 folded before Flop (didn't bet)



PokerStars Hand #166667723938:  Hold'em No Limit ($0.05/$0.10 USD) - 2017/02/23 16:06:22 ET
Table 'Brambilla II' 6-max Seat #6 is the button
Seat 1: Rodik002 ($12.57 in chips) 
Seat 2: dwonder75 ($14.35 in chips) 
Seat 3: BORIS_ENEV ($14.47 in chips) 
Seat 4: david_sara83 ($11.82 in chips) 
Seat 5: FRAID358 ($10.15 in chips) 
Seat 6: boxer821 ($10.08 in chips) 
Rodik002: posts small blind $0.05
dwonder75: posts big blind $0.10
*** HOLE CARDS ***
BORIS_ENEV: raises $0.15 to $0.25
david_sara83: folds 
FRAID358: folds 
boxer821: folds 
Rodik002: folds 
dwonder75: calls $0.15
*** FLOP *** [5s Qc 3d]
dwonder75: checks 
BORIS_ENEV: bets $0.30
dwonder75: calls $0.30
*** TURN *** [5s Qc 3d] [Qs]
dwonder75: checks 
BORIS_ENEV: checks 
*** RIVER *** [5s Qc 3d Qs] [3h]
dwonder75: bets $1.20
BORIS_ENEV: folds 
Uncalled bet ($1.20) returned to dwonder75
dwonder75 collected $1.10 from pot
*** SUMMARY ***
Total pot $1.15 | Rake $0.05 
Board [5s Qc 3d Qs 3h]
Seat 1: Rodik002 (small blind) folded before Flop
Seat 2: dwonder75 (big blind) collected ($1.10)
Seat 3: BORIS_ENEV folded on the River
Seat 4: david_sara83 folded before Flop (didn't bet)
Seat 5: FRAID358 folded before Flop (didn't bet)
Seat 6: boxer821 (button) folded before Flop (didn't bet)



PokerStars Hand #166667724305:  Hold'em No Limit ($0.05/$0.10 USD) - 2017/02/23 16:06:23 ET
Table 'Arduina' 6-max Seat #1 is the button
Seat 1: tauronex ($10 in chips) 
Seat 2: Andy Wolf ($14.50 in chips) 
Seat 3: Dcaro31 ($13.11 in chips) 
Seat 4: ChuikaPridi ($29.23 in chips) 
Seat 5: ettedallas ($7.36 in chips) 
Seat 6: dierri ($9.25 in chips) 
Andy Wolf: posts small blind $0.05
Dcaro31: posts big blind $0.10
*** HOLE CARDS ***
ChuikaPridi: raises $0.20 to $0.30
ettedallas: folds 
dierri: calls $0.30
tauronex: folds 
Andy Wolf: folds 
Dcaro31: calls $0.20
*** FLOP *** [4h 7c As]
Dcaro31: checks 
ChuikaPridi: checks 
dierri: bets $0.46
Dcaro31: folds 
ChuikaPridi: folds 
Uncalled bet ($0.46) returned to dierri
dierri collected $0.91 from pot
*** SUMMARY ***
Total pot $0.95 | Rake $0.04 
Board [4h 7c As]
Seat 1: tauronex (button) folded before Flop (didn't bet)
Seat 2: Andy Wolf (small blind) folded before Flop
Seat 3: Dcaro31 (big blind) folded on the Flop
Seat 4: ChuikaPridi folded on the Flop
Seat 5: ettedallas folded before Flop (didn't bet)
Seat 6: dierri collected ($0.91)



PokerStars Hand #166667724432:  Hold'em No Limit ($0.05/$0.10 USD) - 2017/02/23 16:06:23 ET
Table 'Risha II' 6-max Seat #4 is the button
Seat 1: R. Lemonte ($13.42 in chips) 
Seat 2: KA3AXCTAHEU, ($12.65 in chips) 
Seat 3: steepfell ($10.15 in chips) 
Seat 4: Comeback3392 ($20.66 in chips) 
Seat 5: m.c-alkatraz ($10.10 in chips) 
Seat 6: univibe68 ($10.61 in chips) 
m.c-alkatraz: posts small blind $0.05
univibe68: posts big blind $0.10
*** HOLE CARDS ***
R. Lemonte: calls $0.10
KA3AXCTAHEU,: folds 
steepfell: folds 
Comeback3392: raises $0.30 to $0.40
m.c-alkatraz: folds 
univibe68: folds 
R. Lemonte: calls $0.30
*** FLOP *** [2h 6s Qd]
R. Lemonte: bets $0.30
Comeback3392: calls $0.30
*** TURN *** [2h 6s Qd] [4h]
R. Lemonte: bets $0.60
Comeback3392: calls $0.60
*** RIVER *** [2h 6s Qd 4h] [Ah]
R. Lemonte: checks 
Comeback3392: checks 
*** SHOW DOWN ***
R. Lemonte: shows [Qc Jh] (a pair of Queens)
Comeback3392: mucks hand 
R. Lemonte collected $2.63 from pot
*** SUMMARY ***
Total pot $2.75 | Rake $0.12 
Board [2h 6s Qd 4h Ah]
Seat 1: R. Lemonte showed [Qc Jh] and won ($2.63) with a pair of Queens
Seat 2: KA3AXCTAHEU, folded before Flop (didn't bet)
Seat 3: steepfell folded before Flop (didn't bet)
Seat 4: Comeback3392 (button) mucked
Seat 5: m.c-alkatraz (small blind) folded before Flop
Seat 6: univibe68 (big blind) folded before Flop



PokerStars Hand #166667724665:  Hold'em No Limit ($0.05/$0.10 USD) - 2017/02/23 16:06:23 ET
Table 'Tyche III' 6-max Seat #6 is the button
Seat 1: milt65 ($10.14 in chips) 
Seat 3: ChuikaPridi ($10 in chips) 
Seat 4: Kazacha ($10 in chips) 
Seat 5: chimera252 ($12.90 in chips) 
Seat 6: Ice_Isayev ($10 in chips) 
milt65: posts small blind $0.05
ChuikaPridi: posts big blind $0.10
*** HOLE CARDS ***
Kazacha: folds 
chimera252: raises $0.20 to $0.30
Ice_Isayev: calls $0.30
milt65: folds 
ChuikaPridi: raises $1.10 to $1.40
chimera252: calls $1.10
Ice_Isayev: folds 
*** FLOP *** [2c 8c 9c]
ChuikaPridi: checks 
chimera252: bets $1.50
ChuikaPridi: folds 
Uncalled bet ($1.50) returned to chimera252
chimera252 collected $3.01 from pot
*** SUMMARY ***
Total pot $3.15 | Rake $0.14 
Board [2c 8c 9c]
Seat 1: milt65 (small blind) folded before Flop
Seat 3: ChuikaPridi (big blind) folded on the Flop
Seat 4: Kazacha folded before Flop (didn't bet)
Seat 5: chimera252 collected ($3.01)
Seat 6: Ice_Isayev (button) folded before Flop



PokerStars Hand #166667724705:  Hold'em No Limit ($0.05/$0.10 USD) - 2017/02/23 16:06:23 ET
Table 'Duhr II' 6-max Seat #2 is the button
Seat 1: Lucky HoBBiT ($10 in chips) 
Seat 2: Feverhead ($37.74 in chips) 
Seat 4: CHRO8 ($8.95 in chips) 
Seat 5: Dimka4 ($10 in chips) 
Seat 6: townerz1991 ($11.01 in chips) 
Smitty03300 will be allowed to play after the button
CHRO8: posts small blind $0.05
Dimka4: posts big blind $0.10
*** HOLE CARDS ***
townerz1991: folds 
Lucky HoBBiT: raises $0.20 to $0.30
Feverhead: folds 
CHRO8: calls $0.25
Dimka4: folds 
*** FLOP *** [Th Td Tc]
CHRO8: checks 
Lucky HoBBiT: bets $0.42
CHRO8: calls $0.42
*** TURN *** [Th Td Tc] [Kc]
CHRO8: checks 
Lucky HoBBiT: bets $0.84
CHRO8: folds 
Uncalled bet ($0.84) returned to Lucky HoBBiT
Lucky HoBBiT collected $1.47 from pot
*** SUMMARY ***
Total pot $1.54 | Rake $0.07 
Board [Th Td Tc Kc]
Seat 1: Lucky HoBBiT collected ($1.47)
Seat 2: Feverhead (button) folded before Flop (didn't bet)
Seat 4: CHRO8 (small blind) folded on the Turn
Seat 5: Dimka4 (big blind) folded before Flop
Seat 6: townerz1991 folded before Flop (didn't bet)



PokerStars Hand #166667725014:  Hold'em No Limit ($0.05/$0.10 USD) - 2017/02/23 16:06:24 ET
Table 'Izar' 6-max Seat #5 is the button
Seat 1: bambolejro ($10.39 in chips) 
Seat 2: mvp0013 ($8.08 in chips) 
Seat 3: Yspenyanin ($11.27 in chips) 
Seat 4: Matee92 ($6.01 in chips) 
Seat 5: fishhook5 ($11.30 in chips) 
Seat 6: yodzik ($7.84 in chips) 
yodzik: posts small blind $0.05
bambolejro: posts big blind $0.10
*** HOLE CARDS ***
mvp0013: raises $0.20 to $0.30
Yspenyanin: folds 
Matee92: folds 
fishhook5: folds 
yodzik: folds 
bambolejro: folds 
Uncalled bet ($0.20) returned to mvp0013
mvp0013 collected $0.25 from pot
*** SUMMARY ***
Total pot $0.25 | Rake $0 
Seat 1: bambolejro (big blind) folded before Flop
Seat 2: mvp0013 collected ($0.25)
Seat 3: Yspenyanin folded before Flop (didn't bet)
Seat 4: Matee92 folded before Flop (didn't bet)
Seat 5: fishhook5 (button) folded before Flop (didn't bet)
Seat 6: yodzik (small blind) folded before Flop



PokerStars Hand #166667725087:  Hold'em No Limit ($0.05/$0.10 USD) - 2017/02/23 16:06:24 ET
Table 'Cyane' 6-max Seat #3 is the button
Seat 1: KA3AXCTAHEU, ($10.30 in chips) 
Seat 2: sashi18 ($8.16 in chips) 
Seat 3: Mamm0nism ($12.89 in chips) 
Seat 4: truck1234 ($20.71 in chips) 
Seat 5: RoJ1 ($10 in chips) 
Seat 6: 8th wonders ($11.60 in chips) 
truck1234: posts small blind $0.05
RoJ1: posts big blind $0.10
*** HOLE CARDS ***
8th wonders: folds 
KA3AXCTAHEU,: folds 
sashi18: calls $0.10
Mamm0nism: folds 
truck1234: folds 
RoJ1: checks 
*** FLOP *** [7d 8c 7c]
RoJ1: checks 
sashi18: bets $0.20
RoJ1: calls $0.20
*** TURN *** [7d 8c 7c] [Ts]
RoJ1: checks 
sashi18: checks 
*** RIVER *** [7d 8c 7c Ts] [Ks]
RoJ1: checks 
sashi18: checks 
*** SHOW DOWN ***
RoJ1: shows [Ac 6d] (a pair of Sevens)
sashi18: mucks hand 
RoJ1 collected $0.62 from pot
*** SUMMARY ***
Total pot $0.65 | Rake $0.03 
Board [7d 8c 7c Ts Ks]
Seat 1: KA3AXCTAHEU, folded before Flop (didn't bet)
Seat 2: sashi18 mucked
Seat 3: Mamm0nism (button) folded before Flop (didn't bet)
Seat 4: truck1234 (small blind) folded before Flop
Seat 5: RoJ1 (big blind) showed [Ac 6d] and won ($0.62) with a pair of Sevens
Seat 6: 8th wonders folded before Flop (didn't bet)



PokerStars Hand #166667725224:  Hold'em No Limit ($0.05/$0.10 USD) - 2017/02/23 16:06:24 ET
Table 'Wabash' 6-max Seat #2 is the button
Seat 1: pivanki11 ($10.15 in chips) 
Seat 2: ex3Lero86 ($32.48 in chips) 
Seat 4: Nr847 ($10 in chips) 
Seat 5: popypaleta ($14.29 in chips) 
Seat 6: weez3r ($10.52 in chips) 
Nr847: posts small blind $0.05
popypaleta: posts big blind $0.10
*** HOLE CARDS ***
weez3r: raises $0.20 to $0.30
tauronex joins the table at seat #3 
pivanki11: folds 
ex3Lero86: folds 
Nr847: folds 
popypaleta: folds 
Uncalled bet ($0.20) returned to weez3r
weez3r collected $0.25 from pot
*** SUMMARY ***
Total pot $0.25 | Rake $0 
Seat 1: pivanki11 folded before Flop (didn't bet)
Seat 2: ex3Lero86 (button) folded before Flop (didn't bet)
Seat 4: Nr847 (small blind) folded before Flop
Seat 5: popypaleta (big blind) folded before Flop
Seat 6: weez3r collected ($0.25)



PokerStars Hand #166667725326:  Hold'em No Limit ($0.05/$0.10 USD) - 2017/02/23 16:06:24 ET
Table 'Nauheima II' 6-max Seat #3 is the button
Seat 2: Peter0087 ($10.47 in chips) 
Seat 3: KokoulinV ($13.14 in chips) 
Seat 4: Innerwuss ($10.12 in chips) 
Seat 6: bonyo71 ($5.04 in chips) 
Innerwuss: posts small blind $0.05
Kow6oy: is sitting out 
bonyo71: posts big blind $0.10
*** HOLE CARDS ***
Kow6oy leaves the table
Peter0087: raises $0.20 to $0.30
KokoulinV: folds 
Innerwuss: folds 
bonyo71: folds 
Uncalled bet ($0.20) returned to Peter0087
Peter0087 collected $0.25 from pot
*** SUMMARY ***
Total pot $0.25 | Rake $0 
Seat 2: Peter0087 collected ($0.25)
Seat 3: KokoulinV (button) folded before Flop (didn't bet)
Seat 4: Innerwuss (small blind) folded before Flop
Seat 6: bonyo71 (big blind) folded before Flop



PokerStars Hand #166667725460:  Hold'em No Limit ($0.05/$0.10 USD) - 2017/02/23 16:06:24 ET
Table 'Hunnia' 6-max Seat #2 is the button
Seat 1: univibe68 ($21.48 in chips) 
Seat 2: mhonielsen ($10 in chips) 
Seat 3: 6ePeMeHHa9 ($10.61 in chips) 
Seat 4: Jalida3 ($10.69 in chips) 
Seat 5: Smarkon ($15.44 in chips) 
Seat 6: ChuikaPridi ($10 in chips) 
6ePeMeHHa9: posts small blind $0.05
Jalida3: posts big blind $0.10
*** HOLE CARDS ***
Smarkon: raises $0.20 to $0.30
ChuikaPridi: calls $0.30
univibe68: folds 
mhonielsen: folds 
6ePeMeHHa9: folds 
Jalida3: calls $0.20
*** FLOP *** [5s 7h 9s]
Jalida3: bets $0.91
Smarkon: folds 
ChuikaPridi: calls $0.91
*** TURN *** [5s 7h 9s] [5c]
Jalida3: bets $1.33
ChuikaPridi: calls $1.33
*** RIVER *** [5s 7h 9s 5c] [4s]
Jalida3: bets $5.19
ChuikaPridi: folds 
Uncalled bet ($5.19) returned to Jalida3
Jalida3 collected $5.19 from pot
*** SUMMARY ***
Total pot $5.43 | Rake $0.24 
Board [5s 7h 9s 5c 4s]
Seat 1: univibe68 folded before Flop (didn't bet)
Seat 2: mhonielsen (button) folded before Flop (didn't bet)
Seat 3: 6ePeMeHHa9 (small blind) folded before Flop
Seat 4: Jalida3 (big blind) collected ($5.19)
Seat 5: Smarkon folded on the Flop
Seat 6: ChuikaPridi folded on the River



PokerStars Hand #166667725665:  Hold'em No Limit ($0.05/$0.10 USD) - 2017/02/23 16:06:24 ET
Table 'Aegle' 6-max Seat #3 is the button
Seat 1: phatts76 ($3.90 in chips) 
Seat 2: yodzik ($5 in chips) 
Seat 3: DrejAtom ($12.59 in chips) 
Seat 4: ab260414 ($10.27 in chips) 
Seat 5: KokoulinV ($11.26 in chips) 
Seat 6: CHRO8 ($20.44 in chips) 
ab260414: posts small blind $0.05
KokoulinV: posts big blind $0.10
*** HOLE CARDS ***
CHRO8: raises $0.20 to $0.30
phatts76: calls $0.30
yodzik: folds 
DrejAtom: folds 
ab260414: folds 
KokoulinV: calls $0.20
*** FLOP *** [Th As 8s]
KokoulinV: checks 
CHRO8: checks 
phatts76: checks 
*** TURN *** [Th As 8s] [Jd]
KokoulinV: checks 
CHRO8: bets $0.61
phatts76: folds 
KokoulinV: calls $0.61
*** RIVER *** [Th As 8s Jd] [Qs]
KokoulinV: checks 
CHRO8: checks 
*** SHOW DOWN ***
KokoulinV: shows [9h 9s] (a straight, Eight to Queen)
CHRO8: shows [Td 9d] (a straight, Eight to Queen)
KokoulinV collected $1.04 from pot
CHRO8 collected $1.03 from pot
*** SUMMARY ***
Total pot $2.17 | Rake $0.10 
Board [Th As 8s Jd Qs]
Seat 1: phatts76 folded on the Turn
Seat 2: yodzik folded before Flop (didn't bet)
Seat 3: DrejAtom (button) folded before Flop (didn't bet)
Seat 4: ab260414 (small blind) folded before Flop
Seat 5: KokoulinV (big blind) showed [9h 9s] and won ($1.04) with a straight, Eight to Queen
Seat 6: CHRO8 showed [Td 9d] and won ($1.03) with a straight, Eight to Queen



PokerStars Hand #166667725672:  Hold'em No Limit ($0.05/$0.10 USD) - 2017/02/23 16:06:24 ET
Table 'Kanda' 6-max Seat #4 is the button
Seat 1: Andy Wolf ($11.27 in chips) 
Seat 2: Pelotín ($5.15 in chips) 
Seat 3: XaXaTyH4uK ($10 in chips) 
Seat 4: Orlangoor ($10.19 in chips) 
Seat 5: Dimka4 ($10 in chips) 
Seat 6: oddshoff ($9.36 in chips) 
Dimka4: posts small blind $0.05
oddshoff: posts big blind $0.10
*** HOLE CARDS ***
Andy Wolf: folds 
Pelotín: folds 
XaXaTyH4uK: folds 
Orlangoor: folds 
Dimka4: raises $0.15 to $0.25
oddshoff: folds 
Uncalled bet ($0.15) returned to Dimka4
Dimka4 collected $0.20 from pot
*** SUMMARY ***
Total pot $0.20 | Rake $0 
Seat 1: Andy Wolf folded before Flop (didn't bet)
Seat 2: Pelotín folded before Flop (didn't bet)
Seat 3: XaXaTyH4uK folded before Flop (didn't bet)
Seat 4: Orlangoor (button) folded before Flop (didn't bet)
Seat 5: Dimka4 (small blind) collected ($0.20)
Seat 6: oddshoff (big blind) folded before Flop



PokerStars Hand #166667725714:  Hold'em No Limit ($0.05/$0.10 USD) - 2017/02/23 16:06:24 ET
Table 'Senta II' 6-max Seat #2 is the button
Seat 2: NvR.m1nD ($12.14 in chips) 
Seat 3: Aescul@pius ($20.60 in chips) 
Seat 4: fedorka rus ($20.94 in chips) 
Seat 5: Algarah ($6.52 in chips) 
Seat 6: T9MS ($11.32 in chips) 
Aescul@pius: posts small blind $0.05
fedorka rus: posts big blind $0.10
*** HOLE CARDS ***
Algarah: folds 
T9MS: folds 
NvR.m1nD: folds 
Aescul@pius: raises $0.15 to $0.25
fedorka rus: folds 
Uncalled bet ($0.15) returned to Aescul@pius
Aescul@pius collected $0.20 from pot
*** SUMMARY ***
Total pot $0.20 | Rake $0 
Seat 2: NvR.m1nD (button) folded before Flop (didn't bet)
Seat 3: Aescul@pius (small blind) collected ($0.20)
Seat 4: fedorka rus (big blind) folded before Flop
Seat 5: Algarah folded before Flop (didn't bet)
Seat 6: T9MS folded before Flop (didn't bet)



PokerStars Hand #166667725736:  Hold'em No Limit ($0.05/$0.10 USD) - 2017/02/23 16:06:24 ET
Table 'Nerthus II' 6-max Seat #1 is the button
Seat 1: mdelfin0 ($10.77 in chips) 
Seat 2: Hovhannes990 ($9.68 in chips) 
Seat 3: Mamm0nism ($18.67 in chips) 
Seat 5: Hyd SK ($12.15 in chips) 
Seat 6: Lucky HoBBiT ($10 in chips) 
Hovhannes990: posts small blind $0.05
Mamm0nism: posts big blind $0.10
myevc: sits out 
*** HOLE CARDS ***
Hyd SK: folds 
Lucky HoBBiT: folds 
mdelfin0: folds 
Hovhannes990: calls $0.05
Mamm0nism: checks 
*** FLOP *** [2c Jh 7c]
Hovhannes990: checks 
Mamm0nism: bets $0.12
Hovhannes990: folds 
Uncalled bet ($0.12) returned to Mamm0nism
Mamm0nism collected $0.19 from pot
*** SUMMARY ***
Total pot $0.20 | Rake $0.01 
Board [2c Jh 7c]
Seat 1: mdelfin0 (button) folded before Flop (didn't bet)
Seat 2: Hovhannes990 (small blind) folded on the Flop
Seat 3: Mamm0nism (big blind) collected ($0.19)
Seat 5: Hyd SK folded before Flop (didn't bet)
Seat 6: Lucky HoBBiT folded before Flop (didn't bet)



PokerStars Hand #166667725828:  Hold'em No Limit ($0.05/$0.10 USD) - 2017/02/23 16:06:25 ET
Table 'Wilkens II' 6-max Seat #1 is the button
Seat 1: Islamiq-GuRL ($10.34 in chips) 
Seat 2: manashov ($10.65 in chips) 
Seat 3: Namhkal ($10.99 in chips) 
Seat 5: patrick19111 ($11.58 in chips) 
Seat 6: XaXaTyH4uK ($14.31 in chips) 
manashov: posts small blind $0.05
Namhkal: posts big blind $0.10
myevc: sits out 
*** HOLE CARDS ***
patrick19111: folds 
XaXaTyH4uK: folds 
Islamiq-GuRL: folds 
manashov: raises $0.20 to $0.30
Namhkal: folds 
Uncalled bet ($0.20) returned to manashov
manashov collected $0.20 from pot
*** SUMMARY ***
Total pot $0.20 | Rake $0 
Seat 1: Islamiq-GuRL (button) folded before Flop (didn't bet)
Seat 2: manashov (small blind) collected ($0.20)
Seat 3: Namhkal (big blind) folded before Flop
Seat 5: patrick19111 folded before Flop (didn't bet)
Seat 6: XaXaTyH4uK folded before Flop (didn't bet)



PokerStars Hand #166667725870:  Hold'em No Limit ($0.05/$0.10 USD) - 2017/02/23 16:06:25 ET
Table 'Pompeja III' 6-max Seat #1 is the button
Seat 1: Iarlei ($11.94 in chips) 
Seat 2: steepfell ($10 in chips) 
Seat 3: Yspenyanin ($11.85 in chips) 
Seat 4: Cluckh ($13.87 in chips) 
Seat 5: Spud014 ($12.37 in chips) 
Seat 6: mega spasser ($4.80 in chips) 
steepfell: posts small blind $0.05
Yspenyanin: posts big blind $0.10
*** HOLE CARDS ***
Cluckh: folds 
Spud014: folds 
mega spasser: folds 
Iarlei: folds 
steepfell: raises $0.15 to $0.25
Yspenyanin: calls $0.15
*** FLOP *** [5h 9s 3d]
steepfell: checks 
Yspenyanin: checks 
*** TURN *** [5h 9s 3d] [Js]
steepfell: checks 
Yspenyanin: checks 
*** RIVER *** [5h 9s 3d Js] [2s]
steepfell: checks 
Yspenyanin: checks 
*** SHOW DOWN ***
steepfell: shows [8d Qh] (high card Queen)
Yspenyanin: shows [8h Ah] (high card Ace)
Yspenyanin collected $0.48 from pot
*** SUMMARY ***
Total pot $0.50 | Rake $0.02 
Board [5h 9s 3d Js 2s]
Seat 1: Iarlei (button) folded before Flop (didn't bet)
Seat 2: steepfell (small blind) showed [8d Qh] and lost with high card Queen
Seat 3: Yspenyanin (big blind) showed [8h Ah] and won ($0.48) with high card Ace
Seat 4: Cluckh folded before Flop (didn't bet)
Seat 5: Spud014 folded before Flop (didn't bet)
Seat 6: mega spasser folded before Flop (didn't bet)



PokerStars Hand #166667726002:  Hold'em No Limit ($0.05/$0.10 USD) - 2017/02/23 16:06:25 ET
Table 'Selinur' 6-max Seat #2 is the button
Seat 1: KA3AXCTAHEU, ($10 in chips) 
Seat 2: hoedje72 ($7.99 in chips) 
Seat 3: bambolejro ($11.12 in chips) 
Seat 4: freezing666 ($11.63 in chips) 
Seat 5: IAntikI ($10.07 in chips) 
Seat 6: homelessdan ($18.08 in chips) 
bambolejro: posts small blind $0.05
freezing666: posts big blind $0.10
*** HOLE CARDS ***
IAntikI: folds 
homelessdan: folds 
KA3AXCTAHEU,: folds 
hoedje72: raises $0.20 to $0.30
bambolejro: folds 
freezing666: calls $0.20
*** FLOP *** [9d 8d Jc]
freezing666: checks 
hoedje72: bets $0.62
freezing666: calls $0.62
*** TURN *** [9d 8d Jc] [6c]
freezing666: checks 
hoedje72: checks 
*** RIVER *** [9d 8d Jc 6c] [3d]
freezing666: checks 
hoedje72: checks 
*** SHOW DOWN ***
freezing666: shows [Th Qh] (a straight, Eight to Queen)
hoedje72: mucks hand 
freezing666 collected $1.81 from pot
*** SUMMARY ***
Total pot $1.89 | Rake $0.08 
Board [9d 8d Jc 6c 3d]
Seat 1: KA3AXCTAHEU, folded before Flop (didn't bet)
Seat 2: hoedje72 (button) mucked
Seat 3: bambolejro (small blind) folded before Flop
Seat 4: freezing666 (big blind) showed [Th Qh] and won ($1.81) with a straight, Eight to Queen
Seat 5: IAntikI folded before Flop (didn't bet)
Seat 6: homelessdan folded before Flop (didn't bet)



PokerStars Hand #166667726172:  Hold'em No Limit ($0.05/$0.10 USD) - 2017/02/23 16:06:25 ET
Table 'Reginhild' 6-max Seat #1 is the button
Seat 1: iamkakaroto ($11.25 in chips) 
Seat 2: Kow6oy ($10.20 in chips) 
Seat 3: ARCHITECT83 ($6.39 in chips) 
Seat 4: Raymondo21 ($23.78 in chips) 
Seat 5: XCarlos610 ($29.78 in chips) 
Seat 6: eniksenik ($10 in chips) 
Kow6oy: posts small blind $0.05
ARCHITECT83: posts big blind $0.10
*** HOLE CARDS ***
Raymondo21: folds 
XCarlos610: calls $0.10
eniksenik: folds 
iamkakaroto: folds 
Kow6oy: calls $0.05
ARCHITECT83: checks 
*** FLOP *** [2c 6h 9d]
Kow6oy: checks 
ARCHITECT83: bets $0.10
XCarlos610: calls $0.10
Kow6oy: folds 
*** TURN *** [2c 6h 9d] [As]
ARCHITECT83: bets $0.50
XCarlos610: folds 
Uncalled bet ($0.50) returned to ARCHITECT83
ARCHITECT83 collected $0.48 from pot
*** SUMMARY ***
Total pot $0.50 | Rake $0.02 
Board [2c 6h 9d As]
Seat 1: iamkakaroto (button) folded before Flop (didn't bet)
Seat 2: Kow6oy (small blind) folded on the Flop
Seat 3: ARCHITECT83 (big blind) collected ($0.48)
Seat 4: Raymondo21 folded before Flop (didn't bet)
Seat 5: XCarlos610 folded on the Turn
Seat 6: eniksenik folded before Flop (didn't bet)



PokerStars Hand #166667726214:  Hold'em No Limit ($0.05/$0.10 USD) - 2017/02/23 16:06:25 ET
Table 'Wesselink II' 6-max Seat #3 is the button
Seat 1: vladcol ($5.21 in chips) 
Seat 2: KRZuff ($10 in chips) 
Seat 3: Wargolandros ($8.92 in chips) 
Seat 4: BahiaMinhaP ($10.68 in chips) 
Seat 6: bambolejro ($10.64 in chips) 
BahiaMinhaP: posts small blind $0.05
bambolejro: posts big blind $0.10
*** HOLE CARDS ***
vladcol: calls $0.10
KRZuff: folds 
Wargolandros: folds 
BahiaMinhaP: raises $0.30 to $0.40
bambolejro: folds 
vladcol: calls $0.30
*** FLOP *** [Kc Qc 8s]
BahiaMinhaP: bets $0.43
vladcol: folds 
Uncalled bet ($0.43) returned to BahiaMinhaP
BahiaMinhaP collected $0.86 from pot
*** SUMMARY ***
Total pot $0.90 | Rake $0.04 
Board [Kc Qc 8s]
Seat 1: vladcol folded on the Flop
Seat 2: KRZuff folded before Flop (didn't bet)
Seat 3: Wargolandros (button) folded before Flop (didn't bet)
Seat 4: BahiaMinhaP (small blind) collected ($0.86)
Seat 6: bambolejro (big blind) folded before Flop



PokerStars Hand #166667726350:  Hold'em No Limit ($0.05/$0.10 USD) - 2017/02/23 16:06:25 ET
Table 'Klotho II' 6-max Seat #5 is the button
Seat 3: Zooplack ($10 in chips) 
Seat 4: Lucky HoBBiT ($10.71 in chips) 
Seat 5: david_sara83 ($16.06 in chips) 
Seat 6: D3NyA ($11.47 in chips) 
D3NyA: posts small blind $0.05
kickereens: is sitting out 
Zooplack: posts big blind $0.10
*** HOLE CARDS ***
kickereens leaves the table
xdjango07x joins the table at seat #1 
Lucky HoBBiT: folds 
david_sara83: folds 
D3NyA: folds 
Uncalled bet ($0.05) returned to Zooplack
Zooplack collected $0.10 from pot
*** SUMMARY ***
Total pot $0.10 | Rake $0 
Seat 3: Zooplack (big blind) collected ($0.10)
Seat 4: Lucky HoBBiT folded before Flop (didn't bet)
Seat 5: david_sara83 (button) folded before Flop (didn't bet)
Seat 6: D3NyA (small blind) folded before Flop



PokerStars Hand #166667726498:  Hold'em No Limit ($0.05/$0.10 USD) - 2017/02/23 16:06:25 ET
Table 'Unitas II' 6-max Seat #4 is the button
Seat 1: Peter0087 ($9.70 in chips) 
Seat 2: steepfell ($10.25 in chips) 
Seat 4: truck1234 ($10.79 in chips) 
Seat 5: chimera252 ($24.53 in chips) 
Seat 6: paxit71 ($9.73 in chips) 
chimera252: posts small blind $0.05
paxit71: posts big blind $0.10
*** HOLE CARDS ***
Peter0087: raises $0.20 to $0.30
steepfell: folds 
truck1234: folds 
chimera252: folds 
paxit71: folds 
Uncalled bet ($0.20) returned to Peter0087
Peter0087 collected $0.25 from pot
*** SUMMARY ***
Total pot $0.25 | Rake $0 
Seat 1: Peter0087 collected ($0.25)
Seat 2: steepfell folded before Flop (didn't bet)
Seat 4: truck1234 (button) folded before Flop (didn't bet)
Seat 5: chimera252 (small blind) folded before Flop
Seat 6: paxit71 (big blind) folded before Flop



PokerStars Hand #166667726559:  Hold'em No Limit ($0.05/$0.10 USD) - 2017/02/23 16:06:25 ET
Table 'Persephone' 6-max Seat #6 is the button
Seat 1: dragonste89 ($10 in chips) 
Seat 2: AM-L-SL ($5.50 in chips) 
Seat 3: DasoII ($4.85 in chips) 
Seat 4: 2G28 ($10 in chips) 
Seat 5: ab260414 ($10.96 in chips) 
Seat 6: popypaleta ($14.39 in chips) 
dragonste89: posts small blind $0.05
AM-L-SL: posts big blind $0.10
*** HOLE CARDS ***
DasoII: folds 
2G28: folds 
ab260414: folds 
popypaleta: folds 
dragonste89: folds 
Uncalled bet ($0.05) returned to AM-L-SL
AM-L-SL collected $0.10 from pot
*** SUMMARY ***
Total pot $0.10 | Rake $0 
Seat 1: dragonste89 (small blind) folded before Flop
Seat 2: AM-L-SL (big blind) collected ($0.10)
Seat 3: DasoII folded before Flop (didn't bet)
Seat 4: 2G28 folded before Flop (didn't bet)
Seat 5: ab260414 folded before Flop (didn't bet)
Seat 6: popypaleta (button) folded before Flop (didn't bet)



PokerStars Hand #166667726752:  Hold'em No Limit ($0.05/$0.10 USD) - 2017/02/23 16:06:26 ET
Table 'Geisha' 6-max Seat #4 is the button
Seat 1: facewald ($34.04 in chips) 
Seat 2: voledy ($10.60 in chips) 
Seat 3: Eddys Edge ($10 in chips) 
Seat 4: jvstsayyes ($11.70 in chips) 
Seat 5: KRZuff ($14.11 in chips) 
Seat 6: Namhkal ($21.48 in chips) 
KRZuff: posts small blind $0.05
Namhkal: posts big blind $0.10
*** HOLE CARDS ***
facewald: folds 
voledy: folds 
Eddys Edge: folds 
jvstsayyes: folds 
jvstsayyes leaves the table
KRZuff: raises $0.20 to $0.30
Namhkal: folds 
Uncalled bet ($0.20) returned to KRZuff
KRZuff collected $0.20 from pot
*** SUMMARY ***
Total pot $0.20 | Rake $0 
Seat 1: facewald folded before Flop (didn't bet)
Seat 2: voledy folded before Flop (didn't bet)
Seat 3: Eddys Edge folded before Flop (didn't bet)
Seat 4: jvstsayyes (button) folded before Flop (didn't bet)
Seat 5: KRZuff (small blind) collected ($0.20)
Seat 6: Namhkal (big blind) folded before Flop



PokerStars Hand #166667726837:  Hold'em No Limit ($0.05/$0.10 USD) - 2017/02/23 16:06:26 ET
Table 'Gyldenia II' 6-max Seat #5 is the button
Seat 1: KokoulinV ($10.48 in chips) 
Seat 2: Bandyaev ($10.94 in chips) 
Seat 5: CHRO8 ($15.47 in chips) 
Seat 6: 8th wonders ($11.58 in chips) 
8th wonders: posts small blind $0.05
KokoulinV: posts big blind $0.10
*** HOLE CARDS ***
Bandyaev: raises $0.20 to $0.30
KRZuff joins the table at seat #3 
CHRO8: folds 
8th wonders: raises $0.80 to $1.10
KokoulinV: folds 
Bandyaev: calls $0.80
*** FLOP *** [6c 9h 9c]
8th wonders: bets $1.20
Bandyaev: folds 
Uncalled bet ($1.20) returned to 8th wonders
8th wonders collected $2.20 from pot
*** SUMMARY ***
Total pot $2.30 | Rake $0.10 
Board [6c 9h 9c]
Seat 1: KokoulinV (big blind) folded before Flop
Seat 2: Bandyaev folded on the Flop
Seat 5: CHRO8 (button) folded before Flop (didn't bet)
Seat 6: 8th wonders (small blind) collected ($2.20)



PokerStars Hand #166667726955:  Hold'em No Limit ($0.05/$0.10 USD) - 2017/02/23 16:06:26 ET
Table 'Gelria' 6-max Seat #2 is the button
Seat 1: ab260414 ($10.57 in chips) 
Seat 2: fishhook5 ($10 in chips) 
Seat 3: Orlangoor ($11.83 in chips) 
Seat 4: eniksenik ($10 in chips) 
Seat 5: apenvel ($7.95 in chips) 
Seat 6: Andrei ProFF ($10.27 in chips) 
Orlangoor: posts small blind $0.05
eniksenik: posts big blind $0.10
*** HOLE CARDS ***
apenvel: calls $0.10
Andrei ProFF: folds 
ab260414: folds 
fishhook5: raises $0.23 to $0.33
Orlangoor: folds 
eniksenik: calls $0.23
apenvel: calls $0.23
*** FLOP *** [Qc Ks Td]
eniksenik: bets $0.76
apenvel: calls $0.76
fishhook5: calls $0.76
*** TURN *** [Qc Ks Td] [Th]
eniksenik: checks 
apenvel: checks 
fishhook5: checks 
*** RIVER *** [Qc Ks Td Th] [Jc]
eniksenik: checks 
apenvel: bets $1.59
fishhook5: calls $1.59
eniksenik: folds 
*** SHOW DOWN ***
apenvel: shows [Ad Qh] (a straight, Ten to Ace)
fishhook5: shows [Tc Ah] (a straight, Ten to Ace)
apenvel collected $3.11 from pot
fishhook5 collected $3.10 from pot
*** SUMMARY ***
Total pot $6.50 | Rake $0.29 
Board [Qc Ks Td Th Jc]
Seat 1: ab260414 folded before Flop (didn't bet)
Seat 2: fishhook5 (button) showed [Tc Ah] and won ($3.10) with a straight, Ten to Ace
Seat 3: Orlangoor (small blind) folded before Flop
Seat 4: eniksenik (big blind) folded on the River
Seat 5: apenvel showed [Ad Qh] and won ($3.11) with a straight, Ten to Ace
Seat 6: Andrei ProFF folded before Flop (didn't bet)



PokerStars Hand #166667727021:  Hold'em No Limit ($0.05/$0.10 USD) - 2017/02/23 16:06:26 ET
Table 'Amalia' 6-max Seat #4 is the button
Seat 1: voledy ($12.59 in chips) 
Seat 2: DamDatsAnAce ($11.10 in chips) 
Seat 3: kickereens ($10.08 in chips) 
Seat 4: Rodik002 ($16.13 in chips) 
Seat 5: coolisses111 ($11 in chips) 
Seat 6: oktomber778 ($23.31 in chips) 
coolisses111: posts small blind $0.05
oktomber778: posts big blind $0.10
*** HOLE CARDS ***
voledy: folds 
DamDatsAnAce: folds 
kickereens: folds 
Rodik002: raises $0.10 to $0.20
coolisses111: folds 
oktomber778: calls $0.10
*** FLOP *** [5d 5s 4s]
oktomber778: checks 
Rodik002: bets $0.30
oktomber778: folds 
Uncalled bet ($0.30) returned to Rodik002
Rodik002 collected $0.43 from pot
*** SUMMARY ***
Total pot $0.45 | Rake $0.02 
Board [5d 5s 4s]
Seat 1: voledy folded before Flop (didn't bet)
Seat 2: DamDatsAnAce folded before Flop (didn't bet)
Seat 3: kickereens folded before Flop (didn't bet)
Seat 4: Rodik002 (button) collected ($0.43)
Seat 5: coolisses111 (small blind) folded before Flop
Seat 6: oktomber778 (big blind) folded on the Flop



PokerStars Hand #166667727340:  Hold'em No Limit ($0.05/$0.10 USD) - 2017/02/23 16:06:26 ET
Table 'Krethon' 6-max Seat #4 is the button
Seat 1: boxer821 ($10.92 in chips) 
Seat 2: manashov ($12.21 in chips) 
Seat 3: D3NyA ($10 in chips) 
Seat 4: chimera252 ($14.79 in chips) 
Seat 5: popypaleta ($10.15 in chips) 
popypaleta: posts small blind $0.05
boxer821: posts big blind $0.10
*** HOLE CARDS ***
manashov: folds 
D3NyA: raises $0.15 to $0.25
chimera252: folds 
popypaleta: folds 
boxer821: folds 
Uncalled bet ($0.15) returned to D3NyA
D3NyA collected $0.25 from pot
*** SUMMARY ***
Total pot $0.25 | Rake $0 
Seat 1: boxer821 (big blind) folded before Flop
Seat 2: manashov folded before Flop (didn't bet)
Seat 3: D3NyA collected ($0.25)
Seat 4: chimera252 (button) folded before Flop (didn't bet)
Seat 5: popypaleta (small blind) folded before Flop



PokerStars Hand #166667727346:  Hold'em No Limit ($0.05/$0.10 USD) - 2017/02/23 16:06:26 ET
Table 'Xanthippe II' 6-max Seat #5 is the button
Seat 1: ade22345 ($4.06 in chips) 
Seat 2: Bird et al ($12.91 in chips) 
Seat 3: Dcaro31 ($10.92 in chips) 
Seat 5: yodzik ($14.90 in chips) 
Seat 6: Orlangoor ($10.64 in chips) 
Orlangoor: posts small blind $0.05
ade22345: posts big blind $0.10
*** HOLE CARDS ***
Bird et al: folds 
Dcaro31: folds 
yodzik: folds 
Orlangoor: folds 
Uncalled bet ($0.05) returned to ade22345
ade22345 collected $0.10 from pot
*** SUMMARY ***
Total pot $0.10 | Rake $0 
Seat 1: ade22345 (big blind) collected ($0.10)
Seat 2: Bird et al folded before Flop (didn't bet)
Seat 3: Dcaro31 folded before Flop (didn't bet)
Seat 5: yodzik (button) folded before Flop (didn't bet)
Seat 6: Orlangoor (small blind) folded before Flop



PokerStars Hand #166667727435:  Hold'em No Limit ($0.05/$0.10 USD) - 2017/02/23 16:06:26 ET
Table 'Crommelin II' 6-max Seat #4 is the button
Seat 1: THIMUCHIN ($11.62 in chips) 
Seat 2: Bird et al ($10.15 in chips) 
Seat 3: Strelok1974 ($21.80 in chips) 
Seat 4: Pequeño Clau ($12.97 in chips) 
Seat 5: Action_Gibi ($17.18 in chips) 
Action_Gibi: posts small blind $0.05
THIMUCHIN: posts big blind $0.10
*** HOLE CARDS ***
Bird et al: folds 
Strelok1974: raises $0.20 to $0.30
Pequeño Clau: folds 
Action_Gibi: calls $0.25
THIMUCHIN: folds 
*** FLOP *** [8c 8h 3c]
Action_Gibi: checks 
Strelok1974: bets $0.50
Action_Gibi: calls $0.50
*** TURN *** [8c 8h 3c] [3h]
Action_Gibi: checks 
Strelok1974: bets $1.22
Action_Gibi: calls $1.22
*** RIVER *** [8c 8h 3c 3h] [5c]
Action_Gibi: checks 
Strelok1974: checks 
*** SHOW DOWN ***
Action_Gibi: shows [Ad 9c] (two pair, Eights and Threes)
Strelok1974: mucks hand 
Action_Gibi collected $3.95 from pot
*** SUMMARY ***
Total pot $4.14 | Rake $0.19 
Board [8c 8h 3c 3h 5c]
Seat 1: THIMUCHIN (big blind) folded before Flop
Seat 2: Bird et al folded before Flop (didn't bet)
Seat 3: Strelok1974 mucked
Seat 4: Pequeño Clau (button) folded before Flop (didn't bet)
Seat 5: Action_Gibi (small blind) showed [Ad 9c] and won ($3.95) with two pair, Eights and Threes



PokerStars Hand #166667727588:  Hold'em No Limit ($0.05/$0.10 USD) - 2017/02/23 16:06:27 ET
Table 'Wingolfia II' 6-max Seat #4 is the button
Seat 1: BahiaMinhaP ($10.32 in chips) 
Seat 2: NvR.m1nD ($10.25 in chips) 
Seat 3: truck1234 ($10.36 in chips) 
Seat 4: zlobslob ($17.87 in chips) 
Seat 5: tr41n3r12 ($11.48 in chips) 
Seat 6: EphemeralBen ($11.99 in chips) 
tr41n3r12: posts small blind $0.05
EphemeralBen: posts big blind $0.10
*** HOLE CARDS ***
BahiaMinhaP: folds 
NvR.m1nD: folds 
truck1234: folds 
zlobslob: folds 
tr41n3r12: folds 
Uncalled bet ($0.05) returned to EphemeralBen
EphemeralBen collected $0.10 from pot
*** SUMMARY ***
Total pot $0.10 | Rake $0 
Seat 1: BahiaMinhaP folded before Flop (didn't bet)
Seat 2: NvR.m1nD folded before Flop (didn't bet)
Seat 3: truck1234 folded before Flop (didn't bet)
Seat 4: zlobslob (button) folded before Flop (didn't bet)
Seat 5: tr41n3r12 (small blind) folded before Flop
Seat 6: EphemeralBen (big blind) collected ($0.10)



PokerStars Hand #166667727700:  Hold'em No Limit ($0.05/$0.10 USD) - 2017/02/23 16:06:27 ET
Table 'Sinon II' 6-max Seat #5 is the button
Seat 1: Aescul@pius ($10.27 in chips) 
Seat 2: ÄissesHai ($16.94 in chips) 
Seat 3: crazydevill ($10.88 in chips) 
Seat 4: Bandyaev ($15.33 in chips) 
Seat 5: ab260414 ($10.91 in chips) 
Aescul@pius: posts small blind $0.05
ÄissesHai: posts big blind $0.10
*** HOLE CARDS ***
crazydevill: folds 
Bandyaev: folds 
ab260414: raises $0.20 to $0.30
Aescul@pius: folds 
ÄissesHai: folds 
Uncalled bet ($0.20) returned to ab260414
ab260414 collected $0.25 from pot
*** SUMMARY ***
Total pot $0.25 | Rake $0 
Seat 1: Aescul@pius (small blind) folded before Flop
Seat 2: ÄissesHai (big blind) folded before Flop
Seat 3: crazydevill folded before Flop (didn't bet)
Seat 4: Bandyaev folded before Flop (didn't bet)
Seat 5: ab260414 (button) collected ($0.25)



PokerStars Hand #166667727984:  Hold'em No Limit ($0.05/$0.10 USD) - 2017/02/23 16:06:27 ET
Table 'Manto II' 6-max Seat #5 is the button
Seat 2: voledy ($10 in chips) 
Seat 3: Komap511 ($5.42 in chips) 
Seat 4: dr.goofy ($14.96 in chips) 
Seat 5: ArcticBearDK ($32.54 in chips) 
Seat 6: pancernik21 ($16.25 in chips) 
pancernik21: posts small blind $0.05
MihaGr: is sitting out 
voledy: posts big blind $0.10
*** HOLE CARDS ***
MihaGr leaves the table
Komap511: folds 
dr.goofy: folds 
ArcticBearDK: raises $0.17 to $0.27
pancernik21: folds 
voledy: folds 
Uncalled bet ($0.17) returned to ArcticBearDK
ArcticBearDK collected $0.25 from pot
*** SUMMARY ***
Total pot $0.25 | Rake $0 
Seat 2: voledy (big blind) folded before Flop
Seat 3: Komap511 folded before Flop (didn't bet)
Seat 4: dr.goofy folded before Flop (didn't bet)
Seat 5: ArcticBearDK (button) collected ($0.25)
Seat 6: pancernik21 (small blind) folded before Flop



PokerStars Hand #166667728046:  Hold'em No Limit ($0.05/$0.10 USD) - 2017/02/23 16:06:27 ET
Table 'Heka II' 6-max Seat #3 is the button
Seat 1: Mamm0nism ($15.91 in chips) 
Seat 2: oddshoff ($11.22 in chips) 
Seat 3: MühliJr ($10 in chips) 
Seat 4: theNot0r1ous ($10.68 in chips) 
Seat 5: ArcticBearDK ($12.53 in chips) 
Seat 6: MonteCris92 ($10 in chips) 
theNot0r1ous: posts small blind $0.05
ArcticBearDK: posts big blind $0.10
*** HOLE CARDS ***
MonteCris92: calls $0.10
Mamm0nism: raises $0.30 to $0.40
oddshoff: folds 
MühliJr: folds 
theNot0r1ous: folds 
ArcticBearDK: folds 
MonteCris92: calls $0.30
*** FLOP *** [2d Ah 3s]
MonteCris92: checks 
Mamm0nism: checks 
*** TURN *** [2d Ah 3s] [4c]
MonteCris92: checks 
Mamm0nism: checks 
*** RIVER *** [2d Ah 3s 4c] [4d]
MonteCris92: bets $0.90
Mamm0nism: folds 
Uncalled bet ($0.90) returned to MonteCris92
MonteCris92 collected $0.91 from pot
*** SUMMARY ***
Total pot $0.95 | Rake $0.04 
Board [2d Ah 3s 4c 4d]
Seat 1: Mamm0nism folded on the River
Seat 2: oddshoff folded before Flop (didn't bet)
Seat 3: MühliJr (button) folded before Flop (didn't bet)
Seat 4: theNot0r1ous (small blind) folded before Flop
Seat 5: ArcticBearDK (big blind) folded before Flop
Seat 6: MonteCris92 collected ($0.91)



PokerStars Hand #166667728576:  Hold'em No Limit ($0.05/$0.10 USD) - 2017/02/23 16:06:28 ET
Table 'Azelfafage' 6-max Seat #3 is the button
Seat 1: Sbozzz ($15.61 in chips) 
Seat 2: tr41n3r12 ($10.15 in chips) 
Seat 3: todor1711 ($20.22 in chips) 
Seat 4: fedorka rus ($10 in chips) 
Seat 5: 8th wonders ($12.95 in chips) 
Seat 6: KA3AXCTAHEU, ($10.46 in chips) 
fedorka rus: posts small blind $0.05
8th wonders: posts big blind $0.10
*** HOLE CARDS ***
KA3AXCTAHEU,: raises $0.30 to $0.40
Sbozzz: folds 
tr41n3r12: folds 
todor1711: calls $0.40
fedorka rus: raises $1.20 to $1.60
8th wonders: folds 
KA3AXCTAHEU,: folds 
todor1711: calls $1.20
*** FLOP *** [Qc 3d Qs]
fedorka rus: bets $0.10
todor1711: calls $0.10
*** TURN *** [Qc 3d Qs] [3c]
fedorka rus: bets $2.48
todor1711: folds 
Uncalled bet ($2.48) returned to fedorka rus
fedorka rus collected $3.72 from pot
*** SUMMARY ***
Total pot $3.90 | Rake $0.18 
Board [Qc 3d Qs 3c]
Seat 1: Sbozzz folded before Flop (didn't bet)
Seat 2: tr41n3r12 folded before Flop (didn't bet)
Seat 3: todor1711 (button) folded on the Turn
Seat 4: fedorka rus (small blind) collected ($3.72)
Seat 5: 8th wonders (big blind) folded before Flop
Seat 6: KA3AXCTAHEU, folded before Flop



PokerStars Hand #166667728662:  Hold'em No Limit ($0.05/$0.10 USD) - 2017/02/23 16:06:28 ET
Table 'Nikko II' 6-max Seat #3 is the button
Seat 1: bdixon_5 ($10.37 in chips) 
Seat 2: popypaleta ($10.10 in chips) 
Seat 3: Hyd SK ($12.01 in chips) 
Seat 4: Peter0087 ($9.90 in chips) 
Seat 5: Aescul@pius ($12.33 in chips) 
Seat 6: JahSoldier69 ($10 in chips) 
Peter0087: posts small blind $0.05
Aescul@pius: posts big blind $0.10
*** HOLE CARDS ***
JahSoldier69: raises $0.20 to $0.30
bdixon_5: folds 
popypaleta: folds 
Hyd SK: folds 
Peter0087: folds 
Aescul@pius: folds 
Uncalled bet ($0.20) returned to JahSoldier69
JahSoldier69 collected $0.25 from pot
*** SUMMARY ***
Total pot $0.25 | Rake $0 
Seat 1: bdixon_5 folded before Flop (didn't bet)
Seat 2: popypaleta folded before Flop (didn't bet)
Seat 3: Hyd SK (button) folded before Flop (didn't bet)
Seat 4: Peter0087 (small blind) folded before Flop
Seat 5: Aescul@pius (big blind) folded before Flop
Seat 6: JahSoldier69 collected ($0.25)



PokerStars Hand #166667728666:  Hold'em No Limit ($0.05/$0.10 USD) - 2017/02/23 16:06:28 ET
Table 'Wil' 6-max Seat #2 is the button
Seat 1: jwhelan94 ($22.94 in chips) 
Seat 2: Vrinni ($21.95 in chips) 
Seat 3: Namhkal ($10 in chips) 
Seat 4: x3ultimate ($10.70 in chips) 
Seat 5: Feverhead ($14.06 in chips) 
Seat 6: Comeback3392 ($13.78 in chips) 
Namhkal: posts small blind $0.05
x3ultimate: posts big blind $0.10
*** HOLE CARDS ***
Feverhead: folds 
Comeback3392: folds 
jwhelan94: raises $0.20 to $0.30
Vrinni: folds 
Namhkal: folds 
x3ultimate: folds 
Uncalled bet ($0.20) returned to jwhelan94
jwhelan94 collected $0.25 from pot
*** SUMMARY ***
Total pot $0.25 | Rake $0 
Seat 1: jwhelan94 collected ($0.25)
Seat 2: Vrinni (button) folded before Flop (didn't bet)
Seat 3: Namhkal (small blind) folded before Flop
Seat 4: x3ultimate (big blind) folded before Flop
Seat 5: Feverhead folded before Flop (didn't bet)
Seat 6: Comeback3392 folded before Flop (didn't bet)



PokerStars Hand #166667728896:  Hold'em No Limit ($0.05/$0.10 USD) - 2017/02/23 16:06:28 ET
Table 'Landi II' 6-max Seat #2 is the button
Seat 1: dersiemer ($11.83 in chips) 
Seat 2: Aescul@pius ($10.80 in chips) 
Seat 3: dr.goofy ($21.34 in chips) 
Seat 4: alesi13 ($6.73 in chips) 
Seat 5: Bird et al ($10.10 in chips) 
dr.goofy: posts small blind $0.05
alesi13: posts big blind $0.10
*** HOLE CARDS ***
Bird et al: raises $0.21 to $0.31
dersiemer: folds 
Aescul@pius: folds 
dr.goofy: folds 
alesi13: folds 
Uncalled bet ($0.21) returned to Bird et al
Bird et al collected $0.25 from pot
*** SUMMARY ***
Total pot $0.25 | Rake $0 
Seat 1: dersiemer folded before Flop (didn't bet)
Seat 2: Aescul@pius (button) folded before Flop (didn't bet)
Seat 3: dr.goofy (small blind) folded before Flop
Seat 4: alesi13 (big blind) folded before Flop
Seat 5: Bird et al collected ($0.25)



PokerStars Hand #166667728922:  Hold'em No Limit ($0.05/$0.10 USD) - 2017/02/23 16:06:28 ET
Table 'Armenia' 6-max Seat #6 is the button
Seat 1: tr41n3r12 ($11.72 in chips) 
Seat 2: Yabidooo ($11.72 in chips) 
Seat 3: XwinX25 ($10.15 in chips) 
Seat 4: mbkongstad ($10 in chips) 
Seat 5: boxer821 ($12.28 in chips) 
Seat 6: mega spasser ($6.53 in chips) 
tr41n3r12: posts small blind $0.05
Yabidooo: posts big blind $0.10
mbkongstad: posts big blind $0.10
*** HOLE CARDS ***
XwinX25: raises $0.30 to $0.40
mbkongstad: folds 
boxer821: folds 
mega spasser: folds 
tr41n3r12: folds 
Yabidooo: folds 
Uncalled bet ($0.30) returned to XwinX25
XwinX25 collected $0.35 from pot
*** SUMMARY ***
Total pot $0.35 | Rake $0 
Seat 1: tr41n3r12 (small blind) folded before Flop
Seat 2: Yabidooo (big blind) folded before Flop
Seat 3: XwinX25 collected ($0.35)
Seat 4: mbkongstad folded before Flop
Seat 5: boxer821 folded before Flop (didn't bet)
Seat 6: mega spasser (button) folded before Flop (didn't bet)



PokerStars Hand #166667729000:  Hold'em No Limit ($0.05/$0.10 USD) - 2017/02/23 16:06:28 ET
Table 'Cassini' 6-max Seat #2 is the button
Seat 1: Pokeaster ($10.52 in chips) 
Seat 2: mhonielsen ($12.41 in chips) 
Seat 4: fortieth ($14.02 in chips) 
fortieth: posts small blind $0.05
johkom: is sitting out 
JahSoldier69: is sitting out 
Pokeaster: posts big blind $0.10
*** HOLE CARDS ***
JahSoldier69 leaves the table
MihaGr joins the table at seat #6 
mhonielsen: folds 
johkom leaves the table
fortieth: folds 
Uncalled bet ($0.05) returned to Pokeaster
x3ultimate joins the table at seat #5 
Pokeaster collected $0.10 from pot
*** SUMMARY ***
Total pot $0.10 | Rake $0 
Seat 1: Pokeaster (big blind) collected ($0.10)
Seat 2: mhonielsen (button) folded before Flop (didn't bet)
Seat 4: fortieth (small blind) folded before Flop



PokerStars Hand #166667729182:  Hold'em No Limit ($0.05/$0.10 USD) - 2017/02/23 16:06:28 ET
Table 'Aconcagua' 6-max Seat #6 is the button
Seat 1: MLPlayer16 ($10 in chips) 
Seat 2: Kupi007 ($10 in chips) 
Seat 3: burtila1989 ($6.95 in chips) 
Seat 4: pivanki11 ($10.05 in chips) 
Seat 5: frazaunch ($6.28 in chips) 
Seat 6: coolisses111 ($11.92 in chips) 
MLPlayer16: posts small blind $0.05
Kupi007: posts big blind $0.10
MLPlayer16: posts the ante $0.02
Kupi007: posts the ante $0.02
burtila1989: posts the ante $0.02
pivanki11: posts the ante $0.02
frazaunch: posts the ante $0.02
coolisses111: posts the ante $0.02
*** HOLE CARDS ***
burtila1989: folds 
pivanki11: folds 
frazaunch: calls $0.10
coolisses111: folds 
MLPlayer16: raises $0.40 to $0.50
Kupi007: folds 
frazaunch: calls $0.40
*** FLOP *** [6d 4s Kh]
MLPlayer16: bets $0.64
frazaunch: folds 
Uncalled bet ($0.64) returned to MLPlayer16
MLPlayer16 collected $1.17 from pot
*** SUMMARY ***
Total pot $1.22 | Rake $0.05 
Board [6d 4s Kh]
Seat 1: MLPlayer16 (small blind) collected ($1.17)
Seat 2: Kupi007 (big blind) folded before Flop
Seat 3: burtila1989 folded before Flop (didn't bet)
Seat 4: pivanki11 folded before Flop (didn't bet)
Seat 5: frazaunch folded on the Flop
Seat 6: coolisses111 (button) folded before Flop (didn't bet)



PokerStars Hand #166667729340:  Hold'em No Limit ($0.05/$0.10 USD) - 2017/02/23 16:06:29 ET
Table 'Caupolican II' 6-max Seat #5 is the button
Seat 1: Strelok1974 ($10 in chips) 
Seat 2: MBen10 ($20.95 in chips) 
Seat 3: fedorka rus ($12.13 in chips) 
Seat 4: GESPERIA ($21.42 in chips) 
Seat 5: ArcticBearDK ($15.45 in chips) 
Seat 6: pancernik21 ($13.20 in chips) 
pancernik21: posts small blind $0.05
Strelok1974: posts big blind $0.10
*** HOLE CARDS ***
MBen10: folds 
fedorka rus: folds 
GESPERIA: folds 
ArcticBearDK: folds 
pancernik21: folds 
Uncalled bet ($0.05) returned to Strelok1974
Strelok1974 collected $0.10 from pot
*** SUMMARY ***
Total pot $0.10 | Rake $0 
Seat 1: Strelok1974 (big blind) collected ($0.10)
Seat 2: MBen10 folded before Flop (didn't bet)
Seat 3: fedorka rus folded before Flop (didn't bet)
Seat 4: GESPERIA folded before Flop (didn't bet)
Seat 5: ArcticBearDK (button) folded before Flop (didn't bet)
Seat 6: pancernik21 (small blind) folded before Flop



PokerStars Hand #166667729527:  Hold'em No Limit ($0.05/$0.10 USD) - 2017/02/23 16:06:29 ET
Table 'Cuyo' 6-max Seat #2 is the button
Seat 1: Bandyaev ($10 in chips) 
Seat 2: Therodorus ($10 in chips) 
Seat 5: Kpeti01 ($9.90 in chips) 
Seat 6: iluzja12 ($10.15 in chips) 
bambolejro will be allowed to play after the button
Kpeti01: posts small blind $0.05
iluzja12: posts big blind $0.10
*** HOLE CARDS ***
Bandyaev: raises $0.20 to $0.30
Therodorus: folds 
Kpeti01: folds 
iluzja12: calls $0.20
*** FLOP *** [8c 9s 7d]
JahSoldier69 leaves the table
iluzja12: checks 
Kpeti01 leaves the table
Bandyaev: checks 
*** TURN *** [8c 9s 7d] [6s]
iluzja12: checks 
Bandyaev: bets $0.41
iluzja12: calls $0.41
*** RIVER *** [8c 9s 7d 6s] [9d]
iluzja12: checks 
Bandyaev: bets $0.77
iluzja12: calls $0.77
*** SHOW DOWN ***
Bandyaev: shows [Tc Ad] (a straight, Six to Ten)
iluzja12: mucks hand 
Bandyaev collected $2.87 from pot
*** SUMMARY ***
Total pot $3.01 | Rake $0.14 
Board [8c 9s 7d 6s 9d]
Seat 1: Bandyaev showed [Tc Ad] and won ($2.87) with a straight, Six to Ten
Seat 2: Therodorus (button) folded before Flop (didn't bet)
Seat 5: Kpeti01 (small blind) folded before Flop
Seat 6: iluzja12 (big blind) mucked



PokerStars Hand #166667729807:  Hold'em No Limit ($0.05/$0.10 USD) - 2017/02/23 16:06:29 ET
Table 'Emma II' 6-max Seat #1 is the button
Seat 1: LarryTheStar ($10.10 in chips) 
Seat 2: T9MS ($11.69 in chips) 
Seat 3: oddshoff ($9.52 in chips) 
Seat 4: Jucatorul823 ($6.24 in chips) 
Seat 5: Scanner17 ($11.06 in chips) 
Seat 6: CHRO8 ($14.67 in chips) 
T9MS: posts small blind $0.05
oddshoff: posts big blind $0.10
*** HOLE CARDS ***
Jucatorul823: folds 
Scanner17: folds 
CHRO8: raises $0.20 to $0.30
LarryTheStar: folds 
T9MS: folds 
oddshoff: folds 
Uncalled bet ($0.20) returned to CHRO8
CHRO8 collected $0.25 from pot
*** SUMMARY ***
Total pot $0.25 | Rake $0 
Seat 1: LarryTheStar (button) folded before Flop (didn't bet)
Seat 2: T9MS (small blind) folded before Flop
Seat 3: oddshoff (big blind) folded before Flop
Seat 4: Jucatorul823 folded before Flop (didn't bet)
Seat 5: Scanner17 folded before Flop (didn't bet)
Seat 6: CHRO8 collected ($0.25)



PokerStars Hand #166667729809:  Hold'em No Limit ($0.05/$0.10 USD) - 2017/02/23 16:06:29 ET
Table 'Ruvuma' 6-max Seat #5 is the button
Seat 1: FRAID358 ($14.05 in chips) 
Seat 2: Fab_1512 ($12.90 in chips) 
Seat 3: Spud014 ($10 in chips) 
Seat 4: DamDatsAnAce ($10 in chips) 
Seat 5: sexy_seagull ($10.08 in chips) 
FRAID358: posts small blind $0.05
Fab_1512: posts big blind $0.10
*** HOLE CARDS ***
Spud014: folds 
DamDatsAnAce: folds 
sexy_seagull: raises $0.15 to $0.25
FRAID358: calls $0.20
Fab_1512: folds 
*** FLOP *** [Qs 5h Jd]
FRAID358: checks 
sexy_seagull: bets $0.27
Fab_1512 leaves the table
FRAID358: raises $0.73 to $1
RoJ1 joins the table at seat #2 
sexy_seagull: folds 
Uncalled bet ($0.73) returned to FRAID358
FRAID358 collected $1.09 from pot
*** SUMMARY ***
Total pot $1.14 | Rake $0.05 
Board [Qs 5h Jd]
Seat 1: FRAID358 (small blind) collected ($1.09)
Seat 2: Fab_1512 (big blind) folded before Flop
Seat 3: Spud014 folded before Flop (didn't bet)
Seat 4: DamDatsAnAce folded before Flop (didn't bet)
Seat 5: sexy_seagull (button) folded on the Flop



PokerStars Hand #166667729813:  Hold'em No Limit ($0.05/$0.10 USD) - 2017/02/23 16:06:29 ET
Table 'Walpurga' 6-max Seat #1 is the button
Seat 1: chimera252 ($12.07 in chips) 
Seat 2: paxit71 ($5.95 in chips) 
Seat 3: marianoboni ($10.15 in chips) 
Seat 4: oddshoff ($13.04 in chips) 
Seat 6: AIONCMA1988 ($5.58 in chips) 
paxit71: posts small blind $0.05
marianoboni: posts big blind $0.10
Fremara: sits out 
*** HOLE CARDS ***
oddshoff: folds 
AIONCMA1988: folds 
chimera252: folds 
paxit71: calls $0.05
marianoboni: checks 
*** FLOP *** [Tc Ah Js]
paxit71: bets $0.20
marianoboni: calls $0.20
*** TURN *** [Tc Ah Js] [Jh]
paxit71: checks 
marianoboni: checks 
*** RIVER *** [Tc Ah Js Jh] [3c]
paxit71: bets $0.20
marianoboni: calls $0.20
*** SHOW DOWN ***
paxit71: shows [Th 4s] (two pair, Jacks and Tens)
marianoboni: shows [Ac 6h] (two pair, Aces and Jacks)
marianoboni collected $0.96 from pot
*** SUMMARY ***
Total pot $1 | Rake $0.04 
Board [Tc Ah Js Jh 3c]
Seat 1: chimera252 (button) folded before Flop (didn't bet)
Seat 2: paxit71 (small blind) showed [Th 4s] and lost with two pair, Jacks and Tens
Seat 3: marianoboni (big blind) showed [Ac 6h] and won ($0.96) with two pair, Aces and Jacks
Seat 4: oddshoff folded before Flop (didn't bet)
Seat 6: AIONCMA1988 folded before Flop (didn't bet)



PokerStars Hand #166667730301:  Hold'em No Limit ($0.05/$0.10 USD) - 2017/02/23 16:06:30 ET
Table 'Thoas' 6-max Seat #5 is the button
Seat 1: Pekaml ($11.43 in chips) 
Seat 2: themacer24 ($8.52 in chips) 
Seat 3: iamkakaroto ($10 in chips) 
Seat 4: Morris_Chair ($18.52 in chips) 
Seat 5: Kow6oy ($10.17 in chips) 
Seat 6: takis nik ($10.05 in chips) 
takis nik: posts small blind $0.05
Pekaml: posts big blind $0.10
*** HOLE CARDS ***
themacer24: folds 
iamkakaroto: folds 
Morris_Chair: folds 
Kow6oy: folds 
takis nik: raises $0.10 to $0.20
Pekaml: calls $0.10
*** FLOP *** [9s 3h 5s]
takis nik: checks 
Pekaml: bets $0.19
takis nik: folds 
Uncalled bet ($0.19) returned to Pekaml
Pekaml collected $0.38 from pot
*** SUMMARY ***
Total pot $0.40 | Rake $0.02 
Board [9s 3h 5s]
Seat 1: Pekaml (big blind) collected ($0.38)
Seat 2: themacer24 folded before Flop (didn't bet)
Seat 3: iamkakaroto folded before Flop (didn't bet)
Seat 4: Morris_Chair folded before Flop (didn't bet)
Seat 5: Kow6oy (button) folded before Flop (didn't bet)
Seat 6: takis nik (small blind) folded on the Flop



PokerStars Hand #166667730372:  Hold'em No Limit ($0.05/$0.10 USD) - 2017/02/23 16:06:30 ET
Table 'Alnasl' 6-max Seat #1 is the button
Seat 1: KA3AXCTAHEU, ($11.20 in chips) 
Seat 2: saddur ($9.89 in chips) 
Seat 3: david_sara83 ($22.69 in chips) 
Seat 4: oddshoff ($9.83 in chips) 
Seat 6: Zooplack ($13.43 in chips) 
saddur: posts small blind $0.05
david_sara83: posts big blind $0.10
6ePeMeHHa9: sits out 
*** HOLE CARDS ***
oddshoff: raises $0.20 to $0.30
Zooplack: folds 
KA3AXCTAHEU,: folds 
saddur: folds 
david_sara83: folds 
Uncalled bet ($0.20) returned to oddshoff
oddshoff collected $0.25 from pot
*** SUMMARY ***
Total pot $0.25 | Rake $0 
Seat 1: KA3AXCTAHEU, (button) folded before Flop (didn't bet)
Seat 2: saddur (small blind) folded before Flop
Seat 3: david_sara83 (big blind) folded before Flop
Seat 4: oddshoff collected ($0.25)
Seat 6: Zooplack folded before Flop (didn't bet)



PokerStars Hand #166667730533:  Hold'em No Limit ($0.05/$0.10 USD) - 2017/02/23 16:06:30 ET
Table 'Garlena III' 6-max Seat #4 is the button
Seat 1: dittoro ($10.15 in chips) 
Seat 4: mbkongstad ($9.85 in chips) 
Seat 5: steepfell ($10.05 in chips) 
Seat 6: iluzja12 ($10 in chips) 
steepfell: posts small blind $0.05
iluzja12: posts big blind $0.10
*** HOLE CARDS ***
dittoro: folds 
mbkongstad: raises $0.10 to $0.20
steepfell: folds 
iluzja12: folds 
Uncalled bet ($0.10) returned to mbkongstad
mbkongstad collected $0.25 from pot
*** SUMMARY ***
Total pot $0.25 | Rake $0 
Seat 1: dittoro folded before Flop (didn't bet)
Seat 4: mbkongstad (button) collected ($0.25)
Seat 5: steepfell (small blind) folded before Flop
Seat 6: iluzja12 (big blind) folded before Flop



PokerStars Hand #166667730596:  Hold'em No Limit ($0.05/$0.10 USD) - 2017/02/23 16:06:30 ET
Table 'Aisakos II' 6-max Seat #1 is the button
Seat 1: Crafty23@PS ($10.50 in chips) 
Seat 2: svaika24 ($16.88 in chips) 
Seat 3: iamkakaroto ($10.54 in chips) 
Seat 4: T9MS ($10 in chips) 
Seat 5: KokoulinV ($12.05 in chips) 
Seat 6: LarryTheStar ($10.23 in chips) 
svaika24: posts small blind $0.05
iamkakaroto: posts big blind $0.10
*** HOLE CARDS ***
T9MS: raises $0.20 to $0.30
KokoulinV: folds 
LarryTheStar: folds 
Crafty23@PS: folds 
svaika24: folds 
iamkakaroto: folds 
Uncalled bet ($0.20) returned to T9MS
T9MS collected $0.25 from pot
*** SUMMARY ***
Total pot $0.25 | Rake $0 
Seat 1: Crafty23@PS (button) folded before Flop (didn't bet)
Seat 2: svaika24 (small blind) folded before Flop
Seat 3: iamkakaroto (big blind) folded before Flop
Seat 4: T9MS collected ($0.25)
Seat 5: KokoulinV folded before Flop (didn't bet)
Seat 6: LarryTheStar folded before Flop (didn't bet)



PokerStars Hand #166667730781:  Hold'em No Limit ($0.05/$0.10 USD) - 2017/02/23 16:06:30 ET
Table 'Siebohme' 6-max Seat #3 is the button
Seat 1: kusa4ki ($11.53 in chips) 
Seat 2: el toro 1507 ($11.53 in chips) 
Seat 3: ex3Lero86 ($10.41 in chips) 
Seat 4: Innerwuss ($10.20 in chips) 
Seat 5: Kazacha ($10 in chips) 
Seat 6: townerz1991 ($10.53 in chips) 
Innerwuss: posts small blind $0.05
Kazacha: posts big blind $0.10
*** HOLE CARDS ***
townerz1991: folds 
kusa4ki: folds 
el toro 1507: folds 
ex3Lero86: folds 
Innerwuss: raises $0.20 to $0.30
Kazacha: folds 
Uncalled bet ($0.20) returned to Innerwuss
Innerwuss collected $0.20 from pot
*** SUMMARY ***
Total pot $0.20 | Rake $0 
Seat 1: kusa4ki folded before Flop (didn't bet)
Seat 2: el toro 1507 folded before Flop (didn't bet)
Seat 3: ex3Lero86 (button) folded before Flop (didn't bet)
Seat 4: Innerwuss (small blind) collected ($0.20)
Seat 5: Kazacha (big blind) folded before Flop
Seat 6: townerz1991 folded before Flop (didn't bet)



PokerStars Hand #166667730782:  Hold'em No Limit ($0.05/$0.10 USD) - 2017/02/23 16:06:30 ET
Table 'Arkab' 6-max Seat #3 is the button
Seat 1: iamkakaroto ($10 in chips) 
Seat 2: aktion4ik ($12.24 in chips) 
Seat 3: sexy_seagull ($10 in chips) 
Seat 4: donkucallme ($25.55 in chips) 
Seat 5: OrionYusupov ($9.44 in chips) 
Seat 6: MihaGr ($10.78 in chips) 
donkucallme: posts small blind $0.05
OrionYusupov: posts big blind $0.10
*** HOLE CARDS ***
MihaGr: folds 
iamkakaroto: folds 
aktion4ik: folds 
sexy_seagull: folds 
donkucallme: calls $0.05
OrionYusupov: checks 
*** FLOP *** [Kh 4d 8h]
donkucallme: bets $0.20
OrionYusupov: calls $0.20
*** TURN *** [Kh 4d 8h] [Th]
donkucallme: bets $0.40
OrionYusupov: raises $1.60 to $2
donkucallme: folds 
Uncalled bet ($1.60) returned to OrionYusupov
OrionYusupov collected $1.34 from pot
*** SUMMARY ***
Total pot $1.40 | Rake $0.06 
Board [Kh 4d 8h Th]
Seat 1: iamkakaroto folded before Flop (didn't bet)
Seat 2: aktion4ik folded before Flop (didn't bet)
Seat 3: sexy_seagull (button) folded before Flop (didn't bet)
Seat 4: donkucallme (small blind) folded on the Turn
Seat 5: OrionYusupov (big blind) collected ($1.34)
Seat 6: MihaGr folded before Flop (didn't bet)



PokerStars Hand #166667730835:  Hold'em No Limit ($0.05/$0.10 USD) - 2017/02/23 16:06:30 ET
Table 'Ushakaron II' 6-max Seat #5 is the button
Seat 1: Kow6oy ($10.15 in chips) 
Seat 2: Iarlei ($12.79 in chips) 
Seat 3: Rodik002 ($10.12 in chips) 
Seat 4: avintage176 ($27.71 in chips) 
Seat 5: 1limewax1 ($16.23 in chips) 
Seat 6: eniksenik ($10 in chips) 
eniksenik: posts small blind $0.05
Kow6oy: posts big blind $0.10
*** HOLE CARDS ***
Iarlei: folds 
Rodik002: folds 
avintage176: raises $0.20 to $0.30
1limewax1: folds 
eniksenik: raises $0.70 to $1
Kow6oy: folds 
avintage176: calls $0.70
*** FLOP *** [Js 6h Ah]
eniksenik: bets $1.11
avintage176: raises $1.39 to $2.50
eniksenik: folds 
Uncalled bet ($1.39) returned to avintage176
avintage176 collected $4.13 from pot
*** SUMMARY ***
Total pot $4.32 | Rake $0.19 
Board [Js 6h Ah]
Seat 1: Kow6oy (big blind) folded before Flop
Seat 2: Iarlei folded before Flop (didn't bet)
Seat 3: Rodik002 folded before Flop (didn't bet)
Seat 4: avintage176 collected ($4.13)
Seat 5: 1limewax1 (button) folded before Flop (didn't bet)
Seat 6: eniksenik (small blind) folded on the Flop



PokerStars Hand #166667730889:  Hold'em No Limit ($0.05/$0.10 USD) - 2017/02/23 16:06:30 ET
Table 'Virginia II' 6-max Seat #6 is the button
Seat 1: Iarlei ($11.46 in chips) 
Seat 2: Yspenyanin ($10 in chips) 
Seat 3: garigura ($15.26 in chips) 
Seat 4: onkelottoHH ($10.73 in chips) 
Seat 5: dr.goofy ($20.98 in chips) 
Seat 6: NvR.m1nD ($10 in chips) 
Iarlei: posts small blind $0.05
Yspenyanin: posts big blind $0.10
*** HOLE CARDS ***
garigura: folds 
onkelottoHH: folds 
dr.goofy: folds 
NvR.m1nD: folds 
Iarlei: folds 
Uncalled bet ($0.05) returned to Yspenyanin
Yspenyanin collected $0.10 from pot
*** SUMMARY ***
Total pot $0.10 | Rake $0 
Seat 1: Iarlei (small blind) folded before Flop
Seat 2: Yspenyanin (big blind) collected ($0.10)
Seat 3: garigura folded before Flop (didn't bet)
Seat 4: onkelottoHH folded before Flop (didn't bet)
Seat 5: dr.goofy folded before Flop (didn't bet)
Seat 6: NvR.m1nD (button) folded before Flop (didn't bet)



PokerStars Hand #166667730960:  Hold'em No Limit ($0.05/$0.10 USD) - 2017/02/23 16:06:30 ET
Table 'Markab II' 6-max Seat #6 is the button
Seat 1: david_sara83 ($10.27 in chips) 
Seat 2: truck1234 ($11.05 in chips) 
Seat 3: sexy_seagull ($10.15 in chips) 
Seat 4: Crafty23@PS ($11.54 in chips) 
Seat 5: Rodik002 ($19.77 in chips) 
Seat 6: Comeback3392 ($10 in chips) 
david_sara83: posts small blind $0.05
truck1234: posts big blind $0.10
*** HOLE CARDS ***
sexy_seagull: folds 
Crafty23@PS: folds 
Rodik002: raises $0.15 to $0.25
Comeback3392: folds 
david_sara83: folds 
truck1234: folds 
Uncalled bet ($0.15) returned to Rodik002
Rodik002 collected $0.25 from pot
*** SUMMARY ***
Total pot $0.25 | Rake $0 
Seat 1: david_sara83 (small blind) folded before Flop
Seat 2: truck1234 (big blind) folded before Flop
Seat 3: sexy_seagull folded before Flop (didn't bet)
Seat 4: Crafty23@PS folded before Flop (didn't bet)
Seat 5: Rodik002 collected ($0.25)
Seat 6: Comeback3392 (button) folded before Flop (didn't bet)



PokerStars Hand #166667731208:  Hold'em No Limit ($0.05/$0.10 USD) - 2017/02/23 16:06:31 ET
Table 'Pandora III' 6-max Seat #5 is the button
Seat 1: Pokeaster ($10.84 in chips) 
Seat 2: garigura ($11.54 in chips) 
Seat 4: mhonielsen ($10.15 in chips) 
Seat 5: MühliJr ($10.42 in chips) 
Seat 6: yodzik ($5 in chips) 
yodzik: posts small blind $0.05
Pokeaster: posts big blind $0.10
Chodemuncher: sits out 
*** HOLE CARDS ***
garigura: folds 
mhonielsen: raises $0.15 to $0.25
MühliJr: folds 
yodzik: folds 
Pokeaster: raises $0.65 to $0.90
mhonielsen: folds 
Uncalled bet ($0.65) returned to Pokeaster
Pokeaster collected $0.55 from pot
*** SUMMARY ***
Total pot $0.55 | Rake $0 
Seat 1: Pokeaster (big blind) collected ($0.55)
Seat 2: garigura folded before Flop (didn't bet)
Seat 4: mhonielsen folded before Flop
Seat 5: MühliJr (button) folded before Flop (didn't bet)
Seat 6: yodzik (small blind) folded before Flop



PokerStars Hand #166667731342:  Hold'em No Limit ($0.05/$0.10 USD) - 2017/02/23 16:06:31 ET
Table 'Rostia' 6-max Seat #2 is the button
Seat 1: paxit71 ($7.88 in chips) 
Seat 2: david_sara83 ($19.01 in chips) 
Seat 3: iThreeBarrel ($10 in chips) 
Seat 4: Hyd SK ($11.68 in chips) 
Seat 5: silsilviu ($7.37 in chips) 
Seat 6: Giyorod ($10.70 in chips) 
iThreeBarrel: posts small blind $0.05
Hyd SK: posts big blind $0.10
*** HOLE CARDS ***
silsilviu: folds 
Giyorod: folds 
paxit71: folds 
david_sara83: folds 
iThreeBarrel: folds 
Uncalled bet ($0.05) returned to Hyd SK
Hyd SK collected $0.10 from pot
*** SUMMARY ***
Total pot $0.10 | Rake $0 
Seat 1: paxit71 folded before Flop (didn't bet)
Seat 2: david_sara83 (button) folded before Flop (didn't bet)
Seat 3: iThreeBarrel (small blind) folded before Flop
Seat 4: Hyd SK (big blind) collected ($0.10)
Seat 5: silsilviu folded before Flop (didn't bet)
Seat 6: Giyorod folded before Flop (didn't bet)



PokerStars Hand #166667731698:  Hold'em No Limit ($0.05/$0.10 USD) - 2017/02/23 16:06:31 ET
Table 'Joella' 6-max Seat #3 is the button
Seat 1: Dcaro31 ($12.80 in chips) 
Seat 2: Kaelyns_Bark ($7.15 in chips) 
Seat 3: Joker51_wtf! ($11.20 in chips) 
Seat 5: Anestakis777 ($6.36 in chips) 
Seat 6: dr.goofy ($10.85 in chips) 
KRZuff will be allowed to play after the button
Anestakis777: posts small blind $0.05
dr.goofy: posts big blind $0.10
*** HOLE CARDS ***
Dcaro31: folds 
Kaelyns_Bark: raises $0.20 to $0.30
Joker51_wtf!: folds 
Anestakis777: calls $0.25
dr.goofy: folds 
*** FLOP *** [4h 6s 6d]
Anestakis777: bets $0.30
Kaelyns_Bark: raises $1.70 to $2
Anestakis777: calls $1.70
*** TURN *** [4h 6s 6d] [5h]
Anestakis777: checks 
Kaelyns_Bark: bets $2.80
Anestakis777: folds 
Uncalled bet ($2.80) returned to Kaelyns_Bark
Kaelyns_Bark collected $4.49 from pot
*** SUMMARY ***
Total pot $4.70 | Rake $0.21 
Board [4h 6s 6d 5h]
Seat 1: Dcaro31 folded before Flop (didn't bet)
Seat 2: Kaelyns_Bark collected ($4.49)
Seat 3: Joker51_wtf! (button) folded before Flop (didn't bet)
Seat 5: Anestakis777 (small blind) folded on the Turn
Seat 6: dr.goofy (big blind) folded before Flop



PokerStars Hand #166667731906:  Hold'em No Limit ($0.05/$0.10 USD) - 2017/02/23 16:06:31 ET
Table 'Bengt' 6-max Seat #4 is the button
Seat 1: Lucky HoBBiT ($12.50 in chips) 
Seat 2: ChefRocco ($21.01 in chips) 
Seat 3: nantes15 ($13.23 in chips) 
Seat 4: 8th wonders ($10.09 in chips) 
Seat 5: RoJ1 ($10.21 in chips) 
Seat 6: Goroshkos88 ($10.28 in chips) 
RoJ1: posts small blind $0.05
Goroshkos88: posts big blind $0.10
*** HOLE CARDS ***
Lucky HoBBiT: folds 
ChefRocco: calls $0.10
nantes15: folds 
8th wonders: folds 
RoJ1: folds 
Goroshkos88: raises $0.40 to $0.50
ChefRocco: calls $0.40
*** FLOP *** [Qs Jc 6s]
Goroshkos88: checks 
ChefRocco: bets $0.30
Goroshkos88: calls $0.30
*** TURN *** [Qs Jc 6s] [Ad]
Goroshkos88: bets $1.05
ChefRocco: folds 
Uncalled bet ($1.05) returned to Goroshkos88
Goroshkos88 collected $1.58 from pot
*** SUMMARY ***
Total pot $1.65 | Rake $0.07 
Board [Qs Jc 6s Ad]
Seat 1: Lucky HoBBiT folded before Flop (didn't bet)
Seat 2: ChefRocco folded on the Turn
Seat 3: nantes15 folded before Flop (didn't bet)
Seat 4: 8th wonders (button) folded before Flop (didn't bet)
Seat 5: RoJ1 (small blind) folded before Flop
Seat 6: Goroshkos88 (big blind) collected ($1.58)



PokerStars Hand #166667732587:  Hold'em No Limit ($0.05/$0.10 USD) - 2017/02/23 16:06:32 ET
Table 'Thia' 6-max Seat #3 is the button
Seat 1: Eddys Edge ($10.87 in chips) 
Seat 2: sugrob86 ($19.05 in chips) 
Seat 3: northug18 ($8.84 in chips) 
Seat 4: Bandyaev ($10.25 in chips) 
Seat 5: ab260414 ($10.99 in chips) 
Seat 6: ex3Lero86 ($15.45 in chips) 
Bandyaev: posts small blind $0.05
ab260414: posts big blind $0.10
*** HOLE CARDS ***
ex3Lero86: folds 
Eddys Edge: raises $0.20 to $0.30
sugrob86: folds 
northug18: folds 
Bandyaev: folds 
ab260414: folds 
Uncalled bet ($0.20) returned to Eddys Edge
Eddys Edge collected $0.25 from pot
*** SUMMARY ***
Total pot $0.25 | Rake $0 
Seat 1: Eddys Edge collected ($0.25)
Seat 2: sugrob86 folded before Flop (didn't bet)
Seat 3: northug18 (button) folded before Flop (didn't bet)
Seat 4: Bandyaev (small blind) folded before Flop
Seat 5: ab260414 (big blind) folded before Flop
Seat 6: ex3Lero86 folded before Flop (didn't bet)



PokerStars Hand #166667732969:  Hold'em No Limit ($0.05/$0.10 USD) - 2017/02/23 16:06:33 ET
Table 'Repsolda' 6-max Seat #2 is the button
Seat 2: MBen10 ($23.88 in chips) 
Seat 3: manashov ($14.87 in chips) 
Seat 4: MihaGr ($10 in chips) 
Seat 5: danky24 ($5.51 in chips) 
Seat 6: RkaczoR ($11.26 in chips) 
manashov: posts small blind $0.05
MihaGr: posts big blind $0.10
*** HOLE CARDS ***
danky24: calls $0.10
RkaczoR: folds 
MBen10: raises $0.30 to $0.40
manashov: folds 
MihaGr: folds 
danky24: calls $0.30
*** FLOP *** [7h As 4d]
danky24: checks 
MBen10: bets $0.44
danky24: folds 
Uncalled bet ($0.44) returned to MBen10
MBen10 collected $0.91 from pot
*** SUMMARY ***
Total pot $0.95 | Rake $0.04 
Board [7h As 4d]
Seat 2: MBen10 (button) collected ($0.91)
Seat 3: manashov (small blind) folded before Flop
Seat 4: MihaGr (big blind) folded before Flop
Seat 5: danky24 folded on the Flop
Seat 6: RkaczoR folded before Flop (didn't bet)



PokerStars Hand #166667733036:  Hold'em No Limit ($0.05/$0.10 USD) - 2017/02/23 16:06:33 ET
Table 'Eurydome II' 6-max Seat #3 is the button
Seat 1: rusu_rapid ($11.83 in chips) 
Seat 3: gaHy_HaXeP ($10 in chips) 
Seat 4: Smitty03300 ($10.37 in chips) 
Seat 5: kush-killa87 ($10.49 in chips) 
Seat 6: Jucatorul823 ($6.70 in chips) 
Smitty03300: posts small blind $0.05
kush-killa87: posts big blind $0.10
*** HOLE CARDS ***
Jucatorul823: raises $0.20 to $0.30
rusu_rapid: folds 
gaHy_HaXeP: calls $0.30
Smitty03300: folds 
kush-killa87: calls $0.20
*** FLOP *** [Ks Qc 2h]
kush-killa87: checks 
Jucatorul823: bets $0.60
gaHy_HaXeP: calls $0.60
kush-killa87: folds 
*** TURN *** [Ks Qc 2h] [Jd]
Jucatorul823: bets $1.03
gaHy_HaXeP: calls $1.03
*** RIVER *** [Ks Qc 2h Jd] [2d]
Jucatorul823: checks 
gaHy_HaXeP: checks 
*** SHOW DOWN ***
Jucatorul823: shows [Jh Ah] (two pair, Jacks and Deuces)
gaHy_HaXeP: shows [Tc Kc] (two pair, Kings and Deuces)
gaHy_HaXeP collected $4.02 from pot
*** SUMMARY ***
Total pot $4.21 | Rake $0.19 
Board [Ks Qc 2h Jd 2d]
Seat 1: rusu_rapid folded before Flop (didn't bet)
Seat 3: gaHy_HaXeP (button) showed [Tc Kc] and won ($4.02) with two pair, Kings and Deuces
Seat 4: Smitty03300 (small blind) folded before Flop
Seat 5: kush-killa87 (big blind) folded on the Flop
Seat 6: Jucatorul823 showed [Jh Ah] and lost with two pair, Jacks and Deuces



PokerStars Hand #166667733094:  Hold'em No Limit ($0.05/$0.10 USD) - 2017/02/23 16:06:33 ET
Table 'Epimetheus' 6-max Seat #6 is the button
Seat 1: 6ePeMeHHa9 ($10.34 in chips) 
Seat 2: patrick19111 ($15.51 in chips) 
Seat 3: dineldidi ($9.84 in chips) 
Seat 5: afca128 ($23.68 in chips) 
Seat 6: voledy ($10.60 in chips) 
6ePeMeHHa9: posts small blind $0.05
patrick19111: posts big blind $0.10
Namhkal: sits out 
*** HOLE CARDS ***
dineldidi: folds 
afca128: raises $0.20 to $0.30
voledy: folds 
6ePeMeHHa9: folds 
patrick19111: folds 
Uncalled bet ($0.20) returned to afca128
afca128 collected $0.25 from pot
*** SUMMARY ***
Total pot $0.25 | Rake $0 
Seat 1: 6ePeMeHHa9 (small blind) folded before Flop
Seat 2: patrick19111 (big blind) folded before Flop
Seat 3: dineldidi folded before Flop (didn't bet)
Seat 5: afca128 collected ($0.25)
Seat 6: voledy (button) folded before Flop (didn't bet)



PokerStars Hand #166667733792:  Hold'em No Limit ($0.05/$0.10 USD) - 2017/02/23 16:06:33 ET
Table 'Kobresia II' 6-max Seat #1 is the button
Seat 1: RoJ1 ($13.94 in chips) 
Seat 2: Dcaro31 ($13.19 in chips) 
Seat 3: FRAID358 ($10.84 in chips) 
Seat 4: armstv ($10.87 in chips) 
Seat 5: Goroshkos88 ($12.32 in chips) 
Seat 6: WinninBikini ($10 in chips) 
Dcaro31: posts small blind $0.05
FRAID358: posts big blind $0.10
*** HOLE CARDS ***
armstv: raises $0.30 to $0.40
Goroshkos88: folds 
WinninBikini: calls $0.40
RoJ1: folds 
Dcaro31: folds 
FRAID358: folds 
*** FLOP *** [Kc 6d Kd]
armstv: checks 
WinninBikini: bets $0.54
armstv: raises $1.06 to $1.60
WinninBikini: folds 
Uncalled bet ($1.06) returned to armstv
armstv collected $1.94 from pot
*** SUMMARY ***
Total pot $2.03 | Rake $0.09 
Board [Kc 6d Kd]
Seat 1: RoJ1 (button) folded before Flop (didn't bet)
Seat 2: Dcaro31 (small blind) folded before Flop
Seat 3: FRAID358 (big blind) folded before Flop
Seat 4: armstv collected ($1.94)
Seat 5: Goroshkos88 folded before Flop (didn't bet)
Seat 6: WinninBikini folded on the Flop



PokerStars Hand #166667733852:  Hold'em No Limit ($0.05/$0.10 USD) - 2017/02/23 16:06:33 ET
Table 'California II' 6-max Seat #1 is the button
Seat 1: fedorka rus ($10 in chips) 
Seat 2: homelessdan ($10.05 in chips) 
Seat 3: Bird et al ($10.20 in chips) 
Seat 4: pokekrk ($14.42 in chips) 
Seat 5: Nikolai77798 ($4 in chips) 
Seat 6: chiko4040 ($7.96 in chips) 
homelessdan: posts small blind $0.05
Bird et al: posts big blind $0.10
Nikolai77798: posts big blind $0.10
*** HOLE CARDS ***
pokekrk: folds 
Nikolai77798: checks 
chiko4040: raises $0.30 to $0.40
fedorka rus: calls $0.40
homelessdan: folds 
Bird et al: folds 
Nikolai77798: folds 
*** FLOP *** [3d Ac 5h]
chiko4040: checks 
fedorka rus: checks 
*** TURN *** [3d Ac 5h] [2s]
chiko4040: bets $0.20
fedorka rus: folds 
Uncalled bet ($0.20) returned to chiko4040
chiko4040 collected $1 from pot
*** SUMMARY ***
Total pot $1.05 | Rake $0.05 
Board [3d Ac 5h 2s]
Seat 1: fedorka rus (button) folded on the Turn
Seat 2: homelessdan (small blind) folded before Flop
Seat 3: Bird et al (big blind) folded before Flop
Seat 4: pokekrk folded before Flop (didn't bet)
Seat 5: Nikolai77798 folded before Flop
Seat 6: chiko4040 collected ($1)



PokerStars Hand #166667733991:  Hold'em No Limit ($0.05/$0.10 USD) - 2017/02/23 16:06:34 ET
Table 'Antielus II' 6-max Seat #1 is the button
Seat 1: Dcaro31 ($18.49 in chips) 
Seat 2: Orlangoor ($10.05 in chips) 
Seat 3: mcyi3at2 ($12.31 in chips) 
Seat 4: XwinX25 ($10 in chips) 
Seat 5: Hyd SK ($10.89 in chips) 
Seat 6: GiveTwoMe ($12.25 in chips) 
Orlangoor: posts small blind $0.05
mcyi3at2: posts big blind $0.10
*** HOLE CARDS ***
XwinX25: raises $0.20 to $0.30
Hyd SK: folds 
GiveTwoMe: folds 
Dcaro31: folds 
Orlangoor: folds 
mcyi3at2: folds 
Uncalled bet ($0.20) returned to XwinX25
XwinX25 collected $0.25 from pot
*** SUMMARY ***
Total pot $0.25 | Rake $0 
Seat 1: Dcaro31 (button) folded before Flop (didn't bet)
Seat 2: Orlangoor (small blind) folded before Flop
Seat 3: mcyi3at2 (big blind) folded before Flop
Seat 4: XwinX25 collected ($0.25)
Seat 5: Hyd SK folded before Flop (didn't bet)
Seat 6: GiveTwoMe folded before Flop (didn't bet)



PokerStars Hand #166667734635:  Hold'em No Limit ($0.05/$0.10 USD) - 2017/02/23 16:06:34 ET
Table 'Lobelia II' 6-max Seat #6 is the button
Seat 1: facewald ($21.27 in chips) 
Seat 2: Dcaro31 ($17.61 in chips) 
Seat 3: oddshoff ($19.25 in chips) 
Seat 5: Feverhead ($20.28 in chips) 
Seat 6: NvR.m1nD ($10.10 in chips) 
facewald: posts small blind $0.05
Dcaro31: posts big blind $0.10
*** HOLE CARDS ***
oddshoff: folds 
Feverhead: raises $0.15 to $0.25
NvR.m1nD: calls $0.25
facewald: folds 
Dcaro31: folds 
*** FLOP *** [8s 2s 7c]
Feverhead: checks 
NvR.m1nD: bets $0.32
Feverhead: folds 
Uncalled bet ($0.32) returned to NvR.m1nD
NvR.m1nD collected $0.62 from pot
*** SUMMARY ***
Total pot $0.65 | Rake $0.03 
Board [8s 2s 7c]
Seat 1: facewald (small blind) folded before Flop
Seat 2: Dcaro31 (big blind) folded before Flop
Seat 3: oddshoff folded before Flop (didn't bet)
Seat 5: Feverhead folded on the Flop
Seat 6: NvR.m1nD (button) collected ($0.62)



PokerStars Hand #166667734826:  Hold'em No Limit ($0.05/$0.10 USD) - 2017/02/23 16:06:35 ET
Table 'Esperanto II' 6-max Seat #1 is the button
Seat 1: kurasd ($10.95 in chips) 
Seat 2: MihaGr ($10 in chips) 
Seat 3: Namhkal ($12.10 in chips) 
Seat 4: Andrei ProFF ($10.35 in chips) 
Seat 5: FRAID358 ($9.85 in chips) 
Seat 6: ArcticBearDK ($13.13 in chips) 
MihaGr: posts small blind $0.05
Namhkal: posts big blind $0.10
*** HOLE CARDS ***
Andrei ProFF: folds 
FRAID358: folds 
ArcticBearDK: raises $0.12 to $0.22
kurasd: folds 
MihaGr: folds 
Namhkal: folds 
Uncalled bet ($0.12) returned to ArcticBearDK
ArcticBearDK collected $0.25 from pot
*** SUMMARY ***
Total pot $0.25 | Rake $0 
Seat 1: kurasd (button) folded before Flop (didn't bet)
Seat 2: MihaGr (small blind) folded before Flop
Seat 3: Namhkal (big blind) folded before Flop
Seat 4: Andrei ProFF folded before Flop (didn't bet)
Seat 5: FRAID358 folded before Flop (didn't bet)
Seat 6: ArcticBearDK collected ($0.25)



PokerStars Hand #166667735189:  Hold'em No Limit ($0.05/$0.10 USD) - 2017/02/23 16:06:35 ET
Table 'Girtab' 6-max Seat #5 is the button
Seat 1: pokekrk ($13.56 in chips) 
Seat 2: MühliJr ($10 in chips) 
Seat 3: kingartur222 ($10.45 in chips) 
Seat 4: Hyd SK ($11.23 in chips) 
Seat 5: sexy_seagull ($11.05 in chips) 
Seat 6: iluzja12 ($9.90 in chips) 
iluzja12: posts small blind $0.05
pokekrk: posts big blind $0.10
*** HOLE CARDS ***
MühliJr: folds 
kingartur222: folds 
Hyd SK: folds 
sexy_seagull: raises $0.15 to $0.25
iluzja12: folds 
pokekrk: folds 
Uncalled bet ($0.15) returned to sexy_seagull
sexy_seagull collected $0.25 from pot
*** SUMMARY ***
Total pot $0.25 | Rake $0 
Seat 1: pokekrk (big blind) folded before Flop
Seat 2: MühliJr folded before Flop (didn't bet)
Seat 3: kingartur222 folded before Flop (didn't bet)
Seat 4: Hyd SK folded before Flop (didn't bet)
Seat 5: sexy_seagull (button) collected ($0.25)
Seat 6: iluzja12 (small blind) folded before Flop



PokerStars Hand #166667735258:  Hold'em No Limit ($0.05/$0.10 USD) - 2017/02/23 16:06:35 ET
Table 'Pirola III' 6-max Seat #4 is the button
Seat 1: bdixon_5 ($9.47 in chips) 
Seat 3: kingartur222 ($10.82 in chips) 
Seat 4: McCleans ($10.57 in chips) 
Seat 5: tequila_joop ($10.45 in chips) 
Seat 6: T9MS ($10 in chips) 
tequila_joop: posts small blind $0.05
T9MS: posts big blind $0.10
Chodemuncher: sits out 
*** HOLE CARDS ***
bdixon_5: folds 
kingartur222: folds 
McCleans: raises $0.15 to $0.25
tequila_joop: folds 
T9MS: folds 
Uncalled bet ($0.15) returned to McCleans
McCleans collected $0.25 from pot
*** SUMMARY ***
Total pot $0.25 | Rake $0 
Seat 1: bdixon_5 folded before Flop (didn't bet)
Seat 3: kingartur222 folded before Flop (didn't bet)
Seat 4: McCleans (button) collected ($0.25)
Seat 5: tequila_joop (small blind) folded before Flop
Seat 6: T9MS (big blind) folded before Flop



PokerStars Hand #166667735643:  Hold'em No Limit ($0.05/$0.10 USD) - 2017/02/23 16:06:35 ET
Table 'Pirola' 6-max Seat #6 is the button
Seat 1: Rodik002 ($10.18 in chips) 
Seat 2: lmlmlmlm90 ($18.54 in chips) 
Seat 3: XaXaTyH4uK ($11.08 in chips) 
Seat 4: barons89 ($12.06 in chips) 
Seat 5: Iarlei ($13.99 in chips) 
Seat 6: Hyd SK ($10.35 in chips) 
Rodik002: posts small blind $0.05
lmlmlmlm90: posts big blind $0.10
*** HOLE CARDS ***
XaXaTyH4uK: folds 
barons89: folds 
Iarlei: folds 
Hyd SK: folds 
Rodik002: folds 
Uncalled bet ($0.05) returned to lmlmlmlm90
lmlmlmlm90 collected $0.10 from pot
*** SUMMARY ***
Total pot $0.10 | Rake $0 
Seat 1: Rodik002 (small blind) folded before Flop
Seat 2: lmlmlmlm90 (big blind) collected ($0.10)
Seat 3: XaXaTyH4uK folded before Flop (didn't bet)
Seat 4: barons89 folded before Flop (didn't bet)
Seat 5: Iarlei folded before Flop (didn't bet)
Seat 6: Hyd SK (button) folded before Flop (didn't bet)



PokerStars Hand #166667735663:  Hold'em No Limit ($0.05/$0.10 USD) - 2017/02/23 16:06:35 ET
Table 'Serpens' 6-max Seat #2 is the button
Seat 1: Namhkal ($10.30 in chips) 
Seat 2: KA3AXCTAHEU, ($19.20 in chips) 
Seat 3: homelessdan ($29.34 in chips) 
Seat 4: Ragazzi3 ($9.60 in chips) 
Seat 5: XwinX25 ($12.32 in chips) 
Seat 6: Croplayer1 ($10 in chips) 
homelessdan: posts small blind $0.05
Ragazzi3: posts big blind $0.10
*** HOLE CARDS ***
XwinX25: folds 
Croplayer1: folds 
Namhkal: folds 
KA3AXCTAHEU,: raises $0.15 to $0.25
homelessdan: folds 
Ragazzi3: calls $0.15
*** FLOP *** [4s 3h Jh]
Ragazzi3: checks 
KA3AXCTAHEU,: bets $0.39
Ragazzi3: folds 
Uncalled bet ($0.39) returned to KA3AXCTAHEU,
KA3AXCTAHEU, collected $0.53 from pot
*** SUMMARY ***
Total pot $0.55 | Rake $0.02 
Board [4s 3h Jh]
Seat 1: Namhkal folded before Flop (didn't bet)
Seat 2: KA3AXCTAHEU, (button) collected ($0.53)
Seat 3: homelessdan (small blind) folded before Flop
Seat 4: Ragazzi3 (big blind) folded on the Flop
Seat 5: XwinX25 folded before Flop (didn't bet)
Seat 6: Croplayer1 folded before Flop (didn't bet)



PokerStars Hand #166667735797:  Hold'em No Limit ($0.05/$0.10 USD) - 2017/02/23 16:06:36 ET
Table 'Union' 6-max Seat #5 is the button
Seat 1: IAntikI ($10 in chips) 
Seat 2: Zooplack ($10 in chips) 
Seat 3: Rodik002 ($12.01 in chips) 
Seat 4: Croplayer1 ($14.95 in chips) 
Seat 5: Chodemuncher ($16 in chips) 
Seat 6: bonyo71 ($3.75 in chips) 
bonyo71: posts small blind $0.05
IAntikI: posts big blind $0.10
*** HOLE CARDS ***
Zooplack: folds 
Rodik002: folds 
Croplayer1: folds 
Chodemuncher: folds 
bonyo71: raises $0.20 to $0.30
IAntikI: folds 
Uncalled bet ($0.20) returned to bonyo71
bonyo71 collected $0.20 from pot
*** SUMMARY ***
Total pot $0.20 | Rake $0 
Seat 1: IAntikI (big blind) folded before Flop
Seat 2: Zooplack folded before Flop (didn't bet)
Seat 3: Rodik002 folded before Flop (didn't bet)
Seat 4: Croplayer1 folded before Flop (didn't bet)
Seat 5: Chodemuncher (button) folded before Flop (didn't bet)
Seat 6: bonyo71 (small blind) collected ($0.20)



PokerStars Hand #166667735979:  Hold'em No Limit ($0.05/$0.10 USD) - 2017/02/23 16:06:36 ET
Table 'Wilkens II' 6-max Seat #2 is the button
Seat 1: Islamiq-GuRL ($10.34 in chips) 
Seat 2: manashov ($10.75 in chips) 
Seat 3: Namhkal ($10.89 in chips) 
Seat 4: myevc ($10 in chips) 
Seat 5: patrick19111 ($11.58 in chips) 
Seat 6: XaXaTyH4uK ($14.31 in chips) 
Namhkal: posts small blind $0.05
myevc: posts big blind $0.10
*** HOLE CARDS ***
patrick19111: folds 
XaXaTyH4uK: raises $0.20 to $0.30
Islamiq-GuRL: folds 
manashov: folds 
Namhkal: calls $0.25
myevc: calls $0.20
*** FLOP *** [9d 4h Td]
Namhkal: checks 
myevc: checks 
XaXaTyH4uK: checks 
*** TURN *** [9d 4h Td] [6s]
Namhkal: checks 
myevc: checks 
XaXaTyH4uK: checks 
*** RIVER *** [9d 4h Td 6s] [5h]
Namhkal: checks 
myevc: checks 
XaXaTyH4uK: checks 
*** SHOW DOWN ***
Namhkal: shows [8d 8c] (a pair of Eights)
myevc: mucks hand 
XaXaTyH4uK: mucks hand 
Namhkal collected $0.86 from pot
*** SUMMARY ***
Total pot $0.90 | Rake $0.04 
Board [9d 4h Td 6s 5h]
Seat 1: Islamiq-GuRL folded before Flop (didn't bet)
Seat 2: manashov (button) folded before Flop (didn't bet)
Seat 3: Namhkal (small blind) showed [8d 8c] and won ($0.86) with a pair of Eights
Seat 4: myevc (big blind) mucked
Seat 5: patrick19111 folded before Flop (didn't bet)
Seat 6: XaXaTyH4uK mucked



PokerStars Hand #166667736544:  Hold'em No Limit ($0.05/$0.10 USD) - 2017/02/23 16:06:36 ET
Table 'Glarona' 6-max Seat #4 is the button
Seat 1: LarryTheStar ($10.35 in chips) 
Seat 2: BookWorm78 ($10 in chips) 
Seat 3: hoedje72 ($3.71 in chips) 
Seat 4: CrippledGod ($7.14 in chips) 
Seat 5: david_sara83 ($10.15 in chips) 
david_sara83: posts small blind $0.05
Namhkal: is sitting out 
LarryTheStar: posts big blind $0.10
*** HOLE CARDS ***
Namhkal leaves the table
BookWorm78: folds 
hoedje72: raises $0.20 to $0.30
CrippledGod: folds 
marianoboni joins the table at seat #6 
david_sara83: folds 
LarryTheStar: folds 
Uncalled bet ($0.20) returned to hoedje72
hoedje72 collected $0.25 from pot
*** SUMMARY ***
Total pot $0.25 | Rake $0 
Seat 1: LarryTheStar (big blind) folded before Flop
Seat 2: BookWorm78 folded before Flop (didn't bet)
Seat 3: hoedje72 collected ($0.25)
Seat 4: CrippledGod (button) folded before Flop (didn't bet)
Seat 5: david_sara83 (small blind) folded before Flop



PokerStars Hand #166667736787:  Hold'em No Limit ($0.05/$0.10 USD) - 2017/02/23 16:06:37 ET
Table 'Hajek III' 6-max Seat #4 is the button
Seat 1: MBen10 ($10.60 in chips) 
Seat 2: fortieth ($10.19 in chips) 
Seat 3: fedorka rus ($10.61 in chips) 
Seat 4: NvR.m1nD ($13.52 in chips) 
Seat 5: Croplayer1 ($14.65 in chips) 
Croplayer1: posts small blind $0.05
MBen10: posts big blind $0.10
*** HOLE CARDS ***
fortieth: folds 
fedorka rus: folds 
NvR.m1nD: raises $0.15 to $0.25
Croplayer1: folds 
MBen10: folds 
Uncalled bet ($0.15) returned to NvR.m1nD
NvR.m1nD collected $0.25 from pot
*** SUMMARY ***
Total pot $0.25 | Rake $0 
Seat 1: MBen10 (big blind) folded before Flop
Seat 2: fortieth folded before Flop (didn't bet)
Seat 3: fedorka rus folded before Flop (didn't bet)
Seat 4: NvR.m1nD (button) collected ($0.25)
Seat 5: Croplayer1 (small blind) folded before Flop



PokerStars Hand #166667736788:  Hold'em No Limit ($0.05/$0.10 USD) - 2017/02/23 16:06:37 ET
Table 'Tomita II' 6-max Seat #6 is the button
Seat 2: mhonielsen ($10 in chips) 
Seat 3: Lucky HoBBiT ($12.63 in chips) 
Seat 4: Hyd SK ($11.31 in chips) 
Seat 6: saniasmir ($10 in chips) 
mhonielsen: posts small blind $0.05
Lucky HoBBiT: posts big blind $0.10
ex3Lero86: sits out 
*** HOLE CARDS ***
Hyd SK: folds 
saniasmir: folds 
mhonielsen: raises $0.20 to $0.30
Lucky HoBBiT: raises $0.70 to $1
mhonielsen: folds 
Uncalled bet ($0.70) returned to Lucky HoBBiT
Lucky HoBBiT collected $0.60 from pot
*** SUMMARY ***
Total pot $0.60 | Rake $0 
Seat 2: mhonielsen (small blind) folded before Flop
Seat 3: Lucky HoBBiT (big blind) collected ($0.60)
Seat 4: Hyd SK folded before Flop (didn't bet)
Seat 6: saniasmir (button) folded before Flop (didn't bet)



PokerStars Hand #166667737316:  Hold'em No Limit ($0.05/$0.10 USD) - 2017/02/23 16:06:37 ET
Table 'Apollonia' 6-max Seat #3 is the button
Seat 1: ex3Lero86 ($10.11 in chips) 
Seat 2: ibara000 ($18.43 in chips) 
Seat 3: steepfell ($10.10 in chips) 
Seat 4: Goroshkos88 ($17.77 in chips) 
Goroshkos88: posts small blind $0.05
Namhkal: is sitting out 
ex3Lero86: posts big blind $0.10
*** HOLE CARDS ***
x3ultimate leaves the table
ibara000: folds 
Namhkal leaves the table
steepfell: folds 
iluzja12 joins the table at seat #6 
Goroshkos88: folds 
Uncalled bet ($0.05) returned to ex3Lero86
ex3Lero86 collected $0.10 from pot
*** SUMMARY ***
Total pot $0.10 | Rake $0 
Seat 1: ex3Lero86 (big blind) collected ($0.10)
Seat 2: ibara000 folded before Flop (didn't bet)
Seat 3: steepfell (button) folded before Flop (didn't bet)
Seat 4: Goroshkos88 (small blind) folded before Flop



PokerStars Hand #166667737317:  Hold'em No Limit ($0.05/$0.10 USD) - 2017/02/23 16:06:37 ET
Table 'Tyndareus II' 6-max Seat #5 is the button
Seat 1: Makc1705 ($3.65 in chips) 
Seat 3: McCleans ($11.90 in chips) 
Seat 4: gaHy_HaXeP ($10.61 in chips) 
Seat 5: vtalian ($9.85 in chips) 
Seat 6: sexy_seagull ($10.35 in chips) 
sexy_seagull: posts small blind $0.05
Makc1705: posts big blind $0.10
fishhook5: sits out 
*** HOLE CARDS ***
McCleans: raises $0.20 to $0.30
gaHy_HaXeP: folds 
vtalian: folds 
sexy_seagull: folds 
Makc1705: folds 
Uncalled bet ($0.20) returned to McCleans
McCleans collected $0.25 from pot
*** SUMMARY ***
Total pot $0.25 | Rake $0 
Seat 1: Makc1705 (big blind) folded before Flop
Seat 3: McCleans collected ($0.25)
Seat 4: gaHy_HaXeP folded before Flop (didn't bet)
Seat 5: vtalian (button) folded before Flop (didn't bet)
Seat 6: sexy_seagull (small blind) folded before Flop



PokerStars Hand #166667737531:  Hold'em No Limit ($0.05/$0.10 USD) - 2017/02/23 16:06:37 ET
Table 'Lagrula' 6-max Seat #6 is the button
Seat 1: Ice_Isayev ($10 in chips) 
Seat 2: KRZuff ($10 in chips) 
Seat 3: micke667 ($15.42 in chips) 
Seat 4: Calimero2408 ($10.89 in chips) 
Seat 5: Iarlei ($10 in chips) 
Seat 6: Spud014 ($10 in chips) 
Ice_Isayev: posts small blind $0.05
KRZuff: posts big blind $0.10
*** HOLE CARDS ***
micke667: calls $0.10
Calimero2408: folds 
Iarlei: folds 
Spud014: raises $0.30 to $0.40
Ice_Isayev: folds 
KRZuff: folds 
micke667: raises $0.30 to $0.70
Spud014: calls $0.30
*** FLOP *** [Ad As Th]
micke667: bets $0.70
Spud014: calls $0.70
*** TURN *** [Ad As Th] [5h]
micke667: bets $1.40
Spud014: folds 
Uncalled bet ($1.40) returned to micke667
micke667 collected $2.82 from pot
*** SUMMARY ***
Total pot $2.95 | Rake $0.13 
Board [Ad As Th 5h]
Seat 1: Ice_Isayev (small blind) folded before Flop
Seat 2: KRZuff (big blind) folded before Flop
Seat 3: micke667 collected ($2.82)
Seat 4: Calimero2408 folded before Flop (didn't bet)
Seat 5: Iarlei folded before Flop (didn't bet)
Seat 6: Spud014 (button) folded on the Turn



PokerStars Hand #166667737627:  Hold'em No Limit ($0.05/$0.10 USD) - 2017/02/23 16:06:37 ET
Table 'Girtab II' 6-max Seat #3 is the button
Seat 1: marianoboni ($11.31 in chips) 
Seat 2: Pokeaster ($13.44 in chips) 
Seat 3: chimera252 ($10 in chips) 
Seat 4: Hyd SK ($27.08 in chips) 
Seat 6: DamDatsAnAce ($10 in chips) 
Hyd SK: posts small blind $0.05
DamDatsAnAce: posts big blind $0.10
*** HOLE CARDS ***
marianoboni: folds 
Pokeaster: raises $0.20 to $0.30
chimera252: folds 
Hyd SK: folds 
DamDatsAnAce: folds 
Uncalled bet ($0.20) returned to Pokeaster
Pokeaster collected $0.25 from pot
*** SUMMARY ***
Total pot $0.25 | Rake $0 
Seat 1: marianoboni folded before Flop (didn't bet)
Seat 2: Pokeaster collected ($0.25)
Seat 3: chimera252 (button) folded before Flop (didn't bet)
Seat 4: Hyd SK (small blind) folded before Flop
Seat 6: DamDatsAnAce (big blind) folded before Flop



PokerStars Hand #166667737736:  Hold'em No Limit ($0.05/$0.10 USD) - 2017/02/23 16:06:38 ET
Table 'Garlena III' 6-max Seat #5 is the button
Seat 1: dittoro ($10.15 in chips) 
Seat 4: mbkongstad ($10 in chips) 
Seat 5: steepfell ($10 in chips) 
Seat 6: iluzja12 ($9.90 in chips) 
iluzja12: posts small blind $0.05
dittoro: posts big blind $0.10
YY778: sits out 
*** HOLE CARDS ***
mbkongstad: raises $0.10 to $0.20
steepfell: folds 
iluzja12: folds 
dittoro: folds 
Uncalled bet ($0.10) returned to mbkongstad
mbkongstad collected $0.25 from pot
*** SUMMARY ***
Total pot $0.25 | Rake $0 
Seat 1: dittoro (big blind) folded before Flop
Seat 4: mbkongstad collected ($0.25)
Seat 5: steepfell (button) folded before Flop (didn't bet)
Seat 6: iluzja12 (small blind) folded before Flop



PokerStars Hand #166667737783:  Hold'em No Limit ($0.05/$0.10 USD) - 2017/02/23 16:06:38 ET
Table 'Clavel' 6-max Seat #5 is the button
Seat 1: KRZuff ($14.66 in chips) 
Seat 2: Namhkal ($10 in chips) 
Seat 4: Dcaro31 ($11.83 in chips) 
Seat 5: Vrinni ($10 in chips) 
Seat 6: Gra_anD77 ($4.75 in chips) 
Gra_anD77: posts small blind $0.05
KRZuff: posts big blind $0.10
*** HOLE CARDS ***
Namhkal: folds 
Dcaro31: folds 
Vrinni: folds 
Gra_anD77: calls $0.05
KRZuff: checks 
*** FLOP *** [2h 8h Jc]
Gra_anD77: checks 
KRZuff: checks 
*** TURN *** [2h 8h Jc] [5h]
Gra_anD77: bets $0.10
KRZuff: folds 
Uncalled bet ($0.10) returned to Gra_anD77
Gra_anD77 collected $0.19 from pot
*** SUMMARY ***
Total pot $0.20 | Rake $0.01 
Board [2h 8h Jc 5h]
Seat 1: KRZuff (big blind) folded on the Turn
Seat 2: Namhkal folded before Flop (didn't bet)
Seat 4: Dcaro31 folded before Flop (didn't bet)
Seat 5: Vrinni (button) folded before Flop (didn't bet)
Seat 6: Gra_anD77 (small blind) collected ($0.19)



PokerStars Hand #166667737895:  Hold'em No Limit ($0.05/$0.10 USD) - 2017/02/23 16:06:38 ET
Table 'Xanthippe II' 6-max Seat #6 is the button
Seat 1: ade22345 ($4.11 in chips) 
Seat 2: Bird et al ($12.91 in chips) 
Seat 3: Dcaro31 ($10.92 in chips) 
Seat 5: yodzik ($14.90 in chips) 
Seat 6: Orlangoor ($10.59 in chips) 
ade22345: posts small blind $0.05
Bird et al: posts big blind $0.10
*** HOLE CARDS ***
Dcaro31: folds 
yodzik: folds 
Orlangoor: raises $0.12 to $0.22
ade22345: folds 
Bird et al: calls $0.12
*** FLOP *** [Ac Jd Ah]
Bird et al: bets $0.39
Orlangoor: calls $0.39
*** TURN *** [Ac Jd Ah] [Jc]
Bird et al: bets $0.72
Barcardi14 is disconnected 
Orlangoor: calls $0.72
*** RIVER *** [Ac Jd Ah Jc] [5h]
Bird et al: bets $1.30
Orlangoor: raises $1.76 to $3.06
Bird et al: folds 
Uncalled bet ($1.76) returned to Orlangoor
Orlangoor collected $5.07 from pot
*** SUMMARY ***
Total pot $5.31 | Rake $0.24 
Board [Ac Jd Ah Jc 5h]
Seat 1: ade22345 (small blind) folded before Flop
Seat 2: Bird et al (big blind) folded on the River
Seat 3: Dcaro31 folded before Flop (didn't bet)
Seat 5: yodzik folded before Flop (didn't bet)
Seat 6: Orlangoor (button) collected ($5.07)



PokerStars Hand #166667737979:  Hold'em No Limit ($0.05/$0.10 USD) - 2017/02/23 16:06:38 ET
Table 'Grietje' 6-max Seat #3 is the button
Seat 1: dragonste89 ($10.15 in chips) 
Seat 2: Feverhead ($12.57 in chips) 
Seat 3: GitoValdivia ($6.42 in chips) 
Seat 4: MihaGr ($10.76 in chips) 
Seat 5: iThreeBarrel ($10.15 in chips) 
Seat 6: Prometheu$8 ($21.70 in chips) 
MihaGr: posts small blind $0.05
iThreeBarrel: posts big blind $0.10
*** HOLE CARDS ***
Prometheu$8: folds 
dragonste89: folds 
Feverhead: raises $0.15 to $0.25
GitoValdivia: folds 
MihaGr: folds 
iThreeBarrel: folds 
Uncalled bet ($0.15) returned to Feverhead
Feverhead collected $0.25 from pot
*** SUMMARY ***
Total pot $0.25 | Rake $0 
Seat 1: dragonste89 folded before Flop (didn't bet)
Seat 2: Feverhead collected ($0.25)
Seat 3: GitoValdivia (button) folded before Flop (didn't bet)
Seat 4: MihaGr (small blind) folded before Flop
Seat 5: iThreeBarrel (big blind) folded before Flop
Seat 6: Prometheu$8 folded before Flop (didn't bet)



PokerStars Hand #166667738049:  Hold'em No Limit ($0.05/$0.10 USD) - 2017/02/23 16:06:38 ET
Table 'Persephone' 6-max Seat #1 is the button
Seat 1: dragonste89 ($10 in chips) 
Seat 2: AM-L-SL ($5.55 in chips) 
Seat 3: DasoII ($4.85 in chips) 
Seat 4: 2G28 ($10 in chips) 
Seat 5: ab260414 ($10.96 in chips) 
Seat 6: popypaleta ($14.39 in chips) 
AM-L-SL: posts small blind $0.05
DasoII: posts big blind $0.10
*** HOLE CARDS ***
2G28: folds 
ab260414: folds 
popypaleta: raises $0.20 to $0.30
dragonste89: folds 
AM-L-SL: folds 
DasoII: calls $0.20
*** FLOP *** [6c Qd 7s]
DasoII: checks 
popypaleta: bets $0.40
DasoII: folds 
Uncalled bet ($0.40) returned to popypaleta
popypaleta collected $0.62 from pot
*** SUMMARY ***
Total pot $0.65 | Rake $0.03 
Board [6c Qd 7s]
Seat 1: dragonste89 (button) folded before Flop (didn't bet)
Seat 2: AM-L-SL (small blind) folded before Flop
Seat 3: DasoII (big blind) folded on the Flop
Seat 4: 2G28 folded before Flop (didn't bet)
Seat 5: ab260414 folded before Flop (didn't bet)
Seat 6: popypaleta collected ($0.62)



PokerStars Hand #166667738202:  Hold'em No Limit ($0.05/$0.10 USD) - 2017/02/23 16:06:38 ET
Table 'Stroobantia' 6-max Seat #6 is the button
Seat 1: mam9zyc ($8.87 in chips) 
Seat 2: XwinX25 ($10.30 in chips) 
Seat 3: Namhkal ($10 in chips) 
Seat 4: Yspenyanin ($10 in chips) 
Seat 5: boxer821 ($10.99 in chips) 
Seat 6: KokoulinV ($15.67 in chips) 
mam9zyc: posts small blind $0.05
XwinX25: posts big blind $0.10
*** HOLE CARDS ***
Namhkal: raises $0.15 to $0.25
Yspenyanin: folds 
boxer821: folds 
KokoulinV: folds 
mam9zyc: calls $0.20
XwinX25: folds 
*** FLOP *** [Kh Ac 8c]
mam9zyc: bets $0.10
Namhkal: folds 
Uncalled bet ($0.10) returned to mam9zyc
mam9zyc collected $0.57 from pot
*** SUMMARY ***
Total pot $0.60 | Rake $0.03 
Board [Kh Ac 8c]
Seat 1: mam9zyc (small blind) collected ($0.57)
Seat 2: XwinX25 (big blind) folded before Flop
Seat 3: Namhkal folded on the Flop
Seat 4: Yspenyanin folded before Flop (didn't bet)
Seat 5: boxer821 folded before Flop (didn't bet)
Seat 6: KokoulinV (button) folded before Flop (didn't bet)



PokerStars Hand #166667738282:  Hold'em No Limit ($0.05/$0.10 USD) - 2017/02/23 16:06:38 ET
Table 'Laetitia II' 6-max Seat #5 is the button
Seat 1: Cluckh ($11.28 in chips) 
Seat 2: manashov ($10 in chips) 
Seat 3: 6ePeMeHHa9 ($10.14 in chips) 
Seat 4: Feverhead ($16.66 in chips) 
Seat 5: D3NyA ($16.48 in chips) 
Seat 6: Dima91360 ($5.84 in chips) 
Dima91360: posts small blind $0.05
Cluckh: posts big blind $0.10
*** HOLE CARDS ***
manashov: folds 
6ePeMeHHa9: folds 
Feverhead: folds 
D3NyA: raises $0.10 to $0.20
Dima91360: calls $0.15
Cluckh: calls $0.10
*** FLOP *** [4s 4d 7d]
Dima91360: bets $0.40
Cluckh: folds 
D3NyA: folds 
Uncalled bet ($0.40) returned to Dima91360
Dima91360 collected $0.57 from pot
*** SUMMARY ***
Total pot $0.60 | Rake $0.03 
Board [4s 4d 7d]
Seat 1: Cluckh (big blind) folded on the Flop
Seat 2: manashov folded before Flop (didn't bet)
Seat 3: 6ePeMeHHa9 folded before Flop (didn't bet)
Seat 4: Feverhead folded before Flop (didn't bet)
Seat 5: D3NyA (button) folded on the Flop
Seat 6: Dima91360 (small blind) collected ($0.57)



PokerStars Hand #166667738417:  Hold'em No Limit ($0.05/$0.10 USD) - 2017/02/23 16:06:38 ET
Table 'Atropos' 6-max Seat #2 is the button
Seat 1: ScorpionF39 ($2.07 in chips) 
Seat 2: yodzik ($5 in chips) 
Seat 3: NvR.m1nD ($10 in chips) 
Seat 4: iDecMate ($11.12 in chips) 
Seat 5: KokoulinV ($12.09 in chips) 
Seat 6: Iarlei ($12.58 in chips) 
NvR.m1nD: posts small blind $0.05
iDecMate: posts big blind $0.10
*** HOLE CARDS ***
KokoulinV: folds 
Iarlei: folds 
ScorpionF39: folds 
yodzik: folds 
NvR.m1nD: raises $0.15 to $0.25
iDecMate: folds 
Uncalled bet ($0.15) returned to NvR.m1nD
NvR.m1nD collected $0.20 from pot
*** SUMMARY ***
Total pot $0.20 | Rake $0 
Seat 1: ScorpionF39 folded before Flop (didn't bet)
Seat 2: yodzik (button) folded before Flop (didn't bet)
Seat 3: NvR.m1nD (small blind) collected ($0.20)
Seat 4: iDecMate (big blind) folded before Flop
Seat 5: KokoulinV folded before Flop (didn't bet)
Seat 6: Iarlei folded before Flop (didn't bet)



PokerStars Hand #166667739313:  Hold'em No Limit ($0.05/$0.10 USD) - 2017/02/23 16:06:39 ET
Table 'Landi II' 6-max Seat #3 is the button
Seat 1: dersiemer ($11.83 in chips) 
Seat 2: Aescul@pius ($10.80 in chips) 
Seat 3: dr.goofy ($21.29 in chips) 
Seat 4: alesi13 ($6.63 in chips) 
Seat 5: Bird et al ($10.25 in chips) 
alesi13: posts small blind $0.05
Bird et al: posts big blind $0.10
*** HOLE CARDS ***
dersiemer: folds 
Aescul@pius: folds 
dr.goofy: folds 
alesi13: folds 
Uncalled bet ($0.05) returned to Bird et al
Bird et al collected $0.10 from pot
*** SUMMARY ***
Total pot $0.10 | Rake $0 
Seat 1: dersiemer folded before Flop (didn't bet)
Seat 2: Aescul@pius folded before Flop (didn't bet)
Seat 3: dr.goofy (button) folded before Flop (didn't bet)
Seat 4: alesi13 (small blind) folded before Flop
Seat 5: Bird et al (big blind) collected ($0.10)



PokerStars Hand #166667739389:  Hold'em No Limit ($0.05/$0.10 USD) - 2017/02/23 16:06:39 ET
Table 'Unitas II' 6-max Seat #5 is the button
Seat 1: Peter0087 ($9.85 in chips) 
Seat 2: steepfell ($10.25 in chips) 
Seat 4: truck1234 ($10.79 in chips) 
Seat 5: chimera252 ($24.48 in chips) 
Seat 6: paxit71 ($9.63 in chips) 
paxit71: posts small blind $0.05
Peter0087: posts big blind $0.10
*** HOLE CARDS ***
steepfell: folds 
truck1234: raises $0.30 to $0.40
BahiaMinhaP joins the table at seat #3 
chimera252: folds 
paxit71: folds 
Peter0087: folds 
Uncalled bet ($0.30) returned to truck1234
truck1234 collected $0.25 from pot
*** SUMMARY ***
Total pot $0.25 | Rake $0 
Seat 1: Peter0087 (big blind) folded before Flop
Seat 2: steepfell folded before Flop (didn't bet)
Seat 4: truck1234 collected ($0.25)
Seat 5: chimera252 (button) folded before Flop (didn't bet)
Seat 6: paxit71 (small blind) folded before Flop



PokerStars Hand #166667739457:  Hold'em No Limit ($0.05/$0.10 USD) - 2017/02/23 16:06:39 ET
Table 'Huberta II' 6-max Seat #5 is the button
Seat 1: tr41n3r12 ($10 in chips) 
Seat 2: Ice_Isayev ($12.08 in chips) 
Seat 3: patrick19111 ($10.60 in chips) 
Seat 4: VAD21 ($11.96 in chips) 
Seat 5: Feverhead ($27.80 in chips) 
Seat 6: yodzik ($5.05 in chips) 
yodzik: posts small blind $0.05
tr41n3r12: posts big blind $0.10
*** HOLE CARDS ***
Ice_Isayev: folds 
patrick19111: raises $0.20 to $0.30
VAD21: folds 
Feverhead: folds 
yodzik: calls $0.25
tr41n3r12: folds 
*** FLOP *** [Qd 7s 7c]
yodzik: checks 
patrick19111: bets $0.45
yodzik: calls $0.45
*** TURN *** [Qd 7s 7c] [Kd]
yodzik: checks 
patrick19111: checks 
*** RIVER *** [Qd 7s 7c Kd] [4d]
yodzik: checks 
patrick19111: checks 
*** SHOW DOWN ***
yodzik: shows [Qh Ac] (two pair, Queens and Sevens)
patrick19111: mucks hand 
yodzik collected $1.53 from pot
*** SUMMARY ***
Total pot $1.60 | Rake $0.07 
Board [Qd 7s 7c Kd 4d]
Seat 1: tr41n3r12 (big blind) folded before Flop
Seat 2: Ice_Isayev folded before Flop (didn't bet)
Seat 3: patrick19111 mucked
Seat 4: VAD21 folded before Flop (didn't bet)
Seat 5: Feverhead (button) folded before Flop (didn't bet)
Seat 6: yodzik (small blind) showed [Qh Ac] and won ($1.53) with two pair, Queens and Sevens



PokerStars Hand #166667739573:  Hold'em No Limit ($0.05/$0.10 USD) - 2017/02/23 16:06:39 ET
Table 'Antinous' 6-max Seat #6 is the button
Seat 1: Andrei ProFF ($15.88 in chips) 
Seat 2: Nr847 ($13.60 in chips) 
Seat 3: dittoro ($10.15 in chips) 
Seat 5: Covetsoles ($3.48 in chips) 
Seat 6: coolisses111 ($10 in chips) 
Andrei ProFF: posts small blind $0.05
Nr847: posts big blind $0.10
Pekaml: sits out 
*** HOLE CARDS ***
dittoro: folds 
Covetsoles: calls $0.10
coolisses111: folds 
Andrei ProFF: folds 
Nr847: checks 
*** FLOP *** [Jc 2s 3c]
Nr847: checks 
Covetsoles: bets $0.10
Nr847: folds 
Uncalled bet ($0.10) returned to Covetsoles
Covetsoles collected $0.24 from pot
*** SUMMARY ***
Total pot $0.25 | Rake $0.01 
Board [Jc 2s 3c]
Seat 1: Andrei ProFF (small blind) folded before Flop
Seat 2: Nr847 (big blind) folded on the Flop
Seat 3: dittoro folded before Flop (didn't bet)
Seat 5: Covetsoles collected ($0.24)
Seat 6: coolisses111 (button) folded before Flop (didn't bet)



PokerStars Hand #166667739639:  Hold'em No Limit ($0.05/$0.10 USD) - 2017/02/23 16:06:40 ET
Table 'Themisto II' 6-max Seat #6 is the button
Seat 2: CA225 ($10.25 in chips) 
Seat 3: eniksenik ($16.14 in chips) 
Seat 4: Innerwuss ($10 in chips) 
Seat 5: ex3Lero86 ($11.12 in chips) 
Seat 6: noobigrok ($4 in chips) 
ChuikaPridi will be allowed to play after the button
CA225: posts small blind $0.05
eniksenik: posts big blind $0.10
*** HOLE CARDS ***
Innerwuss: folds 
ex3Lero86: folds 
noobigrok: calls $0.10
CA225: raises $0.30 to $0.40
eniksenik: calls $0.30
noobigrok: calls $0.30
*** FLOP *** [Ah 8s 9d]
CA225: bets $0.60
eniksenik: folds 
noobigrok: folds 
Uncalled bet ($0.60) returned to CA225
CA225 collected $1.15 from pot
*** SUMMARY ***
Total pot $1.20 | Rake $0.05 
Board [Ah 8s 9d]
Seat 2: CA225 (small blind) collected ($1.15)
Seat 3: eniksenik (big blind) folded on the Flop
Seat 4: Innerwuss folded before Flop (didn't bet)
Seat 5: ex3Lero86 folded before Flop (didn't bet)
Seat 6: noobigrok (button) folded on the Flop



PokerStars Hand #166667740050:  Hold'em No Limit ($0.05/$0.10 USD) - 2017/02/23 16:06:40 ET
Table 'Nephthys II' 6-max Seat #4 is the button
Seat 1: DamDatsAnAce ($11.37 in chips) 
Seat 2: Ju$tD0it ($8.14 in chips) 
Seat 3: Newqbrown ($20.76 in chips) 
Seat 4: MihaGr ($10 in chips) 
Seat 5: kingartur222 ($8.66 in chips) 
Seat 6: CHRO8 ($14.34 in chips) 
kingartur222: posts small blind $0.05
CHRO8: posts big blind $0.10
*** HOLE CARDS ***
DamDatsAnAce: folds 
Ju$tD0it: raises $0.10 to $0.20
Newqbrown: folds 
MihaGr: folds 
kingartur222: folds 
CHRO8: folds 
Uncalled bet ($0.10) returned to Ju$tD0it
Ju$tD0it collected $0.25 from pot
*** SUMMARY ***
Total pot $0.25 | Rake $0 
Seat 1: DamDatsAnAce folded before Flop (didn't bet)
Seat 2: Ju$tD0it collected ($0.25)
Seat 3: Newqbrown folded before Flop (didn't bet)
Seat 4: MihaGr (button) folded before Flop (didn't bet)
Seat 5: kingartur222 (small blind) folded before Flop
Seat 6: CHRO8 (big blind) folded before Flop



PokerStars Hand #166667740404:  Hold'em No Limit ($0.05/$0.10 USD) - 2017/02/23 16:06:40 ET
Table 'Kraz II' 6-max Seat #3 is the button
Seat 1: bdixon_5 ($9.55 in chips) 
Seat 2: shellyld ($10.15 in chips) 
Seat 3: Eddys Edge ($10 in chips) 
Seat 5: Joker51_wtf! ($10.05 in chips) 
Seat 6: tr41n3r12 ($10 in chips) 
Joker51_wtf!: posts small blind $0.05
tr41n3r12: posts big blind $0.10
*** HOLE CARDS ***
Andrei ProFF joins the table at seat #4 
Andrei ProFF leaves the table
bdixon_5: raises $0.20 to $0.30
Cluckh joins the table at seat #4 
Cluckh leaves the table
shellyld: calls $0.30
Eddys Edge: folds 
Joker51_wtf!: folds 
tr41n3r12: calls $0.20
*** FLOP *** [9h Qc Kc]
DrVzad joins the table at seat #4 
tr41n3r12: checks 
bdixon_5: checks 
shellyld: checks 
*** TURN *** [9h Qc Kc] [7s]
tr41n3r12: bets $0.61
bdixon_5: folds 
shellyld: calls $0.61
*** RIVER *** [9h Qc Kc 7s] [Qh]
tr41n3r12: bets $1
shellyld: folds 
Uncalled bet ($1) returned to tr41n3r12
tr41n3r12 collected $2.07 from pot
*** SUMMARY ***
Total pot $2.17 | Rake $0.10 
Board [9h Qc Kc 7s Qh]
Seat 1: bdixon_5 folded on the Turn
Seat 2: shellyld folded on the River
Seat 3: Eddys Edge (button) folded before Flop (didn't bet)
Seat 5: Joker51_wtf! (small blind) folded before Flop
Seat 6: tr41n3r12 (big blind) collected ($2.07)



PokerStars Hand #166667740429:  Hold'em No Limit ($0.05/$0.10 USD) - 2017/02/23 16:06:40 ET
Table 'Lampetia III' 6-max Seat #2 is the button
Seat 1: gaHy_HaXeP ($10.55 in chips) 
Seat 2: DamDatsAnAce ($10 in chips) 
Seat 3: Kow6oy ($10 in chips) 
Seat 4: IAntikI ($10.75 in chips) 
Seat 5: robson1235 ($20.62 in chips) 
Seat 6: bdixon_5 ($9.20 in chips) 
Kow6oy: posts small blind $0.05
IAntikI: posts big blind $0.10
*** HOLE CARDS ***
robson1235: raises $0.20 to $0.30
bdixon_5: folds 
gaHy_HaXeP: folds 
DamDatsAnAce: folds 
Kow6oy: folds 
IAntikI: folds 
Uncalled bet ($0.20) returned to robson1235
robson1235 collected $0.25 from pot
*** SUMMARY ***
Total pot $0.25 | Rake $0 
Seat 1: gaHy_HaXeP folded before Flop (didn't bet)
Seat 2: DamDatsAnAce (button) folded before Flop (didn't bet)
Seat 3: Kow6oy (small blind) folded before Flop
Seat 4: IAntikI (big blind) folded before Flop
Seat 5: robson1235 collected ($0.25)
Seat 6: bdixon_5 folded before Flop (didn't bet)



PokerStars Hand #166667740533:  Hold'em No Limit ($0.05/$0.10 USD) - 2017/02/23 16:06:41 ET
Table 'Nauheima II' 6-max Seat #4 is the button
Seat 2: Peter0087 ($10.62 in chips) 
Seat 3: KokoulinV ($13.14 in chips) 
Seat 4: Innerwuss ($10.07 in chips) 
Seat 6: bonyo71 ($4.94 in chips) 
bonyo71: posts small blind $0.05
Peter0087: posts big blind $0.10
*** HOLE CARDS ***
bambolejro joins the table at seat #5 
KokoulinV: folds 
Innerwuss: folds 
bonyo71: raises $0.20 to $0.30
Peter0087: folds 
Uncalled bet ($0.20) returned to bonyo71
bonyo71 collected $0.20 from pot
*** SUMMARY ***
Total pot $0.20 | Rake $0 
Seat 2: Peter0087 (big blind) folded before Flop
Seat 3: KokoulinV folded before Flop (didn't bet)
Seat 4: Innerwuss (button) folded before Flop (didn't bet)
Seat 6: bonyo71 (small blind) collected ($0.20)



PokerStars Hand #166667740778:  Hold'em No Limit ($0.05/$0.10 USD) - 2017/02/23 16:06:41 ET
Table 'Rotraut' 6-max Seat #2 is the button
Seat 2: Newqbrown ($12.05 in chips) 
Seat 3: FlackoD ($10.91 in chips) 
Seat 5: Bird et al ($12.38 in chips) 
Seat 6: KokoulinV ($12.28 in chips) 
FlackoD: posts small blind $0.05
Bird et al: posts big blind $0.10
Hypermetal: sits out 
*** HOLE CARDS ***
KokoulinV: raises $0.20 to $0.30
Newqbrown: calls $0.30
FlackoD: calls $0.25
Bird et al: folds 
*** FLOP *** [7c 4d Jh]
FlackoD: checks 
KokoulinV: checks 
Newqbrown: checks 
*** TURN *** [7c 4d Jh] [8c]
FlackoD: bets $0.60
KokoulinV: calls $0.60
Newqbrown: folds 
*** RIVER *** [7c 4d Jh 8c] [5d]
FlackoD: checks 
KokoulinV: checks 
*** SHOW DOWN ***
FlackoD: shows [Jd Qc] (a pair of Jacks)
KokoulinV: mucks hand 
FlackoD collected $2.10 from pot
*** SUMMARY ***
Total pot $2.20 | Rake $0.10 
Board [7c 4d Jh 8c 5d]
Seat 2: Newqbrown (button) folded on the Turn
Seat 3: FlackoD (small blind) showed [Jd Qc] and won ($2.10) with a pair of Jacks
Seat 5: Bird et al (big blind) folded before Flop
Seat 6: KokoulinV mucked



PokerStars Hand #166667741666:  Hold'em No Limit ($0.05/$0.10 USD) - 2017/02/23 16:06:42 ET
Table 'Isberga' 6-max Seat #2 is the button
Seat 1: Feverhead ($18.17 in chips) 
Seat 2: GESPERIA ($10.12 in chips) 
Seat 4: THIMUCHIN ($10.74 in chips) 
Seat 5: YoungGriff86 ($19.02 in chips) 
Seat 6: Goroshkos88 ($21.38 in chips) 
THIMUCHIN: posts small blind $0.05
YoungGriff86: posts big blind $0.10
*** HOLE CARDS ***
Goroshkos88: folds 
Feverhead: raises $0.15 to $0.25
GESPERIA: folds 
THIMUCHIN: folds 
YoungGriff86: folds 
Uncalled bet ($0.15) returned to Feverhead
Feverhead collected $0.25 from pot
*** SUMMARY ***
Total pot $0.25 | Rake $0 
Seat 1: Feverhead collected ($0.25)
Seat 2: GESPERIA (button) folded before Flop (didn't bet)
Seat 4: THIMUCHIN (small blind) folded before Flop
Seat 5: YoungGriff86 (big blind) folded before Flop
Seat 6: Goroshkos88 folded before Flop (didn't bet)



PokerStars Hand #166667741835:  Hold'em No Limit ($0.05/$0.10 USD) - 2017/02/23 16:06:42 ET
Table 'Sirius II' 6-max Seat #3 is the button
Seat 1: Ampped87 ($13.88 in chips) 
Seat 2: Buddy8711 ($8.08 in chips) 
Seat 3: Spud014 ($10.25 in chips) 
Seat 5: pokekrk ($10.42 in chips) 
Seat 6: MihaGr ($10 in chips) 
pokekrk: posts small blind $0.05
MihaGr: posts big blind $0.10
*** HOLE CARDS ***
Ampped87: raises $0.20 to $0.30
Buddy8711: folds 
Spud014: folds 
pokekrk: folds 
MihaGr: calls $0.20
*** FLOP *** [Jc Ad 2h]
MihaGr: checks 
Ampped87: bets $0.30
MihaGr: calls $0.30
*** TURN *** [Jc Ad 2h] [Qs]
MihaGr: checks 
Ampped87: bets $0.60
MihaGr: calls $0.60
*** RIVER *** [Jc Ad 2h Qs] [9s]
MihaGr: checks 
Ampped87: checks 
*** SHOW DOWN ***
MihaGr: shows [Ah 3h] (a pair of Aces)
Ampped87: shows [Ac 7c] (a pair of Aces)
MihaGr collected $1.17 from pot
Ampped87 collected $1.17 from pot
*** SUMMARY ***
Total pot $2.45 | Rake $0.11 
Board [Jc Ad 2h Qs 9s]
Seat 1: Ampped87 showed [Ac 7c] and won ($1.17) with a pair of Aces
Seat 2: Buddy8711 folded before Flop (didn't bet)
Seat 3: Spud014 (button) folded before Flop (didn't bet)
Seat 5: pokekrk (small blind) folded before Flop
Seat 6: MihaGr (big blind) showed [Ah 3h] and won ($1.17) with a pair of Aces



PokerStars Hand #166667741889:  Hold'em No Limit ($0.05/$0.10 USD) - 2017/02/23 16:06:42 ET
Table 'Tirela' 6-max Seat #3 is the button
Seat 1: Smitty03300 ($10 in chips) 
Seat 2: Andrei ProFF ($17.34 in chips) 
Seat 3: aim444 ($15.84 in chips) 
Seat 4: ArcticBearDK ($10 in chips) 
Seat 5: KRZuff ($11.76 in chips) 
Seat 6: coolisses111 ($9.95 in chips) 
ArcticBearDK: posts small blind $0.05
KRZuff: posts big blind $0.10
*** HOLE CARDS ***
coolisses111: folds 
Smitty03300: folds 
Andrei ProFF: folds 
aim444: calls $0.10
ArcticBearDK: raises $0.40 to $0.50
KRZuff: raises $1 to $1.50
aim444: folds 
ArcticBearDK: calls $1
*** FLOP *** [Tc 9h 4c]
ArcticBearDK: checks 
KRZuff: bets $1.85
ArcticBearDK: folds 
Uncalled bet ($1.85) returned to KRZuff
KRZuff collected $2.96 from pot
*** SUMMARY ***
Total pot $3.10 | Rake $0.14 
Board [Tc 9h 4c]
Seat 1: Smitty03300 folded before Flop (didn't bet)
Seat 2: Andrei ProFF folded before Flop (didn't bet)
Seat 3: aim444 (button) folded before Flop
Seat 4: ArcticBearDK (small blind) folded on the Flop
Seat 5: KRZuff (big blind) collected ($2.96)
Seat 6: coolisses111 folded before Flop (didn't bet)



PokerStars Hand #166667741908:  Hold'em No Limit ($0.05/$0.10 USD) - 2017/02/23 16:06:42 ET
Table 'Senta II' 6-max Seat #3 is the button
Seat 2: NvR.m1nD ($12.14 in chips) 
Seat 3: Aescul@pius ($20.70 in chips) 
Seat 4: fedorka rus ($20.84 in chips) 
Seat 5: Algarah ($6.52 in chips) 
Seat 6: T9MS ($11.32 in chips) 
fedorka rus: posts small blind $0.05
Algarah: posts big blind $0.10
*** HOLE CARDS ***
T9MS: folds 
NvR.m1nD: folds 
Aescul@pius: raises $0.10 to $0.20
fedorka rus: folds 
Algarah: calls $0.10
*** FLOP *** [Qd 4s Ts]
Algarah: checks 
Aescul@pius: bets $0.28
Algarah: calls $0.28
*** TURN *** [Qd 4s Ts] [8h]
Algarah: checks 
Aescul@pius: checks 
*** RIVER *** [Qd 4s Ts 8h] [9s]
Algarah: checks 
Aescul@pius: bets $0.76
Algarah: calls $0.76
*** SHOW DOWN ***
Aescul@pius: shows [8s 6s] (a flush, Ten high)
Algarah: mucks hand 
Aescul@pius collected $2.42 from pot
*** SUMMARY ***
Total pot $2.53 | Rake $0.11 
Board [Qd 4s Ts 8h 9s]
Seat 2: NvR.m1nD folded before Flop (didn't bet)
Seat 3: Aescul@pius (button) showed [8s 6s] and won ($2.42) with a flush, Ten high
Seat 4: fedorka rus (small blind) folded before Flop
Seat 5: Algarah (big blind) mucked
Seat 6: T9MS folded before Flop (didn't bet)



PokerStars Hand #166667741910:  Hold'em No Limit ($0.05/$0.10 USD) - 2017/02/23 16:06:42 ET
Table 'Kanda' 6-max Seat #5 is the button
Seat 1: Andy Wolf ($11.27 in chips) 
Seat 2: Pelotín ($5.15 in chips) 
Seat 3: XaXaTyH4uK ($10 in chips) 
Seat 4: Orlangoor ($10.19 in chips) 
Seat 5: Dimka4 ($10.10 in chips) 
Seat 6: oddshoff ($9.26 in chips) 
oddshoff: posts small blind $0.05
Andy Wolf: posts big blind $0.10
*** HOLE CARDS ***
Pelotín: folds 
XaXaTyH4uK: folds 
Orlangoor: folds 
Dimka4: folds 
oddshoff: folds 
Uncalled bet ($0.05) returned to Andy Wolf
Andy Wolf collected $0.10 from pot
*** SUMMARY ***
Total pot $0.10 | Rake $0 
Seat 1: Andy Wolf (big blind) collected ($0.10)
Seat 2: Pelotín folded before Flop (didn't bet)
Seat 3: XaXaTyH4uK folded before Flop (didn't bet)
Seat 4: Orlangoor folded before Flop (didn't bet)
Seat 5: Dimka4 (button) folded before Flop (didn't bet)
Seat 6: oddshoff (small blind) folded before Flop



PokerStars Hand #166667742025:  Hold'em No Limit ($0.05/$0.10 USD) - 2017/02/23 16:06:42 ET
Table 'Aisakos II' 6-max Seat #2 is the button
Seat 1: Crafty23@PS ($10.50 in chips) 
Seat 2: svaika24 ($16.83 in chips) 
Seat 3: iamkakaroto ($10.44 in chips) 
Seat 4: T9MS ($10.15 in chips) 
Seat 5: KokoulinV ($12.05 in chips) 
Seat 6: LarryTheStar ($10.23 in chips) 
iamkakaroto: posts small blind $0.05
T9MS: posts big blind $0.10
*** HOLE CARDS ***
KokoulinV: folds 
LarryTheStar: folds 
Crafty23@PS: folds 
svaika24: folds 
iamkakaroto: folds 
Uncalled bet ($0.05) returned to T9MS
T9MS collected $0.10 from pot
*** SUMMARY ***
Total pot $0.10 | Rake $0 
Seat 1: Crafty23@PS folded before Flop (didn't bet)
Seat 2: svaika24 (button) folded before Flop (didn't bet)
Seat 3: iamkakaroto (small blind) folded before Flop
Seat 4: T9MS (big blind) collected ($0.10)
Seat 5: KokoulinV folded before Flop (didn't bet)
Seat 6: LarryTheStar folded before Flop (didn't bet)



PokerStars Hand #166667742112:  Hold'em No Limit ($0.05/$0.10 USD) - 2017/02/23 16:06:42 ET
Table 'Juliet II' 6-max Seat #2 is the button
Seat 1: alexpolevaja ($12.65 in chips) 
Seat 2: KA3AXCTAHEU, ($14.93 in chips) 
Seat 3: patrick19111 ($11.47 in chips) 
Seat 4: x3ultimate ($10.55 in chips) 
Seat 5: Dcaro31 ($19.12 in chips) 
Seat 6: BookWorm78 ($31.48 in chips) 
patrick19111: posts small blind $0.05
x3ultimate: posts big blind $0.10
*** HOLE CARDS ***
Dcaro31: raises $0.20 to $0.30
BookWorm78: folds 
alexpolevaja: calls $0.30
BookWorm78 said, "nh"
KA3AXCTAHEU,: raises $1.20 to $1.50
patrick19111: folds 
x3ultimate: folds 
Dcaro31: folds 
alexpolevaja: folds 
Uncalled bet ($1.20) returned to KA3AXCTAHEU,
KA3AXCTAHEU, collected $1.05 from pot
*** SUMMARY ***
Total pot $1.05 | Rake $0 
Seat 1: alexpolevaja folded before Flop
Seat 2: KA3AXCTAHEU, (button) collected ($1.05)
Seat 3: patrick19111 (small blind) folded before Flop
Seat 4: x3ultimate (big blind) folded before Flop
Seat 5: Dcaro31 folded before Flop
Seat 6: BookWorm78 folded before Flop (didn't bet)



PokerStars Hand #166667742171:  Hold'em No Limit ($0.05/$0.10 USD) - 2017/02/23 16:06:42 ET
Table 'Sinon II' 6-max Seat #1 is the button
Seat 1: Aescul@pius ($10.22 in chips) 
Seat 2: ÄissesHai ($16.84 in chips) 
Seat 3: crazydevill ($10.88 in chips) 
Seat 4: Bandyaev ($15.33 in chips) 
Seat 5: ab260414 ($11.06 in chips) 
Seat 6: hartmut2012 ($5.28 in chips) 
ÄissesHai: posts small blind $0.05
crazydevill: posts big blind $0.10
hartmut2012: posts small & big blinds $0.15
*** HOLE CARDS ***
Bandyaev: calls $0.10
ab260414: folds 
hartmut2012: checks 
Aescul@pius: raises $0.40 to $0.50
ÄissesHai: calls $0.45
crazydevill: calls $0.40
Bandyaev: calls $0.40
hartmut2012: folds 
*** FLOP *** [5h Qd 6s]
ÄissesHai: checks 
crazydevill: checks 
Bandyaev: checks 
Aescul@pius: checks 
*** TURN *** [5h Qd 6s] [9h]
ÄissesHai: checks 
crazydevill: bets $1.20
Bandyaev: folds 
Aescul@pius: calls $1.20
ÄissesHai: calls $1.20
*** RIVER *** [5h Qd 6s 9h] [5d]
ÄissesHai: bets $5.49
crazydevill: calls $5.49
Aescul@pius: folds 
*** SHOW DOWN ***
ÄissesHai: shows [6d 6c] (a full house, Sixes full of Fives)
crazydevill: mucks hand 
ÄissesHai collected $15.98 from pot
*** SUMMARY ***
Total pot $16.73 | Rake $0.75 
Board [5h Qd 6s 9h 5d]
Seat 1: Aescul@pius (button) folded on the River
Seat 2: ÄissesHai (small blind) showed [6d 6c] and won ($15.98) with a full house, Sixes full of Fives
Seat 3: crazydevill (big blind) mucked
Seat 4: Bandyaev folded on the Turn
Seat 5: ab260414 folded before Flop (didn't bet)
Seat 6: hartmut2012 folded before Flop



PokerStars Hand #166667743255:  Hold'em No Limit ($0.05/$0.10 USD) - 2017/02/23 16:06:43 ET
Table 'Wingolfia II' 6-max Seat #5 is the button
Seat 1: BahiaMinhaP ($10.32 in chips) 
Seat 2: NvR.m1nD ($10.25 in chips) 
Seat 3: truck1234 ($10.36 in chips) 
Seat 4: zlobslob ($17.87 in chips) 
Seat 5: tr41n3r12 ($11.43 in chips) 
Seat 6: EphemeralBen ($12.04 in chips) 
EphemeralBen: posts small blind $0.05
BahiaMinhaP: posts big blind $0.10
*** HOLE CARDS ***
NvR.m1nD: raises $0.15 to $0.25
truck1234: folds 
zlobslob: folds 
tr41n3r12: folds 
EphemeralBen: folds 
BahiaMinhaP: folds 
Uncalled bet ($0.15) returned to NvR.m1nD
NvR.m1nD collected $0.25 from pot
*** SUMMARY ***
Total pot $0.25 | Rake $0 
Seat 1: BahiaMinhaP (big blind) folded before Flop
Seat 2: NvR.m1nD collected ($0.25)
Seat 3: truck1234 folded before Flop (didn't bet)
Seat 4: zlobslob folded before Flop (didn't bet)
Seat 5: tr41n3r12 (button) folded before Flop (didn't bet)
Seat 6: EphemeralBen (small blind) folded before Flop



PokerStars Hand #166667744635:  Hold'em No Limit ($0.05/$0.10 USD) - 2017/02/23 16:06:45 ET
Table 'Nemo III' 6-max Seat #6 is the button
Seat 1: Kow6oy ($10 in chips) 
Seat 2: Bandyaev ($12.16 in chips) 
Seat 3: Dimka4 ($10.15 in chips) 
Seat 4: vtalian ($9.70 in chips) 
Seat 5: Joker51_wtf! ($11.28 in chips) 
Seat 6: maxiv608 ($10 in chips) 
Kow6oy: posts small blind $0.05
Bandyaev: posts big blind $0.10
*** HOLE CARDS ***
Dimka4: folds 
vtalian: raises $0.20 to $0.30
Joker51_wtf!: folds 
maxiv608: folds 
Kow6oy: folds 
Bandyaev: folds 
Uncalled bet ($0.20) returned to vtalian
vtalian collected $0.25 from pot
*** SUMMARY ***
Total pot $0.25 | Rake $0 
Seat 1: Kow6oy (small blind) folded before Flop
Seat 2: Bandyaev (big blind) folded before Flop
Seat 3: Dimka4 folded before Flop (didn't bet)
Seat 4: vtalian collected ($0.25)
Seat 5: Joker51_wtf! folded before Flop (didn't bet)
Seat 6: maxiv608 (button) folded before Flop (didn't bet)



PokerStars Hand #166667744691:  Hold'em No Limit ($0.05/$0.10 USD) - 2017/02/23 16:06:45 ET
Table 'Tristan III' 6-max Seat #2 is the button
Seat 1: CHRO8 ($18.18 in chips) 
Seat 2: Hyd SK ($13.88 in chips) 
Seat 3: fedorka rus ($26.72 in chips) 
Seat 4: Feverhead ($11.53 in chips) 
Seat 5: david_sara83 ($10 in chips) 
Seat 6: fredrik10528 ($9.90 in chips) 
fedorka rus: posts small blind $0.05
Feverhead: posts big blind $0.10
*** HOLE CARDS ***
david_sara83: folds 
fredrik10528: raises $0.10 to $0.20
CHRO8: folds 
Hyd SK: folds 
fedorka rus: folds 
Feverhead: folds 
Uncalled bet ($0.10) returned to fredrik10528
fredrik10528 collected $0.25 from pot
*** SUMMARY ***
Total pot $0.25 | Rake $0 
Seat 1: CHRO8 folded before Flop (didn't bet)
Seat 2: Hyd SK (button) folded before Flop (didn't bet)
Seat 3: fedorka rus (small blind) folded before Flop
Seat 4: Feverhead (big blind) folded before Flop
Seat 5: david_sara83 folded before Flop (didn't bet)
Seat 6: fredrik10528 collected ($0.25)



PokerStars Hand #166667744980:  Hold'em No Limit ($0.05/$0.10 USD) - 2017/02/23 16:06:45 ET
Table 'Rosalia' 6-max Seat #4 is the button
Seat 1: Hyd SK ($10 in chips) 
Seat 2: Bandyaev ($12.19 in chips) 
Seat 3: Andy Wolf ($11.98 in chips) 
Seat 4: THIMUCHIN ($10 in chips) 
Seat 5: miron762 ($18.80 in chips) 
Seat 6: facewald ($16.78 in chips) 
miron762: posts small blind $0.05
facewald: posts big blind $0.10
*** HOLE CARDS ***
Hyd SK: folds 
Bandyaev: raises $0.20 to $0.30
Andy Wolf: folds 
THIMUCHIN: calls $0.30
miron762: folds 
facewald: calls $0.20
*** FLOP *** [6s 8c Qs]
facewald: checks 
Bandyaev: checks 
THIMUCHIN: checks 
*** TURN *** [6s 8c Qs] [5d]
facewald: checks 
Bandyaev: checks 
THIMUCHIN: checks 
*** RIVER *** [6s 8c Qs 5d] [Ks]
facewald: bets $0.55
Bandyaev: folds 
THIMUCHIN: calls $0.55
*** SHOW DOWN ***
facewald: shows [Kd 6d] (two pair, Kings and Sixes)
THIMUCHIN: mucks hand 
facewald collected $1.96 from pot
*** SUMMARY ***
Total pot $2.05 | Rake $0.09 
Board [6s 8c Qs 5d Ks]
Seat 1: Hyd SK folded before Flop (didn't bet)
Seat 2: Bandyaev folded on the River
Seat 3: Andy Wolf folded before Flop (didn't bet)
Seat 4: THIMUCHIN (button) mucked
Seat 5: miron762 (small blind) folded before Flop
Seat 6: facewald (big blind) showed [Kd 6d] and won ($1.96) with two pair, Kings and Sixes



PokerStars Hand #166667745009:  Hold'em No Limit ($0.05/$0.10 USD) - 2017/02/23 16:06:45 ET
Table 'Hirons' 6-max Seat #1 is the button
Seat 1: RoJ1 ($11.53 in chips) 
Seat 2: coolisses111 ($7.69 in chips) 
Seat 3: czeczen7 ($14.51 in chips) 
Seat 4: Smitty03300 ($11.05 in chips) 
Seat 6: garigura ($13.63 in chips) 
coolisses111: posts small blind $0.05
czeczen7: posts big blind $0.10
Pekaml: sits out 
*** HOLE CARDS ***
Smitty03300: folds 
garigura: folds 
RoJ1: raises $0.12 to $0.22
coolisses111: folds 
czeczen7: calls $0.12
*** FLOP *** [Th Tc 3s]
czeczen7: checks 
RoJ1: bets $0.15
czeczen7: calls $0.15
*** TURN *** [Th Tc 3s] [As]
czeczen7: checks 
RoJ1: bets $0.31
czeczen7: folds 
Uncalled bet ($0.31) returned to RoJ1
RoJ1 collected $0.75 from pot
*** SUMMARY ***
Total pot $0.79 | Rake $0.04 
Board [Th Tc 3s As]
Seat 1: RoJ1 (button) collected ($0.75)
Seat 2: coolisses111 (small blind) folded before Flop
Seat 3: czeczen7 (big blind) folded on the Turn
Seat 4: Smitty03300 folded before Flop (didn't bet)
Seat 6: garigura folded before Flop (didn't bet)



PokerStars Hand #166667745220:  Hold'em No Limit ($0.05/$0.10 USD) - 2017/02/23 16:06:46 ET
Table 'Klotho II' 6-max Seat #6 is the button
Seat 3: Zooplack ($10.05 in chips) 
Seat 4: Lucky HoBBiT ($10.71 in chips) 
Seat 5: david_sara83 ($16.06 in chips) 
Seat 6: D3NyA ($11.42 in chips) 
xdjango07x will be allowed to play after the button
Zooplack: posts small blind $0.05
Lucky HoBBiT: posts big blind $0.10
*** HOLE CARDS ***
david_sara83: folds 
D3NyA: folds 
Zooplack: raises $0.15 to $0.25
Lucky HoBBiT: folds 
Uncalled bet ($0.15) returned to Zooplack
Zooplack collected $0.20 from pot
*** SUMMARY ***
Total pot $0.20 | Rake $0 
Seat 3: Zooplack (small blind) collected ($0.20)
Seat 4: Lucky HoBBiT (big blind) folded before Flop
Seat 5: david_sara83 folded before Flop (didn't bet)
Seat 6: D3NyA (button) folded before Flop (didn't bet)



PokerStars Hand #166667745431:  Hold'em No Limit ($0.05/$0.10 USD) - 2017/02/23 16:06:46 ET
Table 'Wabash' 6-max Seat #4 is the button
Seat 1: pivanki11 ($10.15 in chips) 
Seat 2: ex3Lero86 ($32.48 in chips) 
Seat 4: Nr847 ($10 in chips) 
Seat 5: popypaleta ($14.19 in chips) 
Seat 6: weez3r ($10.67 in chips) 
popypaleta: posts small blind $0.05
weez3r: posts big blind $0.10
tauronex: sits out 
*** HOLE CARDS ***
pivanki11: folds 
ex3Lero86: folds 
Nr847: folds 
popypaleta: raises $0.20 to $0.30
weez3r: raises $0.60 to $0.90
popypaleta: folds 
Uncalled bet ($0.60) returned to weez3r
weez3r collected $0.60 from pot
*** SUMMARY ***
Total pot $0.60 | Rake $0 
Seat 1: pivanki11 folded before Flop (didn't bet)
Seat 2: ex3Lero86 folded before Flop (didn't bet)
Seat 4: Nr847 (button) folded before Flop (didn't bet)
Seat 5: popypaleta (small blind) folded before Flop
Seat 6: weez3r (big blind) collected ($0.60)



PokerStars Hand #166667745443:  Hold'em No Limit ($0.05/$0.10 USD) - 2017/02/23 16:06:46 ET
Table 'Syringa' 6-max Seat #1 is the button
Seat 1: bdixon_5 ($7.65 in chips) 
Seat 2: Goroshkos88 ($10.46 in chips) 
Seat 3: Yspenyanin ($13.52 in chips) 
Seat 4: tangler19 ($14.28 in chips) 
Seat 5: Andrei ProFF ($14.81 in chips) 
Seat 6: ibara000 ($15.28 in chips) 
Goroshkos88: posts small blind $0.05
Yspenyanin: posts big blind $0.10
*** HOLE CARDS ***
tangler19: calls $0.10
Andrei ProFF: folds 
ibara000: folds 
bdixon_5: raises $0.30 to $0.40
Goroshkos88: folds 
Yspenyanin: folds 
tangler19: calls $0.30
*** FLOP *** [3h 4s 5h]
tangler19: checks 
bdixon_5: checks 
*** TURN *** [3h 4s 5h] [Kc]
tangler19: bets $0.40
bdixon_5: raises $0.70 to $1.10
tangler19: calls $0.70
*** RIVER *** [3h 4s 5h Kc] [5d]
tangler19: checks 
bdixon_5: bets $1.60
tangler19: folds 
Uncalled bet ($1.60) returned to bdixon_5
bdixon_5 collected $3.01 from pot
*** SUMMARY ***
Total pot $3.15 | Rake $0.14 
Board [3h 4s 5h Kc 5d]
Seat 1: bdixon_5 (button) collected ($3.01)
Seat 2: Goroshkos88 (small blind) folded before Flop
Seat 3: Yspenyanin (big blind) folded before Flop
Seat 4: tangler19 folded on the River
Seat 5: Andrei ProFF folded before Flop (didn't bet)
Seat 6: ibara000 folded before Flop (didn't bet)



PokerStars Hand #166667745526:  Hold'em No Limit ($0.05/$0.10 USD) - 2017/02/23 16:06:46 ET
Table 'Aludra II' 6-max Seat #2 is the button
Seat 1: voledy ($10.23 in chips) 
Seat 2: JahSoldier69 ($14.05 in chips) 
Seat 3: mbkongstad ($9.90 in chips) 
Seat 4: MihaGr ($10.74 in chips) 
Seat 5: kingartur222 ($15.87 in chips) 
Seat 6: call me haaa ($13.68 in chips) 
mbkongstad: posts small blind $0.05
MihaGr: posts big blind $0.10
*** HOLE CARDS ***
kingartur222: folds 
call me haaa: raises $0.20 to $0.30
voledy: folds 
JahSoldier69: folds 
mbkongstad: folds 
MihaGr: folds 
Uncalled bet ($0.20) returned to call me haaa
call me haaa collected $0.25 from pot
*** SUMMARY ***
Total pot $0.25 | Rake $0 
Seat 1: voledy folded before Flop (didn't bet)
Seat 2: JahSoldier69 (button) folded before Flop (didn't bet)
Seat 3: mbkongstad (small blind) folded before Flop
Seat 4: MihaGr (big blind) folded before Flop
Seat 5: kingartur222 folded before Flop (didn't bet)
Seat 6: call me haaa collected ($0.25)



PokerStars Hand #166667745572:  Hold'em No Limit ($0.05/$0.10 USD) - 2017/02/23 16:06:46 ET
Table 'Iapetus III' 6-max Seat #2 is the button
Seat 1: Czezar Life ($6.65 in chips) 
Seat 2: Crafty23@PS ($10 in chips) 
Seat 3: Goroshkos88 ($10 in chips) 
Seat 4: Raggibest ($8.32 in chips) 
Seat 5: homelessdan ($14.93 in chips) 
Seat 6: tauronex ($10.33 in chips) 
Goroshkos88: posts small blind $0.05
Raggibest: posts big blind $0.10
*** HOLE CARDS ***
homelessdan: folds 
tauronex: raises $0.20 to $0.30
Czezar Life: calls $0.30
Crafty23@PS: calls $0.30
Goroshkos88: raises $1.30 to $1.60
Raggibest: folds 
tauronex: folds 
Czezar Life: folds 
Crafty23@PS: folds 
Uncalled bet ($1.30) returned to Goroshkos88
Goroshkos88 collected $1.30 from pot
*** SUMMARY ***
Total pot $1.30 | Rake $0 
Seat 1: Czezar Life folded before Flop
Seat 2: Crafty23@PS (button) folded before Flop
Seat 3: Goroshkos88 (small blind) collected ($1.30)
Seat 4: Raggibest (big blind) folded before Flop
Seat 5: homelessdan folded before Flop (didn't bet)
Seat 6: tauronex folded before Flop



PokerStars Hand #166667745611:  Hold'em No Limit ($0.05/$0.10 USD) - 2017/02/23 16:06:46 ET
Table 'Manto II' 6-max Seat #6 is the button
Seat 2: voledy ($10 in chips) 
Seat 3: Komap511 ($10 in chips) 
Seat 4: dr.goofy ($14.96 in chips) 
Seat 5: ArcticBearDK ($32.69 in chips) 
Seat 6: pancernik21 ($16.20 in chips) 
voledy: posts small blind $0.05
Komap511: posts big blind $0.10
*** HOLE CARDS ***
dr.goofy: folds 
ArcticBearDK: folds 
pancernik21: raises $0.20 to $0.30
voledy: folds 
Komap511: folds 
Uncalled bet ($0.20) returned to pancernik21
pancernik21 collected $0.25 from pot
*** SUMMARY ***
Total pot $0.25 | Rake $0 
Seat 2: voledy (small blind) folded before Flop
Seat 3: Komap511 (big blind) folded before Flop
Seat 4: dr.goofy folded before Flop (didn't bet)
Seat 5: ArcticBearDK folded before Flop (didn't bet)
Seat 6: pancernik21 (button) collected ($0.25)



PokerStars Hand #166667745883:  Hold'em No Limit ($0.05/$0.10 USD) - 2017/02/23 16:06:46 ET
Table 'Jokaste II' 6-max Seat #4 is the button
Seat 1: Hyd SK ($13.55 in chips) 
Seat 2: T9MS ($12.33 in chips) 
Seat 3: crazydevill ($10.96 in chips) 
Seat 4: FRAID358 ($15.21 in chips) 
Seat 5: Vrinni ($10.18 in chips) 
Seat 6: Adailton07 ($14.30 in chips) 
Vrinni: posts small blind $0.05
Adailton07: posts big blind $0.10
*** HOLE CARDS ***
Hyd SK: folds 
T9MS: folds 
crazydevill: folds 
FRAID358: folds 
Vrinni: folds 
Uncalled bet ($0.05) returned to Adailton07
Adailton07 collected $0.10 from pot
*** SUMMARY ***
Total pot $0.10 | Rake $0 
Seat 1: Hyd SK folded before Flop (didn't bet)
Seat 2: T9MS folded before Flop (didn't bet)
Seat 3: crazydevill folded before Flop (didn't bet)
Seat 4: FRAID358 (button) folded before Flop (didn't bet)
Seat 5: Vrinni (small blind) folded before Flop
Seat 6: Adailton07 (big blind) collected ($0.10)



PokerStars Hand #166667746019:  Hold'em No Limit ($0.05/$0.10 USD) - 2017/02/23 16:06:46 ET
Table 'Hercynia III' 6-max Seat #6 is the button
Seat 1: Bird et al ($14.38 in chips) 
Seat 2: Action_Gibi ($7.14 in chips) 
Seat 3: Dcaro31 ($20.17 in chips) 
Seat 5: THIMUCHIN ($15.45 in chips) 
Seat 6: bdixon_5 ($11.59 in chips) 
Bird et al: posts small blind $0.05
Action_Gibi: posts big blind $0.10
*** HOLE CARDS ***
Dcaro31: folds 
THIMUCHIN: folds 
bdixon_5: folds 
Bird et al: raises $0.20 to $0.30
Action_Gibi: folds 
Uncalled bet ($0.20) returned to Bird et al
Bird et al collected $0.20 from pot
*** SUMMARY ***
Total pot $0.20 | Rake $0 
Seat 1: Bird et al (small blind) collected ($0.20)
Seat 2: Action_Gibi (big blind) folded before Flop
Seat 3: Dcaro31 folded before Flop (didn't bet)
Seat 5: THIMUCHIN folded before Flop (didn't bet)
Seat 6: bdixon_5 (button) folded before Flop (didn't bet)



PokerStars Hand #166667746024:  Hold'em No Limit ($0.05/$0.10 USD) - 2017/02/23 16:06:46 ET
Table 'Lacroute' 6-max Seat #4 is the button
Seat 2: Andy Wolf ($10 in chips) 
Seat 3: Croplayer1 ($14.45 in chips) 
Seat 4: st4tion ($17.37 in chips) 
Seat 5: steepfell ($12.24 in chips) 
Seat 6: IAntikI ($10.12 in chips) 
steepfell: posts small blind $0.05
IAntikI: posts big blind $0.10
Orlangoor: sits out 
*** HOLE CARDS ***
Andy Wolf: folds 
Croplayer1: folds 
st4tion: folds 
steepfell: folds 
Uncalled bet ($0.05) returned to IAntikI
IAntikI collected $0.10 from pot
*** SUMMARY ***
Total pot $0.10 | Rake $0 
Seat 2: Andy Wolf folded before Flop (didn't bet)
Seat 3: Croplayer1 folded before Flop (didn't bet)
Seat 4: st4tion (button) folded before Flop (didn't bet)
Seat 5: steepfell (small blind) folded before Flop
Seat 6: IAntikI (big blind) collected ($0.10)



PokerStars Hand #166667746379:  Hold'em No Limit ($0.05/$0.10 USD) - 2017/02/23 16:06:47 ET
Table 'Pyrrhus III' 6-max Seat #1 is the button
Seat 1: skatejeff ($12.96 in chips) 
Seat 2: univibe68 ($20.18 in chips) 
Seat 3: coolisses111 ($9.85 in chips) 
Seat 4: ex3Lero86 ($23.34 in chips) 
Seat 6: MLPlayer16 ($20.45 in chips) 
univibe68: posts small blind $0.05
coolisses111: posts big blind $0.10
eniksenik: sits out 
skatejeff: posts the ante $0.02
univibe68: posts the ante $0.02
coolisses111: posts the ante $0.02
ex3Lero86: posts the ante $0.02
MLPlayer16: posts the ante $0.02
*** HOLE CARDS ***
ex3Lero86: folds 
MLPlayer16: folds 
skatejeff: raises $0.30 to $0.40
univibe68: calls $0.35
coolisses111: folds 
*** FLOP *** [Qh 4s 2s]
univibe68: checks 
skatejeff: checks 
*** TURN *** [Qh 4s 2s] [Kd]
univibe68: checks 
skatejeff: bets $1.30
univibe68: folds 
Uncalled bet ($1.30) returned to skatejeff
skatejeff collected $0.96 from pot
*** SUMMARY ***
Total pot $1 | Rake $0.04 
Board [Qh 4s 2s Kd]
Seat 1: skatejeff (button) collected ($0.96)
Seat 2: univibe68 (small blind) folded on the Turn
Seat 3: coolisses111 (big blind) folded before Flop
Seat 4: ex3Lero86 folded before Flop (didn't bet)
Seat 6: MLPlayer16 folded before Flop (didn't bet)



PokerStars Hand #166667746382:  Hold'em No Limit ($0.05/$0.10 USD) - 2017/02/23 16:06:47 ET
Table 'Thia' 6-max Seat #4 is the button
Seat 1: Eddys Edge ($11.02 in chips) 
Seat 2: sugrob86 ($19.05 in chips) 
Seat 3: northug18 ($8.84 in chips) 
Seat 4: Bandyaev ($10.20 in chips) 
Seat 5: ab260414 ($10.89 in chips) 
Seat 6: ex3Lero86 ($15.45 in chips) 
ab260414: posts small blind $0.05
ex3Lero86: posts big blind $0.10
*** HOLE CARDS ***
Eddys Edge: folds 
sugrob86: raises $0.25 to $0.35
northug18: calls $0.35
Bandyaev: folds 
ab260414: folds 
ex3Lero86: folds 
*** FLOP *** [Jd Tc 9h]
sugrob86: checks 
northug18: checks 
*** TURN *** [Jd Tc 9h] [6h]
sugrob86: checks 
northug18: bets $0.41
sugrob86: calls $0.41
*** RIVER *** [Jd Tc 9h 6h] [4d]
sugrob86: checks 
northug18: bets $0.80
sugrob86: folds 
Uncalled bet ($0.80) returned to northug18
northug18 collected $1.59 from pot
*** SUMMARY ***
Total pot $1.67 | Rake $0.08 
Board [Jd Tc 9h 6h 4d]
Seat 1: Eddys Edge folded before Flop (didn't bet)
Seat 2: sugrob86 folded on the River
Seat 3: northug18 collected ($1.59)
Seat 4: Bandyaev (button) folded before Flop (didn't bet)
Seat 5: ab260414 (small blind) folded before Flop
Seat 6: ex3Lero86 (big blind) folded before Flop



PokerStars Hand #166667746708:  Hold'em No Limit ($0.05/$0.10 USD) - 2017/02/23 16:06:47 ET
Table 'Izar' 6-max Seat #6 is the button
Seat 1: bambolejro ($10.29 in chips) 
Seat 2: mvp0013 ($8.23 in chips) 
Seat 3: Yspenyanin ($11.27 in chips) 
Seat 4: Matee92 ($6.01 in chips) 
Seat 5: fishhook5 ($11.30 in chips) 
Seat 6: yodzik ($7.79 in chips) 
bambolejro: posts small blind $0.05
mvp0013: posts big blind $0.10
*** HOLE CARDS ***
Yspenyanin: folds 
Matee92: folds 
fishhook5: folds 
yodzik: folds 
bambolejro: raises $0.15 to $0.25
mvp0013: calls $0.15
*** FLOP *** [Jc Jh 8d]
bambolejro: checks 
mvp0013: checks 
*** TURN *** [Jc Jh 8d] [Ah]
bambolejro: bets $0.33
mvp0013: folds 
Uncalled bet ($0.33) returned to bambolejro
bambolejro collected $0.48 from pot
*** SUMMARY ***
Total pot $0.50 | Rake $0.02 
Board [Jc Jh 8d Ah]
Seat 1: bambolejro (small blind) collected ($0.48)
Seat 2: mvp0013 (big blind) folded on the Turn
Seat 3: Yspenyanin folded before Flop (didn't bet)
Seat 4: Matee92 folded before Flop (didn't bet)
Seat 5: fishhook5 folded before Flop (didn't bet)
Seat 6: yodzik (button) folded before Flop (didn't bet)



PokerStars Hand #166667746835:  Hold'em No Limit ($0.05/$0.10 USD) - 2017/02/23 16:06:47 ET
Table 'Camilla II' 6-max Seat #6 is the button
Seat 1: paxit71 ($7.95 in chips) 
Seat 2: Giyorod ($16.11 in chips) 
Seat 3: Andy Wolf ($10 in chips) 
Seat 4: chimera252 ($12.41 in chips) 
Seat 5: LarryTheStar ($11.42 in chips) 
Seat 6: david_sara83 ($10 in chips) 
paxit71: posts small blind $0.05
Giyorod: posts big blind $0.10
*** HOLE CARDS ***
Andy Wolf: raises $0.20 to $0.30
chimera252: folds 
LarryTheStar: calls $0.30
david_sara83: folds 
paxit71: folds 
Giyorod: raises $0.95 to $1.25
Andy Wolf: calls $0.95
LarryTheStar: folds 
*** FLOP *** [6h Js 6d]
Giyorod: bets $1.50
Andy Wolf: calls $1.50
*** TURN *** [6h Js 6d] [2d]
Giyorod: checks 
Andy Wolf: bets $3
Giyorod: folds 
Uncalled bet ($3) returned to Andy Wolf
Andy Wolf collected $5.59 from pot
*** SUMMARY ***
Total pot $5.85 | Rake $0.26 
Board [6h Js 6d 2d]
Seat 1: paxit71 (small blind) folded before Flop
Seat 2: Giyorod (big blind) folded on the Turn
Seat 3: Andy Wolf collected ($5.59)
Seat 4: chimera252 folded before Flop (didn't bet)
Seat 5: LarryTheStar folded before Flop
Seat 6: david_sara83 (button) folded before Flop (didn't bet)



PokerStars Hand #166667746968:  Hold'em No Limit ($0.05/$0.10 USD) - 2017/02/23 16:06:48 ET
Table 'Nata II' 6-max Seat #3 is the button
Seat 1: luisantrs ($8.95 in chips) 
Seat 2: CHRO8 ($15.70 in chips) 
Seat 3: 8th wonders ($10 in chips) 
Seat 4: Comeback3392 ($10.05 in chips) 
Seat 5: RoJ1 ($12.08 in chips) 
Seat 6: IAntikI ($10 in chips) 
Comeback3392: posts small blind $0.05
RoJ1: posts big blind $0.10
*** HOLE CARDS ***
IAntikI: folds 
IAntikI leaves the table
WinninBikini joins the table at seat #6 
luisantrs: folds 
CHRO8: folds 
8th wonders: folds 
Comeback3392: folds 
Uncalled bet ($0.05) returned to RoJ1
RoJ1 collected $0.10 from pot
*** SUMMARY ***
Total pot $0.10 | Rake $0 
Seat 1: luisantrs folded before Flop (didn't bet)
Seat 2: CHRO8 folded before Flop (didn't bet)
Seat 3: 8th wonders (button) folded before Flop (didn't bet)
Seat 4: Comeback3392 (small blind) folded before Flop
Seat 5: RoJ1 (big blind) collected ($0.10)
Seat 6: IAntikI folded before Flop (didn't bet)



PokerStars Hand #166667747055:  Hold'em No Limit ($0.05/$0.10 USD) - 2017/02/23 16:06:48 ET
Table 'Landi II' 6-max Seat #4 is the button
Seat 1: dersiemer ($11.83 in chips) 
Seat 2: Aescul@pius ($10.80 in chips) 
Seat 3: dr.goofy ($21.29 in chips) 
Seat 4: alesi13 ($6.58 in chips) 
Seat 5: Bird et al ($10.30 in chips) 
Bird et al: posts small blind $0.05
dersiemer: posts big blind $0.10
*** HOLE CARDS ***
Aescul@pius: raises $0.20 to $0.30
dr.goofy: folds 
alesi13: folds 
Bird et al: folds 
dersiemer: calls $0.20
*** FLOP *** [3c Kc 9d]
dersiemer: checks 
Aescul@pius: bets $0.40
dersiemer: calls $0.40
*** TURN *** [3c Kc 9d] [Jd]
dersiemer: checks 
Aescul@pius: checks 
*** RIVER *** [3c Kc 9d Jd] [Kd]
dersiemer: bets $0.70
Aescul@pius: folds 
Uncalled bet ($0.70) returned to dersiemer
dersiemer collected $1.38 from pot
*** SUMMARY ***
Total pot $1.45 | Rake $0.07 
Board [3c Kc 9d Jd Kd]
Seat 1: dersiemer (big blind) collected ($1.38)
Seat 2: Aescul@pius folded on the River
Seat 3: dr.goofy folded before Flop (didn't bet)
Seat 4: alesi13 (button) folded before Flop (didn't bet)
Seat 5: Bird et al (small blind) folded before Flop



PokerStars Hand #166667747755:  Hold'em No Limit ($0.05/$0.10 USD) - 2017/02/23 16:06:48 ET
Table 'Atropos' 6-max Seat #3 is the button
Seat 1: ScorpionF39 ($2.07 in chips) 
Seat 2: yodzik ($5 in chips) 
Seat 3: NvR.m1nD ($10.10 in chips) 
Seat 4: iDecMate ($11.02 in chips) 
Seat 5: KokoulinV ($12.09 in chips) 
Seat 6: Iarlei ($12.58 in chips) 
iDecMate: posts small blind $0.05
KokoulinV: posts big blind $0.10
*** HOLE CARDS ***
Iarlei: folds 
ScorpionF39: folds 
yodzik: folds 
NvR.m1nD: raises $0.15 to $0.25
iDecMate: folds 
KokoulinV: calls $0.15
*** FLOP *** [2s Ac 9h]
KokoulinV: checks 
NvR.m1nD: bets $0.28
KokoulinV: folds 
Uncalled bet ($0.28) returned to NvR.m1nD
NvR.m1nD collected $0.53 from pot
*** SUMMARY ***
Total pot $0.55 | Rake $0.02 
Board [2s Ac 9h]
Seat 1: ScorpionF39 folded before Flop (didn't bet)
Seat 2: yodzik folded before Flop (didn't bet)
Seat 3: NvR.m1nD (button) collected ($0.53)
Seat 4: iDecMate (small blind) folded before Flop
Seat 5: KokoulinV (big blind) folded on the Flop
Seat 6: Iarlei folded before Flop (didn't bet)



PokerStars Hand #166667747814:  Hold'em No Limit ($0.05/$0.10 USD) - 2017/02/23 16:06:48 ET
Table 'Siebohme' 6-max Seat #4 is the button
Seat 1: kusa4ki ($11.53 in chips) 
Seat 2: el toro 1507 ($11.53 in chips) 
Seat 3: ex3Lero86 ($10.41 in chips) 
Seat 4: Innerwuss ($10.30 in chips) 
Seat 5: Kazacha ($10 in chips) 
Seat 6: townerz1991 ($10.53 in chips) 
Kazacha: posts small blind $0.05
townerz1991: posts big blind $0.10
*** HOLE CARDS ***
kusa4ki: folds 
el toro 1507: folds 
ex3Lero86: folds 
Innerwuss: raises $0.10 to $0.20
Kazacha: folds 
townerz1991: calls $0.10
*** FLOP *** [8s Ah 2s]
townerz1991: checks 
Innerwuss: checks 
*** TURN *** [8s Ah 2s] [5c]
townerz1991: bets $0.30
Innerwuss: calls $0.30
*** RIVER *** [8s Ah 2s 5c] [9s]
townerz1991: bets $0.80
Innerwuss: raises $9 to $9.80 and is all-in
townerz1991: folds 
Uncalled bet ($9) returned to Innerwuss
Innerwuss collected $2.53 from pot
*** SUMMARY ***
Total pot $2.65 | Rake $0.12 
Board [8s Ah 2s 5c 9s]
Seat 1: kusa4ki folded before Flop (didn't bet)
Seat 2: el toro 1507 folded before Flop (didn't bet)
Seat 3: ex3Lero86 folded before Flop (didn't bet)
Seat 4: Innerwuss (button) collected ($2.53)
Seat 5: Kazacha (small blind) folded before Flop
Seat 6: townerz1991 (big blind) folded on the River



PokerStars Hand #166667747902:  Hold'em No Limit ($0.05/$0.10 USD) - 2017/02/23 16:06:49 ET
Table 'Cassini' 6-max Seat #4 is the button
Seat 1: Pokeaster ($10.57 in chips) 
Seat 2: mhonielsen ($12.41 in chips) 
Seat 4: fortieth ($13.97 in chips) 
x3ultimate will be allowed to play after the button
MihaGr will be allowed to play after the button
Pokeaster: posts small blind $0.05
mhonielsen: posts big blind $0.10
*** HOLE CARDS ***
fortieth: raises $0.25 to $0.35
x3ultimate leaves the table
Pokeaster: folds 
mhonielsen: folds 
Uncalled bet ($0.25) returned to fortieth
fortieth collected $0.25 from pot
*** SUMMARY ***
Total pot $0.25 | Rake $0 
Seat 1: Pokeaster (small blind) folded before Flop
Seat 2: mhonielsen (big blind) folded before Flop
Seat 4: fortieth (button) collected ($0.25)



PokerStars Hand #166667748149:  Hold'em No Limit ($0.05/$0.10 USD) - 2017/02/23 16:06:49 ET
Table 'Nikko II' 6-max Seat #4 is the button
Seat 1: bdixon_5 ($10.37 in chips) 
Seat 2: popypaleta ($10.10 in chips) 
Seat 3: Hyd SK ($12.01 in chips) 
Seat 4: Peter0087 ($9.85 in chips) 
Seat 5: Aescul@pius ($12.23 in chips) 
Seat 6: JahSoldier69 ($10.15 in chips) 
Aescul@pius: posts small blind $0.05
JahSoldier69: posts big blind $0.10
*** HOLE CARDS ***
bdixon_5: folds 
popypaleta: folds 
Hyd SK: raises $0.25 to $0.35
Peter0087: calls $0.35
Aescul@pius: folds 
JahSoldier69: folds 
*** FLOP *** [Kh 5h 6c]
Hyd SK: checks 
Peter0087: bets $0.70
Hyd SK: folds 
Uncalled bet ($0.70) returned to Peter0087
Peter0087 collected $0.81 from pot
*** SUMMARY ***
Total pot $0.85 | Rake $0.04 
Board [Kh 5h 6c]
Seat 1: bdixon_5 folded before Flop (didn't bet)
Seat 2: popypaleta folded before Flop (didn't bet)
Seat 3: Hyd SK folded on the Flop
Seat 4: Peter0087 (button) collected ($0.81)
Seat 5: Aescul@pius (small blind) folded before Flop
Seat 6: JahSoldier69 (big blind) folded before Flop



PokerStars Hand #166667748605:  Hold'em No Limit ($0.05/$0.10 USD) - 2017/02/23 16:06:49 ET
Table 'Siebohme II' 6-max Seat #4 is the button
Seat 1: homelessdan ($17.97 in chips) 
Seat 2: townerz1991 ($14.17 in chips) 
Seat 3: D3NyA ($10.18 in chips) 
Seat 4: POT_TRADER ($12.14 in chips) 
Seat 5: NvR.m1nD ($10.62 in chips) 
Seat 6: Fozzy690 ($9.92 in chips) 
NvR.m1nD: posts small blind $0.05
Fozzy690: posts big blind $0.10
*** HOLE CARDS ***
homelessdan: folds 
townerz1991: folds 
D3NyA: raises $0.15 to $0.25
POT_TRADER: folds 
NvR.m1nD: folds 
Fozzy690: folds 
Uncalled bet ($0.15) returned to D3NyA
D3NyA collected $0.25 from pot
*** SUMMARY ***
Total pot $0.25 | Rake $0 
Seat 1: homelessdan folded before Flop (didn't bet)
Seat 2: townerz1991 folded before Flop (didn't bet)
Seat 3: D3NyA collected ($0.25)
Seat 4: POT_TRADER (button) folded before Flop (didn't bet)
Seat 5: NvR.m1nD (small blind) folded before Flop
Seat 6: Fozzy690 (big blind) folded before Flop



PokerStars Hand #166667748768:  Hold'em No Limit ($0.05/$0.10 USD) - 2017/02/23 16:06:49 ET
Table 'Caupolican II' 6-max Seat #6 is the button
Seat 1: Strelok1974 ($10.05 in chips) 
Seat 2: MBen10 ($20.95 in chips) 
Seat 3: fedorka rus ($12.13 in chips) 
Seat 4: GESPERIA ($21.42 in chips) 
Seat 5: ArcticBearDK ($15.45 in chips) 
Seat 6: pancernik21 ($13.15 in chips) 
Strelok1974: posts small blind $0.05
MBen10: posts big blind $0.10
*** HOLE CARDS ***
fedorka rus: raises $0.20 to $0.30
GESPERIA: folds 
ArcticBearDK: folds 
pancernik21: folds 
Strelok1974: calls $0.25
MBen10: calls $0.20
*** FLOP *** [5d 3s 2s]
Strelok1974: checks 
MBen10: checks 
fedorka rus: checks 
*** TURN *** [5d 3s 2s] [5h]
Strelok1974: checks 
MBen10: bets $0.57
fedorka rus: folds 
Strelok1974: folds 
Uncalled bet ($0.57) returned to MBen10
MBen10 collected $0.86 from pot
*** SUMMARY ***
Total pot $0.90 | Rake $0.04 
Board [5d 3s 2s 5h]
Seat 1: Strelok1974 (small blind) folded on the Turn
Seat 2: MBen10 (big blind) collected ($0.86)
Seat 3: fedorka rus folded on the Turn
Seat 4: GESPERIA folded before Flop (didn't bet)
Seat 5: ArcticBearDK folded before Flop (didn't bet)
Seat 6: pancernik21 (button) folded before Flop (didn't bet)



PokerStars Hand #166667749167:  Hold'em No Limit ($0.05/$0.10 USD) - 2017/02/23 16:06:50 ET
Table 'Wil' 6-max Seat #3 is the button
Seat 1: jwhelan94 ($23.09 in chips) 
Seat 2: Vrinni ($21.95 in chips) 
Seat 3: Namhkal ($10 in chips) 
Seat 4: x3ultimate ($10.60 in chips) 
Seat 5: Feverhead ($14.06 in chips) 
Seat 6: Comeback3392 ($13.78 in chips) 
x3ultimate: posts small blind $0.05
Feverhead: posts big blind $0.10
*** HOLE CARDS ***
Comeback3392: folds 
jwhelan94: raises $0.20 to $0.30
Vrinni: folds 
Namhkal: folds 
x3ultimate: raises $0.70 to $1
Feverhead: folds 
jwhelan94: raises $2 to $3
x3ultimate: folds 
Uncalled bet ($2) returned to jwhelan94
jwhelan94 collected $2.10 from pot
*** SUMMARY ***
Total pot $2.10 | Rake $0 
Seat 1: jwhelan94 collected ($2.10)
Seat 2: Vrinni folded before Flop (didn't bet)
Seat 3: Namhkal (button) folded before Flop (didn't bet)
Seat 4: x3ultimate (small blind) folded before Flop
Seat 5: Feverhead (big blind) folded before Flop
Seat 6: Comeback3392 folded before Flop (didn't bet)



PokerStars Hand #166667749364:  Hold'em No Limit ($0.05/$0.10 USD) - 2017/02/23 16:06:50 ET
Table 'Lorbach' 6-max Seat #1 is the button
Seat 1: LarryTheStar ($15.85 in chips) 
Seat 3: ArcticBearDK ($10 in chips) 
Seat 4: McCleans ($10 in chips) 
Seat 5: Cluckh ($14.47 in chips) 
Seat 6: Worlz ($15.73 in chips) 
fabadam will be allowed to play after the button
ArcticBearDK: posts small blind $0.05
McCleans: posts big blind $0.10
*** HOLE CARDS ***
Cluckh: folds 
Worlz: folds 
Cluckh leaves the table
LarryTheStar: raises $0.10 to $0.20
ArcticBearDK: raises $0.70 to $0.90
McCleans: folds 
Vanpoker84 joins the table at seat #5 
LarryTheStar: calls $0.70
*** FLOP *** [Kd 3h As]
ArcticBearDK: bets $0.80
LarryTheStar: calls $0.80
*** TURN *** [Kd 3h As] [3s]
ArcticBearDK: checks 
LarryTheStar: checks 
*** RIVER *** [Kd 3h As 3s] [Ah]
ArcticBearDK: checks 
LarryTheStar: checks 
*** SHOW DOWN ***
ArcticBearDK: shows [9h 9d] (two pair, Aces and Nines)
LarryTheStar: shows [Jd Jc] (two pair, Aces and Jacks)
LarryTheStar collected $3.34 from pot
*** SUMMARY ***
Total pot $3.50 | Rake $0.16 
Board [Kd 3h As 3s Ah]
Seat 1: LarryTheStar (button) showed [Jd Jc] and won ($3.34) with two pair, Aces and Jacks
Seat 3: ArcticBearDK (small blind) showed [9h 9d] and lost with two pair, Aces and Nines
Seat 4: McCleans (big blind) folded before Flop
Seat 5: Cluckh folded before Flop (didn't bet)
Seat 6: Worlz folded before Flop (didn't bet)



PokerStars Hand #166667749754:  Hold'em No Limit ($0.05/$0.10 USD) - 2017/02/23 16:06:51 ET
Table 'Pulcova II' 6-max Seat #5 is the button
Seat 1: sexy_seagull ($13.40 in chips) 
Seat 2: Kazacha ($10 in chips) 
Seat 3: Lao Tsy ($14.52 in chips) 
Seat 4: VioXion ($10.25 in chips) 
Seat 5: mdelfin0 ($10.09 in chips) 
Seat 6: Ice_Isayev ($10.55 in chips) 
Ice_Isayev: posts small blind $0.05
sexy_seagull: posts big blind $0.10
*** HOLE CARDS ***
Kazacha: folds 
Lao Tsy: raises $0.20 to $0.30
VioXion: calls $0.30
mdelfin0: folds 
Ice_Isayev: folds 
sexy_seagull: raises $0.90 to $1.20
Lao Tsy: folds 
VioXion: calls $0.90
*** FLOP *** [6c 3h Kc]
sexy_seagull: checks 
VioXion: bets $1.32
sexy_seagull: calls $1.32
*** TURN *** [6c 3h Kc] [Qc]
sexy_seagull: checks 
VioXion: bets $2.58
sexy_seagull: folds 
Uncalled bet ($2.58) returned to VioXion
VioXion collected $5.15 from pot
*** SUMMARY ***
Total pot $5.39 | Rake $0.24 
Board [6c 3h Kc Qc]
Seat 1: sexy_seagull (big blind) folded on the Turn
Seat 2: Kazacha folded before Flop (didn't bet)
Seat 3: Lao Tsy folded before Flop
Seat 4: VioXion collected ($5.15)
Seat 5: mdelfin0 (button) folded before Flop (didn't bet)
Seat 6: Ice_Isayev (small blind) folded before Flop



PokerStars Hand #166667749885:  Hold'em No Limit ($0.05/$0.10 USD) - 2017/02/23 16:06:51 ET
Table 'Carina' 6-max Seat #5 is the button
Seat 1: Kupi007 ($10 in chips) 
Seat 2: kickereens ($24.29 in chips) 
Seat 3: LarryTheStar ($11.52 in chips) 
Seat 5: IAntikI ($10.15 in chips) 
Seat 6: alexweezer ($8.40 in chips) 
alexweezer: posts small blind $0.05
Kupi007: posts big blind $0.10
steepfell: sits out 
*** HOLE CARDS ***
kickereens: raises $0.20 to $0.30
LarryTheStar: folds 
IAntikI: folds 
alexweezer: folds 
Kupi007: folds 
Uncalled bet ($0.20) returned to kickereens
kickereens collected $0.25 from pot
*** SUMMARY ***
Total pot $0.25 | Rake $0 
Seat 1: Kupi007 (big blind) folded before Flop
Seat 2: kickereens collected ($0.25)
Seat 3: LarryTheStar folded before Flop (didn't bet)
Seat 5: IAntikI (button) folded before Flop (didn't bet)
Seat 6: alexweezer (small blind) folded before Flop



PokerStars Hand #166667749996:  Hold'em No Limit ($0.05/$0.10 USD) - 2017/02/23 16:06:51 ET
Table 'Iduberga II' 6-max Seat #2 is the button
Seat 1: mhonielsen ($11.06 in chips) 
Seat 2: popypaleta ($12.80 in chips) 
Seat 3: scorpionfish ($11.48 in chips) 
Seat 4: Peter0087 ($9.88 in chips) 
Seat 5: Pokeaster ($11.38 in chips) 
Seat 6: tblocos ($11.19 in chips) 
scorpionfish: posts small blind $0.05
Peter0087: posts big blind $0.10
*** HOLE CARDS ***
Pokeaster: folds 
tblocos: folds 
mhonielsen has timed out
mhonielsen: folds 
popypaleta: raises $0.20 to $0.30
scorpionfish: folds 
Peter0087: folds 
Uncalled bet ($0.20) returned to popypaleta
popypaleta collected $0.25 from pot
*** SUMMARY ***
Total pot $0.25 | Rake $0 
Seat 1: mhonielsen folded before Flop (didn't bet)
Seat 2: popypaleta (button) collected ($0.25)
Seat 3: scorpionfish (small blind) folded before Flop
Seat 4: Peter0087 (big blind) folded before Flop
Seat 5: Pokeaster folded before Flop (didn't bet)
Seat 6: tblocos folded before Flop (didn't bet)



PokerStars Hand #166667750120:  Hold'em No Limit ($0.05/$0.10 USD) - 2017/02/23 16:06:51 ET
Table 'Caupolican' 6-max Seat #1 is the button
Seat 1: kingartur222 ($11.49 in chips) 
Seat 2: garigura ($18.80 in chips) 
Seat 4: mhonielsen ($15.79 in chips) 
Seat 5: Kazacha ($11.51 in chips) 
Seat 6: crazydevill ($10 in chips) 
garigura: posts small blind $0.05
mhonielsen: posts big blind $0.10
*** HOLE CARDS ***
Kazacha: raises $0.14 to $0.24
crazydevill: calls $0.24
kingartur222: folds 
garigura: folds 
mhonielsen: calls $0.14
*** FLOP *** [Jc Jh 3d]
mhonielsen: bets $0.43
arturgalant leaves the table
x3ultimate joins the table at seat #3 
Kazacha: calls $0.43
x3ultimate leaves the table
crazydevill: folds 
*** TURN *** [Jc Jh 3d] [9c]
mhonielsen: checks 
ducksheep82 joins the table at seat #3 
Kazacha: bets $1.20
mhonielsen: folds 
Uncalled bet ($1.20) returned to Kazacha
Kazacha collected $1.56 from pot
*** SUMMARY ***
Total pot $1.63 | Rake $0.07 
Board [Jc Jh 3d 9c]
Seat 1: kingartur222 (button) folded before Flop (didn't bet)
Seat 2: garigura (small blind) folded before Flop
Seat 4: mhonielsen (big blind) folded on the Turn
Seat 5: Kazacha collected ($1.56)
Seat 6: crazydevill folded on the Flop



PokerStars Hand #166667750143:  Hold'em No Limit ($0.05/$0.10 USD) - 2017/02/23 16:06:51 ET
Table 'Ophelia' 6-max Seat #1 is the button
Seat 1: ralfi37 ($10.40 in chips) 
Seat 2: popypaleta ($16.53 in chips) 
Seat 3: mvp0013 ($10.80 in chips) 
Seat 4: Cluckh ($12.14 in chips) 
Seat 5: truck1234 ($13.86 in chips) 
Seat 6: Yabidooo ($11.13 in chips) 
popypaleta: posts small blind $0.05
mvp0013: posts big blind $0.10
*** HOLE CARDS ***
Cluckh: folds 
truck1234: calls $0.10
Yabidooo: folds 
ralfi37: calls $0.10
popypaleta: folds 
mvp0013: checks 
*** FLOP *** [9h Kd Ah]
mvp0013: checks 
truck1234: bets $0.20
ralfi37: calls $0.20
mvp0013: folds 
*** TURN *** [9h Kd Ah] [8d]
truck1234: checks 
ralfi37: checks 
*** RIVER *** [9h Kd Ah 8d] [Jc]
truck1234: checks 
ralfi37: checks 
*** SHOW DOWN ***
truck1234: shows [8h 7h] (a pair of Eights)
ralfi37: shows [7s Ac] (a pair of Aces)
ralfi37 collected $0.72 from pot
*** SUMMARY ***
Total pot $0.75 | Rake $0.03 
Board [9h Kd Ah 8d Jc]
Seat 1: ralfi37 (button) showed [7s Ac] and won ($0.72) with a pair of Aces
Seat 2: popypaleta (small blind) folded before Flop
Seat 3: mvp0013 (big blind) folded on the Flop
Seat 4: Cluckh folded before Flop (didn't bet)
Seat 5: truck1234 showed [8h 7h] and lost with a pair of Eights
Seat 6: Yabidooo folded before Flop (didn't bet)



PokerStars Hand #166667750206:  Hold'em No Limit ($0.05/$0.10 USD) - 2017/02/23 16:06:51 ET
Table 'Tyndareus II' 6-max Seat #6 is the button
Seat 1: Makc1705 ($3.55 in chips) 
Seat 2: fishhook5 ($10 in chips) 
Seat 3: McCleans ($12.05 in chips) 
Seat 4: gaHy_HaXeP ($10.61 in chips) 
Seat 5: vtalian ($9.85 in chips) 
Seat 6: sexy_seagull ($10.30 in chips) 
Makc1705: posts small blind $0.05
fishhook5: posts big blind $0.10
*** HOLE CARDS ***
McCleans: raises $0.20 to $0.30
gaHy_HaXeP: folds 
vtalian: folds 
sexy_seagull: calls $0.30
Makc1705: calls $0.25
fishhook5: folds 
*** FLOP *** [5s 6s 5c]
Makc1705: checks 
McCleans: checks 
sexy_seagull: checks 
*** TURN *** [5s 6s 5c] [9c]
Makc1705: bets $0.20
McCleans: calls $0.20
sexy_seagull: folds 
*** RIVER *** [5s 6s 5c 9c] [4s]
Makc1705: bets $0.55
McCleans: folds 
Uncalled bet ($0.55) returned to Makc1705
Makc1705 collected $1.34 from pot
*** SUMMARY ***
Total pot $1.40 | Rake $0.06 
Board [5s 6s 5c 9c 4s]
Seat 1: Makc1705 (small blind) collected ($1.34)
Seat 2: fishhook5 (big blind) folded before Flop
Seat 3: McCleans folded on the River
Seat 4: gaHy_HaXeP folded before Flop (didn't bet)
Seat 5: vtalian folded before Flop (didn't bet)
Seat 6: sexy_seagull (button) folded on the Turn



PokerStars Hand #166667750607:  Hold'em No Limit ($0.05/$0.10 USD) - 2017/02/23 16:06:51 ET
Table 'Tomyris II' 6-max Seat #6 is the button
Seat 1: ArcticBearDK ($21.88 in chips) 
Seat 2: Yspenyanin ($12.39 in chips) 
Seat 3: robertsabb ($12.13 in chips) 
Seat 4: Dcaro31 ($10 in chips) 
Seat 5: 6ePeMeHHa9 ($11.80 in chips) 
Seat 6: StackSmakka ($10.12 in chips) 
ArcticBearDK: posts small blind $0.05
Yspenyanin: posts big blind $0.10
*** HOLE CARDS ***
robertsabb: folds 
Dcaro31: folds 
6ePeMeHHa9: folds 
StackSmakka: raises $0.13 to $0.23
ArcticBearDK: folds 
Yspenyanin: raises $0.51 to $0.74
StackSmakka: folds 
Uncalled bet ($0.51) returned to Yspenyanin
Yspenyanin collected $0.51 from pot
*** SUMMARY ***
Total pot $0.51 | Rake $0 
Seat 1: ArcticBearDK (small blind) folded before Flop
Seat 2: Yspenyanin (big blind) collected ($0.51)
Seat 3: robertsabb folded before Flop (didn't bet)
Seat 4: Dcaro31 folded before Flop (didn't bet)
Seat 5: 6ePeMeHHa9 folded before Flop (didn't bet)
Seat 6: StackSmakka (button) folded before Flop



PokerStars Hand #166667750683:  Hold'em No Limit ($0.05/$0.10 USD) - 2017/02/23 16:06:52 ET
Table 'Virginia II' 6-max Seat #1 is the button
Seat 1: Iarlei ($11.41 in chips) 
Seat 2: Yspenyanin ($10.05 in chips) 
Seat 3: garigura ($15.26 in chips) 
Seat 4: onkelottoHH ($10.73 in chips) 
Seat 5: dr.goofy ($20.98 in chips) 
Seat 6: NvR.m1nD ($10 in chips) 
Yspenyanin: posts small blind $0.05
garigura: posts big blind $0.10
*** HOLE CARDS ***
onkelottoHH: folds 
dr.goofy: folds 
NvR.m1nD: folds 
Iarlei: folds 
Yspenyanin: raises $0.15 to $0.25
garigura: calls $0.15
*** FLOP *** [9d 8d 5s]
Yspenyanin: checks 
garigura: bets $0.32
Yspenyanin: calls $0.32
*** TURN *** [9d 8d 5s] [2h]
Yspenyanin: checks 
garigura: bets $0.82
Yspenyanin: folds 
Uncalled bet ($0.82) returned to garigura
garigura collected $1.09 from pot
*** SUMMARY ***
Total pot $1.14 | Rake $0.05 
Board [9d 8d 5s 2h]
Seat 1: Iarlei (button) folded before Flop (didn't bet)
Seat 2: Yspenyanin (small blind) folded on the Turn
Seat 3: garigura (big blind) collected ($1.09)
Seat 4: onkelottoHH folded before Flop (didn't bet)
Seat 5: dr.goofy folded before Flop (didn't bet)
Seat 6: NvR.m1nD folded before Flop (didn't bet)



PokerStars Hand #166667751424:  Hold'em No Limit ($0.05/$0.10 USD) - 2017/02/23 16:06:52 ET
Table 'Apollonia' 6-max Seat #4 is the button
Seat 1: ex3Lero86 ($10.16 in chips) 
Seat 2: ibara000 ($18.43 in chips) 
Seat 3: steepfell ($10.10 in chips) 
Seat 4: Goroshkos88 ($17.72 in chips) 
iluzja12 will be allowed to play after the button
ex3Lero86: posts small blind $0.05
ibara000: posts big blind $0.10
*** HOLE CARDS ***
bambolejro joins the table at seat #5 
steepfell: folds 
Goroshkos88: raises $0.15 to $0.25
ex3Lero86: folds 
ibara000: folds 
Uncalled bet ($0.15) returned to Goroshkos88
Goroshkos88 collected $0.25 from pot
*** SUMMARY ***
Total pot $0.25 | Rake $0 
Seat 1: ex3Lero86 (small blind) folded before Flop
Seat 2: ibara000 (big blind) folded before Flop
Seat 3: steepfell folded before Flop (didn't bet)
Seat 4: Goroshkos88 (button) collected ($0.25)



PokerStars Hand #166667751500:  Hold'em No Limit ($0.05/$0.10 USD) - 2017/02/23 16:06:52 ET
Table 'Hamal II' 6-max Seat #5 is the button
Seat 1: saxoalto2011 ($7.79 in chips) 
Seat 2: pancernik21 ($10.15 in chips) 
Seat 3: Cluckh ($10.99 in chips) 
Seat 4: ArcticBearDK ($11.06 in chips) 
Seat 5: eniksenik ($10.74 in chips) 
Seat 6: LarryTheStar ($11.59 in chips) 
LarryTheStar: posts small blind $0.05
saxoalto2011: posts big blind $0.10
*** HOLE CARDS ***
pancernik21: folds 
Cluckh: folds 
ArcticBearDK: folds 
eniksenik: raises $0.20 to $0.30
LarryTheStar: folds 
saxoalto2011: folds 
Uncalled bet ($0.20) returned to eniksenik
eniksenik collected $0.25 from pot
*** SUMMARY ***
Total pot $0.25 | Rake $0 
Seat 1: saxoalto2011 (big blind) folded before Flop
Seat 2: pancernik21 folded before Flop (didn't bet)
Seat 3: Cluckh folded before Flop (didn't bet)
Seat 4: ArcticBearDK folded before Flop (didn't bet)
Seat 5: eniksenik (button) collected ($0.25)
Seat 6: LarryTheStar (small blind) folded before Flop



PokerStars Hand #166667752047:  Hold'em No Limit ($0.05/$0.10 USD) - 2017/02/23 16:06:53 ET
Table 'Halawe II' 6-max Seat #5 is the button
Seat 1: DIGOR100 ($6.81 in chips) 
Seat 3: cherep61987 ($10.79 in chips) 
Seat 4: voledy ($12.45 in chips) 
Seat 5: takis nik ($12.28 in chips) 
Seat 6: Rodik002 ($20.60 in chips) 
Rodik002: posts small blind $0.05
DIGOR100: posts big blind $0.10
*** HOLE CARDS ***
cherep61987: folds 
voledy: folds 
takis nik: folds 
Rodik002: raises $0.15 to $0.25
DIGOR100: calls $0.15
*** FLOP *** [Ac 5s 3d]
Rodik002: checks 
DIGOR100: checks 
*** TURN *** [Ac 5s 3d] [Qs]
Rodik002: checks 
DIGOR100: bets $0.10
Rodik002: calls $0.10
*** RIVER *** [Ac 5s 3d Qs] [Qd]
Rodik002: checks 
DIGOR100: bets $0.10
Rodik002: raises $0.60 to $0.70
DIGOR100: calls $0.60
*** SHOW DOWN ***
Rodik002: shows [Js Qh] (three of a kind, Queens)
DIGOR100: mucks hand 
Rodik002 collected $2.01 from pot
*** SUMMARY ***
Total pot $2.10 | Rake $0.09 
Board [Ac 5s 3d Qs Qd]
Seat 1: DIGOR100 (big blind) mucked
Seat 3: cherep61987 folded before Flop (didn't bet)
Seat 4: voledy folded before Flop (didn't bet)
Seat 5: takis nik (button) folded before Flop (didn't bet)
Seat 6: Rodik002 (small blind) showed [Js Qh] and won ($2.01) with three of a kind, Queens



PokerStars Hand #166667752167:  Hold'em No Limit ($0.05/$0.10 USD) - 2017/02/23 16:06:53 ET
Table 'Marghanna II' 6-max Seat #6 is the button
Seat 1: Goroshkos88 ($10 in chips) 
Seat 2: Namhkal ($11.41 in chips) 
Seat 3: Innerwuss ($12.65 in chips) 
Seat 4: D3NyA ($12.22 in chips) 
Seat 5: ofl21189 ($6.95 in chips) 
Seat 6: VAD21 ($12.96 in chips) 
Goroshkos88: posts small blind $0.05
Namhkal: posts big blind $0.10
*** HOLE CARDS ***
Innerwuss: folds 
D3NyA: folds 
Innerwuss leaves the table
ofl21189: raises $0.25 to $0.35
VAD21: folds 
Goroshkos88: folds 
Namhkal: folds 
Uncalled bet ($0.25) returned to ofl21189
ofl21189 collected $0.25 from pot
*** SUMMARY ***
Total pot $0.25 | Rake $0 
Seat 1: Goroshkos88 (small blind) folded before Flop
Seat 2: Namhkal (big blind) folded before Flop
Seat 3: Innerwuss folded before Flop (didn't bet)
Seat 4: D3NyA folded before Flop (didn't bet)
Seat 5: ofl21189 collected ($0.25)
Seat 6: VAD21 (button) folded before Flop (didn't bet)



PokerStars Hand #166667752261:  Hold'em No Limit ($0.05/$0.10 USD) - 2017/02/23 16:06:53 ET
Table 'Aisakos II' 6-max Seat #3 is the button
Seat 1: Crafty23@PS ($10.50 in chips) 
Seat 2: svaika24 ($16.83 in chips) 
Seat 3: iamkakaroto ($10.39 in chips) 
Seat 4: T9MS ($10.20 in chips) 
Seat 5: KokoulinV ($12.05 in chips) 
Seat 6: LarryTheStar ($10.23 in chips) 
T9MS: posts small blind $0.05
KokoulinV: posts big blind $0.10
*** HOLE CARDS ***
LarryTheStar: folds 
Crafty23@PS: folds 
svaika24: folds 
iamkakaroto: raises $0.15 to $0.25
T9MS: folds 
KokoulinV: calls $0.15
*** FLOP *** [Qd 7c 3c]
KokoulinV: checks 
iamkakaroto: bets $0.34
KokoulinV: folds 
Uncalled bet ($0.34) returned to iamkakaroto
iamkakaroto collected $0.53 from pot
*** SUMMARY ***
Total pot $0.55 | Rake $0.02 
Board [Qd 7c 3c]
Seat 1: Crafty23@PS folded before Flop (didn't bet)
Seat 2: svaika24 folded before Flop (didn't bet)
Seat 3: iamkakaroto (button) collected ($0.53)
Seat 4: T9MS (small blind) folded before Flop
Seat 5: KokoulinV (big blind) folded on the Flop
Seat 6: LarryTheStar folded before Flop (didn't bet)



PokerStars Hand #166667752391:  Hold'em No Limit ($0.05/$0.10 USD) - 2017/02/23 16:06:53 ET
Table 'Peiroos' 6-max Seat #4 is the button
Seat 1: ksandr_hom ($10 in chips) 
Seat 2: Nr847 ($10.95 in chips) 
Seat 3: atlx0711 ($25.69 in chips) 
Seat 4: Peter0087 ($9.85 in chips) 
Seat 5: sergio-cb164 ($8.70 in chips) 
Seat 6: DevonMiles88 ($5.37 in chips) 
sergio-cb164: posts small blind $0.05
DevonMiles88: posts big blind $0.10
*** HOLE CARDS ***
ksandr_hom: folds 
Nr847: folds 
atlx0711: folds 
Peter0087: folds 
sergio-cb164: calls $0.05
DevonMiles88: raises $0.10 to $0.20
sergio-cb164: calls $0.10
*** FLOP *** [3d 9h Qs]
sergio-cb164: checks 
DevonMiles88: bets $0.70
sergio-cb164: folds 
Uncalled bet ($0.70) returned to DevonMiles88
DevonMiles88 collected $0.38 from pot
*** SUMMARY ***
Total pot $0.40 | Rake $0.02 
Board [3d 9h Qs]
Seat 1: ksandr_hom folded before Flop (didn't bet)
Seat 2: Nr847 folded before Flop (didn't bet)
Seat 3: atlx0711 folded before Flop (didn't bet)
Seat 4: Peter0087 (button) folded before Flop (didn't bet)
Seat 5: sergio-cb164 (small blind) folded on the Flop
Seat 6: DevonMiles88 (big blind) collected ($0.38)



PokerStars Hand #166667752432:  Hold'em No Limit ($0.05/$0.10 USD) - 2017/02/23 16:06:53 ET
Table 'Girtab' 6-max Seat #6 is the button
Seat 1: pokekrk ($13.46 in chips) 
Seat 2: MühliJr ($10 in chips) 
Seat 3: kingartur222 ($10.45 in chips) 
Seat 4: Hyd SK ($11.23 in chips) 
Seat 5: sexy_seagull ($11.20 in chips) 
Seat 6: iluzja12 ($9.85 in chips) 
pokekrk: posts small blind $0.05
MühliJr: posts big blind $0.10
*** HOLE CARDS ***
kingartur222: folds 
Hyd SK: raises $0.25 to $0.35
sexy_seagull: folds 
iluzja12: calls $0.35
pokekrk: raises $1 to $1.35
MühliJr: folds 
Hyd SK: folds 
iluzja12: calls $1
*** FLOP *** [6h 9c 8h]
pokekrk: bets $2.26
iluzja12: calls $2.26
*** TURN *** [6h 9c 8h] [Jh]
pokekrk: bets $9.85 and is all-in
iluzja12: folds 
Uncalled bet ($9.85) returned to pokekrk
pokekrk collected $7.32 from pot
*** SUMMARY ***
Total pot $7.67 | Rake $0.35 
Board [6h 9c 8h Jh]
Seat 1: pokekrk (small blind) collected ($7.32)
Seat 2: MühliJr (big blind) folded before Flop
Seat 3: kingartur222 folded before Flop (didn't bet)
Seat 4: Hyd SK folded before Flop
Seat 5: sexy_seagull folded before Flop (didn't bet)
Seat 6: iluzja12 (button) folded on the Turn



PokerStars Hand #166667752741:  Hold'em No Limit ($0.05/$0.10 USD) - 2017/02/23 16:06:54 ET
Table 'Pirola' 6-max Seat #1 is the button
Seat 1: Rodik002 ($10.13 in chips) 
Seat 2: lmlmlmlm90 ($18.59 in chips) 
Seat 4: barons89 ($12.06 in chips) 
Seat 5: Iarlei ($13.99 in chips) 
Seat 6: Hyd SK ($10.35 in chips) 
lmlmlmlm90: posts small blind $0.05
XaXaTyH4uK: is sitting out 
barons89: posts big blind $0.10
XaXaTyH4uK leaves the table
*** HOLE CARDS ***
Goroshkos88 joins the table at seat #3 
Iarlei: folds 
Hyd SK: raises $0.25 to $0.35
Rodik002: calls $0.35
lmlmlmlm90: calls $0.30
barons89: folds 
*** FLOP *** [7s Ah Tc]
lmlmlmlm90: checks 
Hyd SK: bets $0.55
Rodik002: calls $0.55
lmlmlmlm90: calls $0.55
*** TURN *** [7s Ah Tc] [8s]
lmlmlmlm90: checks 
Hyd SK: bets $1.34
Rodik002: calls $1.34
lmlmlmlm90 has timed out
lmlmlmlm90: folds 
*** RIVER *** [7s Ah Tc 8s] [Qd]
Hyd SK: bets $2.62
Rodik002: folds 
Uncalled bet ($2.62) returned to Hyd SK
Hyd SK collected $5.23 from pot
*** SUMMARY ***
Total pot $5.48 | Rake $0.25 
Board [7s Ah Tc 8s Qd]
Seat 1: Rodik002 (button) folded on the River
Seat 2: lmlmlmlm90 (small blind) folded on the Turn
Seat 4: barons89 (big blind) folded before Flop
Seat 5: Iarlei folded before Flop (didn't bet)
Seat 6: Hyd SK collected ($5.23)



PokerStars Hand #166667752895:  Hold'em No Limit ($0.05/$0.10 USD) - 2017/02/23 16:06:54 ET
Table 'Garlena III' 6-max Seat #6 is the button
Seat 1: dittoro ($10.05 in chips) 
Seat 2: YY778 ($10 in chips) 
Seat 4: mbkongstad ($10.15 in chips) 
Seat 5: steepfell ($10 in chips) 
Seat 6: iluzja12 ($9.85 in chips) 
dittoro: posts small blind $0.05
YY778: posts big blind $0.10
*** HOLE CARDS ***
IAntikI joins the table at seat #3 
mbkongstad: folds 
steepfell: folds 
iluzja12: folds 
dittoro: folds 
Uncalled bet ($0.05) returned to YY778
YY778 collected $0.10 from pot
*** SUMMARY ***
Total pot $0.10 | Rake $0 
Seat 1: dittoro (small blind) folded before Flop
Seat 2: YY778 (big blind) collected ($0.10)
Seat 4: mbkongstad folded before Flop (didn't bet)
Seat 5: steepfell folded before Flop (didn't bet)
Seat 6: iluzja12 (button) folded before Flop (didn't bet)



PokerStars Hand #166667753010:  Hold'em No Limit ($0.05/$0.10 USD) - 2017/02/23 16:06:54 ET
Table 'Rostia' 6-max Seat #3 is the button
Seat 1: paxit71 ($7.88 in chips) 
Seat 2: david_sara83 ($19.01 in chips) 
Seat 3: iThreeBarrel ($10 in chips) 
Seat 4: Hyd SK ($11.73 in chips) 
Seat 5: silsilviu ($7.37 in chips) 
Seat 6: Giyorod ($10.70 in chips) 
Hyd SK: posts small blind $0.05
silsilviu: posts big blind $0.10
*** HOLE CARDS ***
Giyorod: folds 
paxit71: folds 
david_sara83: folds 
iThreeBarrel: raises $0.15 to $0.25
Hyd SK: folds 
silsilviu: folds 
Uncalled bet ($0.15) returned to iThreeBarrel
iThreeBarrel collected $0.25 from pot
*** SUMMARY ***
Total pot $0.25 | Rake $0 
Seat 1: paxit71 folded before Flop (didn't bet)
Seat 2: david_sara83 folded before Flop (didn't bet)
Seat 3: iThreeBarrel (button) collected ($0.25)
Seat 4: Hyd SK (small blind) folded before Flop
Seat 5: silsilviu (big blind) folded before Flop
Seat 6: Giyorod folded before Flop (didn't bet)



PokerStars Hand #166667753036:  Hold'em No Limit ($0.05/$0.10 USD) - 2017/02/23 16:06:54 ET
Table 'Sheragul III' 6-max Seat #5 is the button
Seat 1: danky24 ($19.60 in chips) 
Seat 2: Bird et al ($10.47 in chips) 
Seat 4: maxiv608 ($10.44 in chips) 
Seat 5: Bandyaev ($15.97 in chips) 
Seat 6: Andrei ProFF ($10 in chips) 
Andrei ProFF: posts small blind $0.05
danky24: posts big blind $0.10
FRAID358: sits out 
*** HOLE CARDS ***
Bird et al: folds 
maxiv608: folds 
Bandyaev: folds 
Andrei ProFF: raises $0.20 to $0.30
danky24: calls $0.20
*** FLOP *** [Qh 8s 3c]
Andrei ProFF: bets $0.30
danky24: calls $0.30
*** TURN *** [Qh 8s 3c] [Ad]
Andrei ProFF: bets $0.70
danky24: calls $0.70
*** RIVER *** [Qh 8s 3c Ad] [Jc]
Andrei ProFF: bets $0.80
danky24: calls $0.80
*** SHOW DOWN ***
Andrei ProFF: shows [Ks As] (a pair of Aces)
danky24: mucks hand 
Andrei ProFF collected $4.01 from pot
*** SUMMARY ***
Total pot $4.20 | Rake $0.19 
Board [Qh 8s 3c Ad Jc]
Seat 1: danky24 (big blind) mucked
Seat 2: Bird et al folded before Flop (didn't bet)
Seat 4: maxiv608 folded before Flop (didn't bet)
Seat 5: Bandyaev (button) folded before Flop (didn't bet)
Seat 6: Andrei ProFF (small blind) showed [Ks As] and won ($4.01) with a pair of Aces



PokerStars Hand #166667753104:  Hold'em No Limit ($0.05/$0.10 USD) - 2017/02/23 16:06:54 ET
Table 'Antielus II' 6-max Seat #2 is the button
Seat 1: Dcaro31 ($18.49 in chips) 
Seat 2: Orlangoor ($10 in chips) 
Seat 3: mcyi3at2 ($12.21 in chips) 
Seat 4: XwinX25 ($10.15 in chips) 
Seat 5: Hyd SK ($10.89 in chips) 
Seat 6: GiveTwoMe ($12.25 in chips) 
mcyi3at2: posts small blind $0.05
XwinX25: posts big blind $0.10
*** HOLE CARDS ***
Hyd SK: folds 
GiveTwoMe: raises $0.20 to $0.30
Dcaro31: folds 
Orlangoor: folds 
mcyi3at2: raises $0.50 to $0.80
XwinX25: folds 
GiveTwoMe: calls $0.50
*** FLOP *** [Qs 8d 6s]
mcyi3at2: bets $1.20
GiveTwoMe: folds 
Uncalled bet ($1.20) returned to mcyi3at2
mcyi3at2 collected $1.62 from pot
*** SUMMARY ***
Total pot $1.70 | Rake $0.08 
Board [Qs 8d 6s]
Seat 1: Dcaro31 folded before Flop (didn't bet)
Seat 2: Orlangoor (button) folded before Flop (didn't bet)
Seat 3: mcyi3at2 (small blind) collected ($1.62)
Seat 4: XwinX25 (big blind) folded before Flop
Seat 5: Hyd SK folded before Flop (didn't bet)
Seat 6: GiveTwoMe folded on the Flop



PokerStars Hand #166667753216:  Hold'em No Limit ($0.05/$0.10 USD) - 2017/02/23 16:06:54 ET
Table 'Vaisala' 6-max Seat #6 is the button
Seat 1: Pekaml ($10 in chips) 
Seat 2: XaXaTyH4uK ($12.14 in chips) 
Seat 3: x3ultimate ($10.10 in chips) 
Seat 4: sexy_seagull ($10.02 in chips) 
Seat 5: AIONCMA1988 ($5.69 in chips) 
Seat 6: Aleksey K228 ($14.88 in chips) 
Pekaml: posts small blind $0.05
XaXaTyH4uK: posts big blind $0.10
*** HOLE CARDS ***
x3ultimate: folds 
sexy_seagull: folds 
AIONCMA1988: raises $0.10 to $0.20
Aleksey K228: raises $0.30 to $0.50
Pekaml: folds 
XaXaTyH4uK: folds 
AIONCMA1988: calls $0.30
*** FLOP *** [4s Ad Th]
AIONCMA1988: checks 
Aleksey K228: bets $0.50
AIONCMA1988: raises $0.50 to $1
Aleksey K228: calls $0.50
*** TURN *** [4s Ad Th] [Kd]
AIONCMA1988: bets $1.51
Aleksey K228: raises $1.51 to $3.02
AIONCMA1988: raises $1.17 to $4.19 and is all-in
Aleksey K228: calls $1.17
*** RIVER *** [4s Ad Th Kd] [Td]
*** SHOW DOWN ***
AIONCMA1988: shows [As 7h] (two pair, Aces and Tens)
Aleksey K228: shows [Jc Qs] (a straight, Ten to Ace)
Aleksey K228 collected $11.01 from pot
*** SUMMARY ***
Total pot $11.53 | Rake $0.52 
Board [4s Ad Th Kd Td]
Seat 1: Pekaml (small blind) folded before Flop
Seat 2: XaXaTyH4uK (big blind) folded before Flop
Seat 3: x3ultimate folded before Flop (didn't bet)
Seat 4: sexy_seagull folded before Flop (didn't bet)
Seat 5: AIONCMA1988 showed [As 7h] and lost with two pair, Aces and Tens
Seat 6: Aleksey K228 (button) showed [Jc Qs] and won ($11.01) with a straight, Ten to Ace



PokerStars Hand #166667753260:  Hold'em No Limit ($0.05/$0.10 USD) - 2017/02/23 16:06:54 ET
Table 'Wesselink II' 6-max Seat #4 is the button
Seat 1: vladcol ($4.81 in chips) 
Seat 2: KRZuff ($10 in chips) 
Seat 3: Wargolandros ($8.92 in chips) 
Seat 4: BahiaMinhaP ($11.14 in chips) 
Seat 6: bambolejro ($10.54 in chips) 
bambolejro: posts small blind $0.05
vladcol: posts big blind $0.10
*** HOLE CARDS ***
KRZuff: folds 
Wargolandros: raises $0.20 to $0.30
BahiaMinhaP: calls $0.30
bambolejro: calls $0.25
vladcol: calls $0.20
*** FLOP *** [Th Jh 3s]
bambolejro: checks 
vladcol: checks 
Wargolandros: checks 
BahiaMinhaP: bets $0.58
bambolejro is disconnected 
bambolejro is connected 
bambolejro: calls $0.58
vladcol: calls $0.58
Wargolandros: folds 
*** TURN *** [Th Jh 3s] [Ks]
bambolejro: checks 
vladcol: checks 
BahiaMinhaP: bets $0.84
bambolejro: raises $1.12 to $1.96
vladcol: calls $1.96
BahiaMinhaP: calls $1.12
*** RIVER *** [Th Jh 3s Ks] [9c]
bambolejro: bets $7.70 and is all-in
vladcol: calls $1.97 and is all-in
BahiaMinhaP: folds 
Uncalled bet ($5.73) returned to bambolejro
*** SHOW DOWN ***
bambolejro: shows [As Qs] (a straight, Ten to Ace)
vladcol: shows [Qh 4h] (a straight, Nine to King)
bambolejro collected $12.19 from pot
*** SUMMARY ***
Total pot $12.76 | Rake $0.57 
Board [Th Jh 3s Ks 9c]
Seat 1: vladcol (big blind) showed [Qh 4h] and lost with a straight, Nine to King
Seat 2: KRZuff folded before Flop (didn't bet)
Seat 3: Wargolandros folded on the Flop
Seat 4: BahiaMinhaP (button) folded on the River
Seat 6: bambolejro (small blind) showed [As Qs] and won ($12.19) with a straight, Ten to Ace



PokerStars Hand #166667753946:  Hold'em No Limit ($0.05/$0.10 USD) - 2017/02/23 16:06:55 ET
Table 'Vesta II' 6-max Seat #2 is the button
Seat 1: Yabidooo ($13.16 in chips) 
Seat 2: Dimka4 ($10 in chips) 
Seat 3: Pokeaster ($12.61 in chips) 
Seat 4: Dcaro31 ($10 in chips) 
Seat 6: XaXaTyH4uK ($11.31 in chips) 
Pokeaster: posts small blind $0.05
Dcaro31: posts big blind $0.10
ChuikaPridi: sits out 
*** HOLE CARDS ***
XaXaTyH4uK: raises $0.20 to $0.30
Yabidooo: folds 
Dimka4: raises $0.60 to $0.90
Pokeaster: folds 
Dcaro31: folds 
XaXaTyH4uK: folds 
Uncalled bet ($0.60) returned to Dimka4
Dimka4 collected $0.75 from pot
*** SUMMARY ***
Total pot $0.75 | Rake $0 
Seat 1: Yabidooo folded before Flop (didn't bet)
Seat 2: Dimka4 (button) collected ($0.75)
Seat 3: Pokeaster (small blind) folded before Flop
Seat 4: Dcaro31 (big blind) folded before Flop
Seat 6: XaXaTyH4uK folded before Flop



PokerStars Hand #166667754117:  Hold'em No Limit ($0.05/$0.10 USD) - 2017/02/23 16:06:55 ET
Table 'Gyldenia II' 6-max Seat #6 is the button
Seat 1: KokoulinV ($10.38 in chips) 
Seat 2: Bandyaev ($10 in chips) 
Seat 5: CHRO8 ($15.47 in chips) 
Seat 6: 8th wonders ($12.68 in chips) 
KokoulinV: posts small blind $0.05
Bandyaev: posts big blind $0.10
*** HOLE CARDS ***
CHRO8: raises $0.20 to $0.30
8th wonders: folds 
KokoulinV: folds 
KRZuff leaves the table
Bandyaev: folds 
Uncalled bet ($0.20) returned to CHRO8
CHRO8 collected $0.25 from pot
*** SUMMARY ***
Total pot $0.25 | Rake $0 
Seat 1: KokoulinV (small blind) folded before Flop
Seat 2: Bandyaev (big blind) folded before Flop
Seat 5: CHRO8 collected ($0.25)
Seat 6: 8th wonders (button) folded before Flop (didn't bet)



PokerStars Hand #166667754428:  Hold'em No Limit ($0.05/$0.10 USD) - 2017/02/23 16:06:56 ET
Table 'Anhui II' 6-max Seat #2 is the button
Seat 1: kingartur222 ($12.87 in chips) 
Seat 2: kikus334 ($12.81 in chips) 
Seat 3: lochniak556 ($26.19 in chips) 
Seat 4: dragonste89 ($10 in chips) 
Seat 5: Bandyaev ($10 in chips) 
Seat 6: .BaRReL.1122 ($4.65 in chips) 
lochniak556: posts small blind $0.05
dragonste89: posts big blind $0.10
*** HOLE CARDS ***
Bandyaev: folds 
.BaRReL.1122: folds 
lochniak556 said, "tam i haj starczyl"
kingartur222: raises $0.15 to $0.25
kikus334: calls $0.25
lochniak556: calls $0.20
dragonste89: calls $0.15
*** FLOP *** [7s Qs 2s]
lochniak556: checks 
dragonste89: bets $0.48
kingartur222: raises $0.72 to $1.20
kikus334: folds 
lochniak556: folds 
dragonste89: folds 
Uncalled bet ($0.72) returned to kingartur222
kingartur222 collected $1.87 from pot
*** SUMMARY ***
Total pot $1.96 | Rake $0.09 
Board [7s Qs 2s]
Seat 1: kingartur222 collected ($1.87)
Seat 2: kikus334 (button) folded on the Flop
Seat 3: lochniak556 (small blind) folded on the Flop
Seat 4: dragonste89 (big blind) folded on the Flop
Seat 5: Bandyaev folded before Flop (didn't bet)
Seat 6: .BaRReL.1122 folded before Flop (didn't bet)



PokerStars Hand #166667754797:  Hold'em No Limit ($0.05/$0.10 USD) - 2017/02/23 16:06:56 ET
Table 'Kochera' 6-max Seat #6 is the button
Seat 1: chimera252 ($11.72 in chips) 
Seat 2: bartabs2 ($10.54 in chips) 
Seat 3: KA3AXCTAHEU, ($10.46 in chips) 
Seat 4: johkom ($5.95 in chips) 
Seat 5: univibe68 ($11.50 in chips) 
Seat 6: oddshoff ($9.48 in chips) 
chimera252: posts small blind $0.05
bartabs2: posts big blind $0.10
*** HOLE CARDS ***
KA3AXCTAHEU,: folds 
johkom: folds 
univibe68: folds 
oddshoff: raises $0.20 to $0.30
chimera252: folds 
bartabs2: folds 
Uncalled bet ($0.20) returned to oddshoff
oddshoff collected $0.25 from pot
*** SUMMARY ***
Total pot $0.25 | Rake $0 
Seat 1: chimera252 (small blind) folded before Flop
Seat 2: bartabs2 (big blind) folded before Flop
Seat 3: KA3AXCTAHEU, folded before Flop (didn't bet)
Seat 4: johkom folded before Flop (didn't bet)
Seat 5: univibe68 folded before Flop (didn't bet)
Seat 6: oddshoff (button) collected ($0.25)



PokerStars Hand #166667755251:  Hold'em No Limit ($0.05/$0.10 USD) - 2017/02/23 16:06:56 ET
Table 'Nehalennia III' 6-max Seat #3 is the button
Seat 1: boxer821 ($11.47 in chips) 
Seat 2: fortieth ($10.77 in chips) 
Seat 3: ValdemorS ($17.86 in chips) 
Seat 4: eniksenik ($10 in chips) 
Seat 5: wulffboy ($36.86 in chips) 
Seat 6: valzeny ($21.32 in chips) 
eniksenik: posts small blind $0.05
wulffboy: posts big blind $0.10
boxer821: posts the ante $0.02
fortieth: posts the ante $0.02
ValdemorS: posts the ante $0.02
eniksenik: posts the ante $0.02
wulffboy: posts the ante $0.02
valzeny: posts the ante $0.02
*** HOLE CARDS ***
valzeny: calls $0.10
boxer821: folds 
fortieth: folds 
ValdemorS: raises $0.47 to $0.57
eniksenik: folds 
wulffboy: folds 
valzeny: calls $0.47
*** FLOP *** [Qs 6c 2d]
valzeny: checks 
ValdemorS: checks 
*** TURN *** [Qs 6c 2d] [Js]
valzeny: checks 
ValdemorS: bets $1.01
valzeny: folds 
Uncalled bet ($1.01) returned to ValdemorS
ValdemorS collected $1.35 from pot
*** SUMMARY ***
Total pot $1.41 | Rake $0.06 
Board [Qs 6c 2d Js]
Seat 1: boxer821 folded before Flop (didn't bet)
Seat 2: fortieth folded before Flop (didn't bet)
Seat 3: ValdemorS (button) collected ($1.35)
Seat 4: eniksenik (small blind) folded before Flop
Seat 5: wulffboy (big blind) folded before Flop
Seat 6: valzeny folded on the Turn



PokerStars Hand #166667755345:  Hold'em No Limit ($0.05/$0.10 USD) - 2017/02/23 16:06:57 ET
Table 'Atalante' 6-max Seat #6 is the button
Seat 1: OceanBlue100 ($4.99 in chips) 
Seat 2: CiisCi ($20.20 in chips) 
Seat 3: Kow6oy ($10 in chips) 
Seat 4: Dcaro31 ($24.02 in chips) 
Seat 5: eniksenik ($10.14 in chips) 
Seat 6: FlopsterGB ($31.19 in chips) 
OceanBlue100: posts small blind $0.05
CiisCi: posts big blind $0.10
*** HOLE CARDS ***
Kow6oy: raises $0.25 to $0.35
Dcaro31: folds 
eniksenik: folds 
FlopsterGB: folds 
OceanBlue100: folds 
CiisCi: folds 
Uncalled bet ($0.25) returned to Kow6oy
Kow6oy collected $0.25 from pot
*** SUMMARY ***
Total pot $0.25 | Rake $0 
Seat 1: OceanBlue100 (small blind) folded before Flop
Seat 2: CiisCi (big blind) folded before Flop
Seat 3: Kow6oy collected ($0.25)
Seat 4: Dcaro31 folded before Flop (didn't bet)
Seat 5: eniksenik folded before Flop (didn't bet)
Seat 6: FlopsterGB (button) folded before Flop (didn't bet)



PokerStars Hand #166667755499:  Hold'em No Limit ($0.05/$0.10 USD) - 2017/02/23 16:06:57 ET
Table 'Epimetheus' 6-max Seat #1 is the button
Seat 1: 6ePeMeHHa9 ($10.29 in chips) 
Seat 2: patrick19111 ($15.41 in chips) 
Seat 3: dineldidi ($9.84 in chips) 
Seat 5: afca128 ($23.83 in chips) 
Seat 6: voledy ($10.60 in chips) 
patrick19111: posts small blind $0.05
dineldidi: posts big blind $0.10
Namhkal: sits out 
*** HOLE CARDS ***
afca128: folds 
voledy: folds 
6ePeMeHHa9: folds 
patrick19111: folds 
Uncalled bet ($0.05) returned to dineldidi
dineldidi collected $0.10 from pot
*** SUMMARY ***
Total pot $0.10 | Rake $0 
Seat 1: 6ePeMeHHa9 (button) folded before Flop (didn't bet)
Seat 2: patrick19111 (small blind) folded before Flop
Seat 3: dineldidi (big blind) collected ($0.10)
Seat 5: afca128 folded before Flop (didn't bet)
Seat 6: voledy folded before Flop (didn't bet)



PokerStars Hand #166667755901:  Hold'em No Limit ($0.05/$0.10 USD) - 2017/02/23 16:06:57 ET
Table 'Kanda' 6-max Seat #6 is the button
Seat 1: Andy Wolf ($11.32 in chips) 
Seat 2: Pelotín ($5.15 in chips) 
Seat 3: XaXaTyH4uK ($10 in chips) 
Seat 4: Orlangoor ($10.19 in chips) 
Seat 5: Dimka4 ($10.10 in chips) 
Seat 6: oddshoff ($9.21 in chips) 
Andy Wolf: posts small blind $0.05
Pelotín: posts big blind $0.10
*** HOLE CARDS ***
XaXaTyH4uK: raises $0.20 to $0.30
Orlangoor: folds 
Dimka4: folds 
oddshoff: folds 
Andy Wolf: folds 
Pelotín: calls $0.20
*** FLOP *** [3h 8h 5s]
Pelotín: checks 
XaXaTyH4uK: checks 
*** TURN *** [3h 8h 5s] [5c]
Pelotín: bets $0.31
XaXaTyH4uK: folds 
Uncalled bet ($0.31) returned to Pelotín
Pelotín collected $0.62 from pot
*** SUMMARY ***
Total pot $0.65 | Rake $0.03 
Board [3h 8h 5s 5c]
Seat 1: Andy Wolf (small blind) folded before Flop
Seat 2: Pelotín (big blind) collected ($0.62)
Seat 3: XaXaTyH4uK folded on the Turn
Seat 4: Orlangoor folded before Flop (didn't bet)
Seat 5: Dimka4 folded before Flop (didn't bet)
Seat 6: oddshoff (button) folded before Flop (didn't bet)



PokerStars Hand #166667757164:  Hold'em No Limit ($0.05/$0.10 USD) - 2017/02/23 16:06:58 ET
Table 'Hestia' 6-max Seat #3 is the button
Seat 2: Kow6oy ($10.32 in chips) 
Seat 3: MBen10 ($13.56 in chips) 
Seat 4: Lucky HoBBiT ($10 in chips) 
Seat 5: CiisCi ($16.45 in chips) 
Seat 6: Smitty03300 ($10 in chips) 
Lucky HoBBiT: posts small blind $0.05
CiisCi: posts big blind $0.10
Pekaml: sits out 
*** HOLE CARDS ***
Smitty03300: folds 
Kow6oy: folds 
MBen10: raises $0.15 to $0.25
Lucky HoBBiT: folds 
CiisCi: raises $0.75 to $1
MBen10: calls $0.75
*** FLOP *** [5d Kc 3d]
CiisCi: bets $1.50
MBen10: folds 
Uncalled bet ($1.50) returned to CiisCi
CiisCi collected $1.96 from pot
*** SUMMARY ***
Total pot $2.05 | Rake $0.09 
Board [5d Kc 3d]
Seat 2: Kow6oy folded before Flop (didn't bet)
Seat 3: MBen10 (button) folded on the Flop
Seat 4: Lucky HoBBiT (small blind) folded before Flop
Seat 5: CiisCi (big blind) collected ($1.96)
Seat 6: Smitty03300 folded before Flop (didn't bet)



PokerStars Hand #166667757181:  Hold'em No Limit ($0.05/$0.10 USD) - 2017/02/23 16:06:59 ET
Table 'Nemo III' 6-max Seat #1 is the button
Seat 1: Kow6oy ($10 in chips) 
Seat 2: Bandyaev ($12.06 in chips) 
Seat 3: Dimka4 ($10.15 in chips) 
Seat 4: vtalian ($9.85 in chips) 
Seat 5: Joker51_wtf! ($11.28 in chips) 
Seat 6: maxiv608 ($10 in chips) 
Bandyaev: posts small blind $0.05
Dimka4: posts big blind $0.10
*** HOLE CARDS ***
vtalian: folds 
Joker51_wtf!: folds 
maxiv608: raises $0.15 to $0.25
Kow6oy: folds 
Bandyaev: folds 
Dimka4: folds 
Uncalled bet ($0.15) returned to maxiv608
maxiv608 collected $0.25 from pot
*** SUMMARY ***
Total pot $0.25 | Rake $0 
Seat 1: Kow6oy (button) folded before Flop (didn't bet)
Seat 2: Bandyaev (small blind) folded before Flop
Seat 3: Dimka4 (big blind) folded before Flop
Seat 4: vtalian folded before Flop (didn't bet)
Seat 5: Joker51_wtf! folded before Flop (didn't bet)
Seat 6: maxiv608 collected ($0.25)



PokerStars Hand #166667757263:  Hold'em No Limit ($0.05/$0.10 USD) - 2017/02/23 16:06:59 ET
Table 'Geisha' 6-max Seat #5 is the button
Seat 1: facewald ($34.04 in chips) 
Seat 2: voledy ($10.60 in chips) 
Seat 3: Eddys Edge ($10 in chips) 
Seat 5: KRZuff ($14.21 in chips) 
Seat 6: Namhkal ($21.38 in chips) 
Namhkal: posts small blind $0.05
facewald: posts big blind $0.10
*** HOLE CARDS ***
voledy: folds 
Eddys Edge: folds 
KRZuff: raises $0.15 to $0.25
Namhkal: folds 
facewald: folds 
Uncalled bet ($0.15) returned to KRZuff
KRZuff collected $0.25 from pot
*** SUMMARY ***
Total pot $0.25 | Rake $0 
Seat 1: facewald (big blind) folded before Flop
Seat 2: voledy folded before Flop (didn't bet)
Seat 3: Eddys Edge folded before Flop (didn't bet)
Seat 5: KRZuff (button) collected ($0.25)
Seat 6: Namhkal (small blind) folded before Flop



PokerStars Hand #166667757449:  Hold'em No Limit ($0.05/$0.10 USD) - 2017/02/23 16:06:59 ET
Table 'Emma II' 6-max Seat #2 is the button
Seat 1: LarryTheStar ($10.10 in chips) 
Seat 2: T9MS ($11.64 in chips) 
Seat 3: oddshoff ($9.42 in chips) 
Seat 4: Jucatorul823 ($6.24 in chips) 
Seat 5: Scanner17 ($11.06 in chips) 
Seat 6: CHRO8 ($14.82 in chips) 
oddshoff: posts small blind $0.05
Jucatorul823: posts big blind $0.10
*** HOLE CARDS ***
Scanner17: folds 
CHRO8 has timed out
CHRO8: folds 
LarryTheStar: folds 
T9MS: folds 
oddshoff: raises $0.10 to $0.20
Jucatorul823: folds 
Uncalled bet ($0.10) returned to oddshoff
oddshoff collected $0.20 from pot
*** SUMMARY ***
Total pot $0.20 | Rake $0 
Seat 1: LarryTheStar folded before Flop (didn't bet)
Seat 2: T9MS (button) folded before Flop (didn't bet)
Seat 3: oddshoff (small blind) collected ($0.20)
Seat 4: Jucatorul823 (big blind) folded before Flop
Seat 5: Scanner17 folded before Flop (didn't bet)
Seat 6: CHRO8 folded before Flop (didn't bet)



PokerStars Hand #166667757615:  Hold'em No Limit ($0.05/$0.10 USD) - 2017/02/23 16:06:59 ET
Table 'Cuyo' 6-max Seat #6 is the button
Seat 1: Bandyaev ($11.39 in chips) 
Seat 2: Therodorus ($10 in chips) 
Seat 6: iluzja12 ($8.67 in chips) 
Bandyaev: posts small blind $0.05
Therodorus: posts big blind $0.10
bambolejro: sits out 
*** HOLE CARDS ***
iluzja12: folds 
Bandyaev: raises $0.20 to $0.30
Therodorus: raises $0.60 to $0.90
Bandyaev: folds 
Uncalled bet ($0.60) returned to Therodorus
Therodorus collected $0.60 from pot
*** SUMMARY ***
Total pot $0.60 | Rake $0 
Seat 1: Bandyaev (small blind) folded before Flop
Seat 2: Therodorus (big blind) collected ($0.60)
Seat 6: iluzja12 (button) folded before Flop (didn't bet)



PokerStars Hand #166667757681:  Hold'em No Limit ($0.05/$0.10 USD) - 2017/02/23 16:06:59 ET
Table 'Grietje' 6-max Seat #4 is the button
Seat 1: dragonste89 ($10.15 in chips) 
Seat 2: Feverhead ($12.72 in chips) 
Seat 3: GitoValdivia ($6.42 in chips) 
Seat 4: MihaGr ($10.71 in chips) 
Seat 5: iThreeBarrel ($10.05 in chips) 
Seat 6: Prometheu$8 ($21.70 in chips) 
iThreeBarrel: posts small blind $0.05
Prometheu$8: posts big blind $0.10
*** HOLE CARDS ***
dragonste89: folds 
Feverhead: folds 
GitoValdivia: raises $0.20 to $0.30
MihaGr: folds 
iThreeBarrel: folds 
Prometheu$8: calls $0.20
*** FLOP *** [6d 5s 4d]
Prometheu$8: checks 
GitoValdivia: bets $0.31
Prometheu$8: calls $0.31
*** TURN *** [6d 5s 4d] [3d]
Prometheu$8: checks 
GitoValdivia: bets $0.61
Prometheu$8: raises $1.33 to $1.94
GitoValdivia: calls $1.33
*** RIVER *** [6d 5s 4d 3d] [Td]
Prometheu$8: checks 
GitoValdivia: checks 
*** SHOW DOWN ***
Prometheu$8: shows [9d 8d] (a flush, Ten high)
GitoValdivia: mucks hand 
Prometheu$8 collected $4.92 from pot
*** SUMMARY ***
Total pot $5.15 | Rake $0.23 
Board [6d 5s 4d 3d Td]
Seat 1: dragonste89 folded before Flop (didn't bet)
Seat 2: Feverhead folded before Flop (didn't bet)
Seat 3: GitoValdivia mucked
Seat 4: MihaGr (button) folded before Flop (didn't bet)
Seat 5: iThreeBarrel (small blind) folded before Flop
Seat 6: Prometheu$8 (big blind) showed [9d 8d] and won ($4.92) with a flush, Ten high



PokerStars Hand #166667757821:  Hold'em No Limit ($0.05/$0.10 USD) - 2017/02/23 16:06:59 ET
Table 'Luanda' 6-max Seat #2 is the button
Seat 1: AM-L-SL ($4.18 in chips) 
Seat 2: Xander188 ($10.04 in chips) 
Seat 3: DamDatsAnAce ($10.05 in chips) 
Seat 5: st4tion ($13.60 in chips) 
Seat 6: KA3AXCTAHEU, ($11.58 in chips) 
DamDatsAnAce: posts small blind $0.05
st4tion: posts big blind $0.10
*** HOLE CARDS ***
KA3AXCTAHEU,: folds 
AM-L-SL: raises $0.20 to $0.30
Xander188: folds 
DamDatsAnAce: folds 
st4tion: folds 
Uncalled bet ($0.20) returned to AM-L-SL
AM-L-SL collected $0.25 from pot
*** SUMMARY ***
Total pot $0.25 | Rake $0 
Seat 1: AM-L-SL collected ($0.25)
Seat 2: Xander188 (button) folded before Flop (didn't bet)
Seat 3: DamDatsAnAce (small blind) folded before Flop
Seat 5: st4tion (big blind) folded before Flop
Seat 6: KA3AXCTAHEU, folded before Flop (didn't bet)



PokerStars Hand #166667757918:  Hold'em No Limit ($0.05/$0.10 USD) - 2017/02/23 16:06:59 ET
Table 'Lehigh' 6-max Seat #1 is the button
Seat 1: kowe4ka565 ($8.06 in chips) 
Seat 2: Sbozzz ($13.27 in chips) 
Seat 3: Therodorus ($12.79 in chips) 
Seat 4: Chodemuncher ($10 in chips) 
Seat 5: Xander188 ($10 in chips) 
Seat 6: CallByValue ($7.52 in chips) 
Sbozzz: posts small blind $0.05
Therodorus: posts big blind $0.10
*** HOLE CARDS ***
Chodemuncher: folds 
Xander188: raises $0.20 to $0.30
CallByValue: folds 
kowe4ka565: folds 
Sbozzz: folds 
Therodorus: calls $0.20
*** FLOP *** [7c 7h 8h]
Therodorus: checks 
Xander188: checks 
*** TURN *** [7c 7h 8h] [2s]
Therodorus: checks 
Xander188: bets $0.40
Therodorus: folds 
Uncalled bet ($0.40) returned to Xander188
Xander188 collected $0.62 from pot
*** SUMMARY ***
Total pot $0.65 | Rake $0.03 
Board [7c 7h 8h 2s]
Seat 1: kowe4ka565 (button) folded before Flop (didn't bet)
Seat 2: Sbozzz (small blind) folded before Flop
Seat 3: Therodorus (big blind) folded on the Turn
Seat 4: Chodemuncher folded before Flop (didn't bet)
Seat 5: Xander188 collected ($0.62)
Seat 6: CallByValue folded before Flop (didn't bet)



PokerStars Hand #166667758243:  Hold'em No Limit ($0.05/$0.10 USD) - 2017/02/23 16:07:00 ET
Table 'Cassini' 6-max Seat #1 is the button
Seat 1: Pokeaster ($10.52 in chips) 
Seat 2: mhonielsen ($12.31 in chips) 
Seat 4: fortieth ($14.12 in chips) 
mhonielsen: posts small blind $0.05
popypaleta was removed from the table for failing to post
fortieth: posts big blind $0.10
MihaGr: sits out 
*** HOLE CARDS ***
Pokeaster: raises $0.15 to $0.25
mhonielsen: folds 
fortieth: folds 
Uncalled bet ($0.15) returned to Pokeaster
DrVzad joins the table at seat #5 
Pokeaster collected $0.25 from pot
*** SUMMARY ***
Total pot $0.25 | Rake $0 
Seat 1: Pokeaster (button) collected ($0.25)
Seat 2: mhonielsen (small blind) folded before Flop
Seat 4: fortieth (big blind) folded before Flop



PokerStars Hand #166667758699:  Hold'em No Limit ($0.05/$0.10 USD) - 2017/02/23 16:07:00 ET
Table 'Aludra II' 6-max Seat #3 is the button
Seat 1: voledy ($10.23 in chips) 
Seat 2: JahSoldier69 ($14.05 in chips) 
Seat 3: mbkongstad ($9.85 in chips) 
Seat 4: MihaGr ($10.64 in chips) 
Seat 5: kingartur222 ($15.87 in chips) 
Seat 6: call me haaa ($13.83 in chips) 
MihaGr: posts small blind $0.05
kingartur222: posts big blind $0.10
*** HOLE CARDS ***
call me haaa: raises $0.20 to $0.30
voledy: folds 
JahSoldier69: calls $0.30
mbkongstad: folds 
MihaGr: folds 
kingartur222: folds 
*** FLOP *** [Jc Th Ah]
call me haaa: bets $0.50
JahSoldier69: folds 
Uncalled bet ($0.50) returned to call me haaa
call me haaa collected $0.72 from pot
*** SUMMARY ***
Total pot $0.75 | Rake $0.03 
Board [Jc Th Ah]
Seat 1: voledy folded before Flop (didn't bet)
Seat 2: JahSoldier69 folded on the Flop
Seat 3: mbkongstad (button) folded before Flop (didn't bet)
Seat 4: MihaGr (small blind) folded before Flop
Seat 5: kingartur222 (big blind) folded before Flop
Seat 6: call me haaa collected ($0.72)



PokerStars Hand #166667758710:  Hold'em No Limit ($0.05/$0.10 USD) - 2017/02/23 16:07:00 ET
Table 'Armenia' 6-max Seat #1 is the button
Seat 1: tr41n3r12 ($11.67 in chips) 
Seat 2: Yabidooo ($11.62 in chips) 
Seat 4: mbkongstad ($9.90 in chips) 
Seat 5: boxer821 ($12.28 in chips) 
Seat 6: mega spasser ($6.53 in chips) 
Yabidooo: posts small blind $0.05
XwinX25: is sitting out 
mbkongstad: posts big blind $0.10
*** HOLE CARDS ***
XwinX25 leaves the table
boxer821: folds 
mega spasser: folds 
tr41n3r12: folds 
x3ultimate joins the table at seat #3 
x3ultimate leaves the table
Yabidooo: raises $0.15 to $0.25
mbkongstad: folds 
Uncalled bet ($0.15) returned to Yabidooo
Yabidooo collected $0.20 from pot
*** SUMMARY ***
Total pot $0.20 | Rake $0 
Seat 1: tr41n3r12 (button) folded before Flop (didn't bet)
Seat 2: Yabidooo (small blind) collected ($0.20)
Seat 4: mbkongstad (big blind) folded before Flop
Seat 5: boxer821 folded before Flop (didn't bet)
Seat 6: mega spasser folded before Flop (didn't bet)



PokerStars Hand #166667758721:  Hold'em No Limit ($0.05/$0.10 USD) - 2017/02/23 16:07:00 ET
Table 'Martha' 6-max Seat #3 is the button
Seat 1: Peter0087 ($10.44 in chips) 
Seat 2: pauli95 ($10.03 in chips) 
Seat 3: Hyd SK ($12.20 in chips) 
Seat 4: dittoro ($10 in chips) 
Seat 5: MihaGr ($10 in chips) 
Seat 6: 8th wonders ($10 in chips) 
dittoro: posts small blind $0.05
MihaGr: posts big blind $0.10
*** HOLE CARDS ***
8th wonders: folds 
Peter0087: folds 
pauli95: folds 
Hyd SK: raises $0.15 to $0.25
dittoro: calls $0.20
MihaGr: folds 
*** FLOP *** [8h 2c 4c]
dittoro: checks 
Hyd SK: bets $0.38
dittoro: folds 
Uncalled bet ($0.38) returned to Hyd SK
Hyd SK collected $0.57 from pot
*** SUMMARY ***
Total pot $0.60 | Rake $0.03 
Board [8h 2c 4c]
Seat 1: Peter0087 folded before Flop (didn't bet)
Seat 2: pauli95 folded before Flop (didn't bet)
Seat 3: Hyd SK (button) collected ($0.57)
Seat 4: dittoro (small blind) folded on the Flop
Seat 5: MihaGr (big blind) folded before Flop
Seat 6: 8th wonders folded before Flop (didn't bet)



PokerStars Hand #166667759352:  Hold'em No Limit ($0.05/$0.10 USD) - 2017/02/23 16:07:01 ET
Table 'Mesarthim' 6-max Seat #6 is the button
Seat 1: Mancuso2010 ($15.90 in chips) 
Seat 2: MühliJr ($11.53 in chips) 
Seat 3: Damage514 ($9.69 in chips) 
Seat 4: Strelok1974 ($10.11 in chips) 
Seat 5: Iarlei ($10.90 in chips) 
Seat 6: bdixon_5 ($8.81 in chips) 
Mancuso2010: posts small blind $0.05
MühliJr: posts big blind $0.10
*** HOLE CARDS ***
Damage514: calls $0.10
Strelok1974: folds 
Iarlei: raises $0.20 to $0.30
bdixon_5: folds 
Mancuso2010: folds 
MühliJr: calls $0.20
Damage514: folds 
*** FLOP *** [2s Td 2c]
MühliJr: checks 
Iarlei: bets $0.35
MühliJr: calls $0.35
*** TURN *** [2s Td 2c] [6d]
MühliJr: checks 
Iarlei: checks 
*** RIVER *** [2s Td 2c 6d] [Ad]
MühliJr: checks 
Iarlei: bets $0.85
MühliJr: calls $0.85
*** SHOW DOWN ***
Iarlei: shows [9h Jh] (a pair of Deuces)
MühliJr: shows [Jc As] (two pair, Aces and Deuces)
MühliJr collected $3.01 from pot
*** SUMMARY ***
Total pot $3.15 | Rake $0.14 
Board [2s Td 2c 6d Ad]
Seat 1: Mancuso2010 (small blind) folded before Flop
Seat 2: MühliJr (big blind) showed [Jc As] and won ($3.01) with two pair, Aces and Deuces
Seat 3: Damage514 folded before Flop
Seat 4: Strelok1974 folded before Flop (didn't bet)
Seat 5: Iarlei showed [9h Jh] and lost with a pair of Deuces
Seat 6: bdixon_5 (button) folded before Flop (didn't bet)



PokerStars Hand #166667759813:  Hold'em No Limit ($0.05/$0.10 USD) - 2017/02/23 16:07:01 ET
Table 'Wingolfia II' 6-max Seat #6 is the button
Seat 1: BahiaMinhaP ($10.22 in chips) 
Seat 2: NvR.m1nD ($10.40 in chips) 
Seat 3: truck1234 ($10.36 in chips) 
Seat 4: zlobslob ($17.87 in chips) 
Seat 5: tr41n3r12 ($11.43 in chips) 
Seat 6: EphemeralBen ($11.99 in chips) 
BahiaMinhaP: posts small blind $0.05
NvR.m1nD: posts big blind $0.10
*** HOLE CARDS ***
truck1234: folds 
zlobslob: raises $0.15 to $0.25
tr41n3r12: folds 
EphemeralBen: folds 
BahiaMinhaP: folds 
NvR.m1nD: folds 
Uncalled bet ($0.15) returned to zlobslob
zlobslob collected $0.25 from pot
*** SUMMARY ***
Total pot $0.25 | Rake $0 
Seat 1: BahiaMinhaP (small blind) folded before Flop
Seat 2: NvR.m1nD (big blind) folded before Flop
Seat 3: truck1234 folded before Flop (didn't bet)
Seat 4: zlobslob collected ($0.25)
Seat 5: tr41n3r12 folded before Flop (didn't bet)
Seat 6: EphemeralBen (button) folded before Flop (didn't bet)



PokerStars Hand #166667759857:  Hold'em No Limit ($0.05/$0.10 USD) - 2017/02/23 16:07:01 ET
Table 'Reginhild' 6-max Seat #2 is the button
Seat 1: iamkakaroto ($11.25 in chips) 
Seat 2: Kow6oy ($10.10 in chips) 
Seat 3: ARCHITECT83 ($6.67 in chips) 
Seat 4: Raymondo21 ($23.78 in chips) 
Seat 5: XCarlos610 ($29.58 in chips) 
Seat 6: eniksenik ($10 in chips) 
ARCHITECT83: posts small blind $0.05
Raymondo21: posts big blind $0.10
*** HOLE CARDS ***
XCarlos610: folds 
eniksenik: folds 
iamkakaroto: folds 
Kow6oy: folds 
ARCHITECT83: calls $0.05
Raymondo21: raises $0.10 to $0.20
ARCHITECT83: raises $0.70 to $0.90
Raymondo21: calls $0.70
*** FLOP *** [6c Qc 4s]
ARCHITECT83: bets $0.60
Raymondo21: calls $0.60
*** TURN *** [6c Qc 4s] [5s]
ARCHITECT83: bets $5.17 and is all-in
Raymondo21: folds 
Uncalled bet ($5.17) returned to ARCHITECT83
ARCHITECT83 collected $2.86 from pot
*** SUMMARY ***
Total pot $3 | Rake $0.14 
Board [6c Qc 4s 5s]
Seat 1: iamkakaroto folded before Flop (didn't bet)
Seat 2: Kow6oy (button) folded before Flop (didn't bet)
Seat 3: ARCHITECT83 (small blind) collected ($2.86)
Seat 4: Raymondo21 (big blind) folded on the Turn
Seat 5: XCarlos610 folded before Flop (didn't bet)
Seat 6: eniksenik folded before Flop (didn't bet)



PokerStars Hand #166667760056:  Hold'em No Limit ($0.05/$0.10 USD) - 2017/02/23 16:07:02 ET
Table 'Pirola III' 6-max Seat #5 is the button
Seat 1: bdixon_5 ($9.47 in chips) 
Seat 3: kingartur222 ($10.82 in chips) 
Seat 4: McCleans ($10.72 in chips) 
Seat 5: tequila_joop ($10.40 in chips) 
Seat 6: T9MS ($10 in chips) 
T9MS: posts small blind $0.05
bdixon_5: posts big blind $0.10
Chodemuncher: sits out 
*** HOLE CARDS ***
kingartur222: folds 
McCleans: folds 
tequila_joop: raises $0.20 to $0.30
T9MS: raises $0.70 to $1
bdixon_5: folds 
tequila_joop: calls $0.70
*** FLOP *** [5c Kd Kc]
T9MS: checks 
tequila_joop: checks 
*** TURN *** [5c Kd Kc] [Th]
T9MS: checks 
tequila_joop: checks 
*** RIVER *** [5c Kd Kc Th] [Kh]
T9MS: bets $0.66
tequila_joop: folds 
Uncalled bet ($0.66) returned to T9MS
T9MS collected $2.01 from pot
*** SUMMARY ***
Total pot $2.10 | Rake $0.09 
Board [5c Kd Kc Th Kh]
Seat 1: bdixon_5 (big blind) folded before Flop
Seat 3: kingartur222 folded before Flop (didn't bet)
Seat 4: McCleans folded before Flop (didn't bet)
Seat 5: tequila_joop (button) folded on the River
Seat 6: T9MS (small blind) collected ($2.01)



PokerStars Hand #166667760417:  Hold'em No Limit ($0.05/$0.10 USD) - 2017/02/23 16:07:02 ET
Table 'Ebella II' 6-max Seat #2 is the button
Seat 1: gaHy_HaXeP ($10 in chips) 
Seat 2: Therodorus ($10 in chips) 
Seat 3: Torften2 ($17 in chips) 
Seat 4: ValdemorS ($11.50 in chips) 
Seat 5: Bird et al ($10 in chips) 
Seat 6: Joker51_wtf! ($11.24 in chips) 
Torften2: posts small blind $0.05
ValdemorS: posts big blind $0.10
*** HOLE CARDS ***
Bird et al: raises $0.21 to $0.31
Joker51_wtf!: folds 
gaHy_HaXeP: folds 
Therodorus: folds 
Torften2: folds 
ValdemorS: folds 
Uncalled bet ($0.21) returned to Bird et al
Bird et al collected $0.25 from pot
*** SUMMARY ***
Total pot $0.25 | Rake $0 
Seat 1: gaHy_HaXeP folded before Flop (didn't bet)
Seat 2: Therodorus (button) folded before Flop (didn't bet)
Seat 3: Torften2 (small blind) folded before Flop
Seat 4: ValdemorS (big blind) folded before Flop
Seat 5: Bird et al collected ($0.25)
Seat 6: Joker51_wtf! folded before Flop (didn't bet)



PokerStars Hand #166667760542:  Hold'em No Limit ($0.05/$0.10 USD) - 2017/02/23 16:07:02 ET
Table 'Persephone' 6-max Seat #2 is the button
Seat 1: dragonste89 ($10 in chips) 
Seat 2: AM-L-SL ($5.50 in chips) 
Seat 3: DasoII ($4.55 in chips) 
Seat 4: 2G28 ($10 in chips) 
Seat 5: ab260414 ($10.96 in chips) 
Seat 6: popypaleta ($14.71 in chips) 
DasoII: posts small blind $0.05
2G28: posts big blind $0.10
*** HOLE CARDS ***
ab260414: folds 
popypaleta: folds 
dragonste89: folds 
AM-L-SL: folds 
DasoII: calls $0.05
2G28: checks 
*** FLOP *** [5c Ks 8h]
DasoII: checks 
2G28: checks 
*** TURN *** [5c Ks 8h] [3c]
DasoII: checks 
2G28: checks 
*** RIVER *** [5c Ks 8h 3c] [7s]
DasoII: bets $0.10
2G28: folds 
Uncalled bet ($0.10) returned to DasoII
DasoII collected $0.19 from pot
*** SUMMARY ***
Total pot $0.20 | Rake $0.01 
Board [5c Ks 8h 3c 7s]
Seat 1: dragonste89 folded before Flop (didn't bet)
Seat 2: AM-L-SL (button) folded before Flop (didn't bet)
Seat 3: DasoII (small blind) collected ($0.19)
Seat 4: 2G28 (big blind) folded on the River
Seat 5: ab260414 folded before Flop (didn't bet)
Seat 6: popypaleta folded before Flop (didn't bet)



PokerStars Hand #166667760774:  Hold'em No Limit ($0.05/$0.10 USD) - 2017/02/23 16:07:02 ET
Table 'Jokaste II' 6-max Seat #5 is the button
Seat 1: Hyd SK ($13.55 in chips) 
Seat 2: T9MS ($12.33 in chips) 
Seat 3: crazydevill ($10.96 in chips) 
Seat 4: FRAID358 ($15.21 in chips) 
Seat 5: Vrinni ($10.13 in chips) 
Seat 6: Adailton07 ($14.35 in chips) 
Adailton07: posts small blind $0.05
Hyd SK: posts big blind $0.10
*** HOLE CARDS ***
T9MS: folds 
crazydevill: raises $0.20 to $0.30
FRAID358: folds 
Vrinni: folds 
Adailton07: calls $0.25
Hyd SK: folds 
*** FLOP *** [Th 6s 8d]
Adailton07: checks 
crazydevill: bets $0.40
Adailton07: folds 
Uncalled bet ($0.40) returned to crazydevill
crazydevill collected $0.67 from pot
*** SUMMARY ***
Total pot $0.70 | Rake $0.03 
Board [Th 6s 8d]
Seat 1: Hyd SK (big blind) folded before Flop
Seat 2: T9MS folded before Flop (didn't bet)
Seat 3: crazydevill collected ($0.67)
Seat 4: FRAID358 folded before Flop (didn't bet)
Seat 5: Vrinni (button) folded before Flop (didn't bet)
Seat 6: Adailton07 (small blind) folded on the Flop



PokerStars Hand #166667761118:  Hold'em No Limit ($0.05/$0.10 USD) - 2017/02/23 16:07:03 ET
Table 'Aconcagua' 6-max Seat #1 is the button
Seat 1: MLPlayer16 ($10.65 in chips) 
Seat 2: Kupi007 ($10 in chips) 
Seat 3: burtila1989 ($6.93 in chips) 
Seat 4: pivanki11 ($10.03 in chips) 
Seat 5: frazaunch ($5.76 in chips) 
Seat 6: coolisses111 ($11.90 in chips) 
Kupi007: posts small blind $0.05
burtila1989: posts big blind $0.10
MLPlayer16: posts the ante $0.02
Kupi007: posts the ante $0.02
burtila1989: posts the ante $0.02
pivanki11: posts the ante $0.02
frazaunch: posts the ante $0.02
coolisses111: posts the ante $0.02
*** HOLE CARDS ***
pivanki11: calls $0.10
frazaunch: folds 
coolisses111: folds 
MLPlayer16: folds 
Kupi007: folds 
burtila1989: raises $0.10 to $0.20
pivanki11: calls $0.10
*** FLOP *** [6s 3h Th]
burtila1989: checks 
pivanki11: checks 
*** TURN *** [6s 3h Th] [8h]
frazaunch leaves the table
burtila1989: checks 
Andrei ProFF joins the table at seat #5 
pivanki11: checks 
*** RIVER *** [6s 3h Th 8h] [6d]
burtila1989: checks 
pivanki11: checks 
*** SHOW DOWN ***
burtila1989: shows [3c 9c] (two pair, Sixes and Threes)
pivanki11: mucks hand 
burtila1989 collected $0.54 from pot
*** SUMMARY ***
Total pot $0.57 | Rake $0.03 
Board [6s 3h Th 8h 6d]
Seat 1: MLPlayer16 (button) folded before Flop (didn't bet)
Seat 2: Kupi007 (small blind) folded before Flop
Seat 3: burtila1989 (big blind) showed [3c 9c] and won ($0.54) with two pair, Sixes and Threes
Seat 4: pivanki11 mucked
Seat 5: frazaunch folded before Flop (didn't bet)
Seat 6: coolisses111 folded before Flop (didn't bet)



PokerStars Hand #166667761141:  Hold'em No Limit ($0.05/$0.10 USD) - 2017/02/23 16:07:03 ET
Table 'Esperanto II' 6-max Seat #2 is the button
Seat 1: kurasd ($10.95 in chips) 
Seat 2: MihaGr ($10 in chips) 
Seat 3: Namhkal ($12 in chips) 
Seat 4: Andrei ProFF ($10.35 in chips) 
Seat 5: FRAID358 ($9.85 in chips) 
Seat 6: ArcticBearDK ($13.28 in chips) 
Namhkal: posts small blind $0.05
Andrei ProFF: posts big blind $0.10
*** HOLE CARDS ***
FRAID358: folds 
ArcticBearDK: folds 
kurasd: calls $0.10
MihaGr: raises $0.35 to $0.45
Namhkal: folds 
Andrei ProFF: folds 
kurasd: calls $0.35
*** FLOP *** [8s Ac As]
kurasd: checks 
MihaGr: bets $0.65
kurasd: folds 
Uncalled bet ($0.65) returned to MihaGr
MihaGr collected $1 from pot
*** SUMMARY ***
Total pot $1.05 | Rake $0.05 
Board [8s Ac As]
Seat 1: kurasd folded on the Flop
Seat 2: MihaGr (button) collected ($1)
Seat 3: Namhkal (small blind) folded before Flop
Seat 4: Andrei ProFF (big blind) folded before Flop
Seat 5: FRAID358 folded before Flop (didn't bet)
Seat 6: ArcticBearDK folded before Flop (didn't bet)



PokerStars Hand #166667761202:  Hold'em No Limit ($0.05/$0.10 USD) - 2017/02/23 16:07:03 ET
Table 'Isberga' 6-max Seat #4 is the button
Seat 1: Feverhead ($18.32 in chips) 
Seat 2: GESPERIA ($10.12 in chips) 
Seat 4: THIMUCHIN ($10.69 in chips) 
Seat 5: YoungGriff86 ($18.92 in chips) 
Seat 6: Goroshkos88 ($21.38 in chips) 
YoungGriff86: posts small blind $0.05
Goroshkos88: posts big blind $0.10
*** HOLE CARDS ***
Feverhead: folds 
GESPERIA: folds 
THIMUCHIN: folds 
YoungGriff86: folds 
Uncalled bet ($0.05) returned to Goroshkos88
Goroshkos88 collected $0.10 from pot
*** SUMMARY ***
Total pot $0.10 | Rake $0 
Seat 1: Feverhead folded before Flop (didn't bet)
Seat 2: GESPERIA folded before Flop (didn't bet)
Seat 4: THIMUCHIN (button) folded before Flop (didn't bet)
Seat 5: YoungGriff86 (small blind) folded before Flop
Seat 6: Goroshkos88 (big blind) collected ($0.10)



PokerStars Hand #166667761218:  Hold'em No Limit ($0.05/$0.10 USD) - 2017/02/23 16:07:03 ET
Table 'Gaika II' 6-max Seat #6 is the button
Seat 1: Ice_Isayev ($10 in chips) 
Seat 2: steepfell ($10.32 in chips) 
Seat 3: iDecMate ($18.73 in chips) 
Seat 4: Hyd SK ($12.08 in chips) 
Seat 5: KokoulinV ($12.56 in chips) 
Seat 6: bartabs2 ($8.92 in chips) 
Ice_Isayev: posts small blind $0.05
steepfell: posts big blind $0.10
*** HOLE CARDS ***
iDecMate: folds 
Hyd SK: folds 
KokoulinV: folds 
bartabs2: raises $0.20 to $0.30
Ice_Isayev: folds 
steepfell: folds 
Uncalled bet ($0.20) returned to bartabs2
bartabs2 collected $0.25 from pot
*** SUMMARY ***
Total pot $0.25 | Rake $0 
Seat 1: Ice_Isayev (small blind) folded before Flop
Seat 2: steepfell (big blind) folded before Flop
Seat 3: iDecMate folded before Flop (didn't bet)
Seat 4: Hyd SK folded before Flop (didn't bet)
Seat 5: KokoulinV folded before Flop (didn't bet)
Seat 6: bartabs2 (button) collected ($0.25)



PokerStars Hand #166667761258:  Hold'em No Limit ($0.05/$0.10 USD) - 2017/02/23 16:07:03 ET
Table 'Manto II' 6-max Seat #2 is the button
Seat 2: voledy ($10 in chips) 
Seat 3: Komap511 ($9.90 in chips) 
Seat 4: dr.goofy ($14.96 in chips) 
Seat 5: ArcticBearDK ($32.69 in chips) 
Seat 6: pancernik21 ($16.35 in chips) 
Komap511: posts small blind $0.05
dr.goofy: posts big blind $0.10
*** HOLE CARDS ***
ArcticBearDK: folds 
pancernik21: folds 
ex3Lero86 joins the table at seat #1 
voledy: folds 
Komap511: folds 
Uncalled bet ($0.05) returned to dr.goofy
dr.goofy collected $0.10 from pot
*** SUMMARY ***
Total pot $0.10 | Rake $0 
Seat 2: voledy (button) folded before Flop (didn't bet)
Seat 3: Komap511 (small blind) folded before Flop
Seat 4: dr.goofy (big blind) collected ($0.10)
Seat 5: ArcticBearDK folded before Flop (didn't bet)
Seat 6: pancernik21 folded before Flop (didn't bet)



PokerStars Hand #166667761482:  Hold'em No Limit ($0.05/$0.10 USD) - 2017/02/23 16:07:03 ET
Table 'Eudora' 6-max Seat #1 is the button
Seat 1: archer2511 ($11.46 in chips) 
Seat 2: popypaleta ($10 in chips) 
Seat 3: Ice_Isayev ($10.60 in chips) 
Seat 4: yodzik ($5.30 in chips) 
Seat 5: chimera252 ($11.67 in chips) 
popypaleta: posts small blind $0.05
Ice_Isayev: posts big blind $0.10
*** HOLE CARDS ***
yodzik: folds 
chimera252: raises $0.20 to $0.30
archer2511: calls $0.30
popypaleta: folds 
Ice_Isayev: folds 
*** FLOP *** [8h 4h 2c]
chimera252: bets $0.58
archer2511: calls $0.58
*** TURN *** [8h 4h 2c] [5c]
chimera252: checks 
archer2511: bets $1.20
chimera252: folds 
Uncalled bet ($1.20) returned to archer2511
archer2511 collected $1.82 from pot
*** SUMMARY ***
Total pot $1.91 | Rake $0.09 
Board [8h 4h 2c 5c]
Seat 1: archer2511 (button) collected ($1.82)
Seat 2: popypaleta (small blind) folded before Flop
Seat 3: Ice_Isayev (big blind) folded before Flop
Seat 4: yodzik folded before Flop (didn't bet)
Seat 5: chimera252 folded on the Turn



PokerStars Hand #166667761719:  Hold'em No Limit ($0.05/$0.10 USD) - 2017/02/23 16:07:03 ET
Table 'Alnasl' 6-max Seat #2 is the button
Seat 1: KA3AXCTAHEU, ($11.20 in chips) 
Seat 2: saddur ($9.84 in chips) 
Seat 3: david_sara83 ($22.59 in chips) 
Seat 4: oddshoff ($9.98 in chips) 
Seat 6: Zooplack ($13.43 in chips) 
david_sara83: posts small blind $0.05
oddshoff: posts big blind $0.10
6ePeMeHHa9: sits out 
*** HOLE CARDS ***
Zooplack: folds 
KA3AXCTAHEU,: folds 
saddur: raises $0.10 to $0.20
david_sara83: folds 
oddshoff: raises $0.60 to $0.80
saddur: folds 
Uncalled bet ($0.60) returned to oddshoff
oddshoff collected $0.45 from pot
*** SUMMARY ***
Total pot $0.45 | Rake $0 
Seat 1: KA3AXCTAHEU, folded before Flop (didn't bet)
Seat 2: saddur (button) folded before Flop
Seat 3: david_sara83 (small blind) folded before Flop
Seat 4: oddshoff (big blind) collected ($0.45)
Seat 6: Zooplack folded before Flop (didn't bet)



PokerStars Hand #166667761868:  Hold'em No Limit ($0.05/$0.10 USD) - 2017/02/23 16:07:04 ET
Table 'Torrence II' 6-max Seat #6 is the button
Seat 1: Starbooks ($7.36 in chips) 
Seat 2: scorpionfish ($15.80 in chips) 
Seat 3: coolisses111 ($9.80 in chips) 
Seat 4: Zooplack ($10 in chips) 
Seat 5: Kow6oy ($12.18 in chips) 
Seat 6: mhonielsen ($10 in chips) 
Starbooks: posts small blind $0.05
scorpionfish: posts big blind $0.10
*** HOLE CARDS ***
coolisses111: folds 
Zooplack: folds 
Kow6oy: folds 
mhonielsen: folds 
Starbooks: folds 
Uncalled bet ($0.05) returned to scorpionfish
scorpionfish collected $0.10 from pot
*** SUMMARY ***
Total pot $0.10 | Rake $0 
Seat 1: Starbooks (small blind) folded before Flop
Seat 2: scorpionfish (big blind) collected ($0.10)
Seat 3: coolisses111 folded before Flop (didn't bet)
Seat 4: Zooplack folded before Flop (didn't bet)
Seat 5: Kow6oy folded before Flop (didn't bet)
Seat 6: mhonielsen (button) folded before Flop (didn't bet)



PokerStars Hand #166667762084:  Hold'em No Limit ($0.05/$0.10 USD) - 2017/02/23 16:07:04 ET
Table 'Antinous' 6-max Seat #1 is the button
Seat 1: Andrei ProFF ($15.83 in chips) 
Seat 2: Nr847 ($13.50 in chips) 
Seat 3: dittoro ($10.15 in chips) 
Seat 5: Covetsoles ($3.62 in chips) 
Seat 6: coolisses111 ($10 in chips) 
Nr847: posts small blind $0.05
dittoro: posts big blind $0.10
Pekaml: sits out 
*** HOLE CARDS ***
Covetsoles: folds 
coolisses111: folds 
Andrei ProFF: folds 
Nr847: raises $0.20 to $0.30
dittoro: folds 
Uncalled bet ($0.20) returned to Nr847
Nr847 collected $0.20 from pot
*** SUMMARY ***
Total pot $0.20 | Rake $0 
Seat 1: Andrei ProFF (button) folded before Flop (didn't bet)
Seat 2: Nr847 (small blind) collected ($0.20)
Seat 3: dittoro (big blind) folded before Flop
Seat 5: Covetsoles folded before Flop (didn't bet)
Seat 6: coolisses111 folded before Flop (didn't bet)



PokerStars Hand #166667762404:  Hold'em No Limit ($0.05/$0.10 USD) - 2017/02/23 16:07:04 ET
Table 'Nymphe II' 6-max Seat #5 is the button
Seat 1: jacktayra ($1.56 in chips) 
Seat 2: Newqbrown ($10 in chips) 
Seat 3: THIMUCHIN ($16.61 in chips) 
Seat 4: coolisses111 ($18 in chips) 
Seat 5: Yspenyanin ($21.66 in chips) 
Seat 6: Xander188 ($10 in chips) 
Xander188: posts small blind $0.05
jacktayra: posts big blind $0.10
*** HOLE CARDS ***
Newqbrown: raises $0.20 to $0.30
THIMUCHIN: folds 
coolisses111: calls $0.30
Yspenyanin: folds 
Xander188: folds 
jacktayra: folds 
*** FLOP *** [Qh Jh 6h]
Newqbrown: bets $0.40
coolisses111: calls $0.40
*** TURN *** [Qh Jh 6h] [3d]
Newqbrown: bets $1
coolisses111: folds 
Uncalled bet ($1) returned to Newqbrown
Newqbrown collected $1.48 from pot
*** SUMMARY ***
Total pot $1.55 | Rake $0.07 
Board [Qh Jh 6h 3d]
Seat 1: jacktayra (big blind) folded before Flop
Seat 2: Newqbrown collected ($1.48)
Seat 3: THIMUCHIN folded before Flop (didn't bet)
Seat 4: coolisses111 folded on the Turn
Seat 5: Yspenyanin (button) folded before Flop (didn't bet)
Seat 6: Xander188 (small blind) folded before Flop



PokerStars Hand #166667762429:  Hold'em No Limit ($0.05/$0.10 USD) - 2017/02/23 16:07:04 ET
Table 'Lobelia II' 6-max Seat #1 is the button
Seat 1: facewald ($21.22 in chips) 
Seat 2: Dcaro31 ($17.51 in chips) 
Seat 3: oddshoff ($19.25 in chips) 
Seat 5: Feverhead ($20.03 in chips) 
Seat 6: NvR.m1nD ($10.47 in chips) 
Dcaro31: posts small blind $0.05
oddshoff: posts big blind $0.10
*** HOLE CARDS ***
Feverhead: folds 
NvR.m1nD: raises $0.15 to $0.25
facewald: folds 
Dcaro31: folds 
oddshoff: folds 
Uncalled bet ($0.15) returned to NvR.m1nD
NvR.m1nD collected $0.25 from pot
*** SUMMARY ***
Total pot $0.25 | Rake $0 
Seat 1: facewald (button) folded before Flop (didn't bet)
Seat 2: Dcaro31 (small blind) folded before Flop
Seat 3: oddshoff (big blind) folded before Flop
Seat 5: Feverhead folded before Flop (didn't bet)
Seat 6: NvR.m1nD collected ($0.25)



PokerStars Hand #166667762450:  Hold'em No Limit ($0.05/$0.10 USD) - 2017/02/23 16:07:04 ET
Table 'Crocus' 6-max Seat #2 is the button
Seat 1: truck1234 ($25.76 in chips) 
Seat 2: garigura ($10.94 in chips) 
Seat 4: patrick19111 ($12.26 in chips) 
Seat 6: Rodik002 ($10.23 in chips) 
patrick19111: posts small blind $0.05
Golsuorsi: is sitting out 
Rodik002: posts big blind $0.10
*** HOLE CARDS ***
truck1234: folds 
garigura: raises $0.15 to $0.25
patrick19111: raises $0.65 to $0.90
Rodik002: folds 
garigura: folds 
Uncalled bet ($0.65) returned to patrick19111
patrick19111 collected $0.60 from pot
*** SUMMARY ***
Total pot $0.60 | Rake $0 
Seat 1: truck1234 folded before Flop (didn't bet)
Seat 2: garigura (button) folded before Flop
Seat 4: patrick19111 (small blind) collected ($0.60)
Seat 6: Rodik002 (big blind) folded before Flop



PokerStars Hand #166667762767:  Hold'em No Limit ($0.05/$0.10 USD) - 2017/02/23 16:07:05 ET
Table 'Bootes' 6-max Seat #2 is the button
Seat 1: Namhkal ($11.77 in chips) 
Seat 2: Bird et al ($19.15 in chips) 
Seat 3: KA3AXCTAHEU, ($19.13 in chips) 
Seat 4: totonove ($6.41 in chips) 
Seat 6: cherep61987 ($10.22 in chips) 
KA3AXCTAHEU,: posts small blind $0.05
totonove: posts big blind $0.10
Pekaml: sits out 
*** HOLE CARDS ***
cherep61987: folds 
Namhkal: raises $0.15 to $0.25
Bird et al: folds 
KA3AXCTAHEU,: folds 
totonove: calls $0.15
*** FLOP *** [Kd 9h 2c]
totonove: checks 
Namhkal: bets $0.27
totonove: calls $0.27
*** TURN *** [Kd 9h 2c] [3s]
totonove: checks 
Namhkal: checks 
*** RIVER *** [Kd 9h 2c 3s] [Kc]
totonove: bets $0.40
Namhkal: folds 
Uncalled bet ($0.40) returned to totonove
totonove collected $1.04 from pot
*** SUMMARY ***
Total pot $1.09 | Rake $0.05 
Board [Kd 9h 2c 3s Kc]
Seat 1: Namhkal folded on the River
Seat 2: Bird et al (button) folded before Flop (didn't bet)
Seat 3: KA3AXCTAHEU, (small blind) folded before Flop
Seat 4: totonove (big blind) collected ($1.04)
Seat 6: cherep61987 folded before Flop (didn't bet)



PokerStars Hand #166667762894:  Hold'em No Limit ($0.05/$0.10 USD) - 2017/02/23 16:07:05 ET
Table 'Peiroos III' 6-max Seat #5 is the button
Seat 1: tequila_joop ($10 in chips) 
Seat 3: nabatov.m ($6.65 in chips) 
Seat 4: pivanki11 ($10.92 in chips) 
Seat 5: ChuikaPridi ($10 in chips) 
Seat 6: CHRO8 ($10.10 in chips) 
CHRO8: posts small blind $0.05
tequila_joop: posts big blind $0.10
tequila_joop: posts the ante $0.02
nabatov.m: posts the ante $0.02
pivanki11: posts the ante $0.02
ChuikaPridi: posts the ante $0.02
CHRO8: posts the ante $0.02
*** HOLE CARDS ***
nabatov.m: folds 
pivanki11: folds 
ChuikaPridi: raises $0.20 to $0.30
CHRO8: folds 
tequila_joop: folds 
Uncalled bet ($0.20) returned to ChuikaPridi
ChuikaPridi collected $0.35 from pot
*** SUMMARY ***
Total pot $0.35 | Rake $0 
Seat 1: tequila_joop (big blind) folded before Flop
Seat 3: nabatov.m folded before Flop (didn't bet)
Seat 4: pivanki11 folded before Flop (didn't bet)
Seat 5: ChuikaPridi (button) collected ($0.35)
Seat 6: CHRO8 (small blind) folded before Flop



PokerStars Hand #166667763026:  Hold'em No Limit ($0.05/$0.10 USD) - 2017/02/23 16:07:05 ET
Table 'Jacchia' 6-max Seat #1 is the button
Seat 1: viklundm ($35.59 in chips) 
Seat 2: VAD21 ($20.11 in chips) 
Seat 3: maxiv608 ($10 in chips) 
Seat 4: paterthomas ($9.37 in chips) 
Seat 6: RoJ1 ($12.11 in chips) 
VAD21: posts small blind $0.05
maxiv608: posts big blind $0.10
*** HOLE CARDS ***
paterthomas: folds 
RoJ1: folds 
viklundm: calls $0.10
VAD21: folds 
maxiv608: checks 
*** FLOP *** [7d Kd 7c]
maxiv608: checks 
viklundm: bets $0.20
maxiv608: folds 
Uncalled bet ($0.20) returned to viklundm
viklundm collected $0.24 from pot
*** SUMMARY ***
Total pot $0.25 | Rake $0.01 
Board [7d Kd 7c]
Seat 1: viklundm (button) collected ($0.24)
Seat 2: VAD21 (small blind) folded before Flop
Seat 3: maxiv608 (big blind) folded on the Flop
Seat 4: paterthomas folded before Flop (didn't bet)
Seat 6: RoJ1 folded before Flop (didn't bet)



PokerStars Hand #166667763031:  Hold'em No Limit ($0.05/$0.10 USD) - 2017/02/23 16:07:05 ET
Table 'Alnasl II' 6-max Seat #4 is the button
Seat 1: dragonste89 ($14.05 in chips) 
Seat 2: Therodorus ($10.86 in chips) 
Seat 3: ICBM-RS26 ($15.72 in chips) 
Seat 4: Eddys Edge ($10 in chips) 
Seat 5: mdelfin0 ($12.36 in chips) 
Seat 6: Bommer78 ($4.66 in chips) 
mdelfin0: posts small blind $0.05
Bommer78: posts big blind $0.10
*** HOLE CARDS ***
dragonste89: folds 
Therodorus: raises $0.20 to $0.30
ICBM-RS26: folds 
Eddys Edge: folds 
mdelfin0: folds 
Bommer78: calls $0.20
*** FLOP *** [6d Qd 9c]
Bommer78: checks 
Therodorus: checks 
*** TURN *** [6d Qd 9c] [Jd]
Bommer78: bets $0.10
Therodorus: folds 
Uncalled bet ($0.10) returned to Bommer78
Bommer78 collected $0.62 from pot
*** SUMMARY ***
Total pot $0.65 | Rake $0.03 
Board [6d Qd 9c Jd]
Seat 1: dragonste89 folded before Flop (didn't bet)
Seat 2: Therodorus folded on the Turn
Seat 3: ICBM-RS26 folded before Flop (didn't bet)
Seat 4: Eddys Edge (button) folded before Flop (didn't bet)
Seat 5: mdelfin0 (small blind) folded before Flop
Seat 6: Bommer78 (big blind) collected ($0.62)



PokerStars Hand #166667763163:  Hold'em No Limit ($0.05/$0.10 USD) - 2017/02/23 16:07:05 ET
Table 'Stroobantia II' 6-max Seat #5 is the button
Seat 1: XBrosh ($7.69 in chips) 
Seat 2: IAntikI ($10 in chips) 
Seat 3: 8th wonders ($11.19 in chips) 
Seat 5: Zooplack ($12.61 in chips) 
Seat 6: CHRO8 ($12.72 in chips) 
CHRO8: posts small blind $0.05
XBrosh: posts big blind $0.10
Punzzzer: sits out 
*** HOLE CARDS ***
IAntikI: folds 
8th wonders: folds 
Zooplack: folds 
CHRO8: folds 
Uncalled bet ($0.05) returned to XBrosh
XBrosh collected $0.10 from pot
*** SUMMARY ***
Total pot $0.10 | Rake $0 
Seat 1: XBrosh (big blind) collected ($0.10)
Seat 2: IAntikI folded before Flop (didn't bet)
Seat 3: 8th wonders folded before Flop (didn't bet)
Seat 5: Zooplack (button) folded before Flop (didn't bet)
Seat 6: CHRO8 (small blind) folded before Flop



PokerStars Hand #166667763184:  Hold'em No Limit ($0.05/$0.10 USD) - 2017/02/23 16:07:05 ET
Table 'Hajek III' 6-max Seat #5 is the button
Seat 1: MBen10 ($10.50 in chips) 
Seat 2: fortieth ($10.19 in chips) 
Seat 3: fedorka rus ($10.61 in chips) 
Seat 4: NvR.m1nD ($13.67 in chips) 
Seat 5: Croplayer1 ($14.60 in chips) 
fabadam will be allowed to play after the button
MBen10: posts small blind $0.05
fortieth: posts big blind $0.10
*** HOLE CARDS ***
fedorka rus: folds 
NvR.m1nD: folds 
Croplayer1: raises $0.10 to $0.20
MBen10: folds 
fortieth: folds 
Uncalled bet ($0.10) returned to Croplayer1
Croplayer1 collected $0.25 from pot
*** SUMMARY ***
Total pot $0.25 | Rake $0 
Seat 1: MBen10 (small blind) folded before Flop
Seat 2: fortieth (big blind) folded before Flop
Seat 3: fedorka rus folded before Flop (didn't bet)
Seat 4: NvR.m1nD folded before Flop (didn't bet)
Seat 5: Croplayer1 (button) collected ($0.25)



PokerStars Hand #166667763368:  Hold'em No Limit ($0.05/$0.10 USD) - 2017/02/23 16:07:05 ET
Table 'Alzirr II' 6-max Seat #3 is the button
Seat 1: KA3AXCTAHEU, ($10.31 in chips) 
Seat 2: popypaleta ($10.17 in chips) 
Seat 3: devon_red ($7.80 in chips) 
Seat 5: yodzik ($5.27 in chips) 
Seat 6: AM-L-SL ($4.93 in chips) 
yodzik: posts small blind $0.05
AM-L-SL: posts big blind $0.10
*** HOLE CARDS ***
KA3AXCTAHEU,: folds 
popypaleta: raises $0.20 to $0.30
devon_red: calls $0.30
yodzik: calls $0.25
AM-L-SL: folds 
*** FLOP *** [2d Td 5d]
yodzik: checks 
popypaleta: checks 
devon_red: checks 
*** TURN *** [2d Td 5d] [Kc]
yodzik: checks 
popypaleta: checks 
devon_red: checks 
*** RIVER *** [2d Td 5d Kc] [7h]
yodzik: checks 
popypaleta: checks 
devon_red: checks 
*** SHOW DOWN ***
yodzik: shows [8d 8s] (a pair of Eights)
popypaleta: mucks hand 
devon_red: mucks hand 
yodzik collected $0.96 from pot
*** SUMMARY ***
Total pot $1 | Rake $0.04 
Board [2d Td 5d Kc 7h]
Seat 1: KA3AXCTAHEU, folded before Flop (didn't bet)
Seat 2: popypaleta mucked
Seat 3: devon_red (button) mucked
Seat 5: yodzik (small blind) showed [8d 8s] and won ($0.96) with a pair of Eights
Seat 6: AM-L-SL (big blind) folded before Flop



PokerStars Hand #166667763370:  Hold'em No Limit ($0.05/$0.10 USD) - 2017/02/23 16:07:05 ET
Table 'Walpurga' 6-max Seat #2 is the button
Seat 1: chimera252 ($12.07 in chips) 
Seat 2: paxit71 ($5.45 in chips) 
Seat 3: marianoboni ($10.61 in chips) 
Seat 4: oddshoff ($13.04 in chips) 
Seat 6: AIONCMA1988 ($5.58 in chips) 
marianoboni: posts small blind $0.05
oddshoff: posts big blind $0.10
Fremara: sits out 
*** HOLE CARDS ***
AIONCMA1988: folds 
chimera252: folds 
paxit71: folds 
marianoboni: folds 
Uncalled bet ($0.05) returned to oddshoff
oddshoff collected $0.10 from pot
*** SUMMARY ***
Total pot $0.10 | Rake $0 
Seat 1: chimera252 folded before Flop (didn't bet)
Seat 2: paxit71 (button) folded before Flop (didn't bet)
Seat 3: marianoboni (small blind) folded before Flop
Seat 4: oddshoff (big blind) collected ($0.10)
Seat 6: AIONCMA1988 folded before Flop (didn't bet)



PokerStars Hand #166667763752:  Hold'em No Limit ($0.05/$0.10 USD) - 2017/02/23 16:07:06 ET
Table 'Carina' 6-max Seat #6 is the button
Seat 1: Kupi007 ($10 in chips) 
Seat 3: LarryTheStar ($11.52 in chips) 
Seat 5: IAntikI ($10.15 in chips) 
Seat 6: alexweezer ($8.35 in chips) 
Kupi007: posts small blind $0.05
kickereens: is sitting out 
kickereens leaves the table
LarryTheStar: posts big blind $0.10
steepfell: sits out 
*** HOLE CARDS ***
IAntikI: raises $0.20 to $0.30
alexweezer: folds 
Kupi007: calls $0.25
XwinX25 joins the table at seat #2 
LarryTheStar: calls $0.20
*** FLOP *** [9d 4h Qc]
Kupi007: checks 
LarryTheStar: checks 
IAntikI: checks 
*** TURN *** [9d 4h Qc] [9c]
Kupi007: bets $0.45
LarryTheStar: raises $0.95 to $1.40
IAntikI: folds 
Kupi007: folds 
Uncalled bet ($0.95) returned to LarryTheStar
LarryTheStar collected $1.72 from pot
*** SUMMARY ***
Total pot $1.80 | Rake $0.08 
Board [9d 4h Qc 9c]
Seat 1: Kupi007 (small blind) folded on the Turn
Seat 3: LarryTheStar (big blind) collected ($1.72)
Seat 5: IAntikI folded on the Turn
Seat 6: alexweezer (button) folded before Flop (didn't bet)



PokerStars Hand #166667763917:  Hold'em No Limit ($0.05/$0.10 USD) - 2017/02/23 16:07:06 ET
Table 'Markab II' 6-max Seat #1 is the button
Seat 1: david_sara83 ($10.22 in chips) 
Seat 2: truck1234 ($10.95 in chips) 
Seat 3: sexy_seagull ($10.15 in chips) 
Seat 4: Crafty23@PS ($11.54 in chips) 
Seat 5: Rodik002 ($19.92 in chips) 
Seat 6: Comeback3392 ($10 in chips) 
truck1234: posts small blind $0.05
sexy_seagull: posts big blind $0.10
*** HOLE CARDS ***
Crafty23@PS: folds 
Rodik002: folds 
Comeback3392: folds 
david_sara83: folds 
truck1234: folds 
Uncalled bet ($0.05) returned to sexy_seagull
sexy_seagull collected $0.10 from pot
*** SUMMARY ***
Total pot $0.10 | Rake $0 
Seat 1: david_sara83 (button) folded before Flop (didn't bet)
Seat 2: truck1234 (small blind) folded before Flop
Seat 3: sexy_seagull (big blind) collected ($0.10)
Seat 4: Crafty23@PS folded before Flop (didn't bet)
Seat 5: Rodik002 folded before Flop (didn't bet)
Seat 6: Comeback3392 folded before Flop (didn't bet)



PokerStars Hand #166667765700:  Hold'em No Limit ($0.05/$0.10 USD) - 2017/02/23 16:07:08 ET
Table 'Nauheima II' 6-max Seat #6 is the button
Seat 2: Peter0087 ($10.52 in chips) 
Seat 3: KokoulinV ($13.14 in chips) 
Seat 4: Innerwuss ($10.07 in chips) 
Seat 6: bonyo71 ($5.04 in chips) 
Peter0087: posts small blind $0.05
KokoulinV: posts big blind $0.10
bambolejro: sits out 
*** HOLE CARDS ***
Innerwuss has timed out
Innerwuss: folds 
bonyo71: folds 
Peter0087: raises $0.10 to $0.20
KokoulinV: folds 
Uncalled bet ($0.10) returned to Peter0087
Peter0087 collected $0.20 from pot
*** SUMMARY ***
Total pot $0.20 | Rake $0 
Seat 2: Peter0087 (small blind) collected ($0.20)
Seat 3: KokoulinV (big blind) folded before Flop
Seat 4: Innerwuss folded before Flop (didn't bet)
Seat 6: bonyo71 (button) folded before Flop (didn't bet)



PokerStars Hand #166667766171:  Hold'em No Limit ($0.05/$0.10 USD) - 2017/02/23 16:07:08 ET
Table 'Sham' 6-max Seat #2 is the button
Seat 1: pancernik21 ($10 in chips) 
Seat 2: ex3Lero86 ($10.30 in chips) 
Seat 3: weez3r ($14.53 in chips) 
Seat 4: VAD21 ($14.36 in chips) 
Seat 5: T9MS ($10 in chips) 
Seat 6: bdixon_5 ($15.90 in chips) 
weez3r: posts small blind $0.05
VAD21: posts big blind $0.10
*** HOLE CARDS ***
T9MS: folds 
bdixon_5: raises $0.20 to $0.30
pancernik21: raises $0.60 to $0.90
ex3Lero86: folds 
weez3r: folds 
VAD21: folds 
bdixon_5: calls $0.60
*** FLOP *** [Th Js 9h]
bdixon_5: checks 
pancernik21: bets $1
bdixon_5: calls $1
*** TURN *** [Th Js 9h] [2s]
bdixon_5: checks 
pancernik21: checks 
*** RIVER *** [Th Js 9h 2s] [5h]
bdixon_5: bets $1.90
pancernik21: calls $1.90
*** SHOW DOWN ***
bdixon_5: shows [8d 8h] (a pair of Eights)
pancernik21: mucks hand 
bdixon_5 collected $7.40 from pot
*** SUMMARY ***
Total pot $7.75 | Rake $0.35 
Board [Th Js 9h 2s 5h]
Seat 1: pancernik21 mucked
Seat 2: ex3Lero86 (button) folded before Flop (didn't bet)
Seat 3: weez3r (small blind) folded before Flop
Seat 4: VAD21 (big blind) folded before Flop
Seat 5: T9MS folded before Flop (didn't bet)
Seat 6: bdixon_5 showed [8d 8h] and won ($7.40) with a pair of Eights



PokerStars Hand #166667766240:  Hold'em No Limit ($0.05/$0.10 USD) - 2017/02/23 16:07:08 ET
Table 'Nekkar' 6-max Seat #4 is the button
Seat 2: Bird et al ($11.02 in chips) 
Seat 3: Zemz_Ru ($15.20 in chips) 
Seat 4: kingartur222 ($12.65 in chips) 
Seat 5: Vrinni ($12.24 in chips) 
Seat 6: Eddys Edge ($10.48 in chips) 
Vrinni: posts small blind $0.05
Eddys Edge: posts big blind $0.10
*** HOLE CARDS ***
Bird et al: folds 
Zemz_Ru: folds 
kingartur222: folds 
Vrinni: folds 
Uncalled bet ($0.05) returned to Eddys Edge
Eddys Edge collected $0.10 from pot
*** SUMMARY ***
Total pot $0.10 | Rake $0 
Seat 2: Bird et al folded before Flop (didn't bet)
Seat 3: Zemz_Ru folded before Flop (didn't bet)
Seat 4: kingartur222 (button) folded before Flop (didn't bet)
Seat 5: Vrinni (small blind) folded before Flop
Seat 6: Eddys Edge (big blind) collected ($0.10)



PokerStars Hand #166667766305:  Hold'em No Limit ($0.05/$0.10 USD) - 2017/02/23 16:07:08 ET
Table 'Samitchell III' 6-max Seat #6 is the button
Seat 1: dr.goofy ($10 in chips) 
Seat 3: Vanne11 ($9.90 in chips) 
Seat 5: steepfell ($10 in chips) 
Seat 6: fedorka rus ($12.31 in chips) 
dr.goofy: posts small blind $0.05
scorpionfish: is sitting out 
Vanne11: posts big blind $0.10
DEraser: sits out 
*** HOLE CARDS ***
steepfell: folds 
fedorka rus: folds 
dr.goofy: raises $0.20 to $0.30
Vanne11: folds 
Uncalled bet ($0.20) returned to dr.goofy
dr.goofy collected $0.20 from pot
*** SUMMARY ***
Total pot $0.20 | Rake $0 
Seat 1: dr.goofy (small blind) collected ($0.20)
Seat 3: Vanne11 (big blind) folded before Flop
Seat 5: steepfell folded before Flop (didn't bet)
Seat 6: fedorka rus (button) folded before Flop (didn't bet)



PokerStars Hand #166667766421:  Hold'em No Limit ($0.05/$0.10 USD) - 2017/02/23 16:07:09 ET
Table 'Wabash' 6-max Seat #5 is the button
Seat 1: pivanki11 ($10.15 in chips) 
Seat 2: ex3Lero86 ($32.48 in chips) 
Seat 4: Nr847 ($10 in chips) 
Seat 5: popypaleta ($13.89 in chips) 
Seat 6: weez3r ($10.97 in chips) 
weez3r: posts small blind $0.05
pivanki11: posts big blind $0.10
tauronex: sits out 
*** HOLE CARDS ***
ex3Lero86: folds 
Nr847: folds 
popypaleta: folds 
weez3r: raises $0.20 to $0.30
pivanki11: folds 
Uncalled bet ($0.20) returned to weez3r
weez3r collected $0.20 from pot
*** SUMMARY ***
Total pot $0.20 | Rake $0 
Seat 1: pivanki11 (big blind) folded before Flop
Seat 2: ex3Lero86 folded before Flop (didn't bet)
Seat 4: Nr847 folded before Flop (didn't bet)
Seat 5: popypaleta (button) folded before Flop (didn't bet)
Seat 6: weez3r (small blind) collected ($0.20)



PokerStars Hand #166667766705:  Hold'em No Limit ($0.05/$0.10 USD) - 2017/02/23 16:07:09 ET
Table 'Ostara III' 6-max Seat #3 is the button
Seat 1: MühliJr ($13.65 in chips) 
Seat 2: Action_Gibi ($6.37 in chips) 
Seat 3: vtalian ($12.98 in chips) 
Seat 6: FlopsterGB ($10.05 in chips) 
FlopsterGB: posts small blind $0.05
MühliJr: posts big blind $0.10
*** HOLE CARDS ***
Action_Gibi: raises $6.27 to $6.37 and is all-in
vtalian: folds 
FlopsterGB: folds 
MühliJr: folds 
Uncalled bet ($6.27) returned to Action_Gibi
Action_Gibi collected $0.25 from pot
*** SUMMARY ***
Total pot $0.25 | Rake $0 
Seat 1: MühliJr (big blind) folded before Flop
Seat 2: Action_Gibi collected ($0.25)
Seat 3: vtalian (button) folded before Flop (didn't bet)
Seat 6: FlopsterGB (small blind) folded before Flop



PokerStars Hand #166667767000:  Hold'em No Limit ($0.05/$0.10 USD) - 2017/02/23 16:07:09 ET
Table 'Oongaq' 6-max Seat #3 is the button
Seat 1: Dmitrij218 ($13.49 in chips) 
Seat 2: homelessdan ($18.40 in chips) 
Seat 3: iDecMate ($10.09 in chips) 
Seat 4: Bird et al ($10.05 in chips) 
Seat 5: Dizzler1991 ($5.58 in chips) 
Seat 6: boxer821 ($10 in chips) 
Bird et al: posts small blind $0.05
Dizzler1991: posts big blind $0.10
*** HOLE CARDS ***
boxer821: folds 
Dmitrij218: raises $0.10 to $0.20
homelessdan: folds 
iDecMate: folds 
Bird et al: folds 
Dizzler1991: calls $0.10
*** FLOP *** [Kh 2h Jc]
Dizzler1991: checks 
Dmitrij218: bets $0.10
Dizzler1991: calls $0.10
*** TURN *** [Kh 2h Jc] [5c]
Dizzler1991: checks 
Dmitrij218: bets $0.10
Dizzler1991: calls $0.10
*** RIVER *** [Kh 2h Jc 5c] [2c]
Dizzler1991: checks 
Dmitrij218: checks 
*** SHOW DOWN ***
Dizzler1991: shows [Qh 9d] (a pair of Deuces)
Dmitrij218: shows [3h Ac] (a pair of Deuces - Ace kicker)
Dmitrij218 collected $0.81 from pot
*** SUMMARY ***
Total pot $0.85 | Rake $0.04 
Board [Kh 2h Jc 5c 2c]
Seat 1: Dmitrij218 showed [3h Ac] and won ($0.81) with a pair of Deuces
Seat 2: homelessdan folded before Flop (didn't bet)
Seat 3: iDecMate (button) folded before Flop (didn't bet)
Seat 4: Bird et al (small blind) folded before Flop
Seat 5: Dizzler1991 (big blind) showed [Qh 9d] and lost with a pair of Deuces
Seat 6: boxer821 folded before Flop (didn't bet)



PokerStars Hand #166667767391:  Hold'em No Limit ($0.05/$0.10 USD) - 2017/02/23 16:07:10 ET
Table 'Phereclos II' 6-max Seat #5 is the button
Seat 1: Croplayer1 ($10 in chips) 
Seat 2: Kazacha ($10.40 in chips) 
Seat 3: BJamesB2014 ($5.70 in chips) 
Seat 4: DamDatsAnAce ($10.53 in chips) 
Seat 5: crazydevill ($12.19 in chips) 
Seat 6: mhonielsen ($16.20 in chips) 
mhonielsen: posts small blind $0.05
Croplayer1: posts big blind $0.10
*** HOLE CARDS ***
Kazacha: folds 
BJamesB2014: calls $0.10
DamDatsAnAce: folds 
crazydevill: folds 
mhonielsen: calls $0.05
Croplayer1: checks 
*** FLOP *** [3c 6c 3s]
mhonielsen: checks 
Croplayer1: checks 
BJamesB2014: checks 
*** TURN *** [3c 6c 3s] [Ah]
mhonielsen: bets $0.20
Croplayer1: folds 
BJamesB2014: folds 
Uncalled bet ($0.20) returned to mhonielsen
mhonielsen collected $0.29 from pot
*** SUMMARY ***
Total pot $0.30 | Rake $0.01 
Board [3c 6c 3s Ah]
Seat 1: Croplayer1 (big blind) folded on the Turn
Seat 2: Kazacha folded before Flop (didn't bet)
Seat 3: BJamesB2014 folded on the Turn
Seat 4: DamDatsAnAce folded before Flop (didn't bet)
Seat 5: crazydevill (button) folded before Flop (didn't bet)
Seat 6: mhonielsen (small blind) collected ($0.29)



PokerStars Hand #166667767963:  Hold'em No Limit ($0.05/$0.10 USD) - 2017/02/23 16:07:10 ET
Table 'Lacroute' 6-max Seat #5 is the button
Seat 1: Orlangoor ($10 in chips) 
Seat 2: Andy Wolf ($10 in chips) 
Seat 3: Croplayer1 ($14.45 in chips) 
Seat 4: st4tion ($17.37 in chips) 
Seat 5: steepfell ($12.19 in chips) 
Seat 6: IAntikI ($10.17 in chips) 
IAntikI: posts small blind $0.05
Orlangoor: posts big blind $0.10
*** HOLE CARDS ***
Andy Wolf: folds 
Croplayer1: folds 
st4tion: folds 
steepfell: raises $0.15 to $0.25
IAntikI: raises $0.55 to $0.80
Orlangoor: folds 
steepfell: raises $1.20 to $2
IAntikI: raises $8.17 to $10.17 and is all-in
steepfell: folds 
Uncalled bet ($8.17) returned to IAntikI
IAntikI collected $4.10 from pot
*** SUMMARY ***
Total pot $4.10 | Rake $0 
Seat 1: Orlangoor (big blind) folded before Flop
Seat 2: Andy Wolf folded before Flop (didn't bet)
Seat 3: Croplayer1 folded before Flop (didn't bet)
Seat 4: st4tion folded before Flop (didn't bet)
Seat 5: steepfell (button) folded before Flop
Seat 6: IAntikI (small blind) collected ($4.10)



PokerStars Hand #166667767975:  Hold'em No Limit ($0.05/$0.10 USD) - 2017/02/23 16:07:10 ET
Table 'Euryalos II' 6-max Seat #2 is the button
Seat 2: silsilviu ($6.65 in chips) 
Seat 3: Hyd SK ($10.55 in chips) 
Seat 4: popypaleta ($15.62 in chips) 
Seat 5: horang2 ($8.62 in chips) 
Seat 6: MihaGr ($10.37 in chips) 
Hyd SK: posts small blind $0.05
popypaleta: posts big blind $0.10
voledy: sits out 
*** HOLE CARDS ***
horang2: raises $0.20 to $0.30
MihaGr: calls $0.30
silsilviu: calls $0.30
Hyd SK: folds 
popypaleta: calls $0.20
*** FLOP *** [3s 9d 8d]
popypaleta: bets $1.19
horang2: calls $1.19
MihaGr: folds 
silsilviu: calls $1.19
*** TURN *** [3s 9d 8d] [9c]
popypaleta: checks 
horang2: bets $2
silsilviu: calls $2
popypaleta: calls $2
*** RIVER *** [3s 9d 8d 9c] [2s]
popypaleta: checks 
horang2: bets $3.50
silsilviu: calls $3.16 and is all-in
popypaleta: folds 
Uncalled bet ($0.34) returned to horang2
*** SHOW DOWN ***
horang2: shows [9h Ah] (three of a kind, Nines)
silsilviu: shows [3h 3d] (a full house, Threes full of Nines)
silsilviu collected $16.37 from pot
*** SUMMARY ***
Total pot $17.14 | Rake $0.77 
Board [3s 9d 8d 9c 2s]
Seat 2: silsilviu (button) showed [3h 3d] and won ($16.37) with a full house, Threes full of Nines
Seat 3: Hyd SK (small blind) folded before Flop
Seat 4: popypaleta (big blind) folded on the River
Seat 5: horang2 showed [9h Ah] and lost with three of a kind, Nines
Seat 6: MihaGr folded on the Flop



PokerStars Hand #166667767996:  Hold'em No Limit ($0.05/$0.10 USD) - 2017/02/23 16:07:10 ET
Table 'Serpens' 6-max Seat #3 is the button
Seat 1: Namhkal ($10.30 in chips) 
Seat 2: KA3AXCTAHEU, ($19.48 in chips) 
Seat 3: homelessdan ($29.29 in chips) 
Seat 4: Ragazzi3 ($9.35 in chips) 
Seat 5: XwinX25 ($12.32 in chips) 
Seat 6: Croplayer1 ($10 in chips) 
Ragazzi3: posts small blind $0.05
XwinX25: posts big blind $0.10
*** HOLE CARDS ***
Croplayer1: folds 
Namhkal: folds 
KA3AXCTAHEU,: raises $0.15 to $0.25
homelessdan: folds 
Ragazzi3: folds 
XwinX25: folds 
Uncalled bet ($0.15) returned to KA3AXCTAHEU,
KA3AXCTAHEU, collected $0.25 from pot
*** SUMMARY ***
Total pot $0.25 | Rake $0 
Seat 1: Namhkal folded before Flop (didn't bet)
Seat 2: KA3AXCTAHEU, collected ($0.25)
Seat 3: homelessdan (button) folded before Flop (didn't bet)
Seat 4: Ragazzi3 (small blind) folded before Flop
Seat 5: XwinX25 (big blind) folded before Flop
Seat 6: Croplayer1 folded before Flop (didn't bet)



PokerStars Hand #166667768712:  Hold'em No Limit ($0.05/$0.10 USD) - 2017/02/23 16:07:11 ET
Table 'Krethon' 6-max Seat #5 is the button
Seat 1: boxer821 ($10.82 in chips) 
Seat 2: manashov ($12.21 in chips) 
Seat 3: D3NyA ($10.15 in chips) 
Seat 4: chimera252 ($14.79 in chips) 
Seat 5: popypaleta ($10.10 in chips) 
fabadam will be allowed to play after the button
boxer821: posts small blind $0.05
manashov: posts big blind $0.10
*** HOLE CARDS ***
D3NyA: folds 
chimera252: folds 
popypaleta: raises $0.20 to $0.30
boxer821: folds 
manashov: folds 
Uncalled bet ($0.20) returned to popypaleta
popypaleta collected $0.25 from pot
*** SUMMARY ***
Total pot $0.25 | Rake $0 
Seat 1: boxer821 (small blind) folded before Flop
Seat 2: manashov (big blind) folded before Flop
Seat 3: D3NyA folded before Flop (didn't bet)
Seat 4: chimera252 folded before Flop (didn't bet)
Seat 5: popypaleta (button) collected ($0.25)



PokerStars Hand #166667768759:  Hold'em No Limit ($0.05/$0.10 USD) - 2017/02/23 16:07:11 ET
Table 'Garlena III' 6-max Seat #1 is the button
Seat 1: dittoro ($10 in chips) 
Seat 2: YY778 ($10.05 in chips) 
Seat 3: IAntikI ($10 in chips) 
Seat 4: mbkongstad ($10.15 in chips) 
Seat 5: steepfell ($10 in chips) 
Seat 6: iluzja12 ($9.85 in chips) 
YY778: posts small blind $0.05
IAntikI: posts big blind $0.10
*** HOLE CARDS ***
mbkongstad: folds 
steepfell: folds 
iluzja12: folds 
dittoro: folds 
YY778: raises $0.20 to $0.30
IAntikI: folds 
Uncalled bet ($0.20) returned to YY778
YY778 collected $0.20 from pot
*** SUMMARY ***
Total pot $0.20 | Rake $0 
Seat 1: dittoro (button) folded before Flop (didn't bet)
Seat 2: YY778 (small blind) collected ($0.20)
Seat 3: IAntikI (big blind) folded before Flop
Seat 4: mbkongstad folded before Flop (didn't bet)
Seat 5: steepfell folded before Flop (didn't bet)
Seat 6: iluzja12 folded before Flop (didn't bet)



PokerStars Hand #166667768955:  Hold'em No Limit ($0.05/$0.10 USD) - 2017/02/23 16:07:11 ET
Table 'Armenia' 6-max Seat #2 is the button
Seat 1: tr41n3r12 ($11.67 in chips) 
Seat 2: Yabidooo ($11.72 in chips) 
Seat 4: mbkongstad ($9.80 in chips) 
Seat 6: mega spasser ($6.53 in chips) 
mbkongstad: posts small blind $0.05
boxer821: is sitting out 
boxer821 leaves the table
mega spasser: posts big blind $0.10
*** HOLE CARDS ***
tr41n3r12: folds 
Yabidooo: raises $0.10 to $0.20
mbkongstad: calls $0.15
mega spasser: calls $0.10
*** FLOP *** [5d 8s Qs]
mbkongstad: checks 
mega spasser: checks 
Yabidooo: bets $0.38
DrVzad joins the table at seat #5 
mbkongstad: folds 
mega spasser: folds 
Uncalled bet ($0.38) returned to Yabidooo
JahSoldier69 joins the table at seat #3 
Yabidooo collected $0.57 from pot
*** SUMMARY ***
Total pot $0.60 | Rake $0.03 
Board [5d 8s Qs]
Seat 1: tr41n3r12 folded before Flop (didn't bet)
Seat 2: Yabidooo (button) collected ($0.57)
Seat 4: mbkongstad (small blind) folded on the Flop
Seat 6: mega spasser (big blind) folded on the Flop



PokerStars Hand #166667769012:  Hold'em No Limit ($0.05/$0.10 USD) - 2017/02/23 16:07:11 ET
Table 'Fechtig III' 6-max Seat #5 is the button
Seat 1: Scanner17 ($12.24 in chips) 
Seat 2: GV82 ($16.83 in chips) 
Seat 3: eniksenik ($10 in chips) 
Seat 4: Kow6oy ($10 in chips) 
Seat 5: ksandr_hom ($10.10 in chips) 
Seat 6: Glatzemandse ($18.31 in chips) 
Glatzemandse: posts small blind $0.05
Scanner17: posts big blind $0.10
*** HOLE CARDS ***
GV82: raises $0.10 to $0.20
eniksenik: folds 
Kow6oy: folds 
ksandr_hom: folds 
Glatzemandse: calls $0.15
Scanner17: folds 
*** FLOP *** [Ac Kc Kd]
Glatzemandse: checks 
GV82: bets $0.24
Glatzemandse: calls $0.24
*** TURN *** [Ac Kc Kd] [4h]
Glatzemandse: checks 
GV82: checks 
*** RIVER *** [Ac Kc Kd 4h] [Jc]
Glatzemandse: checks 
GV82: checks 
*** SHOW DOWN ***
Glatzemandse: shows [5s 8c] (a pair of Kings)
GV82: shows [As Td] (two pair, Aces and Kings)
GV82 collected $0.94 from pot
*** SUMMARY ***
Total pot $0.98 | Rake $0.04 
Board [Ac Kc Kd 4h Jc]
Seat 1: Scanner17 (big blind) folded before Flop
Seat 2: GV82 showed [As Td] and won ($0.94) with two pair, Aces and Kings
Seat 3: eniksenik folded before Flop (didn't bet)
Seat 4: Kow6oy folded before Flop (didn't bet)
Seat 5: ksandr_hom (button) folded before Flop (didn't bet)
Seat 6: Glatzemandse (small blind) showed [5s 8c] and lost with a pair of Kings



PokerStars Hand #166667769126:  Hold'em No Limit ($0.05/$0.10 USD) - 2017/02/23 16:07:11 ET
Table 'Brambilla II' 6-max Seat #1 is the button
Seat 1: Rodik002 ($12.52 in chips) 
Seat 2: dwonder75 ($14.90 in chips) 
Seat 3: BORIS_ENEV ($13.92 in chips) 
Seat 4: david_sara83 ($11.82 in chips) 
Seat 5: FRAID358 ($10.15 in chips) 
Seat 6: boxer821 ($10.08 in chips) 
dwonder75: posts small blind $0.05
BORIS_ENEV: posts big blind $0.10
*** HOLE CARDS ***
david_sara83: folds 
FRAID358: folds 
boxer821: raises $0.15 to $0.25
Rodik002: calls $0.25
dwonder75: calls $0.20
BORIS_ENEV: folds 
*** FLOP *** [4h Kh 4d]
dwonder75: bets $0.50
boxer821: folds 
Rodik002: folds 
Uncalled bet ($0.50) returned to dwonder75
dwonder75 collected $0.81 from pot
*** SUMMARY ***
Total pot $0.85 | Rake $0.04 
Board [4h Kh 4d]
Seat 1: Rodik002 (button) folded on the Flop
Seat 2: dwonder75 (small blind) collected ($0.81)
Seat 3: BORIS_ENEV (big blind) folded before Flop
Seat 4: david_sara83 folded before Flop (didn't bet)
Seat 5: FRAID358 folded before Flop (didn't bet)
Seat 6: boxer821 folded on the Flop



PokerStars Hand #166667769242:  Hold'em No Limit ($0.05/$0.10 USD) - 2017/02/23 16:07:12 ET
Table 'Nata II' 6-max Seat #4 is the button
Seat 1: luisantrs ($8.95 in chips) 
Seat 2: CHRO8 ($15.70 in chips) 
Seat 3: 8th wonders ($10 in chips) 
Seat 4: Comeback3392 ($10 in chips) 
Seat 5: RoJ1 ($12.13 in chips) 
RoJ1: posts small blind $0.05
luisantrs: posts big blind $0.10
*** HOLE CARDS ***
CHRO8: raises $0.20 to $0.30
8th wonders: folds 
Comeback3392: folds 
WinninBikini leaves the table
RoJ1: folds 
luisantrs: calls $0.20
*** FLOP *** [Qc Js 3s]
luisantrs: checks 
CHRO8: bets $0.31
luisantrs: folds 
Uncalled bet ($0.31) returned to CHRO8
CHRO8 collected $0.62 from pot
*** SUMMARY ***
Total pot $0.65 | Rake $0.03 
Board [Qc Js 3s]
Seat 1: luisantrs (big blind) folded on the Flop
Seat 2: CHRO8 collected ($0.62)
Seat 3: 8th wonders folded before Flop (didn't bet)
Seat 4: Comeback3392 (button) folded before Flop (didn't bet)
Seat 5: RoJ1 (small blind) folded before Flop



PokerStars Hand #166667769569:  Hold'em No Limit ($0.05/$0.10 USD) - 2017/02/23 16:07:12 ET
Table 'Nuki' 6-max Seat #2 is the button
Seat 1: bdixon_5 ($7.80 in chips) 
Seat 2: ArcticBearDK ($18.88 in chips) 
Seat 3: david_sara83 ($12.51 in chips) 
Seat 4: GESPERIA ($28.58 in chips) 
Seat 6: Zooplack ($26.47 in chips) 
david_sara83: posts small blind $0.05
GESPERIA: posts big blind $0.10
fabadam: sits out 
*** HOLE CARDS ***
Zooplack: raises $0.20 to $0.30
bdixon_5: folds 
ArcticBearDK: folds 
david_sara83: calls $0.25
GESPERIA: folds 
*** FLOP *** [3d 3s Qc]
david_sara83: checks 
Zooplack: bets $0.40
david_sara83: calls $0.40
*** TURN *** [3d 3s Qc] [Kc]
david_sara83: checks 
Zooplack: checks 
*** RIVER *** [3d 3s Qc Kc] [Jc]
david_sara83: checks 
Zooplack: checks 
*** SHOW DOWN ***
david_sara83: shows [Jd Qd] (two pair, Queens and Jacks)
Zooplack: mucks hand 
david_sara83 collected $1.43 from pot
*** SUMMARY ***
Total pot $1.50 | Rake $0.07 
Board [3d 3s Qc Kc Jc]
Seat 1: bdixon_5 folded before Flop (didn't bet)
Seat 2: ArcticBearDK (button) folded before Flop (didn't bet)
Seat 3: david_sara83 (small blind) showed [Jd Qd] and won ($1.43) with two pair, Queens and Jacks
Seat 4: GESPERIA (big blind) folded before Flop
Seat 6: Zooplack mucked



PokerStars Hand #166667769677:  Hold'em No Limit ($0.05/$0.10 USD) - 2017/02/23 16:07:12 ET
Table 'Isberga' 6-max Seat #5 is the button
Seat 1: Feverhead ($18.32 in chips) 
Seat 2: GESPERIA ($10.12 in chips) 
Seat 4: THIMUCHIN ($10.69 in chips) 
Seat 5: YoungGriff86 ($18.87 in chips) 
Seat 6: Goroshkos88 ($21.43 in chips) 
Goroshkos88: posts small blind $0.05
Feverhead: posts big blind $0.10
*** HOLE CARDS ***
GESPERIA: folds 
THIMUCHIN: folds 
YoungGriff86: folds 
Goroshkos88: folds 
Uncalled bet ($0.05) returned to Feverhead
Feverhead collected $0.10 from pot
*** SUMMARY ***
Total pot $0.10 | Rake $0 
Seat 1: Feverhead (big blind) collected ($0.10)
Seat 2: GESPERIA folded before Flop (didn't bet)
Seat 4: THIMUCHIN folded before Flop (didn't bet)
Seat 5: YoungGriff86 (button) folded before Flop (didn't bet)
Seat 6: Goroshkos88 (small blind) folded before Flop



PokerStars Hand #166667769756:  Hold'em No Limit ($0.05/$0.10 USD) - 2017/02/23 16:07:12 ET
Table 'Marghanna II' 6-max Seat #1 is the button
Seat 1: Goroshkos88 ($10 in chips) 
Seat 2: Namhkal ($11.31 in chips) 
Seat 4: D3NyA ($12.22 in chips) 
Seat 5: ofl21189 ($7.10 in chips) 
Seat 6: VAD21 ($12.96 in chips) 
Namhkal: posts small blind $0.05
D3NyA: posts big blind $0.10
*** HOLE CARDS ***
WinninBikini joins the table at seat #3 
ofl21189 is disconnected 
WinninBikini leaves the table
KRZuff joins the table at seat #3 
ofl21189 is connected 
KRZuff leaves the table
ofl21189: folds 
VAD21: raises $0.20 to $0.30
Goroshkos88: folds 
Namhkal: folds 
D3NyA: calls $0.20
*** FLOP *** [6c 9c Kd]
D3NyA: checks 
VAD21: bets $0.40
Andrei ProFF joins the table at seat #3 
D3NyA: folds 
Uncalled bet ($0.40) returned to VAD21
VAD21 collected $0.62 from pot
*** SUMMARY ***
Total pot $0.65 | Rake $0.03 
Board [6c 9c Kd]
Seat 1: Goroshkos88 (button) folded before Flop (didn't bet)
Seat 2: Namhkal (small blind) folded before Flop
Seat 4: D3NyA (big blind) folded on the Flop
Seat 5: ofl21189 folded before Flop (didn't bet)
Seat 6: VAD21 collected ($0.62)



PokerStars Hand #166667769837:  Hold'em No Limit ($0.05/$0.10 USD) - 2017/02/23 16:07:12 ET
Table 'Union' 6-max Seat #6 is the button
Seat 1: IAntikI ($10 in chips) 
Seat 2: Zooplack ($10 in chips) 
Seat 3: Rodik002 ($12.01 in chips) 
Seat 4: Croplayer1 ($14.95 in chips) 
Seat 5: Chodemuncher ($16 in chips) 
Seat 6: bonyo71 ($3.85 in chips) 
IAntikI: posts small blind $0.05
Zooplack: posts big blind $0.10
*** HOLE CARDS ***
Rodik002: folds 
Croplayer1: folds 
Chodemuncher: folds 
bonyo71: raises $0.20 to $0.30
IAntikI: folds 
Zooplack: folds 
Uncalled bet ($0.20) returned to bonyo71
bonyo71 collected $0.25 from pot
*** SUMMARY ***
Total pot $0.25 | Rake $0 
Seat 1: IAntikI (small blind) folded before Flop
Seat 2: Zooplack (big blind) folded before Flop
Seat 3: Rodik002 folded before Flop (didn't bet)
Seat 4: Croplayer1 folded before Flop (didn't bet)
Seat 5: Chodemuncher folded before Flop (didn't bet)
Seat 6: bonyo71 (button) collected ($0.25)



PokerStars Hand #166667769917:  Hold'em No Limit ($0.05/$0.10 USD) - 2017/02/23 16:07:12 ET
Table 'Veniakaverin' 6-max Seat #6 is the button
Seat 1: pivanki11 ($10.11 in chips) 
Seat 2: david_sara83 ($10.42 in chips) 
Seat 3: Hyd SK ($29.73 in chips) 
Seat 5: Tox1cel ($10 in chips) 
Seat 6: bdixon_5 ($9.30 in chips) 
pivanki11: posts small blind $0.05
david_sara83: posts big blind $0.10
FRAID358: sits out 
Tox1cel: posts big blind $0.10
*** HOLE CARDS ***
Hyd SK: folds 
Tox1cel: checks 
bdixon_5: folds 
pivanki11: calls $0.05
david_sara83: checks 
*** FLOP *** [5h Js 3s]
pivanki11: bets $0.30
david_sara83: folds 
Tox1cel: calls $0.30
*** TURN *** [5h Js 3s] [Tc]
pivanki11: bets $0.90
Tox1cel: calls $0.90
*** RIVER *** [5h Js 3s Tc] [6c]
pivanki11: bets $2.60
Tox1cel: raises $4 to $6.60
pivanki11: folds 
Uncalled bet ($4) returned to Tox1cel
Tox1cel collected $7.54 from pot
*** SUMMARY ***
Total pot $7.90 | Rake $0.36 
Board [5h Js 3s Tc 6c]
Seat 1: pivanki11 (small blind) folded on the River
Seat 2: david_sara83 (big blind) folded on the Flop
Seat 3: Hyd SK folded before Flop (didn't bet)
Seat 5: Tox1cel collected ($7.54)
Seat 6: bdixon_5 (button) folded before Flop (didn't bet)



PokerStars Hand #166667770193:  Hold'em No Limit ($0.05/$0.10 USD) - 2017/02/23 16:07:13 ET
Table 'Juliet II' 6-max Seat #3 is the button
Seat 1: alexpolevaja ($12.35 in chips) 
Seat 2: KA3AXCTAHEU, ($15.68 in chips) 
Seat 3: patrick19111 ($11.42 in chips) 
Seat 4: x3ultimate ($10.45 in chips) 
Seat 5: Dcaro31 ($18.82 in chips) 
Seat 6: BookWorm78 ($31.48 in chips) 
x3ultimate: posts small blind $0.05
Dcaro31: posts big blind $0.10
*** HOLE CARDS ***
BookWorm78: folds 
alexpolevaja: calls $0.10
KA3AXCTAHEU,: folds 
patrick19111: folds 
x3ultimate: folds 
Dcaro31: checks 
*** FLOP *** [3c 3s Qs]
Dcaro31: checks 
alexpolevaja: bets $0.10
Dcaro31: folds 
Uncalled bet ($0.10) returned to alexpolevaja
alexpolevaja collected $0.24 from pot
*** SUMMARY ***
Total pot $0.25 | Rake $0.01 
Board [3c 3s Qs]
Seat 1: alexpolevaja collected ($0.24)
Seat 2: KA3AXCTAHEU, folded before Flop (didn't bet)
Seat 3: patrick19111 (button) folded before Flop (didn't bet)
Seat 4: x3ultimate (small blind) folded before Flop
Seat 5: Dcaro31 (big blind) folded on the Flop
Seat 6: BookWorm78 folded before Flop (didn't bet)



PokerStars Hand #166667770607:  Hold'em No Limit ($0.05/$0.10 USD) - 2017/02/23 16:07:13 ET
Table 'Nemo III' 6-max Seat #2 is the button
Seat 1: Kow6oy ($10 in chips) 
Seat 2: Bandyaev ($12.01 in chips) 
Seat 3: Dimka4 ($10.05 in chips) 
Seat 4: vtalian ($9.85 in chips) 
Seat 5: Joker51_wtf! ($11.28 in chips) 
Seat 6: maxiv608 ($10.15 in chips) 
Dimka4: posts small blind $0.05
vtalian: posts big blind $0.10
*** HOLE CARDS ***
Joker51_wtf!: folds 
maxiv608: folds 
Kow6oy: folds 
Bandyaev: folds 
Dimka4: folds 
Uncalled bet ($0.05) returned to vtalian
vtalian collected $0.10 from pot
*** SUMMARY ***
Total pot $0.10 | Rake $0 
Seat 1: Kow6oy folded before Flop (didn't bet)
Seat 2: Bandyaev (button) folded before Flop (didn't bet)
Seat 3: Dimka4 (small blind) folded before Flop
Seat 4: vtalian (big blind) collected ($0.10)
Seat 5: Joker51_wtf! folded before Flop (didn't bet)
Seat 6: maxiv608 folded before Flop (didn't bet)



PokerStars Hand #166667770654:  Hold'em No Limit ($0.05/$0.10 USD) - 2017/02/23 16:07:13 ET
Table 'Ushakaron II' 6-max Seat #6 is the button
Seat 1: Kow6oy ($10.05 in chips) 
Seat 2: Iarlei ($12.79 in chips) 
Seat 3: Rodik002 ($10.12 in chips) 
Seat 4: avintage176 ($29.73 in chips) 
Seat 5: 1limewax1 ($16.23 in chips) 
Seat 6: eniksenik ($10 in chips) 
Kow6oy: posts small blind $0.05
Iarlei: posts big blind $0.10
*** HOLE CARDS ***
Rodik002: raises $0.20 to $0.30
avintage176: folds 
1limewax1: folds 
eniksenik: calls $0.30
Kow6oy: folds 
Iarlei: calls $0.20
*** FLOP *** [9s 5h 9c]
Iarlei: checks 
Rodik002: bets $0.54
eniksenik: calls $0.54
Iarlei: folds 
*** TURN *** [9s 5h 9c] [Tc]
Rodik002: bets $1.14
eniksenik: folds 
Uncalled bet ($1.14) returned to Rodik002
Rodik002 collected $1.94 from pot
*** SUMMARY ***
Total pot $2.03 | Rake $0.09 
Board [9s 5h 9c Tc]
Seat 1: Kow6oy (small blind) folded before Flop
Seat 2: Iarlei (big blind) folded on the Flop
Seat 3: Rodik002 collected ($1.94)
Seat 4: avintage176 folded before Flop (didn't bet)
Seat 5: 1limewax1 folded before Flop (didn't bet)
Seat 6: eniksenik (button) folded on the Turn



PokerStars Hand #166667770778:  Hold'em No Limit ($0.05/$0.10 USD) - 2017/02/23 16:07:13 ET
Table 'Tyndareus III' 6-max Seat #2 is the button
Seat 1: MBen10 ($19.24 in chips) 
Seat 2: MihaGr ($10.42 in chips) 
Seat 3: XaXaTyH4uK ($10 in chips) 
Seat 4: tequila_joop ($10 in chips) 
Seat 5: yodzik ($5 in chips) 
Seat 6: Hb-309 ($10 in chips) 
XaXaTyH4uK: posts small blind $0.05
tequila_joop: posts big blind $0.10
*** HOLE CARDS ***
yodzik: folds 
Hb-309: calls $0.10
MBen10: folds 
MihaGr: folds 
XaXaTyH4uK: folds 
tequila_joop: checks 
*** FLOP *** [As Qs Ah]
tequila_joop: checks 
Hb-309: checks 
*** TURN *** [As Qs Ah] [9d]
tequila_joop: checks 
Hb-309: bets $0.10
tequila_joop: folds 
Uncalled bet ($0.10) returned to Hb-309
Hb-309 collected $0.24 from pot
*** SUMMARY ***
Total pot $0.25 | Rake $0.01 
Board [As Qs Ah 9d]
Seat 1: MBen10 folded before Flop (didn't bet)
Seat 2: MihaGr (button) folded before Flop (didn't bet)
Seat 3: XaXaTyH4uK (small blind) folded before Flop
Seat 4: tequila_joop (big blind) folded on the Turn
Seat 5: yodzik folded before Flop (didn't bet)
Seat 6: Hb-309 collected ($0.24)



PokerStars Hand #166667770986:  Hold'em No Limit ($0.05/$0.10 USD) - 2017/02/23 16:07:13 ET
Table 'Atalante' 6-max Seat #1 is the button
Seat 1: OceanBlue100 ($4.94 in chips) 
Seat 2: CiisCi ($20.10 in chips) 
Seat 3: Kow6oy ($10.15 in chips) 
Seat 4: Dcaro31 ($24.02 in chips) 
Seat 5: eniksenik ($10.14 in chips) 
Seat 6: FlopsterGB ($31.19 in chips) 
CiisCi: posts small blind $0.05
Kow6oy: posts big blind $0.10
*** HOLE CARDS ***
Dcaro31: raises $0.20 to $0.30
eniksenik: folds 
FlopsterGB: folds 
OceanBlue100: folds 
CiisCi: folds 
Kow6oy: folds 
Uncalled bet ($0.20) returned to Dcaro31
Dcaro31 collected $0.25 from pot
*** SUMMARY ***
Total pot $0.25 | Rake $0 
Seat 1: OceanBlue100 (button) folded before Flop (didn't bet)
Seat 2: CiisCi (small blind) folded before Flop
Seat 3: Kow6oy (big blind) folded before Flop
Seat 4: Dcaro31 collected ($0.25)
Seat 5: eniksenik folded before Flop (didn't bet)
Seat 6: FlopsterGB folded before Flop (didn't bet)



PokerStars Hand #166667770987:  Hold'em No Limit ($0.05/$0.10 USD) - 2017/02/23 16:07:13 ET
Table 'Selinur' 6-max Seat #3 is the button
Seat 1: KA3AXCTAHEU, ($10 in chips) 
Seat 2: hoedje72 ($7.07 in chips) 
Seat 3: bambolejro ($11.07 in chips) 
Seat 4: freezing666 ($12.52 in chips) 
Seat 6: homelessdan ($18.08 in chips) 
freezing666: posts small blind $0.05
IAntikI: is sitting out 
homelessdan: posts big blind $0.10
*** HOLE CARDS ***
IAntikI leaves the table
KA3AXCTAHEU,: folds 
hoedje72: folds 
DrVzad joins the table at seat #5 
bambolejro has timed out while being disconnected
bambolejro: folds 
freezing666: folds 
Uncalled bet ($0.05) returned to homelessdan
homelessdan collected $0.10 from pot
*** SUMMARY ***
Total pot $0.10 | Rake $0 
Seat 1: KA3AXCTAHEU, folded before Flop (didn't bet)
Seat 2: hoedje72 folded before Flop (didn't bet)
Seat 3: bambolejro (button) folded before Flop (didn't bet)
Seat 4: freezing666 (small blind) folded before Flop
Seat 6: homelessdan (big blind) collected ($0.10)



PokerStars Hand #166667771118:  Hold'em No Limit ($0.05/$0.10 USD) - 2017/02/23 16:07:14 ET
Table 'Tomita II' 6-max Seat #2 is the button
Seat 2: mhonielsen ($10 in chips) 
Seat 4: Hyd SK ($11.31 in chips) 
Seat 5: ex3Lero86 ($10 in chips) 
Seat 6: saniasmir ($10 in chips) 
Hyd SK: posts small blind $0.05
ex3Lero86: posts big blind $0.10
*** HOLE CARDS ***
saniasmir: folds 
mhonielsen: raises $0.10 to $0.20
Lucky HoBBiT leaves the table
Hyd SK: folds 
ex3Lero86: folds 
Uncalled bet ($0.10) returned to mhonielsen
D3NyA joins the table at seat #3 
mhonielsen collected $0.25 from pot
*** SUMMARY ***
Total pot $0.25 | Rake $0 
Seat 2: mhonielsen (button) collected ($0.25)
Seat 4: Hyd SK (small blind) folded before Flop
Seat 5: ex3Lero86 (big blind) folded before Flop
Seat 6: saniasmir folded before Flop (didn't bet)



PokerStars Hand #166667771201:  Hold'em No Limit ($0.05/$0.10 USD) - 2017/02/23 16:07:14 ET
Table 'Manto II' 6-max Seat #3 is the button
Seat 2: voledy ($10 in chips) 
Seat 3: Komap511 ($9.85 in chips) 
Seat 4: dr.goofy ($15.01 in chips) 
Seat 5: ArcticBearDK ($32.69 in chips) 
Seat 6: pancernik21 ($16.35 in chips) 
dr.goofy: posts small blind $0.05
ArcticBearDK: posts big blind $0.10
ex3Lero86: sits out 
*** HOLE CARDS ***
pancernik21: folds 
voledy: raises $0.20 to $0.30
Komap511: folds 
dr.goofy: folds 
ArcticBearDK: folds 
Uncalled bet ($0.20) returned to voledy
voledy collected $0.25 from pot
*** SUMMARY ***
Total pot $0.25 | Rake $0 
Seat 2: voledy collected ($0.25)
Seat 3: Komap511 (button) folded before Flop (didn't bet)
Seat 4: dr.goofy (small blind) folded before Flop
Seat 5: ArcticBearDK (big blind) folded before Flop
Seat 6: pancernik21 folded before Flop (didn't bet)



PokerStars Hand #166667771964:  Hold'em No Limit ($0.05/$0.10 USD) - 2017/02/23 16:07:15 ET
Table 'Themisto II' 6-max Seat #2 is the button
Seat 2: CA225 ($11 in chips) 
Seat 3: eniksenik ($15.74 in chips) 
Seat 5: ex3Lero86 ($11.12 in chips) 
Seat 6: noobigrok ($3.60 in chips) 
eniksenik: posts small blind $0.05
Innerwuss: is sitting out 
ex3Lero86: posts big blind $0.10
Innerwuss leaves the table
ChuikaPridi: sits out 
*** HOLE CARDS ***
noobigrok: folds 
DrVzad joins the table at seat #4 
CA225: raises $0.10 to $0.20
eniksenik: folds 
ex3Lero86: calls $0.10
*** FLOP *** [8h 3s 7d]
ex3Lero86: checks 
CA225: checks 
*** TURN *** [8h 3s 7d] [9s]
ex3Lero86: bets $0.30
CA225: calls $0.30
*** RIVER *** [8h 3s 7d 9s] [9c]
ex3Lero86: checks 
CA225: bets $0.50
ex3Lero86: calls $0.50
*** SHOW DOWN ***
CA225: shows [Qc 9d] (three of a kind, Nines)
ex3Lero86: mucks hand 
CA225 collected $1.96 from pot
*** SUMMARY ***
Total pot $2.05 | Rake $0.09 
Board [8h 3s 7d 9s 9c]
Seat 2: CA225 (button) showed [Qc 9d] and won ($1.96) with three of a kind, Nines
Seat 3: eniksenik (small blind) folded before Flop
Seat 5: ex3Lero86 (big blind) mucked
Seat 6: noobigrok folded before Flop (didn't bet)



PokerStars Hand #166667772381:  Hold'em No Limit ($0.05/$0.10 USD) - 2017/02/23 16:07:15 ET
Table 'Siebohme II' 6-max Seat #5 is the button
Seat 1: homelessdan ($17.97 in chips) 
Seat 2: townerz1991 ($14.17 in chips) 
Seat 3: D3NyA ($10.33 in chips) 
Seat 4: POT_TRADER ($12.14 in chips) 
Seat 5: NvR.m1nD ($10.57 in chips) 
Seat 6: Fozzy690 ($9.82 in chips) 
Fozzy690: posts small blind $0.05
homelessdan: posts big blind $0.10
*** HOLE CARDS ***
townerz1991: folds 
D3NyA: folds 
POT_TRADER: folds 
NvR.m1nD: raises $0.15 to $0.25
Fozzy690: calls $0.20
homelessdan: calls $0.15
*** FLOP *** [Jc Kh 3h]
Fozzy690: checks 
homelessdan: checks 
NvR.m1nD: checks 
*** TURN *** [Jc Kh 3h] [Ts]
Fozzy690: checks 
homelessdan: checks 
NvR.m1nD: checks 
*** RIVER *** [Jc Kh 3h Ts] [5c]
Fozzy690: checks 
homelessdan: checks 
NvR.m1nD: checks 
*** SHOW DOWN ***
Fozzy690: shows [5h 2h] (a pair of Fives)
homelessdan: shows [6s 6d] (a pair of Sixes)
NvR.m1nD: shows [Ah Td] (a pair of Tens)
NvR.m1nD collected $0.72 from pot
*** SUMMARY ***
Total pot $0.75 | Rake $0.03 
Board [Jc Kh 3h Ts 5c]
Seat 1: homelessdan (big blind) showed [6s 6d] and lost with a pair of Sixes
Seat 2: townerz1991 folded before Flop (didn't bet)
Seat 3: D3NyA folded before Flop (didn't bet)
Seat 4: POT_TRADER folded before Flop (didn't bet)
Seat 5: NvR.m1nD (button) showed [Ah Td] and won ($0.72) with a pair of Tens
Seat 6: Fozzy690 (small blind) showed [5h 2h] and lost with a pair of Fives



PokerStars Hand #166667772504:  Hold'em No Limit ($0.05/$0.10 USD) - 2017/02/23 16:07:15 ET
Table 'Stroobantia' 6-max Seat #1 is the button
Seat 1: mam9zyc ($9.19 in chips) 
Seat 2: XwinX25 ($10.20 in chips) 
Seat 3: Namhkal ($10 in chips) 
Seat 4: Yspenyanin ($10 in chips) 
Seat 5: boxer821 ($10.99 in chips) 
Seat 6: KokoulinV ($15.67 in chips) 
XwinX25: posts small blind $0.05
Namhkal: posts big blind $0.10
*** HOLE CARDS ***
Yspenyanin: folds 
boxer821: folds 
KokoulinV: folds 
mam9zyc: folds 
XwinX25: raises $0.15 to $0.25
Namhkal: raises $0.50 to $0.75
XwinX25: folds 
Uncalled bet ($0.50) returned to Namhkal
Namhkal collected $0.50 from pot
*** SUMMARY ***
Total pot $0.50 | Rake $0 
Seat 1: mam9zyc (button) folded before Flop (didn't bet)
Seat 2: XwinX25 (small blind) folded before Flop
Seat 3: Namhkal (big blind) collected ($0.50)
Seat 4: Yspenyanin folded before Flop (didn't bet)
Seat 5: boxer821 folded before Flop (didn't bet)
Seat 6: KokoulinV folded before Flop (didn't bet)



PokerStars Hand #166667772823:  Hold'em No Limit ($0.05/$0.10 USD) - 2017/02/23 16:07:15 ET
Table 'Unitas II' 6-max Seat #6 is the button
Seat 1: Peter0087 ($9.75 in chips) 
Seat 2: steepfell ($10.25 in chips) 
Seat 4: truck1234 ($10.94 in chips) 
Seat 5: chimera252 ($24.48 in chips) 
Seat 6: paxit71 ($9.58 in chips) 
Peter0087: posts small blind $0.05
steepfell: posts big blind $0.10
BahiaMinhaP: sits out 
*** HOLE CARDS ***
truck1234: folds 
chimera252: folds 
paxit71: folds 
Peter0087: calls $0.05
steepfell: checks 
*** FLOP *** [4d Ts 3d]
Peter0087: checks 
steepfell: checks 
*** TURN *** [4d Ts 3d] [9s]
Peter0087: bets $0.20
steepfell: folds 
Uncalled bet ($0.20) returned to Peter0087
Peter0087 collected $0.19 from pot
*** SUMMARY ***
Total pot $0.20 | Rake $0.01 
Board [4d Ts 3d 9s]
Seat 1: Peter0087 (small blind) collected ($0.19)
Seat 2: steepfell (big blind) folded on the Turn
Seat 4: truck1234 folded before Flop (didn't bet)
Seat 5: chimera252 folded before Flop (didn't bet)
Seat 6: paxit71 (button) folded before Flop (didn't bet)



PokerStars Hand #166667773154:  Hold'em No Limit ($0.05/$0.10 USD) - 2017/02/23 16:07:16 ET
Table 'Lampetia III' 6-max Seat #3 is the button
Seat 1: gaHy_HaXeP ($10.55 in chips) 
Seat 2: DamDatsAnAce ($10 in chips) 
Seat 3: Kow6oy ($10 in chips) 
Seat 4: IAntikI ($10.65 in chips) 
Seat 5: robson1235 ($20.77 in chips) 
Seat 6: bdixon_5 ($9.20 in chips) 
IAntikI: posts small blind $0.05
robson1235: posts big blind $0.10
*** HOLE CARDS ***
bdixon_5: folds 
gaHy_HaXeP: folds 
DamDatsAnAce: raises $0.20 to $0.30
Kow6oy: folds 
IAntikI: folds 
robson1235: calls $0.20
*** FLOP *** [6s 8d 5d]
robson1235: checks 
DamDatsAnAce: bets $0.40
robson1235: folds 
Uncalled bet ($0.40) returned to DamDatsAnAce
DamDatsAnAce collected $0.62 from pot
*** SUMMARY ***
Total pot $0.65 | Rake $0.03 
Board [6s 8d 5d]
Seat 1: gaHy_HaXeP folded before Flop (didn't bet)
Seat 2: DamDatsAnAce collected ($0.62)
Seat 3: Kow6oy (button) folded before Flop (didn't bet)
Seat 4: IAntikI (small blind) folded before Flop
Seat 5: robson1235 (big blind) folded on the Flop
Seat 6: bdixon_5 folded before Flop (didn't bet)



PokerStars Hand #166667773369:  Hold'em No Limit ($0.05/$0.10 USD) - 2017/02/23 16:07:16 ET
Table 'Nerthus II' 6-max Seat #2 is the button
Seat 1: mdelfin0 ($10.77 in chips) 
Seat 2: Hovhannes990 ($9.58 in chips) 
Seat 3: Mamm0nism ($18.76 in chips) 
Seat 4: myevc ($16.28 in chips) 
Seat 5: Hyd SK ($12.15 in chips) 
Seat 6: Lucky HoBBiT ($10 in chips) 
Mamm0nism: posts small blind $0.05
myevc: posts big blind $0.10
*** HOLE CARDS ***
Hyd SK: folds 
Lucky HoBBiT: folds 
mdelfin0: folds 
Hovhannes990: folds 
Mamm0nism: folds 
Uncalled bet ($0.05) returned to myevc
myevc collected $0.10 from pot
*** SUMMARY ***
Total pot $0.10 | Rake $0 
Seat 1: mdelfin0 folded before Flop (didn't bet)
Seat 2: Hovhannes990 (button) folded before Flop (didn't bet)
Seat 3: Mamm0nism (small blind) folded before Flop
Seat 4: myevc (big blind) collected ($0.10)
Seat 5: Hyd SK folded before Flop (didn't bet)
Seat 6: Lucky HoBBiT folded before Flop (didn't bet)



PokerStars Hand #166667773696:  Hold'em No Limit ($0.05/$0.10 USD) - 2017/02/23 16:07:16 ET
Table 'Nephthys II' 6-max Seat #5 is the button
Seat 1: DamDatsAnAce ($11.37 in chips) 
Seat 2: Ju$tD0it ($8.29 in chips) 
Seat 3: Newqbrown ($20.76 in chips) 
Seat 4: MihaGr ($10 in chips) 
Seat 5: kingartur222 ($8.61 in chips) 
Seat 6: CHRO8 ($14.24 in chips) 
CHRO8: posts small blind $0.05
DamDatsAnAce: posts big blind $0.10
*** HOLE CARDS ***
Ju$tD0it: calls $0.10
Newqbrown: calls $0.10
MihaGr: folds 
kingartur222: folds 
CHRO8: calls $0.05
DamDatsAnAce: checks 
*** FLOP *** [5h Tc Ad]
CHRO8: checks 
DamDatsAnAce: checks 
Ju$tD0it: bets $0.19
Newqbrown: folds 
CHRO8: folds 
DamDatsAnAce: calls $0.19
*** TURN *** [5h Tc Ad] [Jc]
DamDatsAnAce: checks 
Ju$tD0it: bets $0.37
DamDatsAnAce: folds 
Uncalled bet ($0.37) returned to Ju$tD0it
Ju$tD0it collected $0.74 from pot
*** SUMMARY ***
Total pot $0.78 | Rake $0.04 
Board [5h Tc Ad Jc]
Seat 1: DamDatsAnAce (big blind) folded on the Turn
Seat 2: Ju$tD0it collected ($0.74)
Seat 3: Newqbrown folded on the Flop
Seat 4: MihaGr folded before Flop (didn't bet)
Seat 5: kingartur222 (button) folded before Flop (didn't bet)
Seat 6: CHRO8 (small blind) folded on the Flop



PokerStars Hand #166667773802:  Hold'em No Limit ($0.05/$0.10 USD) - 2017/02/23 16:07:17 ET
Table 'Lobelia II' 6-max Seat #2 is the button
Seat 1: facewald ($21.22 in chips) 
Seat 2: Dcaro31 ($17.46 in chips) 
Seat 3: oddshoff ($19.15 in chips) 
Seat 5: Feverhead ($20.03 in chips) 
Seat 6: NvR.m1nD ($10.62 in chips) 
oddshoff: posts small blind $0.05
Feverhead: posts big blind $0.10
*** HOLE CARDS ***
NvR.m1nD: folds 
facewald: raises $0.19 to $0.29
Dcaro31: folds 
oddshoff: folds 
Feverhead: calls $0.19
*** FLOP *** [Ts 2h Jh]
Feverhead: checks 
facewald: bets $0.38
Feverhead: calls $0.38
*** TURN *** [Ts 2h Jh] [Ac]
Feverhead: checks 
facewald: bets $0.85
Feverhead: calls $0.85
*** RIVER *** [Ts 2h Jh Ac] [8h]
Feverhead: checks 
facewald: bets $5
Feverhead: folds 
Uncalled bet ($5) returned to facewald
facewald collected $2.95 from pot
*** SUMMARY ***
Total pot $3.09 | Rake $0.14 
Board [Ts 2h Jh Ac 8h]
Seat 1: facewald collected ($2.95)
Seat 2: Dcaro31 (button) folded before Flop (didn't bet)
Seat 3: oddshoff (small blind) folded before Flop
Seat 5: Feverhead (big blind) folded on the River
Seat 6: NvR.m1nD folded before Flop (didn't bet)



PokerStars Hand #166667774273:  Hold'em No Limit ($0.05/$0.10 USD) - 2017/02/23 16:07:17 ET
Table 'Lesath III' 6-max Seat #5 is the button
Seat 1: Gogeta26 ($6.99 in chips) 
Seat 2: WinninBikini ($10.32 in chips) 
Seat 3: Giyorod ($10 in chips) 
Seat 4: Eddys Edge ($10.51 in chips) 
Seat 5: eniksenik ($16 in chips) 
Seat 6: patrick19111 ($10.26 in chips) 
patrick19111: posts small blind $0.05
Gogeta26: posts big blind $0.10
*** HOLE CARDS ***
WinninBikini: folds 
Giyorod: folds 
Eddys Edge: folds 
eniksenik: raises $0.20 to $0.30
patrick19111: folds 
Gogeta26: folds 
Uncalled bet ($0.20) returned to eniksenik
eniksenik collected $0.25 from pot
*** SUMMARY ***
Total pot $0.25 | Rake $0 
Seat 1: Gogeta26 (big blind) folded before Flop
Seat 2: WinninBikini folded before Flop (didn't bet)
Seat 3: Giyorod folded before Flop (didn't bet)
Seat 4: Eddys Edge folded before Flop (didn't bet)
Seat 5: eniksenik (button) collected ($0.25)
Seat 6: patrick19111 (small blind) folded before Flop



PokerStars Hand #166667774461:  Hold'em No Limit ($0.05/$0.10 USD) - 2017/02/23 16:07:17 ET
Table 'Lagrula' 6-max Seat #1 is the button
Seat 1: Ice_Isayev ($10 in chips) 
Seat 2: KRZuff ($10 in chips) 
Seat 3: micke667 ($16.84 in chips) 
Seat 4: Calimero2408 ($10.89 in chips) 
Seat 5: Iarlei ($10 in chips) 
Seat 6: Spud014 ($10 in chips) 
KRZuff: posts small blind $0.05
micke667: posts big blind $0.10
*** HOLE CARDS ***
Calimero2408: calls $0.10
Iarlei: folds 
Spud014: raises $0.40 to $0.50
Ice_Isayev: folds 
KRZuff: folds 
micke667: calls $0.40
Calimero2408: calls $0.40
*** FLOP *** [Qc 9s 8d]
micke667: checks 
Calimero2408: checks 
Spud014: checks 
*** TURN *** [Qc 9s 8d] [3h]
micke667: bets $0.70
Calimero2408: calls $0.70
Spud014: calls $0.70
*** RIVER *** [Qc 9s 8d 3h] [6s]
micke667: checks 
Calimero2408: checks 
Spud014: checks 
*** SHOW DOWN ***
micke667: shows [4c 8c] (a pair of Eights)
Calimero2408: shows [Qd Jd] (a pair of Queens)
Spud014: mucks hand 
Calimero2408 collected $3.49 from pot
*** SUMMARY ***
Total pot $3.65 | Rake $0.16 
Board [Qc 9s 8d 3h 6s]
Seat 1: Ice_Isayev (button) folded before Flop (didn't bet)
Seat 2: KRZuff (small blind) folded before Flop
Seat 3: micke667 (big blind) showed [4c 8c] and lost with a pair of Eights
Seat 4: Calimero2408 showed [Qd Jd] and won ($3.49) with a pair of Queens
Seat 5: Iarlei folded before Flop (didn't bet)
Seat 6: Spud014 mucked



PokerStars Hand #166667774730:  Hold'em No Limit ($0.05/$0.10 USD) - 2017/02/23 16:07:18 ET
Table 'Girtab II' 6-max Seat #4 is the button
Seat 1: marianoboni ($11.31 in chips) 
Seat 2: Pokeaster ($13.59 in chips) 
Seat 3: chimera252 ($10 in chips) 
Seat 4: Hyd SK ($27.03 in chips) 
Seat 6: DamDatsAnAce ($10 in chips) 
DamDatsAnAce: posts small blind $0.05
marianoboni: posts big blind $0.10
*** HOLE CARDS ***
Pokeaster: folds 
chimera252: raises $0.20 to $0.30
Hyd SK: folds 
DamDatsAnAce: raises $0.70 to $1
marianoboni: folds 
chimera252: calls $0.70
*** FLOP *** [Qs Qh 5d]
DamDatsAnAce: bets $1
chimera252: calls $1
*** TURN *** [Qs Qh 5d] [Kd]
DamDatsAnAce: bets $1.80
dzesio18 leaves the table
chimera252: raises $6.20 to $8 and is all-in
JahSoldier69 joins the table at seat #5 
JahSoldier69 leaves the table
DamDatsAnAce: folds 
Uncalled bet ($6.20) returned to chimera252
chimera252 collected $7.35 from pot
*** SUMMARY ***
Total pot $7.70 | Rake $0.35 
Board [Qs Qh 5d Kd]
Seat 1: marianoboni (big blind) folded before Flop
Seat 2: Pokeaster folded before Flop (didn't bet)
Seat 3: chimera252 collected ($7.35)
Seat 4: Hyd SK (button) folded before Flop (didn't bet)
Seat 6: DamDatsAnAce (small blind) folded on the Turn



PokerStars Hand #166667774810:  Hold'em No Limit ($0.05/$0.10 USD) - 2017/02/23 16:07:18 ET
Table 'Tristan III' 6-max Seat #3 is the button
Seat 1: CHRO8 ($18.18 in chips) 
Seat 2: Hyd SK ($13.88 in chips) 
Seat 3: fedorka rus ($26.67 in chips) 
Seat 4: Feverhead ($11.43 in chips) 
Seat 5: david_sara83 ($10 in chips) 
Seat 6: fredrik10528 ($10.05 in chips) 
Feverhead: posts small blind $0.05
david_sara83: posts big blind $0.10
*** HOLE CARDS ***
fredrik10528: folds 
CHRO8: folds 
Hyd SK: folds 
fedorka rus: folds 
Feverhead: raises $0.15 to $0.25
david_sara83: raises $0.56 to $0.81
Feverhead: folds 
Uncalled bet ($0.56) returned to david_sara83
david_sara83 collected $0.50 from pot
*** SUMMARY ***
Total pot $0.50 | Rake $0 
Seat 1: CHRO8 folded before Flop (didn't bet)
Seat 2: Hyd SK folded before Flop (didn't bet)
Seat 3: fedorka rus (button) folded before Flop (didn't bet)
Seat 4: Feverhead (small blind) folded before Flop
Seat 5: david_sara83 (big blind) collected ($0.50)
Seat 6: fredrik10528 folded before Flop (didn't bet)



PokerStars Hand #166667774947:  Hold'em No Limit ($0.05/$0.10 USD) - 2017/02/23 16:07:18 ET
Table 'Giclas' 6-max Seat #5 is the button
Seat 1: david_sara83 ($10 in chips) 
Seat 2: Crafty23@PS ($10.41 in chips) 
Seat 3: fidas1972 ($6.21 in chips) 
Seat 4: Eddys Edge ($13.94 in chips) 
Seat 5: dedea1989 ($25.27 in chips) 
Seat 6: eniksenik ($14.53 in chips) 
eniksenik: posts small blind $0.05
david_sara83: posts big blind $0.10
*** HOLE CARDS ***
Crafty23@PS: folds 
fidas1972: raises $0.20 to $0.30
Eddys Edge: folds 
dedea1989: calls $0.30
eniksenik: folds 
david_sara83: folds 
*** FLOP *** [Ts Js Ac]
fidas1972: bets $0.36
dedea1989: folds 
Uncalled bet ($0.36) returned to fidas1972
fidas1972 collected $0.72 from pot
*** SUMMARY ***
Total pot $0.75 | Rake $0.03 
Board [Ts Js Ac]
Seat 1: david_sara83 (big blind) folded before Flop
Seat 2: Crafty23@PS folded before Flop (didn't bet)
Seat 3: fidas1972 collected ($0.72)
Seat 4: Eddys Edge folded before Flop (didn't bet)
Seat 5: dedea1989 (button) folded on the Flop
Seat 6: eniksenik (small blind) folded before Flop



PokerStars Hand #166667775157:  Hold'em No Limit ($0.05/$0.10 USD) - 2017/02/23 16:07:18 ET
Table 'Apollonia' 6-max Seat #1 is the button
Seat 1: ex3Lero86 ($10.11 in chips) 
Seat 2: ibara000 ($18.33 in chips) 
Seat 3: steepfell ($10.10 in chips) 
Seat 4: Goroshkos88 ($17.87 in chips) 
ibara000: posts small blind $0.05
steepfell: posts big blind $0.10
bambolejro: sits out 
iluzja12: sits out 
*** HOLE CARDS ***
Goroshkos88: folds 
ex3Lero86: folds 
ibara000: raises $0.16 to $0.26
steepfell: folds 
Uncalled bet ($0.16) returned to ibara000
ibara000 collected $0.20 from pot
*** SUMMARY ***
Total pot $0.20 | Rake $0 
Seat 1: ex3Lero86 (button) folded before Flop (didn't bet)
Seat 2: ibara000 (small blind) collected ($0.20)
Seat 3: steepfell (big blind) folded before Flop
Seat 4: Goroshkos88 folded before Flop (didn't bet)



PokerStars Hand #166667775390:  Hold'em No Limit ($0.05/$0.10 USD) - 2017/02/23 16:07:18 ET
Table 'Pompeja III' 6-max Seat #2 is the button
Seat 1: Iarlei ($11.94 in chips) 
Seat 2: steepfell ($10 in chips) 
Seat 3: Yspenyanin ($12.08 in chips) 
Seat 4: Cluckh ($13.87 in chips) 
Seat 5: Spud014 ($12.37 in chips) 
Seat 6: mega spasser ($4.80 in chips) 
Yspenyanin: posts small blind $0.05
Cluckh: posts big blind $0.10
*** HOLE CARDS ***
Spud014: folds 
mega spasser: folds 
Iarlei: folds 
steepfell: folds 
Yspenyanin: raises $0.15 to $0.25
Cluckh: calls $0.15
*** FLOP *** [Jc As Ad]
Yspenyanin: bets $0.24
Cluckh: folds 
Uncalled bet ($0.24) returned to Yspenyanin
Yspenyanin collected $0.48 from pot
*** SUMMARY ***
Total pot $0.50 | Rake $0.02 
Board [Jc As Ad]
Seat 1: Iarlei folded before Flop (didn't bet)
Seat 2: steepfell (button) folded before Flop (didn't bet)
Seat 3: Yspenyanin (small blind) collected ($0.48)
Seat 4: Cluckh (big blind) folded on the Flop
Seat 5: Spud014 folded before Flop (didn't bet)
Seat 6: mega spasser folded before Flop (didn't bet)



PokerStars Hand #166667775471:  Hold'em No Limit ($0.05/$0.10 USD) - 2017/02/23 16:07:18 ET
Table 'Hunnia' 6-max Seat #3 is the button
Seat 1: univibe68 ($21.48 in chips) 
Seat 2: mhonielsen ($10 in chips) 
Seat 3: 6ePeMeHHa9 ($10.56 in chips) 
Seat 4: Jalida3 ($13.34 in chips) 
Seat 5: Smarkon ($15.14 in chips) 
Seat 6: ChuikaPridi ($10 in chips) 
Jalida3: posts small blind $0.05
Smarkon: posts big blind $0.10
*** HOLE CARDS ***
ChuikaPridi: raises $0.20 to $0.30
univibe68: calls $0.30
mhonielsen: calls $0.30
6ePeMeHHa9: folds 
Jalida3: calls $0.25
Smarkon: folds 
*** FLOP *** [Kh Kc Th]
Jalida3: checks 
ChuikaPridi: checks 
univibe68: checks 
mhonielsen: bets $0.72
Jalida3: folds 
ChuikaPridi: folds 
univibe68: folds 
Uncalled bet ($0.72) returned to mhonielsen
mhonielsen collected $1.24 from pot
*** SUMMARY ***
Total pot $1.30 | Rake $0.06 
Board [Kh Kc Th]
Seat 1: univibe68 folded on the Flop
Seat 2: mhonielsen collected ($1.24)
Seat 3: 6ePeMeHHa9 (button) folded before Flop (didn't bet)
Seat 4: Jalida3 (small blind) folded on the Flop
Seat 5: Smarkon (big blind) folded before Flop
Seat 6: ChuikaPridi folded on the Flop



PokerStars Hand #166667775992:  Hold'em No Limit ($0.05/$0.10 USD) - 2017/02/23 16:07:19 ET
Table 'Sheragul III' 6-max Seat #6 is the button
Seat 1: danky24 ($17.50 in chips) 
Seat 2: Bird et al ($10.47 in chips) 
Seat 4: maxiv608 ($10.44 in chips) 
Seat 5: Bandyaev ($15.97 in chips) 
Seat 6: Andrei ProFF ($11.91 in chips) 
danky24: posts small blind $0.05
Bird et al: posts big blind $0.10
FRAID358: sits out 
*** HOLE CARDS ***
maxiv608: raises $0.20 to $0.30
Bandyaev: folds 
Andrei ProFF: folds 
danky24: folds 
Bird et al: calls $0.20
*** FLOP *** [Kh 7h 2h]
Bird et al: checks 
maxiv608: checks 
*** TURN *** [Kh 7h 2h] [6h]
Bird et al: checks 
maxiv608: bets $0.40
Bird et al: calls $0.40
*** RIVER *** [Kh 7h 2h 6h] [4h]
Bird et al: checks 
maxiv608: checks 
*** SHOW DOWN ***
Bird et al: shows [6d 6c] (a flush, King high)
maxiv608: shows [Ad 9d] (a flush, King high)
Bird et al collected $0.69 from pot
maxiv608 collected $0.69 from pot
*** SUMMARY ***
Total pot $1.45 | Rake $0.07 
Board [Kh 7h 2h 6h 4h]
Seat 1: danky24 (small blind) folded before Flop
Seat 2: Bird et al (big blind) showed [6d 6c] and won ($0.69) with a flush, King high
Seat 4: maxiv608 showed [Ad 9d] and won ($0.69) with a flush, King high
Seat 5: Bandyaev folded before Flop (didn't bet)
Seat 6: Andrei ProFF (button) folded before Flop (didn't bet)



PokerStars Hand #166667776053:  Hold'em No Limit ($0.05/$0.10 USD) - 2017/02/23 16:07:19 ET
Table 'Ebella II' 6-max Seat #3 is the button
Seat 1: gaHy_HaXeP ($10 in chips) 
Seat 2: Therodorus ($10 in chips) 
Seat 3: Torften2 ($16.95 in chips) 
Seat 4: ValdemorS ($11.40 in chips) 
Seat 5: Bird et al ($10.15 in chips) 
Seat 6: Joker51_wtf! ($11.24 in chips) 
ValdemorS: posts small blind $0.05
Bird et al: posts big blind $0.10
*** HOLE CARDS ***
Joker51_wtf!: folds 
gaHy_HaXeP: folds 
Therodorus: folds 
Torften2: calls $0.10
ValdemorS: folds 
Bird et al: checks 
*** FLOP *** [9c 7s Jc]
Bird et al: checks 
Torften2: bets $0.10
Bird et al: folds 
Uncalled bet ($0.10) returned to Torften2
Torften2 collected $0.24 from pot
*** SUMMARY ***
Total pot $0.25 | Rake $0.01 
Board [9c 7s Jc]
Seat 1: gaHy_HaXeP folded before Flop (didn't bet)
Seat 2: Therodorus folded before Flop (didn't bet)
Seat 3: Torften2 (button) collected ($0.24)
Seat 4: ValdemorS (small blind) folded before Flop
Seat 5: Bird et al (big blind) folded on the Flop
Seat 6: Joker51_wtf! folded before Flop (didn't bet)



PokerStars Hand #166667776349:  Hold'em No Limit ($0.05/$0.10 USD) - 2017/02/23 16:07:19 ET
Table 'Gyldenia II' 6-max Seat #1 is the button
Seat 1: KokoulinV ($10.33 in chips) 
Seat 2: Bandyaev ($10 in chips) 
Seat 5: CHRO8 ($15.62 in chips) 
Seat 6: 8th wonders ($12.68 in chips) 
Bandyaev: posts small blind $0.05
CHRO8: posts big blind $0.10
*** HOLE CARDS ***
8th wonders: raises $0.20 to $0.30
KokoulinV: folds 
Punzzzer joins the table at seat #3 
Bandyaev: folds 
Punzzzer leaves the table
CHRO8: folds 
Uncalled bet ($0.20) returned to 8th wonders
8th wonders collected $0.25 from pot
*** SUMMARY ***
Total pot $0.25 | Rake $0 
Seat 1: KokoulinV (button) folded before Flop (didn't bet)
Seat 2: Bandyaev (small blind) folded before Flop
Seat 5: CHRO8 (big blind) folded before Flop
Seat 6: 8th wonders collected ($0.25)



PokerStars Hand #166667776352:  Hold'em No Limit ($0.05/$0.10 USD) - 2017/02/23 16:07:19 ET
Table 'Luanda' 6-max Seat #3 is the button
Seat 1: AM-L-SL ($4.33 in chips) 
Seat 2: Xander188 ($10.04 in chips) 
Seat 3: DamDatsAnAce ($10 in chips) 
Seat 5: st4tion ($13.50 in chips) 
Seat 6: KA3AXCTAHEU, ($11.58 in chips) 
st4tion: posts small blind $0.05
KA3AXCTAHEU,: posts big blind $0.10
*** HOLE CARDS ***
AM-L-SL: folds 
Xander188: folds 
DamDatsAnAce: raises $0.15 to $0.25
st4tion: folds 
KA3AXCTAHEU,: folds 
Uncalled bet ($0.15) returned to DamDatsAnAce
DamDatsAnAce collected $0.25 from pot
*** SUMMARY ***
Total pot $0.25 | Rake $0 
Seat 1: AM-L-SL folded before Flop (didn't bet)
Seat 2: Xander188 folded before Flop (didn't bet)
Seat 3: DamDatsAnAce (button) collected ($0.25)
Seat 5: st4tion (small blind) folded before Flop
Seat 6: KA3AXCTAHEU, (big blind) folded before Flop



PokerStars Hand #166667777112:  Hold'em No Limit ($0.05/$0.10 USD) - 2017/02/23 16:07:20 ET
Table 'Duhr II' 6-max Seat #4 is the button
Seat 1: Lucky HoBBiT ($10.75 in chips) 
Seat 2: Feverhead ($37.74 in chips) 
Seat 4: CHRO8 ($9.33 in chips) 
Seat 5: Dimka4 ($10 in chips) 
Seat 6: townerz1991 ($11.01 in chips) 
Dimka4: posts small blind $0.05
townerz1991: posts big blind $0.10
Smitty03300: sits out 
*** HOLE CARDS ***
Lucky HoBBiT: folds 
Feverhead: folds 
CHRO8: folds 
Dimka4: raises $0.15 to $0.25
townerz1991: folds 
Uncalled bet ($0.15) returned to Dimka4
Dimka4 collected $0.20 from pot
*** SUMMARY ***
Total pot $0.20 | Rake $0 
Seat 1: Lucky HoBBiT folded before Flop (didn't bet)
Seat 2: Feverhead folded before Flop (didn't bet)
Seat 4: CHRO8 (button) folded before Flop (didn't bet)
Seat 5: Dimka4 (small blind) collected ($0.20)
Seat 6: townerz1991 (big blind) folded before Flop



PokerStars Hand #166667777259:  Hold'em No Limit ($0.05/$0.10 USD) - 2017/02/23 16:07:20 ET
Table 'Nekkar' 6-max Seat #5 is the button
Seat 2: Bird et al ($11.02 in chips) 
Seat 3: Zemz_Ru ($15.20 in chips) 
Seat 4: kingartur222 ($12.65 in chips) 
Seat 5: Vrinni ($12.19 in chips) 
Seat 6: Eddys Edge ($10.53 in chips) 
Eddys Edge: posts small blind $0.05
Bird et al: posts big blind $0.10
*** HOLE CARDS ***
Zemz_Ru: calls $0.10
kingartur222: raises $0.30 to $0.40
Vrinni: folds 
Eddys Edge: folds 
Bird et al: folds 
Zemz_Ru: calls $0.30
*** FLOP *** [3c 5d 9h]
Zemz_Ru: bets $0.46
kingartur222: folds 
Uncalled bet ($0.46) returned to Zemz_Ru
Zemz_Ru collected $0.91 from pot
*** SUMMARY ***
Total pot $0.95 | Rake $0.04 
Board [3c 5d 9h]
Seat 2: Bird et al (big blind) folded before Flop
Seat 3: Zemz_Ru collected ($0.91)
Seat 4: kingartur222 folded on the Flop
Seat 5: Vrinni (button) folded before Flop (didn't bet)
Seat 6: Eddys Edge (small blind) folded before Flop



PokerStars Hand #166667777323:  Hold'em No Limit ($0.05/$0.10 USD) - 2017/02/23 16:07:20 ET
Table 'Hercynia III' 6-max Seat #1 is the button
Seat 1: Bird et al ($14.48 in chips) 
Seat 2: Action_Gibi ($7.04 in chips) 
Seat 3: Dcaro31 ($20.17 in chips) 
Seat 5: THIMUCHIN ($15.45 in chips) 
Seat 6: bdixon_5 ($11.59 in chips) 
Action_Gibi: posts small blind $0.05
Dcaro31: posts big blind $0.10
*** HOLE CARDS ***
THIMUCHIN: folds 
bdixon_5: folds 
Bird et al: raises $0.15 to $0.25
Action_Gibi: folds 
Dcaro31: folds 
Uncalled bet ($0.15) returned to Bird et al
Bird et al collected $0.25 from pot
*** SUMMARY ***
Total pot $0.25 | Rake $0 
Seat 1: Bird et al (button) collected ($0.25)
Seat 2: Action_Gibi (small blind) folded before Flop
Seat 3: Dcaro31 (big blind) folded before Flop
Seat 5: THIMUCHIN folded before Flop (didn't bet)
Seat 6: bdixon_5 folded before Flop (didn't bet)



PokerStars Hand #166667777648:  Hold'em No Limit ($0.05/$0.10 USD) - 2017/02/23 16:07:21 ET
Table 'Cassini' 6-max Seat #2 is the button
Seat 1: Pokeaster ($10.67 in chips) 
Seat 2: mhonielsen ($12.26 in chips) 
Seat 4: fortieth ($14.02 in chips) 
Seat 5: DrVzad ($10 in chips) 
fortieth: posts small blind $0.05
DrVzad: posts big blind $0.10
MihaGr: sits out 
*** HOLE CARDS ***
Pokeaster: folds 
J1234T joins the table at seat #3 
mhonielsen: raises $0.20 to $0.30
fortieth: folds 
DrVzad: folds 
Uncalled bet ($0.20) returned to mhonielsen
mhonielsen collected $0.25 from pot
*** SUMMARY ***
Total pot $0.25 | Rake $0 
Seat 1: Pokeaster folded before Flop (didn't bet)
Seat 2: mhonielsen (button) collected ($0.25)
Seat 4: fortieth (small blind) folded before Flop
Seat 5: DrVzad (big blind) folded before Flop



PokerStars Hand #166667778050:  Hold'em No Limit ($0.05/$0.10 USD) - 2017/02/23 16:07:21 ET
Table 'Kunigunde II' 6-max Seat #6 is the button
Seat 1: facewald ($10 in chips) 
Seat 3: pancernik21 ($18.71 in chips) 
Seat 4: david_sara83 ($13.42 in chips) 
Seat 5: mdelfin0 ($11.44 in chips) 
Seat 6: Zooplack ($10 in chips) 
facewald: posts small blind $0.05
pancernik21: posts big blind $0.10
*** HOLE CARDS ***
DrVzad joins the table at seat #2 
david_sara83: folds 
mdelfin0: folds 
Zooplack: folds 
facewald: raises $0.12 to $0.22
pancernik21: calls $0.12
*** FLOP *** [8s 4s 6c]
facewald: checks 
pancernik21: checks 
*** TURN *** [8s 4s 6c] [8h]
facewald: checks 
pancernik21: checks 
*** RIVER *** [8s 4s 6c 8h] [Kc]
facewald: checks 
pancernik21: checks 
*** SHOW DOWN ***
facewald: shows [4c Tc] (two pair, Eights and Fours)
pancernik21: mucks hand 
facewald collected $0.42 from pot
*** SUMMARY ***
Total pot $0.44 | Rake $0.02 
Board [8s 4s 6c 8h Kc]
Seat 1: facewald (small blind) showed [4c Tc] and won ($0.42) with two pair, Eights and Fours
Seat 3: pancernik21 (big blind) mucked
Seat 4: david_sara83 folded before Flop (didn't bet)
Seat 5: mdelfin0 folded before Flop (didn't bet)
Seat 6: Zooplack (button) folded before Flop (didn't bet)



PokerStars Hand #166667778086:  Hold'em No Limit ($0.05/$0.10 USD) - 2017/02/23 16:07:21 ET
Table 'Azelfafage' 6-max Seat #4 is the button
Seat 1: Sbozzz ($15.61 in chips) 
Seat 2: tr41n3r12 ($10.15 in chips) 
Seat 3: todor1711 ($18.52 in chips) 
Seat 4: fedorka rus ($12.02 in chips) 
Seat 5: 8th wonders ($12.85 in chips) 
Seat 6: KA3AXCTAHEU, ($10.06 in chips) 
8th wonders: posts small blind $0.05
KA3AXCTAHEU,: posts big blind $0.10
*** HOLE CARDS ***
Sbozzz has timed out
Sbozzz: folds 
tr41n3r12: raises $0.20 to $0.30
todor1711: calls $0.30
fedorka rus: folds 
8th wonders: folds 
KA3AXCTAHEU,: folds 
*** FLOP *** [Qs Ts 7s]
tr41n3r12: checks 
todor1711: checks 
*** TURN *** [Qs Ts 7s] [7d]
tr41n3r12: checks 
todor1711: checks 
*** RIVER *** [Qs Ts 7s 7d] [2s]
tr41n3r12: bets $0.48
todor1711: calls $0.48
*** SHOW DOWN ***
tr41n3r12: shows [Ad 5d] (a pair of Sevens)
todor1711: shows [9s Jh] (a flush, Queen high)
todor1711 collected $1.63 from pot
*** SUMMARY ***
Total pot $1.71 | Rake $0.08 
Board [Qs Ts 7s 7d 2s]
Seat 1: Sbozzz folded before Flop (didn't bet)
Seat 2: tr41n3r12 showed [Ad 5d] and lost with a pair of Sevens
Seat 3: todor1711 showed [9s Jh] and won ($1.63) with a flush, Queen high
Seat 4: fedorka rus (button) folded before Flop (didn't bet)
Seat 5: 8th wonders (small blind) folded before Flop
Seat 6: KA3AXCTAHEU, (big blind) folded before Flop



PokerStars Hand #166667778317:  Hold'em No Limit ($0.05/$0.10 USD) - 2017/02/23 16:07:21 ET
Table 'Ostara III' 6-max Seat #6 is the button
Seat 1: MühliJr ($13.55 in chips) 
Seat 2: Action_Gibi ($6.52 in chips) 
Seat 3: vtalian ($12.98 in chips) 
Seat 6: FlopsterGB ($10 in chips) 
MühliJr: posts small blind $0.05
Action_Gibi: posts big blind $0.10
*** HOLE CARDS ***
vtalian: folds 
FlopsterGB: folds 
MühliJr: folds 
Uncalled bet ($0.05) returned to Action_Gibi
Action_Gibi collected $0.10 from pot
*** SUMMARY ***
Total pot $0.10 | Rake $0 
Seat 1: MühliJr (small blind) folded before Flop
Seat 2: Action_Gibi (big blind) collected ($0.10)
Seat 3: vtalian folded before Flop (didn't bet)
Seat 6: FlopsterGB (button) folded before Flop (didn't bet)



PokerStars Hand #166667778629:  Hold'em No Limit ($0.05/$0.10 USD) - 2017/02/23 16:07:22 ET
Table 'Orthos III' 6-max Seat #6 is the button
Seat 1: sexy_seagull ($11.17 in chips) 
Seat 2: Xander188 ($19.46 in chips) 
Seat 3: koka4cs ($5.75 in chips) 
Seat 4: FlopsterGB ($15.42 in chips) 
Seat 5: Bird et al ($19.24 in chips) 
Seat 6: RoJ1 ($10.64 in chips) 
sexy_seagull: posts small blind $0.05
Xander188: posts big blind $0.10
*** HOLE CARDS ***
koka4cs: folds 
FlopsterGB: raises $0.20 to $0.30
Bird et al: raises $0.63 to $0.93
RoJ1: folds 
sexy_seagull: folds 
Xander188: folds 
FlopsterGB: raises $1.07 to $2
Bird et al: folds 
Uncalled bet ($1.07) returned to FlopsterGB
FlopsterGB collected $2.01 from pot
*** SUMMARY ***
Total pot $2.01 | Rake $0 
Seat 1: sexy_seagull (small blind) folded before Flop
Seat 2: Xander188 (big blind) folded before Flop
Seat 3: koka4cs folded before Flop (didn't bet)
Seat 4: FlopsterGB collected ($2.01)
Seat 5: Bird et al folded before Flop
Seat 6: RoJ1 (button) folded before Flop (didn't bet)



PokerStars Hand #166667778750:  Hold'em No Limit ($0.05/$0.10 USD) - 2017/02/23 16:07:22 ET
Table 'Epimetheus' 6-max Seat #2 is the button
Seat 1: 6ePeMeHHa9 ($10.29 in chips) 
Seat 2: patrick19111 ($15.36 in chips) 
Seat 3: dineldidi ($9.89 in chips) 
Seat 4: Namhkal ($10 in chips) 
Seat 5: afca128 ($23.83 in chips) 
Seat 6: voledy ($10.60 in chips) 
dineldidi: posts small blind $0.05
Namhkal: posts big blind $0.10
*** HOLE CARDS ***
afca128: folds 
voledy: folds 
6ePeMeHHa9: folds 
patrick19111: raises $0.15 to $0.25
dineldidi: folds 
Namhkal: folds 
Uncalled bet ($0.15) returned to patrick19111
patrick19111 collected $0.25 from pot
*** SUMMARY ***
Total pot $0.25 | Rake $0 
Seat 1: 6ePeMeHHa9 folded before Flop (didn't bet)
Seat 2: patrick19111 (button) collected ($0.25)
Seat 3: dineldidi (small blind) folded before Flop
Seat 4: Namhkal (big blind) folded before Flop
Seat 5: afca128 folded before Flop (didn't bet)
Seat 6: voledy folded before Flop (didn't bet)



PokerStars Hand #166667778994:  Hold'em No Limit ($0.05/$0.10 USD) - 2017/02/23 16:07:22 ET
Table 'Eurykleia' 6-max Seat #5 is the button
Seat 1: Giyorod ($10.15 in chips) 
Seat 2: x3ultimate ($10.74 in chips) 
Seat 3: boxer821 ($20.41 in chips) 
Seat 4: 6ePeMeHHa9 ($16.87 in chips) 
Seat 5: fishhook5 ($10 in chips) 
Seat 6: afca128 ($6.81 in chips) 
afca128: posts small blind $0.05
Giyorod: posts big blind $0.10
*** HOLE CARDS ***
x3ultimate: folds 
boxer821: folds 
6ePeMeHHa9: raises $0.18 to $0.28
fishhook5: folds 
afca128: calls $0.23
Giyorod: folds 
*** FLOP *** [Qh 5h 3d]
afca128: checks 
6ePeMeHHa9: checks 
*** TURN *** [Qh 5h 3d] [8c]
afca128: bets $0.63
6ePeMeHHa9: folds 
Uncalled bet ($0.63) returned to afca128
afca128 collected $0.63 from pot
*** SUMMARY ***
Total pot $0.66 | Rake $0.03 
Board [Qh 5h 3d 8c]
Seat 1: Giyorod (big blind) folded before Flop
Seat 2: x3ultimate folded before Flop (didn't bet)
Seat 3: boxer821 folded before Flop (didn't bet)
Seat 4: 6ePeMeHHa9 folded on the Turn
Seat 5: fishhook5 (button) folded before Flop (didn't bet)
Seat 6: afca128 (small blind) collected ($0.63)



PokerStars Hand #166667779246:  Hold'em No Limit ($0.05/$0.10 USD) - 2017/02/23 16:07:22 ET
Table 'Cuyo' 6-max Seat #1 is the button
Seat 1: Bandyaev ($11.09 in chips) 
Seat 2: Therodorus ($10.30 in chips) 
Seat 6: iluzja12 ($8.67 in chips) 
Therodorus: posts small blind $0.05
DrVzad joins the table at seat #5 
Hergie88 joins the table at seat #3 
bambolejro has timed out while being disconnected
bambolejro: is sitting out 
iluzja12: posts big blind $0.10
*** HOLE CARDS ***
Bandyaev: folds 
Therodorus: folds 
Uncalled bet ($0.05) returned to iluzja12
iluzja12 collected $0.10 from pot
*** SUMMARY ***
Total pot $0.10 | Rake $0 
Seat 1: Bandyaev (button) folded before Flop (didn't bet)
Seat 2: Therodorus (small blind) folded before Flop
Seat 6: iluzja12 (big blind) collected ($0.10)



PokerStars Hand #166667779863:  Hold'em No Limit ($0.05/$0.10 USD) - 2017/02/23 16:07:23 ET
Table 'Pandora III' 6-max Seat #6 is the button
Seat 1: Pokeaster ($11.14 in chips) 
Seat 2: garigura ($11.54 in chips) 
Seat 4: mhonielsen ($10 in chips) 
Seat 5: MühliJr ($10.42 in chips) 
Seat 6: yodzik ($5 in chips) 
Pokeaster: posts small blind $0.05
garigura: posts big blind $0.10
Chodemuncher: sits out 
*** HOLE CARDS ***
mhonielsen: folds 
MühliJr: folds 
yodzik: folds 
Pokeaster: folds 
Uncalled bet ($0.05) returned to garigura
garigura collected $0.10 from pot
*** SUMMARY ***
Total pot $0.10 | Rake $0 
Seat 1: Pokeaster (small blind) folded before Flop
Seat 2: garigura (big blind) collected ($0.10)
Seat 4: mhonielsen folded before Flop (didn't bet)
Seat 5: MühliJr folded before Flop (didn't bet)
Seat 6: yodzik (button) folded before Flop (didn't bet)



PokerStars Hand #166667780166:  Hold'em No Limit ($0.05/$0.10 USD) - 2017/02/23 16:07:23 ET
Table 'Vesta II' 6-max Seat #3 is the button
Seat 1: Yabidooo ($13.16 in chips) 
Seat 2: Dimka4 ($10.45 in chips) 
Seat 3: Pokeaster ($12.56 in chips) 
Seat 4: Dcaro31 ($10 in chips) 
Seat 5: ChuikaPridi ($10 in chips) 
Seat 6: XaXaTyH4uK ($11.01 in chips) 
Dcaro31: posts small blind $0.05
ChuikaPridi: posts big blind $0.10
*** HOLE CARDS ***
XaXaTyH4uK: folds 
Yabidooo: raises $0.20 to $0.30
Dimka4: calls $0.30
Pokeaster: folds 
Dcaro31: calls $0.25
ChuikaPridi: folds 
*** FLOP *** [3h Kh 2c]
Dcaro31: checks 
Yabidooo: bets $0.50
Dimka4: calls $0.50
Dcaro31: folds 
*** TURN *** [3h Kh 2c] [2d]
Yabidooo: checks 
Dimka4: bets $1
Yabidooo: calls $1
*** RIVER *** [3h Kh 2c 2d] [4s]
Yabidooo: checks 
Dimka4: bets $2.30
Yabidooo: calls $2.30
*** SHOW DOWN ***
Dimka4: shows [9c 9h] (two pair, Nines and Deuces)
Yabidooo: shows [Qh Kd] (two pair, Kings and Deuces)
Yabidooo collected $8.21 from pot
*** SUMMARY ***
Total pot $8.60 | Rake $0.39 
Board [3h Kh 2c 2d 4s]
Seat 1: Yabidooo showed [Qh Kd] and won ($8.21) with two pair, Kings and Deuces
Seat 2: Dimka4 showed [9c 9h] and lost with two pair, Nines and Deuces
Seat 3: Pokeaster (button) folded before Flop (didn't bet)
Seat 4: Dcaro31 (small blind) folded on the Flop
Seat 5: ChuikaPridi (big blind) folded before Flop
Seat 6: XaXaTyH4uK folded before Flop (didn't bet)



PokerStars Hand #166667780209:  Hold'em No Limit ($0.05/$0.10 USD) - 2017/02/23 16:07:23 ET
Table 'Glarona' 6-max Seat #5 is the button
Seat 1: LarryTheStar ($10.25 in chips) 
Seat 2: BookWorm78 ($10 in chips) 
Seat 3: hoedje72 ($3.86 in chips) 
Seat 4: CrippledGod ($7.14 in chips) 
Seat 5: david_sara83 ($10.10 in chips) 
marianoboni will be allowed to play after the button
LarryTheStar: posts small blind $0.05
BookWorm78: posts big blind $0.10
*** HOLE CARDS ***
hoedje72: folds 
CrippledGod: folds 
david_sara83: folds 
LarryTheStar: folds 
Uncalled bet ($0.05) returned to BookWorm78
BookWorm78 collected $0.10 from pot
*** SUMMARY ***
Total pot $0.10 | Rake $0 
Seat 1: LarryTheStar (small blind) folded before Flop
Seat 2: BookWorm78 (big blind) collected ($0.10)
Seat 3: hoedje72 folded before Flop (didn't bet)
Seat 4: CrippledGod folded before Flop (didn't bet)
Seat 5: david_sara83 (button) folded before Flop (didn't bet)



PokerStars Hand #166667780268:  Hold'em No Limit ($0.05/$0.10 USD) - 2017/02/23 16:07:23 ET
Table 'Huberta II' 6-max Seat #6 is the button
Seat 1: tr41n3r12 ($10 in chips) 
Seat 2: Ice_Isayev ($12.08 in chips) 
Seat 3: patrick19111 ($10 in chips) 
Seat 4: VAD21 ($11.96 in chips) 
Seat 5: Feverhead ($27.80 in chips) 
Seat 6: yodzik ($5.83 in chips) 
tr41n3r12: posts small blind $0.05
Ice_Isayev: posts big blind $0.10
*** HOLE CARDS ***
patrick19111: folds 
VAD21: folds 
Feverhead: folds 
yodzik: folds 
tr41n3r12: folds 
Uncalled bet ($0.05) returned to Ice_Isayev
Ice_Isayev collected $0.10 from pot
*** SUMMARY ***
Total pot $0.10 | Rake $0 
Seat 1: tr41n3r12 (small blind) folded before Flop
Seat 2: Ice_Isayev (big blind) collected ($0.10)
Seat 3: patrick19111 folded before Flop (didn't bet)
Seat 4: VAD21 folded before Flop (didn't bet)
Seat 5: Feverhead folded before Flop (didn't bet)
Seat 6: yodzik (button) folded before Flop (didn't bet)



PokerStars Hand #166667780322:  Hold'em No Limit ($0.05/$0.10 USD) - 2017/02/23 16:07:23 ET
Table 'Kochera' 6-max Seat #1 is the button
Seat 1: chimera252 ($11.67 in chips) 
Seat 2: bartabs2 ($10.44 in chips) 
Seat 3: KA3AXCTAHEU, ($10.46 in chips) 
Seat 4: johkom ($5.95 in chips) 
Seat 5: univibe68 ($11.50 in chips) 
Seat 6: oddshoff ($9.63 in chips) 
bartabs2: posts small blind $0.05
KA3AXCTAHEU,: posts big blind $0.10
*** HOLE CARDS ***
johkom: folds 
johkom leaves the table
univibe68: raises $0.20 to $0.30
x3ultimate joins the table at seat #4 
oddshoff: folds 
x3ultimate leaves the table
dany_de_vit joins the table at seat #4 
chimera252: folds 
bartabs2: folds 
KA3AXCTAHEU,: folds 
Uncalled bet ($0.20) returned to univibe68
univibe68 collected $0.25 from pot
*** SUMMARY ***
Total pot $0.25 | Rake $0 
Seat 1: chimera252 (button) folded before Flop (didn't bet)
Seat 2: bartabs2 (small blind) folded before Flop
Seat 3: KA3AXCTAHEU, (big blind) folded before Flop
Seat 4: johkom folded before Flop (didn't bet)
Seat 5: univibe68 collected ($0.25)
Seat 6: oddshoff folded before Flop (didn't bet)



PokerStars Hand #166667781278:  Hold'em No Limit ($0.05/$0.10 USD) - 2017/02/23 16:07:25 ET
Table 'Nemo III' 6-max Seat #3 is the button
Seat 1: Kow6oy ($10 in chips) 
Seat 2: Bandyaev ($12.01 in chips) 
Seat 3: Dimka4 ($10 in chips) 
Seat 4: vtalian ($9.90 in chips) 
Seat 5: Joker51_wtf! ($11.28 in chips) 
Seat 6: maxiv608 ($10.15 in chips) 
vtalian: posts small blind $0.05
Joker51_wtf!: posts big blind $0.10
*** HOLE CARDS ***
maxiv608: folds 
Kow6oy: folds 
Bandyaev: raises $0.20 to $0.30
Dimka4: folds 
vtalian: raises $0.60 to $0.90
Joker51_wtf!: folds 
Bandyaev: calls $0.60
*** FLOP *** [Tc 3h 4c]
vtalian: bets $1
Bandyaev: folds 
Uncalled bet ($1) returned to vtalian
vtalian collected $1.81 from pot
*** SUMMARY ***
Total pot $1.90 | Rake $0.09 
Board [Tc 3h 4c]
Seat 1: Kow6oy folded before Flop (didn't bet)
Seat 2: Bandyaev folded on the Flop
Seat 3: Dimka4 (button) folded before Flop (didn't bet)
Seat 4: vtalian (small blind) collected ($1.81)
Seat 5: Joker51_wtf! (big blind) folded before Flop
Seat 6: maxiv608 folded before Flop (didn't bet)



PokerStars Hand #166667781307:  Hold'em No Limit ($0.05/$0.10 USD) - 2017/02/23 16:07:25 ET
Table 'Arduina' 6-max Seat #2 is the button
Seat 1: tauronex ($10 in chips) 
Seat 2: Andy Wolf ($14.45 in chips) 
Seat 3: Dcaro31 ($12.81 in chips) 
Seat 4: ChuikaPridi ($28.93 in chips) 
Seat 5: ettedallas ($7.36 in chips) 
Seat 6: dierri ($9.86 in chips) 
Dcaro31: posts small blind $0.05
ChuikaPridi: posts big blind $0.10
*** HOLE CARDS ***
ettedallas: raises $0.25 to $0.35
dierri: folds 
tauronex: folds 
Andy Wolf: folds 
Dcaro31: folds 
ChuikaPridi: folds 
Uncalled bet ($0.25) returned to ettedallas
ettedallas collected $0.25 from pot
*** SUMMARY ***
Total pot $0.25 | Rake $0 
Seat 1: tauronex folded before Flop (didn't bet)
Seat 2: Andy Wolf (button) folded before Flop (didn't bet)
Seat 3: Dcaro31 (small blind) folded before Flop
Seat 4: ChuikaPridi (big blind) folded before Flop
Seat 5: ettedallas collected ($0.25)
Seat 6: dierri folded before Flop (didn't bet)



PokerStars Hand #166667781357:  Hold'em No Limit ($0.05/$0.10 USD) - 2017/02/23 16:07:25 ET
Table 'Ruvuma' 6-max Seat #1 is the button
Seat 1: FRAID358 ($14.62 in chips) 
Seat 3: Spud014 ($10 in chips) 
Seat 4: DamDatsAnAce ($10 in chips) 
Seat 5: sexy_seagull ($10 in chips) 
RoJ1 will be allowed to play after the button
Spud014: posts small blind $0.05
DamDatsAnAce: posts big blind $0.10
*** HOLE CARDS ***
sexy_seagull: folds 
FRAID358: raises $0.15 to $0.25
Spud014: calls $0.20
DamDatsAnAce: folds 
*** FLOP *** [8s Tc 6d]
Spud014: bets $0.42
FRAID358: calls $0.42
*** TURN *** [8s Tc 6d] [Jc]
Spud014: bets $0.91
FRAID358: calls $0.91
*** RIVER *** [8s Tc 6d Jc] [Ts]
RoJ1 leaves the table
Spud014: bets $2.33
FRAID358: raises $6.57 to $8.90
Spud014: calls $6.09 and is all-in
Uncalled bet ($0.48) returned to FRAID358
*** SHOW DOWN ***
FRAID358: shows [6s 6c] (a full house, Sixes full of Tens)
Spud014: shows [Td Ac] (three of a kind, Tens)
FRAID358 collected $19.20 from pot
*** SUMMARY ***
Total pot $20.10 | Rake $0.90 
Board [8s Tc 6d Jc Ts]
Seat 1: FRAID358 (button) showed [6s 6c] and won ($19.20) with a full house, Sixes full of Tens
Seat 3: Spud014 (small blind) showed [Td Ac] and lost with three of a kind, Tens
Seat 4: DamDatsAnAce (big blind) folded before Flop
Seat 5: sexy_seagull folded before Flop (didn't bet)



PokerStars Hand #166667781516:  Hold'em No Limit ($0.05/$0.10 USD) - 2017/02/23 16:07:25 ET
Table 'Pyrrhus III' 6-max Seat #2 is the button
Seat 1: skatejeff ($13.50 in chips) 
Seat 2: univibe68 ($19.76 in chips) 
Seat 3: coolisses111 ($9.73 in chips) 
Seat 4: ex3Lero86 ($23.32 in chips) 
Seat 6: MLPlayer16 ($20.43 in chips) 
coolisses111: posts small blind $0.05
ex3Lero86: posts big blind $0.10
eniksenik: sits out 
skatejeff: posts the ante $0.02
univibe68: posts the ante $0.02
coolisses111: posts the ante $0.02
ex3Lero86: posts the ante $0.02
MLPlayer16: posts the ante $0.02
*** HOLE CARDS ***
MLPlayer16: raises $0.15 to $0.25
skatejeff: folds 
univibe68: raises $0.55 to $0.80
skatejeff leaves the table
coolisses111: folds 
ex3Lero86: folds 
Andrei ProFF joins the table at seat #1 
MLPlayer16: calls $0.55
*** FLOP *** [7c 4d 8h]
Andrei ProFF leaves the table
MLPlayer16: checks 
univibe68: checks 
*** TURN *** [7c 4d 8h] [4h]
MLPlayer16: bets $0.97
univibe68: folds 
Uncalled bet ($0.97) returned to MLPlayer16
MLPlayer16 collected $1.77 from pot
*** SUMMARY ***
Total pot $1.85 | Rake $0.08 
Board [7c 4d 8h 4h]
Seat 1: skatejeff folded before Flop (didn't bet)
Seat 2: univibe68 (button) folded on the Turn
Seat 3: coolisses111 (small blind) folded before Flop
Seat 4: ex3Lero86 (big blind) folded before Flop
Seat 6: MLPlayer16 collected ($1.77)



PokerStars Hand #166667781616:  Hold'em No Limit ($0.05/$0.10 USD) - 2017/02/23 16:07:25 ET
Table 'Repsolda' 6-max Seat #3 is the button
Seat 2: MBen10 ($24.39 in chips) 
Seat 3: manashov ($14.82 in chips) 
Seat 4: MihaGr ($10 in chips) 
Seat 5: danky24 ($5.11 in chips) 
Seat 6: RkaczoR ($11.26 in chips) 
MihaGr: posts small blind $0.05
danky24: posts big blind $0.10
fabadam: sits out 
*** HOLE CARDS ***
RkaczoR: folds 
MBen10: raises $0.15 to $0.25
manashov: folds 
MihaGr: folds 
danky24: calls $0.15
*** FLOP *** [4c 5d Ac]
danky24: checks 
MBen10: bets $0.25
danky24: folds 
Uncalled bet ($0.25) returned to MBen10
MBen10 collected $0.53 from pot
*** SUMMARY ***
Total pot $0.55 | Rake $0.02 
Board [4c 5d Ac]
Seat 2: MBen10 collected ($0.53)
Seat 3: manashov (button) folded before Flop (didn't bet)
Seat 4: MihaGr (small blind) folded before Flop
Seat 5: danky24 (big blind) folded on the Flop
Seat 6: RkaczoR folded before Flop (didn't bet)



PokerStars Hand #166667781617:  Hold'em No Limit ($0.05/$0.10 USD) - 2017/02/23 16:07:25 ET
Table 'Hamal II' 6-max Seat #6 is the button
Seat 1: saxoalto2011 ($7.69 in chips) 
Seat 2: pancernik21 ($10.15 in chips) 
Seat 3: Cluckh ($10.99 in chips) 
Seat 4: ArcticBearDK ($11.06 in chips) 
Seat 5: eniksenik ($10.89 in chips) 
Seat 6: LarryTheStar ($11.54 in chips) 
saxoalto2011: posts small blind $0.05
pancernik21: posts big blind $0.10
*** HOLE CARDS ***
Cluckh: folds 
ArcticBearDK: folds 
eniksenik: folds 
LarryTheStar: raises $0.10 to $0.20
saxoalto2011: folds 
pancernik21: calls $0.10
*** FLOP *** [4c 2c Qh]
pancernik21: checks 
LarryTheStar: checks 
*** TURN *** [4c 2c Qh] [7s]
pancernik21: checks 
LarryTheStar: checks 
*** RIVER *** [4c 2c Qh 7s] [3c]
pancernik21: checks 
LarryTheStar: checks 
*** SHOW DOWN ***
pancernik21: shows [Ad 9s] (high card Ace)
LarryTheStar: mucks hand 
pancernik21 collected $0.43 from pot
*** SUMMARY ***
Total pot $0.45 | Rake $0.02 
Board [4c 2c Qh 7s 3c]
Seat 1: saxoalto2011 (small blind) folded before Flop
Seat 2: pancernik21 (big blind) showed [Ad 9s] and won ($0.43) with high card Ace
Seat 3: Cluckh folded before Flop (didn't bet)
Seat 4: ArcticBearDK folded before Flop (didn't bet)
Seat 5: eniksenik folded before Flop (didn't bet)
Seat 6: LarryTheStar (button) mucked



PokerStars Hand #166667781624:  Hold'em No Limit ($0.05/$0.10 USD) - 2017/02/23 16:07:25 ET
Table 'Laetitia II' 6-max Seat #6 is the button
Seat 1: Cluckh ($11.08 in chips) 
Seat 2: manashov ($10 in chips) 
Seat 3: 6ePeMeHHa9 ($10.14 in chips) 
Seat 4: Feverhead ($16.66 in chips) 
Seat 5: D3NyA ($16.28 in chips) 
Seat 6: Dima91360 ($6.21 in chips) 
Cluckh: posts small blind $0.05
manashov: posts big blind $0.10
*** HOLE CARDS ***
6ePeMeHHa9: folds 
Feverhead: folds 
D3NyA: raises $0.15 to $0.25
Dima91360: calls $0.25
Cluckh: calls $0.20
manashov: folds 
*** FLOP *** [Ad Qh Jd]
Cluckh: checks 
D3NyA: bets $0.57
Dima91360: calls $0.57
Cluckh: folds 
*** TURN *** [Ad Qh Jd] [Th]
D3NyA: bets $1.33
Dima91360: folds 
Uncalled bet ($1.33) returned to D3NyA
D3NyA collected $1.90 from pot
*** SUMMARY ***
Total pot $1.99 | Rake $0.09 
Board [Ad Qh Jd Th]
Seat 1: Cluckh (small blind) folded on the Flop
Seat 2: manashov (big blind) folded before Flop
Seat 3: 6ePeMeHHa9 folded before Flop (didn't bet)
Seat 4: Feverhead folded before Flop (didn't bet)
Seat 5: D3NyA collected ($1.90)
Seat 6: Dima91360 (button) folded on the Turn



PokerStars Hand #166667781805:  Hold'em No Limit ($0.05/$0.10 USD) - 2017/02/23 16:07:25 ET
Table 'Walpurga' 6-max Seat #3 is the button
Seat 1: chimera252 ($12.07 in chips) 
Seat 2: paxit71 ($5.45 in chips) 
Seat 3: marianoboni ($10.56 in chips) 
Seat 4: oddshoff ($13.09 in chips) 
Seat 5: Fremara ($10 in chips) 
Seat 6: AIONCMA1988 ($5.58 in chips) 
oddshoff: posts small blind $0.05
Fremara: posts big blind $0.10
*** HOLE CARDS ***
AIONCMA1988: raises $0.10 to $0.20
chimera252: folds 
paxit71: calls $0.20
marianoboni: calls $0.20
oddshoff: calls $0.15
Fremara: calls $0.10
*** FLOP *** [Qc 5h 6c]
oddshoff: checks 
Fremara: checks 
AIONCMA1988: bets $5.38 and is all-in
paxit71: folds 
marianoboni: calls $5.38
oddshoff: folds 
Fremara: folds 
*** TURN *** [Qc 5h 6c] [3s]
*** RIVER *** [Qc 5h 6c 3s] [Td]
*** SHOW DOWN ***
AIONCMA1988: shows [As 4h] (high card Ace)
marianoboni: shows [6h 6d] (three of a kind, Sixes)
marianoboni collected $11.23 from pot
*** SUMMARY ***
Total pot $11.76 | Rake $0.53 
Board [Qc 5h 6c 3s Td]
Seat 1: chimera252 folded before Flop (didn't bet)
Seat 2: paxit71 folded on the Flop
Seat 3: marianoboni (button) showed [6h 6d] and won ($11.23) with three of a kind, Sixes
Seat 4: oddshoff (small blind) folded on the Flop
Seat 5: Fremara (big blind) folded on the Flop
Seat 6: AIONCMA1988 showed [As 4h] and lost with high card Ace



PokerStars Hand #166667782089:  Hold'em No Limit ($0.05/$0.10 USD) - 2017/02/23 16:07:25 ET
Table 'Manto II' 6-max Seat #4 is the button
Seat 2: voledy ($10.15 in chips) 
Seat 3: Komap511 ($9.85 in chips) 
Seat 4: dr.goofy ($14.96 in chips) 
Seat 5: ArcticBearDK ($32.59 in chips) 
Seat 6: pancernik21 ($16.35 in chips) 
ArcticBearDK: posts small blind $0.05
pancernik21: posts big blind $0.10
ex3Lero86: sits out 
*** HOLE CARDS ***
voledy: raises $0.20 to $0.30
Komap511: calls $0.30
dr.goofy: folds 
ArcticBearDK: folds 
pancernik21: folds 
*** FLOP *** [2d 4s 7d]
voledy: bets $0.41
Komap511: folds 
Uncalled bet ($0.41) returned to voledy
voledy collected $0.72 from pot
*** SUMMARY ***
Total pot $0.75 | Rake $0.03 
Board [2d 4s 7d]
Seat 2: voledy collected ($0.72)
Seat 3: Komap511 folded on the Flop
Seat 4: dr.goofy (button) folded before Flop (didn't bet)
Seat 5: ArcticBearDK (small blind) folded before Flop
Seat 6: pancernik21 (big blind) folded before Flop



PokerStars Hand #166667782283:  Hold'em No Limit ($0.05/$0.10 USD) - 2017/02/23 16:07:26 ET
Table 'Joella' 6-max Seat #5 is the button
Seat 1: Dcaro31 ($12.80 in chips) 
Seat 2: Kaelyns_Bark ($9.34 in chips) 
Seat 3: Joker51_wtf! ($11.20 in chips) 
Seat 5: Anestakis777 ($4.06 in chips) 
Seat 6: dr.goofy ($10.75 in chips) 
dr.goofy: posts small blind $0.05
Dcaro31: posts big blind $0.10
KRZuff: sits out 
*** HOLE CARDS ***
Kaelyns_Bark: folds 
Joker51_wtf!: raises $0.12 to $0.22
Anestakis777: calls $0.22
dr.goofy: folds 
Dcaro31: calls $0.12
*** FLOP *** [5d 8h 7s]
Dcaro31: checks 
Joker51_wtf!: bets $0.40
Anestakis777: folds 
Dcaro31: folds 
Uncalled bet ($0.40) returned to Joker51_wtf!
Joker51_wtf! collected $0.68 from pot
*** SUMMARY ***
Total pot $0.71 | Rake $0.03 
Board [5d 8h 7s]
Seat 1: Dcaro31 (big blind) folded on the Flop
Seat 2: Kaelyns_Bark folded before Flop (didn't bet)
Seat 3: Joker51_wtf! collected ($0.68)
Seat 5: Anestakis777 (button) folded on the Flop
Seat 6: dr.goofy (small blind) folded before Flop



PokerStars Hand #166667782597:  Hold'em No Limit ($0.05/$0.10 USD) - 2017/02/23 16:07:26 ET
Table 'Tyche III' 6-max Seat #1 is the button
Seat 1: milt65 ($10.09 in chips) 
Seat 3: ChuikaPridi ($10 in chips) 
Seat 4: Kazacha ($10 in chips) 
Seat 5: chimera252 ($14.51 in chips) 
Seat 6: Ice_Isayev ($10 in chips) 
arti192837 will be allowed to play after the button
ChuikaPridi: posts small blind $0.05
Kazacha: posts big blind $0.10
*** HOLE CARDS ***
chimera252: folds 
Ice_Isayev: folds 
milt65: folds 
ChuikaPridi: raises $0.20 to $0.30
Kazacha: folds 
Uncalled bet ($0.20) returned to ChuikaPridi
ChuikaPridi collected $0.20 from pot
*** SUMMARY ***
Total pot $0.20 | Rake $0 
Seat 1: milt65 (button) folded before Flop (didn't bet)
Seat 3: ChuikaPridi (small blind) collected ($0.20)
Seat 4: Kazacha (big blind) folded before Flop
Seat 5: chimera252 folded before Flop (didn't bet)
Seat 6: Ice_Isayev folded before Flop (didn't bet)



PokerStars Hand #166667783343:  Hold'em No Limit ($0.05/$0.10 USD) - 2017/02/23 16:07:27 ET
Table 'Hirons' 6-max Seat #2 is the button
Seat 1: RoJ1 ($11.91 in chips) 
Seat 2: coolisses111 ($7.64 in chips) 
Seat 3: czeczen7 ($14.14 in chips) 
Seat 4: Smitty03300 ($11.05 in chips) 
Seat 6: garigura ($13.63 in chips) 
czeczen7: posts small blind $0.05
Smitty03300: posts big blind $0.10
Pekaml: sits out 
*** HOLE CARDS ***
garigura: folds 
RoJ1: folds 
coolisses111: folds 
czeczen7: calls $0.05
Smitty03300: raises $0.35 to $0.45
czeczen7: calls $0.35
*** FLOP *** [Td 2s 6c]
czeczen7: bets $0.10
Smitty03300: calls $0.10
*** TURN *** [Td 2s 6c] [Th]
czeczen7: bets $0.10
Smitty03300: calls $0.10
*** RIVER *** [Td 2s 6c Th] [8h]
czeczen7: bets $0.50
Smitty03300: folds 
Uncalled bet ($0.50) returned to czeczen7
czeczen7 collected $1.24 from pot
*** SUMMARY ***
Total pot $1.30 | Rake $0.06 
Board [Td 2s 6c Th 8h]
Seat 1: RoJ1 folded before Flop (didn't bet)
Seat 2: coolisses111 (button) folded before Flop (didn't bet)
Seat 3: czeczen7 (small blind) collected ($1.24)
Seat 4: Smitty03300 (big blind) folded on the River
Seat 6: garigura folded before Flop (didn't bet)



PokerStars Hand #166667783352:  Hold'em No Limit ($0.05/$0.10 USD) - 2017/02/23 16:07:27 ET
Table 'Risha II' 6-max Seat #5 is the button
Seat 1: R. Lemonte ($14.75 in chips) 
Seat 2: KA3AXCTAHEU, ($12.65 in chips) 
Seat 3: steepfell ($10.15 in chips) 
Seat 4: Comeback3392 ($19.36 in chips) 
Seat 5: m.c-alkatraz ($10.05 in chips) 
Seat 6: univibe68 ($10.51 in chips) 
univibe68: posts small blind $0.05
R. Lemonte: posts big blind $0.10
*** HOLE CARDS ***
KA3AXCTAHEU,: folds 
steepfell: folds 
Comeback3392: raises $0.20 to $0.30
m.c-alkatraz: folds 
univibe68: folds 
R. Lemonte: calls $0.20
*** FLOP *** [Jd 3c 7s]
R. Lemonte: checks 
Comeback3392: bets $0.35
R. Lemonte: folds 
Uncalled bet ($0.35) returned to Comeback3392
Comeback3392 collected $0.62 from pot
*** SUMMARY ***
Total pot $0.65 | Rake $0.03 
Board [Jd 3c 7s]
Seat 1: R. Lemonte (big blind) folded on the Flop
Seat 2: KA3AXCTAHEU, folded before Flop (didn't bet)
Seat 3: steepfell folded before Flop (didn't bet)
Seat 4: Comeback3392 collected ($0.62)
Seat 5: m.c-alkatraz (button) folded before Flop (didn't bet)
Seat 6: univibe68 (small blind) folded before Flop



PokerStars Hand #166667783392:  Hold'em No Limit ($0.05/$0.10 USD) - 2017/02/23 16:07:27 ET
Table 'Marbachia II' 6-max Seat #2 is the button
Seat 1: AC Evergreen ($10 in chips) 
Seat 2: Yabidooo ($11.69 in chips) 
Seat 3: MisterX413 ($10.09 in chips) 
Seat 5: MihaGr ($10 in chips) 
Seat 6: DamDatsAnAce ($10.15 in chips) 
MisterX413: posts small blind $0.05
BahiaMinhaP: is sitting out 
MihaGr: posts big blind $0.10
*** HOLE CARDS ***
DamDatsAnAce: folds 
AC Evergreen: folds 
Yabidooo: folds 
BahiaMinhaP leaves the table
marianoboni joins the table at seat #4 
MisterX413: folds 
Uncalled bet ($0.05) returned to MihaGr
MihaGr collected $0.10 from pot
*** SUMMARY ***
Total pot $0.10 | Rake $0 
Seat 1: AC Evergreen folded before Flop (didn't bet)
Seat 2: Yabidooo (button) folded before Flop (didn't bet)
Seat 3: MisterX413 (small blind) folded before Flop
Seat 5: MihaGr (big blind) collected ($0.10)
Seat 6: DamDatsAnAce folded before Flop (didn't bet)



PokerStars Hand #166667783430:  Hold'em No Limit ($0.05/$0.10 USD) - 2017/02/23 16:07:27 ET
Table 'Tomita II' 6-max Seat #4 is the button
Seat 2: mhonielsen ($10.15 in chips) 
Seat 4: Hyd SK ($11.26 in chips) 
Seat 5: ex3Lero86 ($10 in chips) 
Seat 6: saniasmir ($10 in chips) 
ex3Lero86: posts small blind $0.05
saniasmir: posts big blind $0.10
D3NyA: sits out 
*** HOLE CARDS ***
mhonielsen: folds 
Hyd SK: folds 
ex3Lero86: raises $0.20 to $0.30
saniasmir: folds 
Uncalled bet ($0.20) returned to ex3Lero86
ex3Lero86 collected $0.20 from pot
*** SUMMARY ***
Total pot $0.20 | Rake $0 
Seat 2: mhonielsen folded before Flop (didn't bet)
Seat 4: Hyd SK (button) folded before Flop (didn't bet)
Seat 5: ex3Lero86 (small blind) collected ($0.20)
Seat 6: saniasmir (big blind) folded before Flop



PokerStars Hand #166667783522:  Hold'em No Limit ($0.05/$0.10 USD) - 2017/02/23 16:07:27 ET
Table 'Alnasl' 6-max Seat #3 is the button
Seat 1: KA3AXCTAHEU, ($11.20 in chips) 
Seat 2: saddur ($9.64 in chips) 
Seat 3: david_sara83 ($22.54 in chips) 
Seat 4: oddshoff ($10.23 in chips) 
Seat 5: 6ePeMeHHa9 ($10 in chips) 
Seat 6: Zooplack ($13.43 in chips) 
oddshoff: posts small blind $0.05
6ePeMeHHa9: posts big blind $0.10
*** HOLE CARDS ***
Zooplack: raises $0.20 to $0.30
KA3AXCTAHEU,: folds 
saddur: folds 
david_sara83: folds 
oddshoff: folds 
6ePeMeHHa9: folds 
Uncalled bet ($0.20) returned to Zooplack
Zooplack collected $0.25 from pot
*** SUMMARY ***
Total pot $0.25 | Rake $0 
Seat 1: KA3AXCTAHEU, folded before Flop (didn't bet)
Seat 2: saddur folded before Flop (didn't bet)
Seat 3: david_sara83 (button) folded before Flop (didn't bet)
Seat 4: oddshoff (small blind) folded before Flop
Seat 5: 6ePeMeHHa9 (big blind) folded before Flop
Seat 6: Zooplack collected ($0.25)



PokerStars Hand #166667783947:  Hold'em No Limit ($0.05/$0.10 USD) - 2017/02/23 16:07:27 ET
Table 'Geisha' 6-max Seat #6 is the button
Seat 1: facewald ($33.94 in chips) 
Seat 3: Eddys Edge ($10 in chips) 
Seat 5: KRZuff ($14.36 in chips) 
Seat 6: Namhkal ($21.33 in chips) 
facewald: posts small blind $0.05
voledy: is sitting out 
Eddys Edge: posts big blind $0.10
*** HOLE CARDS ***
voledy leaves the table
RoJ1 joins the table at seat #4 
KRZuff: folds 
Namhkal: raises $0.10 to $0.20
facewald: raises $0.30 to $0.50
Kow6oy joins the table at seat #2 
Eddys Edge: folds 
Kow6oy leaves the table
Namhkal: calls $0.30
*** FLOP *** [7s 2s 7c]
MisterX413 joins the table at seat #2 
RoJ1 leaves the table
facewald: checks 
marianoboni joins the table at seat #4 
Namhkal: checks 
*** TURN *** [7s 2s 7c] [5s]
facewald: bets $0.67
Namhkal: folds 
Uncalled bet ($0.67) returned to facewald
facewald collected $1.05 from pot
*** SUMMARY ***
Cruger: !!???????!!??!!??
Total pot $1.10 | Rake $0.05 
Board [7s 2s 7c 5s]
Seat 1: facewald (small blind) collected ($1.05)
Seat 3: Eddys Edge (big blind) folded before Flop
Seat 5: KRZuff folded before Flop (didn't bet)
Seat 6: Namhkal (button) folded on the Turn



PokerStars Hand #166667783986:  Hold'em No Limit ($0.05/$0.10 USD) - 2017/02/23 16:07:27 ET
Table 'Amalia' 6-max Seat #5 is the button
Seat 1: voledy ($12.59 in chips) 
Seat 2: DamDatsAnAce ($11.10 in chips) 
Seat 3: kickereens ($10.08 in chips) 
Seat 4: Rodik002 ($16.36 in chips) 
Seat 5: coolisses111 ($10.95 in chips) 
Seat 6: oktomber778 ($23.11 in chips) 
oktomber778: posts small blind $0.05
voledy: posts big blind $0.10
*** HOLE CARDS ***
DamDatsAnAce: folds 
kickereens: folds 
Rodik002: folds 
coolisses111: folds 
oktomber778: calls $0.05
voledy: checks 
*** FLOP *** [Kc Jc 2d]
oktomber778: checks 
voledy: bets $0.11
oktomber778: folds 
Uncalled bet ($0.11) returned to voledy
voledy collected $0.19 from pot
*** SUMMARY ***
Total pot $0.20 | Rake $0.01 
Board [Kc Jc 2d]
Seat 1: voledy (big blind) collected ($0.19)
Seat 2: DamDatsAnAce folded before Flop (didn't bet)
Seat 3: kickereens folded before Flop (didn't bet)
Seat 4: Rodik002 folded before Flop (didn't bet)
Seat 5: coolisses111 (button) folded before Flop (didn't bet)
Seat 6: oktomber778 (small blind) folded on the Flop



PokerStars Hand #166667784166:  Hold'em No Limit ($0.05/$0.10 USD) - 2017/02/23 16:07:28 ET
Table 'Lederle' 6-max Seat #4 is the button
Seat 2: truck1234 ($14.85 in chips) 
Seat 3: Kazacha ($11.20 in chips) 
Seat 4: Pokeaster ($13.76 in chips) 
Seat 5: 8th wonders ($14.23 in chips) 
Seat 6: pokekrk ($10.10 in chips) 
8th wonders: posts small blind $0.05
pokekrk: posts big blind $0.10
Sterjek: sits out 
*** HOLE CARDS ***
truck1234: raises $0.20 to $0.30
Kazacha: folds 
Pokeaster: folds 
8th wonders: folds 
pokekrk: folds 
Uncalled bet ($0.20) returned to truck1234
truck1234 collected $0.25 from pot
*** SUMMARY ***
Total pot $0.25 | Rake $0 
Seat 2: truck1234 collected ($0.25)
Seat 3: Kazacha folded before Flop (didn't bet)
Seat 4: Pokeaster (button) folded before Flop (didn't bet)
Seat 5: 8th wonders (small blind) folded before Flop
Seat 6: pokekrk (big blind) folded before Flop



PokerStars Hand #166667784819:  Hold'em No Limit ($0.05/$0.10 USD) - 2017/02/23 16:07:28 ET
Table 'Samitchell III' 6-max Seat #1 is the button
Seat 1: dr.goofy ($10.10 in chips) 
Seat 3: Vanne11 ($9.80 in chips) 
Seat 4: DEraser ($8 in chips) 
Seat 5: steepfell ($10 in chips) 
Seat 6: fedorka rus ($12.31 in chips) 
scorpionfish will be allowed to play after the button
Vanne11: posts small blind $0.05
DEraser: posts big blind $0.10
*** HOLE CARDS ***
steepfell: folds 
fedorka rus: folds 
dr.goofy: raises $0.15 to $0.25
Vanne11: calls $0.20
DEraser: raises $0.85 to $1.10
dr.goofy: folds 
Vanne11: folds 
Uncalled bet ($0.85) returned to DEraser
DEraser collected $0.75 from pot
*** SUMMARY ***
Total pot $0.75 | Rake $0 
Seat 1: dr.goofy (button) folded before Flop
Seat 3: Vanne11 (small blind) folded before Flop
Seat 4: DEraser (big blind) collected ($0.75)
Seat 5: steepfell folded before Flop (didn't bet)
Seat 6: fedorka rus folded before Flop (didn't bet)



PokerStars Hand #166667785046:  Hold'em No Limit ($0.05/$0.10 USD) - 2017/02/23 16:07:29 ET
Table 'Izar' 6-max Seat #1 is the button
Seat 1: bambolejro ($10.52 in chips) 
Seat 2: mvp0013 ($7.98 in chips) 
Seat 3: Yspenyanin ($11.27 in chips) 
Seat 4: Matee92 ($6.01 in chips) 
Seat 5: fishhook5 ($11.30 in chips) 
Seat 6: yodzik ($7.79 in chips) 
mvp0013: posts small blind $0.05
Yspenyanin: posts big blind $0.10
*** HOLE CARDS ***
Matee92: calls $0.10
fishhook5: folds 
yodzik: folds 
bambolejro is disconnected 
bambolejro has timed out while disconnected
bambolejro: folds 
mvp0013: folds 
Yspenyanin: checks 
*** FLOP *** [2s 3d 7d]
Yspenyanin: checks 
Matee92: checks 
*** TURN *** [2s 3d 7d] [Kh]
Yspenyanin: bets $0.10
Matee92: raises $0.10 to $0.20
Yspenyanin: folds 
Uncalled bet ($0.10) returned to Matee92
Matee92 collected $0.43 from pot
*** SUMMARY ***
Total pot $0.45 | Rake $0.02 
Board [2s 3d 7d Kh]
Seat 1: bambolejro (button) folded before Flop (didn't bet)
Seat 2: mvp0013 (small blind) folded before Flop
Seat 3: Yspenyanin (big blind) folded on the Turn
Seat 4: Matee92 collected ($0.43)
Seat 5: fishhook5 folded before Flop (didn't bet)
Seat 6: yodzik folded before Flop (didn't bet)



PokerStars Hand #166667785145:  Hold'em No Limit ($0.05/$0.10 USD) - 2017/02/23 16:07:29 ET
Table 'Markab II' 6-max Seat #2 is the button
Seat 1: david_sara83 ($10.22 in chips) 
Seat 2: truck1234 ($10.90 in chips) 
Seat 3: sexy_seagull ($10.20 in chips) 
Seat 4: Crafty23@PS ($11.54 in chips) 
Seat 5: Rodik002 ($19.92 in chips) 
Seat 6: Comeback3392 ($10 in chips) 
sexy_seagull: posts small blind $0.05
Crafty23@PS: posts big blind $0.10
*** HOLE CARDS ***
Rodik002: folds 
Comeback3392: folds 
david_sara83: folds 
truck1234: folds 
sexy_seagull: folds 
Uncalled bet ($0.05) returned to Crafty23@PS
Crafty23@PS collected $0.10 from pot
*** SUMMARY ***
Total pot $0.10 | Rake $0 
Seat 1: david_sara83 folded before Flop (didn't bet)
Seat 2: truck1234 (button) folded before Flop (didn't bet)
Seat 3: sexy_seagull (small blind) folded before Flop
Seat 4: Crafty23@PS (big blind) collected ($0.10)
Seat 5: Rodik002 folded before Flop (didn't bet)
Seat 6: Comeback3392 folded before Flop (didn't bet)



PokerStars Hand #166667785164:  Hold'em No Limit ($0.05/$0.10 USD) - 2017/02/23 16:07:29 ET
Table 'Antielus II' 6-max Seat #3 is the button
Seat 1: Dcaro31 ($18.49 in chips) 
Seat 2: Orlangoor ($10 in chips) 
Seat 3: mcyi3at2 ($13.03 in chips) 
Seat 4: XwinX25 ($10.05 in chips) 
Seat 5: Hyd SK ($10.89 in chips) 
Seat 6: GiveTwoMe ($11.45 in chips) 
XwinX25: posts small blind $0.05
Hyd SK: posts big blind $0.10
*** HOLE CARDS ***
GiveTwoMe: folds 
Dcaro31: raises $0.20 to $0.30
Orlangoor: folds 
mcyi3at2: folds 
XwinX25: folds 
Hyd SK: folds 
Uncalled bet ($0.20) returned to Dcaro31
Dcaro31 collected $0.25 from pot
*** SUMMARY ***
Total pot $0.25 | Rake $0 
Seat 1: Dcaro31 collected ($0.25)
Seat 2: Orlangoor folded before Flop (didn't bet)
Seat 3: mcyi3at2 (button) folded before Flop (didn't bet)
Seat 4: XwinX25 (small blind) folded before Flop
Seat 5: Hyd SK (big blind) folded before Flop
Seat 6: GiveTwoMe folded before Flop (didn't bet)



PokerStars Hand #166667785278:  Hold'em No Limit ($0.05/$0.10 USD) - 2017/02/23 16:07:29 ET
Table 'Postrema' 6-max Seat #2 is the button
Seat 1: CHRO8 ($10.51 in chips) 
Seat 2: pancernik21 ($12.61 in chips) 
Seat 3: edcc19 ($5.70 in chips) 
Seat 4: ChuikaPridi ($13.63 in chips) 
Seat 5: Comeback3392 ($12.12 in chips) 
Seat 6: Scanner17 ($10 in chips) 
edcc19: posts small blind $0.05
ChuikaPridi: posts big blind $0.10
*** HOLE CARDS ***
Comeback3392: raises $0.20 to $0.30
Scanner17: folds 
CHRO8: folds 
pancernik21: calls $0.30
edcc19: folds 
ChuikaPridi: folds 
*** FLOP *** [Th Kd 9s]
Comeback3392: bets $0.45
pancernik21: raises $1.05 to $1.50
Comeback3392: folds 
Uncalled bet ($1.05) returned to pancernik21
pancernik21 collected $1.58 from pot
*** SUMMARY ***
Total pot $1.65 | Rake $0.07 
Board [Th Kd 9s]
Seat 1: CHRO8 folded before Flop (didn't bet)
Seat 2: pancernik21 (button) collected ($1.58)
Seat 3: edcc19 (small blind) folded before Flop
Seat 4: ChuikaPridi (big blind) folded before Flop
Seat 5: Comeback3392 folded on the Flop
Seat 6: Scanner17 folded before Flop (didn't bet)



PokerStars Hand #166667785839:  Hold'em No Limit ($0.05/$0.10 USD) - 2017/02/23 16:07:29 ET
Table 'Torrence II' 6-max Seat #1 is the button
Seat 1: Starbooks ($7.31 in chips) 
Seat 2: scorpionfish ($15.85 in chips) 
Seat 3: coolisses111 ($9.80 in chips) 
Seat 4: Zooplack ($10 in chips) 
Seat 5: Kow6oy ($12.18 in chips) 
Seat 6: mhonielsen ($10 in chips) 
scorpionfish: posts small blind $0.05
coolisses111: posts big blind $0.10
*** HOLE CARDS ***
Zooplack: folds 
Kow6oy: folds 
mhonielsen: folds 
Starbooks: calls $0.10
scorpionfish: folds 
coolisses111: checks 
*** FLOP *** [Qh Th 8d]
coolisses111: checks 
Starbooks: checks 
*** TURN *** [Qh Th 8d] [Kd]
coolisses111: checks 
Starbooks: checks 
*** RIVER *** [Qh Th 8d Kd] [Qc]
coolisses111: checks 
Starbooks: checks 
*** SHOW DOWN ***
coolisses111: shows [Ts 5d] (two pair, Queens and Tens)
Starbooks: mucks hand 
coolisses111 collected $0.24 from pot
*** SUMMARY ***
Total pot $0.25 | Rake $0.01 
Board [Qh Th 8d Kd Qc]
Seat 1: Starbooks (button) mucked
Seat 2: scorpionfish (small blind) folded before Flop
Seat 3: coolisses111 (big blind) showed [Ts 5d] and won ($0.24) with two pair, Queens and Tens
Seat 4: Zooplack folded before Flop (didn't bet)
Seat 5: Kow6oy folded before Flop (didn't bet)
Seat 6: mhonielsen folded before Flop (didn't bet)



PokerStars Hand #166667785915:  Hold'em No Limit ($0.05/$0.10 USD) - 2017/02/23 16:07:29 ET
Table 'Goto II' 6-max Seat #4 is the button
Seat 1: FRAID358 ($12.46 in chips) 
Seat 2: 6ePeMeHHa9 ($11.82 in chips) 
Seat 3: Goroshkos88 ($10.81 in chips) 
Seat 4: KRZuff ($13.39 in chips) 
Seat 5: RoJ1 ($14.40 in chips) 
Seat 6: ermananb93 ($11.49 in chips) 
RoJ1: posts small blind $0.05
ermananb93: posts big blind $0.10
*** HOLE CARDS ***
FRAID358: raises $0.20 to $0.30
6ePeMeHHa9: folds 
Goroshkos88: folds 
KRZuff: folds 
RoJ1: folds 
ermananb93: calls $0.20
*** FLOP *** [Jd 4h 7c]
ermananb93: bets $0.10
FRAID358: folds 
Uncalled bet ($0.10) returned to ermananb93
ermananb93 collected $0.62 from pot
*** SUMMARY ***
Total pot $0.65 | Rake $0.03 
Board [Jd 4h 7c]
Seat 1: FRAID358 folded on the Flop
Seat 2: 6ePeMeHHa9 folded before Flop (didn't bet)
Seat 3: Goroshkos88 folded before Flop (didn't bet)
Seat 4: KRZuff (button) folded before Flop (didn't bet)
Seat 5: RoJ1 (small blind) folded before Flop
Seat 6: ermananb93 (big blind) collected ($0.62)



PokerStars Hand #166667786062:  Hold'em No Limit ($0.05/$0.10 USD) - 2017/02/23 16:07:30 ET
Table 'Martha' 6-max Seat #4 is the button
Seat 1: Peter0087 ($10.44 in chips) 
Seat 2: pauli95 ($10.03 in chips) 
Seat 3: Hyd SK ($12.52 in chips) 
Seat 4: dittoro ($10 in chips) 
Seat 5: MihaGr ($10 in chips) 
Seat 6: 8th wonders ($10 in chips) 
MihaGr: posts small blind $0.05
8th wonders: posts big blind $0.10
*** HOLE CARDS ***
Peter0087: folds 
pauli95: folds 
Hyd SK: folds 
dittoro: folds 
MihaGr: folds 
Uncalled bet ($0.05) returned to 8th wonders
8th wonders collected $0.10 from pot
*** SUMMARY ***
Total pot $0.10 | Rake $0 
Seat 1: Peter0087 folded before Flop (didn't bet)
Seat 2: pauli95 folded before Flop (didn't bet)
Seat 3: Hyd SK folded before Flop (didn't bet)
Seat 4: dittoro (button) folded before Flop (didn't bet)
Seat 5: MihaGr (small blind) folded before Flop
Seat 6: 8th wonders (big blind) collected ($0.10)



PokerStars Hand #166667786085:  Hold'em No Limit ($0.05/$0.10 USD) - 2017/02/23 16:07:30 ET
Table 'Iduberga II' 6-max Seat #3 is the button
Seat 1: mhonielsen ($11.06 in chips) 
Seat 2: popypaleta ($12.95 in chips) 
Seat 3: scorpionfish ($11.43 in chips) 
Seat 4: Peter0087 ($9.78 in chips) 
Seat 5: Pokeaster ($11.38 in chips) 
Seat 6: tblocos ($11.19 in chips) 
Peter0087: posts small blind $0.05
Pokeaster: posts big blind $0.10
*** HOLE CARDS ***
tblocos: calls $0.10
mhonielsen: folds 
popypaleta: folds 
scorpionfish: folds 
Peter0087: calls $0.05
Pokeaster: checks 
*** FLOP *** [4d 5s 6c]
Peter0087: checks 
Pokeaster: checks 
tblocos: checks 
*** TURN *** [4d 5s 6c] [3c]
Peter0087: checks 
Pokeaster: bets $0.22
tblocos: folds 
Peter0087: folds 
Uncalled bet ($0.22) returned to Pokeaster
Pokeaster collected $0.29 from pot
*** SUMMARY ***
Total pot $0.30 | Rake $0.01 
Board [4d 5s 6c 3c]
Seat 1: mhonielsen folded before Flop (didn't bet)
Seat 2: popypaleta folded before Flop (didn't bet)
Seat 3: scorpionfish (button) folded before Flop (didn't bet)
Seat 4: Peter0087 (small blind) folded on the Turn
Seat 5: Pokeaster (big blind) collected ($0.29)
Seat 6: tblocos folded on the Turn



PokerStars Hand #166667786142:  Hold'em No Limit ($0.05/$0.10 USD) - 2017/02/23 16:07:30 ET
Table 'Peiroos III' 6-max Seat #6 is the button
Seat 1: tequila_joop ($10 in chips) 
Seat 3: nabatov.m ($6.63 in chips) 
Seat 4: pivanki11 ($10.90 in chips) 
Seat 5: ChuikaPridi ($10.23 in chips) 
Seat 6: CHRO8 ($10.03 in chips) 
tequila_joop: posts small blind $0.05
nabatov.m: posts big blind $0.10
tequila_joop: posts the ante $0.02
nabatov.m: posts the ante $0.02
pivanki11: posts the ante $0.02
ChuikaPridi: posts the ante $0.02
CHRO8: posts the ante $0.02
*** HOLE CARDS ***
pivanki11: folds 
ChuikaPridi: folds 
CHRO8: raises $0.20 to $0.30
tequila_joop: folds 
nabatov.m: calls $0.20
*** FLOP *** [7s 3s 8d]
nabatov.m: checks 
CHRO8: bets $0.36
nabatov.m: folds 
Uncalled bet ($0.36) returned to CHRO8
CHRO8 collected $0.72 from pot
*** SUMMARY ***
Total pot $0.75 | Rake $0.03 
Board [7s 3s 8d]
Seat 1: tequila_joop (small blind) folded before Flop
Seat 3: nabatov.m (big blind) folded on the Flop
Seat 4: pivanki11 folded before Flop (didn't bet)
Seat 5: ChuikaPridi folded before Flop (didn't bet)
Seat 6: CHRO8 (button) collected ($0.72)



PokerStars Hand #166667786202:  Hold'em No Limit ($0.05/$0.10 USD) - 2017/02/23 16:07:30 ET
Table 'Anhui II' 6-max Seat #3 is the button
Seat 1: kingartur222 ($14.01 in chips) 
Seat 2: kikus334 ($12.56 in chips) 
Seat 3: lochniak556 ($25.94 in chips) 
Seat 4: dragonste89 ($10 in chips) 
Seat 5: Bandyaev ($10 in chips) 
Seat 6: .BaRReL.1122 ($4.65 in chips) 
dragonste89: posts small blind $0.05
Bandyaev: posts big blind $0.10
*** HOLE CARDS ***
.BaRReL.1122: raises $0.25 to $0.35
kingartur222: calls $0.35
kikus334: folds 
lochniak556: calls $0.35
dragonste89: folds 
Bandyaev: folds 
*** FLOP *** [8c 7c 3s]
.BaRReL.1122: bets $0.40
kingartur222: calls $0.40
lochniak556: raises $0.80 to $1.20
.BaRReL.1122: folds 
kingartur222: calls $0.80
*** TURN *** [8c 7c 3s] [Ts]
kingartur222: checks 
lochniak556: bets $1.60
kingartur222: calls $1.60
*** RIVER *** [8c 7c 3s Ts] [As]
kingartur222: checks 
lochniak556: checks 
*** SHOW DOWN ***
kingartur222: shows [Tc Kc] (a pair of Tens)
lochniak556: mucks hand 
kingartur222 collected $6.88 from pot
*** SUMMARY ***
Total pot $7.20 | Rake $0.32 
Board [8c 7c 3s Ts As]
Seat 1: kingartur222 showed [Tc Kc] and won ($6.88) with a pair of Tens
Seat 2: kikus334 folded before Flop (didn't bet)
Seat 3: lochniak556 (button) mucked
Seat 4: dragonste89 (small blind) folded before Flop
Seat 5: Bandyaev (big blind) folded before Flop
Seat 6: .BaRReL.1122 folded on the Flop



PokerStars Hand #166667786257:  Hold'em No Limit ($0.05/$0.10 USD) - 2017/02/23 16:07:30 ET
Table 'Serpens' 6-max Seat #4 is the button
Seat 1: Namhkal ($10.30 in chips) 
Seat 2: KA3AXCTAHEU, ($19.63 in chips) 
Seat 3: homelessdan ($29.29 in chips) 
Seat 4: Ragazzi3 ($9.30 in chips) 
Seat 5: XwinX25 ($12.22 in chips) 
Seat 6: Croplayer1 ($10 in chips) 
XwinX25: posts small blind $0.05
Croplayer1: posts big blind $0.10
*** HOLE CARDS ***
Namhkal: folds 
KA3AXCTAHEU,: folds 
homelessdan: folds 
Ragazzi3: folds 
XwinX25: raises $0.15 to $0.25
Croplayer1: calls $0.15
*** FLOP *** [Ac 9d 5h]
XwinX25: checks 
Croplayer1: bets $0.24
XwinX25: folds 
Uncalled bet ($0.24) returned to Croplayer1
Croplayer1 collected $0.48 from pot
*** SUMMARY ***
Total pot $0.50 | Rake $0.02 
Board [Ac 9d 5h]
Seat 1: Namhkal folded before Flop (didn't bet)
Seat 2: KA3AXCTAHEU, folded before Flop (didn't bet)
Seat 3: homelessdan folded before Flop (didn't bet)
Seat 4: Ragazzi3 (button) folded before Flop (didn't bet)
Seat 5: XwinX25 (small blind) folded on the Flop
Seat 6: Croplayer1 (big blind) collected ($0.48)



PokerStars Hand #166667786440:  Hold'em No Limit ($0.05/$0.10 USD) - 2017/02/23 16:07:30 ET
Table 'Luanda' 6-max Seat #5 is the button
Seat 1: AM-L-SL ($4.33 in chips) 
Seat 2: Xander188 ($10.04 in chips) 
Seat 3: DamDatsAnAce ($10.15 in chips) 
Seat 5: st4tion ($13.45 in chips) 
Seat 6: KA3AXCTAHEU, ($11.48 in chips) 
KA3AXCTAHEU,: posts small blind $0.05
AM-L-SL: posts big blind $0.10
*** HOLE CARDS ***
Xander188: folds 
DamDatsAnAce: raises $0.20 to $0.30
st4tion: folds 
KA3AXCTAHEU,: folds 
AM-L-SL: calls $0.20
*** FLOP *** [Th Td Jd]
AM-L-SL: checks 
DamDatsAnAce: bets $0.41
AM-L-SL: calls $0.41
*** TURN *** [Th Td Jd] [5d]
AM-L-SL: checks 
DamDatsAnAce: bets $0.90
AM-L-SL: raises $1.30 to $2.20
DamDatsAnAce: calls $1.30
*** RIVER *** [Th Td Jd 5d] [4d]
AM-L-SL: checks 
DamDatsAnAce: checks 
*** SHOW DOWN ***
AM-L-SL: shows [Tc 8h] (three of a kind, Tens)
DamDatsAnAce: shows [Qh Ts] (three of a kind, Tens - Queen kicker)
DamDatsAnAce collected $5.61 from pot
*** SUMMARY ***
Total pot $5.87 | Rake $0.26 
Board [Th Td Jd 5d 4d]
Seat 1: AM-L-SL (big blind) showed [Tc 8h] and lost with three of a kind, Tens
Seat 2: Xander188 folded before Flop (didn't bet)
Seat 3: DamDatsAnAce showed [Qh Ts] and won ($5.61) with three of a kind, Tens
Seat 5: st4tion (button) folded before Flop (didn't bet)
Seat 6: KA3AXCTAHEU, (small blind) folded before Flop



PokerStars Hand #166667786490:  Hold'em No Limit ($0.05/$0.10 USD) - 2017/02/23 16:07:30 ET
Table 'Clavel' 6-max Seat #6 is the button
Seat 1: KRZuff ($14.56 in chips) 
Seat 2: Namhkal ($10 in chips) 
Seat 4: Dcaro31 ($11.83 in chips) 
Seat 5: Vrinni ($10 in chips) 
Seat 6: Gra_anD77 ($4.84 in chips) 
KRZuff: posts small blind $0.05
Namhkal: posts big blind $0.10
*** HOLE CARDS ***
Dcaro31: folds 
Vrinni: folds 
Gra_anD77: raises $0.10 to $0.20
KRZuff: folds 
Namhkal: folds 
Uncalled bet ($0.10) returned to Gra_anD77
Gra_anD77 collected $0.25 from pot
*** SUMMARY ***
Total pot $0.25 | Rake $0 
Seat 1: KRZuff (small blind) folded before Flop
Seat 2: Namhkal (big blind) folded before Flop
Seat 4: Dcaro31 folded before Flop (didn't bet)
Seat 5: Vrinni folded before Flop (didn't bet)
Seat 6: Gra_anD77 (button) collected ($0.25)



PokerStars Hand #166667786499:  Hold'em No Limit ($0.05/$0.10 USD) - 2017/02/23 16:07:30 ET
Table 'Alnasl II' 6-max Seat #5 is the button
Seat 1: dragonste89 ($14.05 in chips) 
Seat 2: Therodorus ($10.56 in chips) 
Seat 3: ICBM-RS26 ($15.72 in chips) 
Seat 4: Eddys Edge ($10 in chips) 
Seat 5: mdelfin0 ($12.31 in chips) 
Seat 6: Bommer78 ($4.98 in chips) 
Bommer78: posts small blind $0.05
dragonste89: posts big blind $0.10
*** HOLE CARDS ***
Therodorus: folds 
ICBM-RS26: folds 
Eddys Edge: folds 
mdelfin0: raises $0.12 to $0.22
Bommer78: calls $0.17
dragonste89: folds 
*** FLOP *** [Qs 8s Tc]
Bommer78: checks 
mdelfin0: checks 
*** TURN *** [Qs 8s Tc] [Qh]
Bommer78: checks 
mdelfin0: bets $0.24
Bommer78: folds 
Uncalled bet ($0.24) returned to mdelfin0
mdelfin0 collected $0.52 from pot
*** SUMMARY ***
Total pot $0.54 | Rake $0.02 
Board [Qs 8s Tc Qh]
Seat 1: dragonste89 (big blind) folded before Flop
Seat 2: Therodorus folded before Flop (didn't bet)
Seat 3: ICBM-RS26 folded before Flop (didn't bet)
Seat 4: Eddys Edge folded before Flop (didn't bet)
Seat 5: mdelfin0 (button) collected ($0.52)
Seat 6: Bommer78 (small blind) folded on the Turn



PokerStars Hand #166667786999:  Hold'em No Limit ($0.05/$0.10 USD) - 2017/02/23 16:07:31 ET
Table 'Hajek III' 6-max Seat #1 is the button
Seat 1: MBen10 ($10.45 in chips) 
Seat 2: fortieth ($10.09 in chips) 
Seat 3: fedorka rus ($10.61 in chips) 
Seat 4: NvR.m1nD ($13.67 in chips) 
Seat 5: Croplayer1 ($14.75 in chips) 
fortieth: posts small blind $0.05
fedorka rus: posts big blind $0.10
fabadam: sits out 
*** HOLE CARDS ***
NvR.m1nD: folds 
Croplayer1: raises $0.15 to $0.25
MBen10: calls $0.25
fortieth: folds 
fedorka rus: folds 
*** FLOP *** [4s 5c 4h]
Croplayer1: checks 
MBen10: checks 
*** TURN *** [4s 5c 4h] [Qd]
Croplayer1: bets $0.40
MBen10: calls $0.40
*** RIVER *** [4s 5c 4h Qd] [3d]
Croplayer1: checks 
MBen10: bets $0.93
Croplayer1: calls $0.93
*** SHOW DOWN ***
MBen10: shows [Qh Ah] (two pair, Queens and Fours)
Croplayer1: mucks hand 
MBen10 collected $3.16 from pot
*** SUMMARY ***
Total pot $3.31 | Rake $0.15 
Board [4s 5c 4h Qd 3d]
Seat 1: MBen10 (button) showed [Qh Ah] and won ($3.16) with two pair, Queens and Fours
Seat 2: fortieth (small blind) folded before Flop
Seat 3: fedorka rus (big blind) folded before Flop
Seat 4: NvR.m1nD folded before Flop (didn't bet)
Seat 5: Croplayer1 mucked



PokerStars Hand #166667787218:  Hold'em No Limit ($0.05/$0.10 USD) - 2017/02/23 16:07:31 ET
Table 'Emma II' 6-max Seat #3 is the button
Seat 1: LarryTheStar ($10.10 in chips) 
Seat 2: T9MS ($11.64 in chips) 
Seat 3: oddshoff ($9.52 in chips) 
Seat 4: Jucatorul823 ($6.14 in chips) 
Seat 5: Scanner17 ($11.06 in chips) 
Seat 6: CHRO8 ($14.82 in chips) 
Jucatorul823: posts small blind $0.05
Scanner17: posts big blind $0.10
*** HOLE CARDS ***
CHRO8: folds 
LarryTheStar: folds 
T9MS: folds 
oddshoff: raises $0.10 to $0.20
Jucatorul823: calls $0.15
Scanner17: calls $0.10
*** FLOP *** [6d 8s 2s]
Jucatorul823: checks 
Scanner17: checks 
oddshoff: checks 
*** TURN *** [6d 8s 2s] [2c]
Jucatorul823: checks 
Scanner17: checks 
oddshoff: checks 
*** RIVER *** [6d 8s 2s 2c] [4s]
Jucatorul823: checks 
Scanner17: checks 
oddshoff: checks 
*** SHOW DOWN ***
Jucatorul823: shows [As 9d] (a pair of Deuces)
Scanner17: mucks hand 
oddshoff: mucks hand 
Jucatorul823 collected $0.57 from pot
*** SUMMARY ***
Total pot $0.60 | Rake $0.03 
Board [6d 8s 2s 2c 4s]
Seat 1: LarryTheStar folded before Flop (didn't bet)
Seat 2: T9MS folded before Flop (didn't bet)
Seat 3: oddshoff (button) mucked
Seat 4: Jucatorul823 (small blind) showed [As 9d] and won ($0.57) with a pair of Deuces
Seat 5: Scanner17 (big blind) mucked
Seat 6: CHRO8 folded before Flop (didn't bet)



PokerStars Hand #166667787441:  Hold'em No Limit ($0.05/$0.10 USD) - 2017/02/23 16:07:31 ET
Table 'Kanda' 6-max Seat #1 is the button
Seat 1: Andy Wolf ($11.27 in chips) 
Seat 2: Pelotín ($5.47 in chips) 
Seat 3: XaXaTyH4uK ($10 in chips) 
Seat 4: Orlangoor ($10.19 in chips) 
Seat 5: Dimka4 ($10.10 in chips) 
Seat 6: oddshoff ($9.21 in chips) 
Pelotín: posts small blind $0.05
XaXaTyH4uK: posts big blind $0.10
*** HOLE CARDS ***
Orlangoor: folds 
Dimka4: folds 
oddshoff: folds 
Andy Wolf: raises $0.20 to $0.30
Pelotín: folds 
XaXaTyH4uK: folds 
Uncalled bet ($0.20) returned to Andy Wolf
Andy Wolf collected $0.25 from pot
*** SUMMARY ***
Total pot $0.25 | Rake $0 
Seat 1: Andy Wolf (button) collected ($0.25)
Seat 2: Pelotín (small blind) folded before Flop
Seat 3: XaXaTyH4uK (big blind) folded before Flop
Seat 4: Orlangoor folded before Flop (didn't bet)
Seat 5: Dimka4 folded before Flop (didn't bet)
Seat 6: oddshoff folded before Flop (didn't bet)



PokerStars Hand #166667788017:  Hold'em No Limit ($0.05/$0.10 USD) - 2017/02/23 16:07:32 ET
Table 'Armenia' 6-max Seat #4 is the button
Seat 1: tr41n3r12 ($11.67 in chips) 
Seat 2: Yabidooo ($12.09 in chips) 
Seat 4: mbkongstad ($9.60 in chips) 
Seat 6: mega spasser ($6.33 in chips) 
DrVzad will be allowed to play after the button
mega spasser: posts small blind $0.05
tr41n3r12: posts big blind $0.10
JahSoldier69: sits out 
*** HOLE CARDS ***
Yabidooo: raises $0.15 to $0.25
mbkongstad: folds 
JahSoldier69 leaves the table
mega spasser: calls $0.20
tr41n3r12: folds 
*** FLOP *** [6c 4d 3c]
mega spasser: checks 
Yabidooo: bets $0.29
mega spasser: calls $0.29
*** TURN *** [6c 4d 3c] [6h]
mega spasser: checks 
Yabidooo: bets $0.57
Crimsonr joins the table at seat #3 
mega spasser: calls $0.57
*** RIVER *** [6c 4d 3c 6h] [Ac]
mega spasser: checks 
Yabidooo: checks 
*** SHOW DOWN ***
mega spasser: shows [Jd Js] (two pair, Jacks and Sixes)
Yabidooo: mucks hand 
mega spasser collected $2.22 from pot
*** SUMMARY ***
Total pot $2.32 | Rake $0.10 
Board [6c 4d 3c 6h Ac]
Seat 1: tr41n3r12 (big blind) folded before Flop
Seat 2: Yabidooo mucked
Seat 4: mbkongstad (button) folded before Flop (didn't bet)
Seat 6: mega spasser (small blind) showed [Jd Js] and won ($2.22) with two pair, Jacks and Sixes



PokerStars Hand #166667788394:  Hold'em No Limit ($0.05/$0.10 USD) - 2017/02/23 16:07:32 ET
Table 'Virginia II' 6-max Seat #2 is the button
Seat 1: Iarlei ($11.41 in chips) 
Seat 2: Yspenyanin ($10 in chips) 
Seat 3: garigura ($15.78 in chips) 
Seat 4: onkelottoHH ($10.73 in chips) 
Seat 5: dr.goofy ($20.98 in chips) 
Seat 6: NvR.m1nD ($10 in chips) 
garigura: posts small blind $0.05
onkelottoHH: posts big blind $0.10
*** HOLE CARDS ***
dr.goofy: folds 
NvR.m1nD: raises $0.15 to $0.25
Iarlei: folds 
Yspenyanin: folds 
garigura: folds 
onkelottoHH: folds 
Uncalled bet ($0.15) returned to NvR.m1nD
NvR.m1nD collected $0.25 from pot
*** SUMMARY ***
Total pot $0.25 | Rake $0 
Seat 1: Iarlei folded before Flop (didn't bet)
Seat 2: Yspenyanin (button) folded before Flop (didn't bet)
Seat 3: garigura (small blind) folded before Flop
Seat 4: onkelottoHH (big blind) folded before Flop
Seat 5: dr.goofy folded before Flop (didn't bet)
Seat 6: NvR.m1nD collected ($0.25)



PokerStars Hand #166667788507:  Hold'em No Limit ($0.05/$0.10 USD) - 2017/02/23 16:07:32 ET
Table 'Apollonia' 6-max Seat #2 is the button
Seat 1: ex3Lero86 ($10.11 in chips) 
Seat 2: ibara000 ($18.43 in chips) 
Seat 3: steepfell ($10 in chips) 
Seat 4: Goroshkos88 ($17.87 in chips) 
steepfell: posts small blind $0.05
Goroshkos88: posts big blind $0.10
bambolejro is disconnected 
bambolejro has timed out while disconnected
bambolejro: is sitting out 
iluzja12: sits out 
*** HOLE CARDS ***
ex3Lero86: raises $0.15 to $0.25
ibara000: folds 
steepfell: folds 
Goroshkos88: folds 
Uncalled bet ($0.15) returned to ex3Lero86
ex3Lero86 collected $0.25 from pot
*** SUMMARY ***
Total pot $0.25 | Rake $0 
Seat 1: ex3Lero86 collected ($0.25)
Seat 2: ibara000 (button) folded before Flop (didn't bet)
Seat 3: steepfell (small blind) folded before Flop
Seat 4: Goroshkos88 (big blind) folded before Flop



PokerStars Hand #166667788861:  Hold'em No Limit ($0.05/$0.10 USD) - 2017/02/23 16:07:33 ET
Table 'Sirius II' 6-max Seat #5 is the button
Seat 1: Ampped87 ($13.85 in chips) 
Seat 2: Buddy8711 ($8.08 in chips) 
Seat 3: Spud014 ($10.25 in chips) 
Seat 5: pokekrk ($10.37 in chips) 
Seat 6: MihaGr ($10 in chips) 
MihaGr: posts small blind $0.05
Ampped87: posts big blind $0.10
*** HOLE CARDS ***
Buddy8711: folds 
Spud014: folds 
pokekrk: raises $0.10 to $0.20
MihaGr: folds 
Ampped87: raises $0.50 to $0.70
pokekrk: folds 
Uncalled bet ($0.50) returned to Ampped87
Ampped87 collected $0.45 from pot
*** SUMMARY ***
Total pot $0.45 | Rake $0 
Seat 1: Ampped87 (big blind) collected ($0.45)
Seat 2: Buddy8711 folded before Flop (didn't bet)
Seat 3: Spud014 folded before Flop (didn't bet)
Seat 5: pokekrk (button) folded before Flop
Seat 6: MihaGr (small blind) folded before Flop



PokerStars Hand #166667789006:  Hold'em No Limit ($0.05/$0.10 USD) - 2017/02/23 16:07:33 ET
Table 'Isberga' 6-max Seat #6 is the button
Seat 1: Feverhead ($18.37 in chips) 
Seat 2: GESPERIA ($10.12 in chips) 
Seat 4: THIMUCHIN ($10.69 in chips) 
Seat 5: YoungGriff86 ($18.87 in chips) 
Seat 6: Goroshkos88 ($21.38 in chips) 
Feverhead: posts small blind $0.05
GESPERIA: posts big blind $0.10
*** HOLE CARDS ***
THIMUCHIN: folds 
YoungGriff86: folds 
Goroshkos88: raises $0.15 to $0.25
Feverhead: folds 
GESPERIA: calls $0.15
*** FLOP *** [9h Jc 9d]
GESPERIA: checks 
Goroshkos88: bets $0.35
GESPERIA: folds 
Uncalled bet ($0.35) returned to Goroshkos88
Goroshkos88 collected $0.53 from pot
*** SUMMARY ***
Total pot $0.55 | Rake $0.02 
Board [9h Jc 9d]
Seat 1: Feverhead (small blind) folded before Flop
Seat 2: GESPERIA (big blind) folded on the Flop
Seat 4: THIMUCHIN folded before Flop (didn't bet)
Seat 5: YoungGriff86 folded before Flop (didn't bet)
Seat 6: Goroshkos88 (button) collected ($0.53)



PokerStars Hand #166667789020:  Hold'em No Limit ($0.05/$0.10 USD) - 2017/02/23 16:07:33 ET
Table 'Arkab' 6-max Seat #4 is the button
Seat 1: iamkakaroto ($10 in chips) 
Seat 2: aktion4ik ($12.24 in chips) 
Seat 3: sexy_seagull ($10 in chips) 
Seat 4: donkucallme ($24.85 in chips) 
Seat 5: OrionYusupov ($10.08 in chips) 
Seat 6: MihaGr ($10.78 in chips) 
OrionYusupov: posts small blind $0.05
MihaGr: posts big blind $0.10
*** HOLE CARDS ***
iamkakaroto: folds 
aktion4ik: folds 
sexy_seagull: folds 
donkucallme: calls $0.10
OrionYusupov: calls $0.05
MihaGr: checks 
*** FLOP *** [7d Tc 9c]
OrionYusupov: checks 
MihaGr: checks 
donkucallme: checks 
*** TURN *** [7d Tc 9c] [2s]
OrionYusupov: checks 
MihaGr: bets $0.15
donkucallme: calls $0.15
OrionYusupov: calls $0.15
*** RIVER *** [7d Tc 9c 2s] [Td]
OrionYusupov: checks 
MihaGr: bets $0.35
donkucallme: folds 
OrionYusupov: folds 
Uncalled bet ($0.35) returned to MihaGr
MihaGr collected $0.72 from pot
*** SUMMARY ***
Total pot $0.75 | Rake $0.03 
Board [7d Tc 9c 2s Td]
Seat 1: iamkakaroto folded before Flop (didn't bet)
Seat 2: aktion4ik folded before Flop (didn't bet)
Seat 3: sexy_seagull folded before Flop (didn't bet)
Seat 4: donkucallme (button) folded on the River
Seat 5: OrionYusupov (small blind) folded on the River
Seat 6: MihaGr (big blind) collected ($0.72)



PokerStars Hand #166667789465:  Hold'em No Limit ($0.05/$0.10 USD) - 2017/02/23 16:07:33 ET
Table 'Wabash' 6-max Seat #6 is the button
Seat 1: pivanki11 ($10.05 in chips) 
Seat 2: ex3Lero86 ($32.48 in chips) 
Seat 4: Nr847 ($10 in chips) 
Seat 5: popypaleta ($13.89 in chips) 
Seat 6: weez3r ($11.07 in chips) 
pivanki11: posts small blind $0.05
ex3Lero86: posts big blind $0.10
tauronex: sits out 
*** HOLE CARDS ***
Nr847: folds 
popypaleta: folds 
weez3r: folds 
pivanki11: folds 
Uncalled bet ($0.05) returned to ex3Lero86
ex3Lero86 collected $0.10 from pot
*** SUMMARY ***
Total pot $0.10 | Rake $0 
Seat 1: pivanki11 (small blind) folded before Flop
Seat 2: ex3Lero86 (big blind) collected ($0.10)
Seat 4: Nr847 folded before Flop (didn't bet)
Seat 5: popypaleta folded before Flop (didn't bet)
Seat 6: weez3r (button) folded before Flop (didn't bet)



PokerStars Hand #166667789824:  Hold'em No Limit ($0.05/$0.10 USD) - 2017/02/23 16:07:34 ET
Table 'Garlena III' 6-max Seat #2 is the button
Seat 1: dittoro ($10 in chips) 
Seat 2: YY778 ($10.15 in chips) 
Seat 3: IAntikI ($10 in chips) 
Seat 4: mbkongstad ($10.15 in chips) 
Seat 5: steepfell ($10 in chips) 
Seat 6: iluzja12 ($9.85 in chips) 
IAntikI: posts small blind $0.05
mbkongstad: posts big blind $0.10
*** HOLE CARDS ***
steepfell: folds 
iluzja12: folds 
dittoro: folds 
YY778: raises $0.20 to $0.30
IAntikI: folds 
mbkongstad: folds 
Uncalled bet ($0.20) returned to YY778
YY778 collected $0.25 from pot
*** SUMMARY ***
Total pot $0.25 | Rake $0 
Seat 1: dittoro folded before Flop (didn't bet)
Seat 2: YY778 (button) collected ($0.25)
Seat 3: IAntikI (small blind) folded before Flop
Seat 4: mbkongstad (big blind) folded before Flop
Seat 5: steepfell folded before Flop (didn't bet)
Seat 6: iluzja12 folded before Flop (didn't bet)



PokerStars Hand #166667789940:  Hold'em No Limit ($0.05/$0.10 USD) - 2017/02/23 16:07:34 ET
Table 'Aludra II' 6-max Seat #4 is the button
Seat 1: voledy ($10.23 in chips) 
Seat 2: JahSoldier69 ($13.75 in chips) 
Seat 3: mbkongstad ($9.85 in chips) 
Seat 4: MihaGr ($10.59 in chips) 
Seat 5: kingartur222 ($15.77 in chips) 
Seat 6: call me haaa ($14.25 in chips) 
kingartur222: posts small blind $0.05
call me haaa: posts big blind $0.10
*** HOLE CARDS ***
voledy: folds 
JahSoldier69: folds 
mbkongstad: folds 
MihaGr: raises $0.20 to $0.30
kingartur222: folds 
call me haaa: calls $0.20
*** FLOP *** [Ac 7s Kh]
call me haaa: checks 
MihaGr: bets $0.35
call me haaa: calls $0.35
*** TURN *** [Ac 7s Kh] [8h]
call me haaa: checks 
MihaGr: checks 
*** RIVER *** [Ac 7s Kh 8h] [2s]
call me haaa: bets $1.29
MihaGr: folds 
Uncalled bet ($1.29) returned to call me haaa
call me haaa collected $1.29 from pot
*** SUMMARY ***
Total pot $1.35 | Rake $0.06 
Board [Ac 7s Kh 8h 2s]
Seat 1: voledy folded before Flop (didn't bet)
Seat 2: JahSoldier69 folded before Flop (didn't bet)
Seat 3: mbkongstad folded before Flop (didn't bet)
Seat 4: MihaGr (button) folded on the River
Seat 5: kingartur222 (small blind) folded before Flop
Seat 6: call me haaa (big blind) collected ($1.29)



PokerStars Hand #166667789983:  Hold'em No Limit ($0.05/$0.10 USD) - 2017/02/23 16:07:34 ET
Table 'Gaika II' 6-max Seat #1 is the button
Seat 1: Ice_Isayev ($10 in chips) 
Seat 2: steepfell ($10.22 in chips) 
Seat 3: iDecMate ($18.73 in chips) 
Seat 4: Hyd SK ($12.08 in chips) 
Seat 5: KokoulinV ($12.56 in chips) 
Seat 6: bartabs2 ($9.07 in chips) 
steepfell: posts small blind $0.05
iDecMate: posts big blind $0.10
*** HOLE CARDS ***
Hyd SK: folds 
KokoulinV: folds 
bartabs2: folds 
Ice_Isayev: folds 
steepfell: folds 
Uncalled bet ($0.05) returned to iDecMate
iDecMate collected $0.10 from pot
*** SUMMARY ***
Total pot $0.10 | Rake $0 
Seat 1: Ice_Isayev (button) folded before Flop (didn't bet)
Seat 2: steepfell (small blind) folded before Flop
Seat 3: iDecMate (big blind) collected ($0.10)
Seat 4: Hyd SK folded before Flop (didn't bet)
Seat 5: KokoulinV folded before Flop (didn't bet)
Seat 6: bartabs2 folded before Flop (didn't bet)



PokerStars Hand #166667790065:  Hold'em No Limit ($0.05/$0.10 USD) - 2017/02/23 16:07:34 ET
Table 'Jacchia' 6-max Seat #2 is the button
Seat 1: viklundm ($35.73 in chips) 
Seat 2: VAD21 ($20.06 in chips) 
Seat 3: maxiv608 ($10 in chips) 
Seat 4: paterthomas ($9.37 in chips) 
Seat 6: RoJ1 ($12.11 in chips) 
maxiv608: posts small blind $0.05
paterthomas: posts big blind $0.10
arti192837: sits out 
*** HOLE CARDS ***
RoJ1: folds 
viklundm: calls $0.10
VAD21: folds 
maxiv608: calls $0.05
paterthomas: checks 
*** FLOP *** [Jh 3c 9s]
maxiv608: checks 
paterthomas: bets $0.19
viklundm: folds 
maxiv608: folds 
Uncalled bet ($0.19) returned to paterthomas
paterthomas collected $0.29 from pot
*** SUMMARY ***
Total pot $0.30 | Rake $0.01 
Board [Jh 3c 9s]
Seat 1: viklundm folded on the Flop
Seat 2: VAD21 (button) folded before Flop (didn't bet)
Seat 3: maxiv608 (small blind) folded on the Flop
Seat 4: paterthomas (big blind) collected ($0.29)
Seat 6: RoJ1 folded before Flop (didn't bet)



PokerStars Hand #166667790357:  Hold'em No Limit ($0.05/$0.10 USD) - 2017/02/23 16:07:34 ET
Table 'Arpola' 6-max Seat #2 is the button
Seat 1: dincimus ($11.12 in chips) 
Seat 2: patrick19111 ($10 in chips) 
Seat 3: simaryk ($9.75 in chips) 
Seat 4: Orlangoor ($18.95 in chips) 
Seat 5: truck1234 ($11.41 in chips) 
Seat 6: Andrei ProFF ($10.22 in chips) 
simaryk: posts small blind $0.05
Orlangoor: posts big blind $0.10
*** HOLE CARDS ***
truck1234: raises $0.20 to $0.30
Andrei ProFF: folds 
dincimus: folds 
patrick19111: folds 
simaryk: folds 
Orlangoor: folds 
Uncalled bet ($0.20) returned to truck1234
truck1234 collected $0.25 from pot
*** SUMMARY ***
Total pot $0.25 | Rake $0 
Seat 1: dincimus folded before Flop (didn't bet)
Seat 2: patrick19111 (button) folded before Flop (didn't bet)
Seat 3: simaryk (small blind) folded before Flop
Seat 4: Orlangoor (big blind) folded before Flop
Seat 5: truck1234 collected ($0.25)
Seat 6: Andrei ProFF folded before Flop (didn't bet)



PokerStars Hand #166667790576:  Hold'em No Limit ($0.05/$0.10 USD) - 2017/02/23 16:07:34 ET
Table 'Rostia' 6-max Seat #4 is the button
Seat 1: paxit71 ($7.88 in chips) 
Seat 2: david_sara83 ($19.01 in chips) 
Seat 3: iThreeBarrel ($10.15 in chips) 
Seat 4: Hyd SK ($11.68 in chips) 
Seat 5: silsilviu ($7.27 in chips) 
Seat 6: Giyorod ($10.70 in chips) 
silsilviu: posts small blind $0.05
Giyorod: posts big blind $0.10
*** HOLE CARDS ***
paxit71: raises $0.20 to $0.30
david_sara83: folds 
iThreeBarrel: folds 
Hyd SK: folds 
silsilviu: raises $0.60 to $0.90
Giyorod: folds 
paxit71: folds 
Uncalled bet ($0.60) returned to silsilviu
silsilviu collected $0.70 from pot
*** SUMMARY ***
Total pot $0.70 | Rake $0 
Seat 1: paxit71 folded before Flop
Seat 2: david_sara83 folded before Flop (didn't bet)
Seat 3: iThreeBarrel folded before Flop (didn't bet)
Seat 4: Hyd SK (button) folded before Flop (didn't bet)
Seat 5: silsilviu (small blind) collected ($0.70)
Seat 6: Giyorod (big blind) folded before Flop



PokerStars Hand #166667790837:  Hold'em No Limit ($0.05/$0.10 USD) - 2017/02/23 16:07:35 ET
Table 'Heka II' 6-max Seat #4 is the button
Seat 1: Mamm0nism ($15.51 in chips) 
Seat 2: oddshoff ($11.22 in chips) 
Seat 3: MühliJr ($10 in chips) 
Seat 4: theNot0r1ous ($10.63 in chips) 
Seat 5: ArcticBearDK ($12.43 in chips) 
Seat 6: MonteCris92 ($10.51 in chips) 
ArcticBearDK: posts small blind $0.05
MonteCris92: posts big blind $0.10
*** HOLE CARDS ***
Mamm0nism: folds 
oddshoff: folds 
MühliJr: folds 
theNot0r1ous: folds 
ArcticBearDK: raises $0.20 to $0.30
MonteCris92: folds 
Uncalled bet ($0.20) returned to ArcticBearDK
ArcticBearDK collected $0.20 from pot
*** SUMMARY ***
Total pot $0.20 | Rake $0 
Seat 1: Mamm0nism folded before Flop (didn't bet)
Seat 2: oddshoff folded before Flop (didn't bet)
Seat 3: MühliJr folded before Flop (didn't bet)
Seat 4: theNot0r1ous (button) folded before Flop (didn't bet)
Seat 5: ArcticBearDK (small blind) collected ($0.20)
Seat 6: MonteCris92 (big blind) folded before Flop



PokerStars Hand #166667790845:  Hold'em No Limit ($0.05/$0.10 USD) - 2017/02/23 16:07:35 ET
Table 'Eurydome II' 6-max Seat #4 is the button
Seat 1: rusu_rapid ($11.83 in chips) 
Seat 3: gaHy_HaXeP ($12.09 in chips) 
Seat 4: Smitty03300 ($10.32 in chips) 
Seat 5: kush-killa87 ($10.19 in chips) 
Seat 6: Jucatorul823 ($4.77 in chips) 
kush-killa87: posts small blind $0.05
Jucatorul823: posts big blind $0.10
*** HOLE CARDS ***
rusu_rapid: folds 
gaHy_HaXeP: folds 
Smitty03300: folds 
kush-killa87: raises $0.10 to $0.20
Jucatorul823: calls $0.10
*** FLOP *** [5d Tc Ts]
kush-killa87: bets $0.20
Jucatorul823: folds 
Uncalled bet ($0.20) returned to kush-killa87
kush-killa87 collected $0.38 from pot
*** SUMMARY ***
Total pot $0.40 | Rake $0.02 
Board [5d Tc Ts]
Seat 1: rusu_rapid folded before Flop (didn't bet)
Seat 3: gaHy_HaXeP folded before Flop (didn't bet)
Seat 4: Smitty03300 (button) folded before Flop (didn't bet)
Seat 5: kush-killa87 (small blind) collected ($0.38)
Seat 6: Jucatorul823 (big blind) folded on the Flop



PokerStars Hand #166667791044:  Hold'em No Limit ($0.05/$0.10 USD) - 2017/02/23 16:07:35 ET
Table 'Antinous' 6-max Seat #2 is the button
Seat 1: Andrei ProFF ($15.83 in chips) 
Seat 2: Nr847 ($13.60 in chips) 
Seat 3: dittoro ($10.05 in chips) 
Seat 4: Pekaml ($15.42 in chips) 
Seat 5: Covetsoles ($3.62 in chips) 
Seat 6: coolisses111 ($10 in chips) 
dittoro: posts small blind $0.05
Pekaml: posts big blind $0.10
*** HOLE CARDS ***
Covetsoles: folds 
coolisses111: folds 
Andrei ProFF: raises $0.20 to $0.30
Nr847: folds 
dittoro: folds 
Pekaml: folds 
Uncalled bet ($0.20) returned to Andrei ProFF
Andrei ProFF collected $0.25 from pot
*** SUMMARY ***
Total pot $0.25 | Rake $0 
Seat 1: Andrei ProFF collected ($0.25)
Seat 2: Nr847 (button) folded before Flop (didn't bet)
Seat 3: dittoro (small blind) folded before Flop
Seat 4: Pekaml (big blind) folded before Flop
Seat 5: Covetsoles folded before Flop (didn't bet)
Seat 6: coolisses111 folded before Flop (didn't bet)



PokerStars Hand #166667791295:  Hold'em No Limit ($0.05/$0.10 USD) - 2017/02/23 16:07:35 ET
Table 'Stroobantia II' 6-max Seat #6 is the button
Seat 1: XBrosh ($7.74 in chips) 
Seat 2: IAntikI ($10 in chips) 
Seat 3: 8th wonders ($11.19 in chips) 
Seat 5: Zooplack ($12.61 in chips) 
Seat 6: CHRO8 ($12.67 in chips) 
XBrosh: posts small blind $0.05
IAntikI: posts big blind $0.10
Punzzzer: sits out 
*** HOLE CARDS ***
8th wonders: folds 
Zooplack: folds 
CHRO8: raises $0.20 to $0.30
XBrosh: calls $0.25
IAntikI: calls $0.20
*** FLOP *** [4d 8h 5h]
XBrosh: bets $0.10
IAntikI: calls $0.10
CHRO8: calls $0.10
*** TURN *** [4d 8h 5h] [Js]
XBrosh: bets $0.10
IAntikI: calls $0.10
CHRO8: calls $0.10
*** RIVER *** [4d 8h 5h Js] [2d]
XBrosh: bets $1.60
IAntikI: folds 
CHRO8: folds 
Uncalled bet ($1.60) returned to XBrosh
XBrosh collected $1.43 from pot
*** SUMMARY ***
Total pot $1.50 | Rake $0.07 
Board [4d 8h 5h Js 2d]
Seat 1: XBrosh (small blind) collected ($1.43)
Seat 2: IAntikI (big blind) folded on the River
Seat 3: 8th wonders folded before Flop (didn't bet)
Seat 5: Zooplack folded before Flop (didn't bet)
Seat 6: CHRO8 (button) folded on the River



PokerStars Hand #166667791412:  Hold'em No Limit ($0.05/$0.10 USD) - 2017/02/23 16:07:35 ET
Table 'Nerthus II' 6-max Seat #3 is the button
Seat 1: mdelfin0 ($10.77 in chips) 
Seat 2: Hovhannes990 ($9.58 in chips) 
Seat 3: Mamm0nism ($18.71 in chips) 
Seat 4: myevc ($16.33 in chips) 
Seat 5: Hyd SK ($12.15 in chips) 
Seat 6: Lucky HoBBiT ($10 in chips) 
myevc: posts small blind $0.05
Hyd SK: posts big blind $0.10
*** HOLE CARDS ***
Lucky HoBBiT: folds 
mdelfin0: raises $0.20 to $0.30
Hovhannes990: folds 
Mamm0nism: folds 
myevc: folds 
Hyd SK: calls $0.20
*** FLOP *** [Ah 2c 8h]
Hyd SK: checks 
mdelfin0: checks 
*** TURN *** [Ah 2c 8h] [Td]
Hyd SK: bets $0.41
mdelfin0: calls $0.41
*** RIVER *** [Ah 2c 8h Td] [9c]
Hyd SK: bets $0.92
mdelfin0: raises $1.52 to $2.44
Hyd SK: folds 
Uncalled bet ($1.52) returned to mdelfin0
mdelfin0 collected $3.16 from pot
*** SUMMARY ***
Total pot $3.31 | Rake $0.15 
Board [Ah 2c 8h Td 9c]
Seat 1: mdelfin0 collected ($3.16)
Seat 2: Hovhannes990 folded before Flop (didn't bet)
Seat 3: Mamm0nism (button) folded before Flop (didn't bet)
Seat 4: myevc (small blind) folded before Flop
Seat 5: Hyd SK (big blind) folded on the River
Seat 6: Lucky HoBBiT folded before Flop (didn't bet)



PokerStars Hand #166667791665:  Hold'em No Limit ($0.05/$0.10 USD) - 2017/02/23 16:07:36 ET
Table 'Nikko II' 6-max Seat #5 is the button
Seat 1: bdixon_5 ($10.37 in chips) 
Seat 2: popypaleta ($10.10 in chips) 
Seat 3: Hyd SK ($11.66 in chips) 
Seat 4: Peter0087 ($10.31 in chips) 
Seat 5: Aescul@pius ($12.18 in chips) 
Seat 6: JahSoldier69 ($10.05 in chips) 
JahSoldier69: posts small blind $0.05
bdixon_5: posts big blind $0.10
*** HOLE CARDS ***
popypaleta: folds 
Hyd SK: folds 
Peter0087: folds 
Aescul@pius: folds 
JahSoldier69: folds 
Uncalled bet ($0.05) returned to bdixon_5
bdixon_5 collected $0.10 from pot
*** SUMMARY ***
Total pot $0.10 | Rake $0 
Seat 1: bdixon_5 (big blind) collected ($0.10)
Seat 2: popypaleta folded before Flop (didn't bet)
Seat 3: Hyd SK folded before Flop (didn't bet)
Seat 4: Peter0087 folded before Flop (didn't bet)
Seat 5: Aescul@pius (button) folded before Flop (didn't bet)
Seat 6: JahSoldier69 (small blind) folded before Flop



PokerStars Hand #166667791866:  Hold'em No Limit ($0.05/$0.10 USD) - 2017/02/23 16:07:36 ET
Table 'Aisakos II' 6-max Seat #4 is the button
Seat 1: Crafty23@PS ($10.50 in chips) 
Seat 2: svaika24 ($16.83 in chips) 
Seat 3: iamkakaroto ($10.67 in chips) 
Seat 4: T9MS ($10.15 in chips) 
Seat 5: KokoulinV ($11.80 in chips) 
Seat 6: LarryTheStar ($10.23 in chips) 
KokoulinV: posts small blind $0.05
LarryTheStar: posts big blind $0.10
*** HOLE CARDS ***
Crafty23@PS: folds 
svaika24: folds 
iamkakaroto: raises $0.20 to $0.30
T9MS: folds 
KokoulinV: folds 
LarryTheStar: folds 
Uncalled bet ($0.20) returned to iamkakaroto
iamkakaroto collected $0.25 from pot
*** SUMMARY ***
Total pot $0.25 | Rake $0 
Seat 1: Crafty23@PS folded before Flop (didn't bet)
Seat 2: svaika24 folded before Flop (didn't bet)
Seat 3: iamkakaroto collected ($0.25)
Seat 4: T9MS (button) folded before Flop (didn't bet)
Seat 5: KokoulinV (small blind) folded before Flop
Seat 6: LarryTheStar (big blind) folded before Flop



PokerStars Hand #166667791957:  Hold'em No Limit ($0.05/$0.10 USD) - 2017/02/23 16:07:36 ET
Table 'Pandora III' 6-max Seat #1 is the button
Seat 1: Pokeaster ($11.09 in chips) 
Seat 2: garigura ($11.59 in chips) 
Seat 3: Chodemuncher ($10 in chips) 
Seat 4: mhonielsen ($10 in chips) 
Seat 5: MühliJr ($10.42 in chips) 
Seat 6: yodzik ($5 in chips) 
garigura: posts small blind $0.05
Chodemuncher: posts big blind $0.10
*** HOLE CARDS ***
mhonielsen: folds 
MühliJr: raises $0.15 to $0.25
yodzik: folds 
Pokeaster: folds 
garigura: folds 
Chodemuncher: folds 
Uncalled bet ($0.15) returned to MühliJr
MühliJr collected $0.25 from pot
*** SUMMARY ***
Total pot $0.25 | Rake $0 
Seat 1: Pokeaster (button) folded before Flop (didn't bet)
Seat 2: garigura (small blind) folded before Flop
Seat 3: Chodemuncher (big blind) folded before Flop
Seat 4: mhonielsen folded before Flop (didn't bet)
Seat 5: MühliJr collected ($0.25)
Seat 6: yodzik folded before Flop (didn't bet)



PokerStars Hand #166667792010:  Hold'em No Limit ($0.05/$0.10 USD) - 2017/02/23 16:07:36 ET
Table 'Gelria' 6-max Seat #3 is the button
Seat 1: ab260414 ($10.57 in chips) 
Seat 2: fishhook5 ($10.42 in chips) 
Seat 3: Orlangoor ($11.78 in chips) 
Seat 4: eniksenik ($10 in chips) 
Seat 5: apenvel ($8.38 in chips) 
Seat 6: Andrei ProFF ($10.27 in chips) 
eniksenik: posts small blind $0.05
apenvel: posts big blind $0.10
*** HOLE CARDS ***
Andrei ProFF: folds 
ab260414: folds 
fishhook5: raises $0.14 to $0.24
Orlangoor: folds 
eniksenik: folds 
apenvel: folds 
Uncalled bet ($0.14) returned to fishhook5
fishhook5 collected $0.25 from pot
*** SUMMARY ***
Total pot $0.25 | Rake $0 
Seat 1: ab260414 folded before Flop (didn't bet)
Seat 2: fishhook5 collected ($0.25)
Seat 3: Orlangoor (button) folded before Flop (didn't bet)
Seat 4: eniksenik (small blind) folded before Flop
Seat 5: apenvel (big blind) folded before Flop
Seat 6: Andrei ProFF folded before Flop (didn't bet)



PokerStars Hand #166667792153:  Hold'em No Limit ($0.05/$0.10 USD) - 2017/02/23 16:07:36 ET
Table 'Nehalennia III' 6-max Seat #4 is the button
Seat 1: boxer821 ($11.45 in chips) 
Seat 2: fortieth ($10.75 in chips) 
Seat 3: ValdemorS ($18.62 in chips) 
Seat 4: eniksenik ($10 in chips) 
Seat 5: wulffboy ($36.74 in chips) 
Seat 6: valzeny ($20.73 in chips) 
wulffboy: posts small blind $0.05
valzeny: posts big blind $0.10
boxer821: posts the ante $0.02
fortieth: posts the ante $0.02
ValdemorS: posts the ante $0.02
eniksenik: posts the ante $0.02
wulffboy: posts the ante $0.02
valzeny: posts the ante $0.02
*** HOLE CARDS ***
boxer821: folds 
fortieth: folds 
ValdemorS: folds 
eniksenik: folds 
wulffboy: raises $0.20 to $0.30
valzeny: folds 
Uncalled bet ($0.20) returned to wulffboy
wulffboy collected $0.32 from pot
*** SUMMARY ***
Total pot $0.32 | Rake $0 
Seat 1: boxer821 folded before Flop (didn't bet)
Seat 2: fortieth folded before Flop (didn't bet)
Seat 3: ValdemorS folded before Flop (didn't bet)
Seat 4: eniksenik (button) folded before Flop (didn't bet)
Seat 5: wulffboy (small blind) collected ($0.32)
Seat 6: valzeny (big blind) folded before Flop



PokerStars Hand #166667792513:  Hold'em No Limit ($0.05/$0.10 USD) - 2017/02/23 16:07:37 ET
Table 'Crommelin II' 6-max Seat #5 is the button
Seat 1: THIMUCHIN ($11.52 in chips) 
Seat 2: Bird et al ($10.15 in chips) 
Seat 3: Strelok1974 ($19.78 in chips) 
Seat 4: Pequeño Clau ($12.97 in chips) 
Seat 5: Action_Gibi ($19.11 in chips) 
THIMUCHIN: posts small blind $0.05
Bird et al: posts big blind $0.10
*** HOLE CARDS ***
Strelok1974: folds 
Pequeño Clau: folds 
Action_Gibi: calls $0.10
THIMUCHIN: calls $0.05
Bird et al: checks 
*** FLOP *** [Tc 8s Qc]
THIMUCHIN: checks 
Bird et al: checks 
Action_Gibi: bets $0.15
THIMUCHIN: folds 
Bird et al: folds 
Uncalled bet ($0.15) returned to Action_Gibi
Action_Gibi collected $0.29 from pot
*** SUMMARY ***
Total pot $0.30 | Rake $0.01 
Board [Tc 8s Qc]
Seat 1: THIMUCHIN (small blind) folded on the Flop
Seat 2: Bird et al (big blind) folded on the Flop
Seat 3: Strelok1974 folded before Flop (didn't bet)
Seat 4: Pequeño Clau folded before Flop (didn't bet)
Seat 5: Action_Gibi (button) collected ($0.29)



PokerStars Hand #166667792619:  Hold'em No Limit ($0.05/$0.10 USD) - 2017/02/23 16:07:37 ET
Table 'Caprera III' 6-max Seat #1 is the button
Seat 1: Vrinni ($19.29 in chips) 
Seat 2: hg123454321 ($10.77 in chips) 
Seat 5: fedorka rus ($49.23 in chips) 
Seat 6: GESPERIA ($16.89 in chips) 
hg123454321: posts small blind $0.05
fedorka rus: posts big blind $0.10
*** HOLE CARDS ***
GESPERIA: folds 
Vrinni: raises $0.15 to $0.25
hg123454321: folds 
fedorka rus: folds 
Uncalled bet ($0.15) returned to Vrinni
Vrinni collected $0.25 from pot
*** SUMMARY ***
Total pot $0.25 | Rake $0 
Seat 1: Vrinni (button) collected ($0.25)
Seat 2: hg123454321 (small blind) folded before Flop
Seat 5: fedorka rus (big blind) folded before Flop
Seat 6: GESPERIA folded before Flop (didn't bet)



PokerStars Hand #166667792758:  Hold'em No Limit ($0.05/$0.10 USD) - 2017/02/23 16:07:37 ET
Table 'Persephone' 6-max Seat #3 is the button
Seat 1: dragonste89 ($10 in chips) 
Seat 2: AM-L-SL ($5.50 in chips) 
Seat 3: DasoII ($4.64 in chips) 
Seat 4: 2G28 ($10 in chips) 
Seat 5: ab260414 ($10.96 in chips) 
Seat 6: popypaleta ($14.71 in chips) 
2G28: posts small blind $0.05
ab260414: posts big blind $0.10
*** HOLE CARDS ***
popypaleta: folds 
dragonste89: raises $0.25 to $0.35
AM-L-SL: folds 
DasoII: calls $0.35
2G28: folds 
ab260414: calls $0.25
*** FLOP *** [5d 8s 3s]
ab260414: checks 
dragonste89: bets $0.79
DasoII: raises $3.50 to $4.29 and is all-in
ab260414: folds 
dragonste89: calls $3.50
*** TURN *** [5d 8s 3s] [7c]
*** RIVER *** [5d 8s 3s 7c] [4d]
*** SHOW DOWN ***
dragonste89: shows [5s 5h] (three of a kind, Fives)
DasoII: shows [3h 3c] (three of a kind, Threes)
dragonste89 collected $9.24 from pot
*** SUMMARY ***
Total pot $9.68 | Rake $0.44 
Board [5d 8s 3s 7c 4d]
Seat 1: dragonste89 showed [5s 5h] and won ($9.24) with three of a kind, Fives
Seat 2: AM-L-SL folded before Flop (didn't bet)
Seat 3: DasoII (button) showed [3h 3c] and lost with three of a kind, Threes
Seat 4: 2G28 (small blind) folded before Flop
Seat 5: ab260414 (big blind) folded on the Flop
Seat 6: popypaleta folded before Flop (didn't bet)



PokerStars Hand #166667792930:  Hold'em No Limit ($0.05/$0.10 USD) - 2017/02/23 16:07:37 ET
Table 'Union' 6-max Seat #1 is the button
Seat 1: IAntikI ($10 in chips) 
Seat 2: Zooplack ($10 in chips) 
Seat 3: Rodik002 ($12.01 in chips) 
Seat 4: Croplayer1 ($14.95 in chips) 
Seat 5: Chodemuncher ($16 in chips) 
Seat 6: bonyo71 ($4 in chips) 
Zooplack: posts small blind $0.05
Rodik002: posts big blind $0.10
*** HOLE CARDS ***
Croplayer1: folds 
Chodemuncher: raises $0.20 to $0.30
bonyo71: folds 
IAntikI: folds 
Zooplack: folds 
Rodik002: folds 
Uncalled bet ($0.20) returned to Chodemuncher
Chodemuncher collected $0.25 from pot
*** SUMMARY ***
Total pot $0.25 | Rake $0 
Seat 1: IAntikI (button) folded before Flop (didn't bet)
Seat 2: Zooplack (small blind) folded before Flop
Seat 3: Rodik002 (big blind) folded before Flop
Seat 4: Croplayer1 folded before Flop (didn't bet)
Seat 5: Chodemuncher collected ($0.25)
Seat 6: bonyo71 folded before Flop (didn't bet)



PokerStars Hand #166667793260:  Hold'em No Limit ($0.05/$0.10 USD) - 2017/02/23 16:07:37 ET
Table 'Rotraut' 6-max Seat #3 is the button
Seat 2: Newqbrown ($11.75 in chips) 
Seat 3: FlackoD ($12.11 in chips) 
Seat 5: Bird et al ($12.28 in chips) 
Seat 6: KokoulinV ($11.38 in chips) 
Bird et al: posts small blind $0.05
KokoulinV: posts big blind $0.10
Hypermetal: sits out 
*** HOLE CARDS ***
Newqbrown: folds 
FlackoD: raises $0.10 to $0.20
Bird et al: folds 
KokoulinV: folds 
Uncalled bet ($0.10) returned to FlackoD
FlackoD collected $0.25 from pot
*** SUMMARY ***
Total pot $0.25 | Rake $0 
Seat 2: Newqbrown folded before Flop (didn't bet)
Seat 3: FlackoD (button) collected ($0.25)
Seat 5: Bird et al (small blind) folded before Flop
Seat 6: KokoulinV (big blind) folded before Flop



PokerStars Hand #166667793372:  Hold'em No Limit ($0.05/$0.10 USD) - 2017/02/23 16:07:38 ET
Table 'Wingolfia II' 6-max Seat #1 is the button
Seat 1: BahiaMinhaP ($10.17 in chips) 
Seat 2: NvR.m1nD ($10.30 in chips) 
Seat 3: truck1234 ($10.36 in chips) 
Seat 4: zlobslob ($18.02 in chips) 
Seat 5: tr41n3r12 ($11.43 in chips) 
Seat 6: EphemeralBen ($11.99 in chips) 
NvR.m1nD: posts small blind $0.05
truck1234: posts big blind $0.10
*** HOLE CARDS ***
zlobslob: folds 
tr41n3r12: raises $0.20 to $0.30
EphemeralBen: folds 
BahiaMinhaP is connected 
BahiaMinhaP: folds 
NvR.m1nD: folds 
truck1234: folds 
Uncalled bet ($0.20) returned to tr41n3r12
tr41n3r12 collected $0.25 from pot
*** SUMMARY ***
Total pot $0.25 | Rake $0 
Seat 1: BahiaMinhaP (button) folded before Flop (didn't bet)
Seat 2: NvR.m1nD (small blind) folded before Flop
Seat 3: truck1234 (big blind) folded before Flop
Seat 4: zlobslob folded before Flop (didn't bet)
Seat 5: tr41n3r12 collected ($0.25)
Seat 6: EphemeralBen folded before Flop (didn't bet)



PokerStars Hand #166667793588:  Hold'em No Limit ($0.05/$0.10 USD) - 2017/02/23 16:07:38 ET
Table 'Crocus' 6-max Seat #4 is the button
Seat 1: truck1234 ($25.76 in chips) 
Seat 2: garigura ($10.69 in chips) 
Seat 4: patrick19111 ($12.61 in chips) 
Seat 6: Rodik002 ($10.13 in chips) 
Rodik002: posts small blind $0.05
truck1234: posts big blind $0.10
*** HOLE CARDS ***
garigura: folds 
patrick19111: folds 
Rodik002: folds 
Uncalled bet ($0.05) returned to truck1234
truck1234 collected $0.10 from pot
*** SUMMARY ***
Total pot $0.10 | Rake $0 
Seat 1: truck1234 (big blind) collected ($0.10)
Seat 2: garigura folded before Flop (didn't bet)
Seat 4: patrick19111 (button) folded before Flop (didn't bet)
Seat 6: Rodik002 (small blind) folded before Flop



PokerStars Hand #166667793845:  Hold'em No Limit ($0.05/$0.10 USD) - 2017/02/23 16:07:38 ET
Table 'Juliet II' 6-max Seat #4 is the button
Seat 1: alexpolevaja ($12.49 in chips) 
Seat 2: KA3AXCTAHEU, ($15.68 in chips) 
Seat 3: patrick19111 ($11.42 in chips) 
Seat 4: x3ultimate ($10.40 in chips) 
Seat 5: Dcaro31 ($18.72 in chips) 
Seat 6: BookWorm78 ($31.48 in chips) 
Dcaro31: posts small blind $0.05
BookWorm78: posts big blind $0.10
*** HOLE CARDS ***
alexpolevaja: raises $0.10 to $0.20
KA3AXCTAHEU,: folds 
patrick19111: folds 
x3ultimate: folds 
Dcaro31: calls $0.15
BookWorm78: folds 
*** FLOP *** [4d Tc 9h]
Dcaro31: checks 
alexpolevaja: checks 
*** TURN *** [4d Tc 9h] [Qc]
Dcaro31: bets $0.30
alexpolevaja: calls $0.30
*** RIVER *** [4d Tc 9h Qc] [Ad]
Dcaro31: bets $0.70
alexpolevaja: calls $0.70
*** SHOW DOWN ***
Dcaro31: shows [4h 4s] (three of a kind, Fours)
alexpolevaja: mucks hand 
Dcaro31 collected $2.39 from pot
*** SUMMARY ***
Total pot $2.50 | Rake $0.11 
Board [4d Tc 9h Qc Ad]
Seat 1: alexpolevaja mucked
Seat 2: KA3AXCTAHEU, folded before Flop (didn't bet)
Seat 3: patrick19111 folded before Flop (didn't bet)
Seat 4: x3ultimate (button) folded before Flop (didn't bet)
Seat 5: Dcaro31 (small blind) showed [4h 4s] and won ($2.39) with three of a kind, Fours
Seat 6: BookWorm78 (big blind) folded before Flop



PokerStars Hand #166667793956:  Hold'em No Limit ($0.05/$0.10 USD) - 2017/02/23 16:07:38 ET
Table 'Vaisala' 6-max Seat #1 is the button
Seat 1: Pekaml ($10 in chips) 
Seat 2: XaXaTyH4uK ($12.04 in chips) 
Seat 3: x3ultimate ($10.10 in chips) 
Seat 4: sexy_seagull ($10.02 in chips) 
Seat 6: Aleksey K228 ($20.20 in chips) 
XaXaTyH4uK: posts small blind $0.05
x3ultimate: posts big blind $0.10
*** HOLE CARDS ***
sexy_seagull: folds 
Aleksey K228: folds 
AIONCMA1988 leaves the table
Pekaml: raises $0.10 to $0.20
Aleksey K228 leaves the table
XaXaTyH4uK: raises $0.80 to $1
x3ultimate: folds 
Pekaml: folds 
Uncalled bet ($0.80) returned to XaXaTyH4uK
XaXaTyH4uK collected $0.50 from pot
*** SUMMARY ***
Total pot $0.50 | Rake $0 
Seat 1: Pekaml (button) folded before Flop
Seat 2: XaXaTyH4uK (small blind) collected ($0.50)
Seat 3: x3ultimate (big blind) folded before Flop
Seat 4: sexy_seagull folded before Flop (didn't bet)
Seat 6: Aleksey K228 folded before Flop (didn't bet)



PokerStars Hand #166667794045:  Hold'em No Limit ($0.05/$0.10 USD) - 2017/02/23 16:07:38 ET
Table 'Bengt' 6-max Seat #5 is the button
Seat 1: Lucky HoBBiT ($12.50 in chips) 
Seat 2: ChefRocco ($20.21 in chips) 
Seat 3: nantes15 ($13.23 in chips) 
Seat 4: 8th wonders ($10.09 in chips) 
Seat 5: RoJ1 ($10.16 in chips) 
Seat 6: Goroshkos88 ($11.06 in chips) 
Goroshkos88: posts small blind $0.05
Lucky HoBBiT: posts big blind $0.10
*** HOLE CARDS ***
ChefRocco: calls $0.10
nantes15: folds 
8th wonders: raises $0.20 to $0.30
RoJ1: folds 
Goroshkos88: folds 
Lucky HoBBiT: folds 
ChefRocco: calls $0.20
*** FLOP *** [Ac 8c Jc]
ChefRocco: checks 
8th wonders: checks 
*** TURN *** [Ac 8c Jc] [Ad]
ChefRocco: bets $0.30
8th wonders: folds 
Uncalled bet ($0.30) returned to ChefRocco
ChefRocco collected $0.72 from pot
*** SUMMARY ***
Total pot $0.75 | Rake $0.03 
Board [Ac 8c Jc Ad]
Seat 1: Lucky HoBBiT (big blind) folded before Flop
Seat 2: ChefRocco collected ($0.72)
Seat 3: nantes15 folded before Flop (didn't bet)
Seat 4: 8th wonders folded on the Turn
Seat 5: RoJ1 (button) folded before Flop (didn't bet)
Seat 6: Goroshkos88 (small blind) folded before Flop



PokerStars Hand #166667794105:  Hold'em No Limit ($0.05/$0.10 USD) - 2017/02/23 16:07:38 ET
Table 'Esperanto II' 6-max Seat #3 is the button
Seat 1: kurasd ($10.50 in chips) 
Seat 2: MihaGr ($10.55 in chips) 
Seat 3: Namhkal ($11.95 in chips) 
Seat 4: Andrei ProFF ($10.25 in chips) 
Seat 5: FRAID358 ($9.85 in chips) 
Seat 6: ArcticBearDK ($13.28 in chips) 
Andrei ProFF: posts small blind $0.05
FRAID358: posts big blind $0.10
*** HOLE CARDS ***
ArcticBearDK: raises $0.15 to $0.25
kurasd: folds 
MihaGr: calls $0.25
Namhkal: folds 
Andrei ProFF: folds 
FRAID358: folds 
*** FLOP *** [Jc 9d 8s]
ArcticBearDK: bets $0.45
MihaGr: folds 
Uncalled bet ($0.45) returned to ArcticBearDK
ArcticBearDK collected $0.62 from pot
*** SUMMARY ***
Total pot $0.65 | Rake $0.03 
Board [Jc 9d 8s]
Seat 1: kurasd folded before Flop (didn't bet)
Seat 2: MihaGr folded on the Flop
Seat 3: Namhkal (button) folded before Flop (didn't bet)
Seat 4: Andrei ProFF (small blind) folded before Flop
Seat 5: FRAID358 (big blind) folded before Flop
Seat 6: ArcticBearDK collected ($0.62)



PokerStars Hand #166667794416:  Hold'em No Limit ($0.05/$0.10 USD) - 2017/02/23 16:07:39 ET
Table 'Gyldenia II' 6-max Seat #2 is the button
Seat 1: KokoulinV ($10.33 in chips) 
Seat 2: Bandyaev ($10 in chips) 
Seat 5: CHRO8 ($15.52 in chips) 
Seat 6: 8th wonders ($12.83 in chips) 
CHRO8: posts small blind $0.05
8th wonders: posts big blind $0.10
*** HOLE CARDS ***
KokoulinV: raises $0.20 to $0.30
Bandyaev: folds 
D3NyA joins the table at seat #3 
CHRO8: folds 
8th wonders: folds 
Uncalled bet ($0.20) returned to KokoulinV
KokoulinV collected $0.25 from pot
*** SUMMARY ***
Total pot $0.25 | Rake $0 
Seat 1: KokoulinV collected ($0.25)
Seat 2: Bandyaev (button) folded before Flop (didn't bet)
Seat 5: CHRO8 (small blind) folded before Flop
Seat 6: 8th wonders (big blind) folded before Flop



PokerStars Hand #166667794458:  Hold'em No Limit ($0.05/$0.10 USD) - 2017/02/23 16:07:39 ET
Table 'Lehigh' 6-max Seat #2 is the button
Seat 1: kowe4ka565 ($8.06 in chips) 
Seat 2: Sbozzz ($13.22 in chips) 
Seat 3: Therodorus ($12.49 in chips) 
Seat 4: Chodemuncher ($10 in chips) 
Seat 5: Xander188 ($10.32 in chips) 
Seat 6: CallByValue ($10 in chips) 
Therodorus: posts small blind $0.05
Chodemuncher: posts big blind $0.10
*** HOLE CARDS ***
Xander188: folds 
CallByValue: raises $0.20 to $0.30
kowe4ka565: raises $7.76 to $8.06 and is all-in
Sbozzz: folds 
Therodorus: folds 
Chodemuncher: folds 
CallByValue: folds 
Uncalled bet ($7.76) returned to kowe4ka565
kowe4ka565 collected $0.75 from pot
*** SUMMARY ***
Total pot $0.75 | Rake $0 
Seat 1: kowe4ka565 collected ($0.75)
Seat 2: Sbozzz (button) folded before Flop (didn't bet)
Seat 3: Therodorus (small blind) folded before Flop
Seat 4: Chodemuncher (big blind) folded before Flop
Seat 5: Xander188 folded before Flop (didn't bet)
Seat 6: CallByValue folded before Flop



PokerStars Hand #166667794486:  Hold'em No Limit ($0.05/$0.10 USD) - 2017/02/23 16:07:39 ET
Table 'Tomyris II' 6-max Seat #1 is the button
Seat 1: ArcticBearDK ($21.83 in chips) 
Seat 2: Yspenyanin ($12.67 in chips) 
Seat 3: robertsabb ($12.13 in chips) 
Seat 4: Dcaro31 ($10 in chips) 
Seat 5: 6ePeMeHHa9 ($11.80 in chips) 
Seat 6: StackSmakka ($9.89 in chips) 
Yspenyanin: posts small blind $0.05
robertsabb: posts big blind $0.10
*** HOLE CARDS ***
Dcaro31: raises $0.20 to $0.30
6ePeMeHHa9: folds 
StackSmakka: folds 
ArcticBearDK: folds 
Yspenyanin: folds 
robertsabb: folds 
Uncalled bet ($0.20) returned to Dcaro31
Dcaro31 collected $0.25 from pot
*** SUMMARY ***
Total pot $0.25 | Rake $0 
Seat 1: ArcticBearDK (button) folded before Flop (didn't bet)
Seat 2: Yspenyanin (small blind) folded before Flop
Seat 3: robertsabb (big blind) folded before Flop
Seat 4: Dcaro31 collected ($0.25)
Seat 5: 6ePeMeHHa9 folded before Flop (didn't bet)
Seat 6: StackSmakka folded before Flop (didn't bet)



PokerStars Hand #166667794639:  Hold'em No Limit ($0.05/$0.10 USD) - 2017/02/23 16:07:39 ET
Table 'Rosalia' 6-max Seat #5 is the button
Seat 1: Hyd SK ($10 in chips) 
Seat 2: Bandyaev ($11.89 in chips) 
Seat 3: Andy Wolf ($11.98 in chips) 
Seat 4: THIMUCHIN ($10 in chips) 
Seat 5: miron762 ($18.75 in chips) 
Seat 6: facewald ($17.89 in chips) 
facewald: posts small blind $0.05
Hyd SK: posts big blind $0.10
*** HOLE CARDS ***
Bandyaev: raises $0.20 to $0.30
Andy Wolf: folds 
THIMUCHIN: folds 
miron762: raises $0.60 to $0.90
facewald: folds 
Hyd SK: folds 
Bandyaev: calls $0.60
*** FLOP *** [Ts 4c Jc]
Bandyaev: checks 
miron762: bets $1.10
Bandyaev: folds 
Uncalled bet ($1.10) returned to miron762
miron762 collected $1.86 from pot
*** SUMMARY ***
Total pot $1.95 | Rake $0.09 
Board [Ts 4c Jc]
Seat 1: Hyd SK (big blind) folded before Flop
Seat 2: Bandyaev folded on the Flop
Seat 3: Andy Wolf folded before Flop (didn't bet)
Seat 4: THIMUCHIN folded before Flop (didn't bet)
Seat 5: miron762 (button) collected ($1.86)
Seat 6: facewald (small blind) folded before Flop



PokerStars Hand #166667794640:  Hold'em No Limit ($0.05/$0.10 USD) - 2017/02/23 16:07:39 ET
Table 'Pompeja III' 6-max Seat #3 is the button
Seat 1: Iarlei ($11.94 in chips) 
Seat 2: steepfell ($10 in chips) 
Seat 3: Yspenyanin ($12.31 in chips) 
Seat 4: Cluckh ($13.62 in chips) 
Seat 5: Spud014 ($12.37 in chips) 
Seat 6: mega spasser ($4.80 in chips) 
Cluckh: posts small blind $0.05
Spud014: posts big blind $0.10
*** HOLE CARDS ***
mega spasser: folds 
Iarlei: folds 
steepfell: raises $0.15 to $0.25
Yspenyanin: folds 
Cluckh: folds 
Spud014: folds 
Uncalled bet ($0.15) returned to steepfell
steepfell collected $0.25 from pot
*** SUMMARY ***
Total pot $0.25 | Rake $0 
Seat 1: Iarlei folded before Flop (didn't bet)
Seat 2: steepfell collected ($0.25)
Seat 3: Yspenyanin (button) folded before Flop (didn't bet)
Seat 4: Cluckh (small blind) folded before Flop
Seat 5: Spud014 (big blind) folded before Flop
Seat 6: mega spasser folded before Flop (didn't bet)



PokerStars Hand #166667795156:  Hold'em No Limit ($0.05/$0.10 USD) - 2017/02/23 16:07:39 ET
Table 'California II' 6-max Seat #2 is the button
Seat 1: fedorka rus ($10 in chips) 
Seat 2: homelessdan ($10 in chips) 
Seat 3: Bird et al ($10.10 in chips) 
Seat 4: pokekrk ($14.42 in chips) 
Seat 5: Nikolai77798 ($3.90 in chips) 
Seat 6: chiko4040 ($8.56 in chips) 
Bird et al: posts small blind $0.05
pokekrk: posts big blind $0.10
*** HOLE CARDS ***
Nikolai77798: raises $0.10 to $0.20
chiko4040: folds 
fedorka rus: folds 
homelessdan: folds 
Bird et al: folds 
pokekrk: folds 
Uncalled bet ($0.10) returned to Nikolai77798
Nikolai77798 collected $0.25 from pot
*** SUMMARY ***
Total pot $0.25 | Rake $0 
Seat 1: fedorka rus folded before Flop (didn't bet)
Seat 2: homelessdan (button) folded before Flop (didn't bet)
Seat 3: Bird et al (small blind) folded before Flop
Seat 4: pokekrk (big blind) folded before Flop
Seat 5: Nikolai77798 collected ($0.25)
Seat 6: chiko4040 folded before Flop (didn't bet)



PokerStars Hand #166667795262:  Hold'em No Limit ($0.05/$0.10 USD) - 2017/02/23 16:07:40 ET
Table 'Deflotte' 6-max Seat #1 is the button
Seat 1: Zooplack ($16.16 in chips) 
Seat 2: MonteCris92 ($10 in chips) 
Seat 3: Croplayer1 ($10.15 in chips) 
Seat 4: 8th wonders ($10.17 in chips) 
Seat 5: Pokeaster ($11.47 in chips) 
Seat 6: Iarlei ($11.60 in chips) 
MonteCris92: posts small blind $0.05
Croplayer1: posts big blind $0.10
*** HOLE CARDS ***
8th wonders: folds 
Pokeaster: folds 
Iarlei: folds 
Zooplack: folds 
MonteCris92: folds 
Uncalled bet ($0.05) returned to Croplayer1
Croplayer1 collected $0.10 from pot
*** SUMMARY ***
Total pot $0.10 | Rake $0 
Seat 1: Zooplack (button) folded before Flop (didn't bet)
Seat 2: MonteCris92 (small blind) folded before Flop
Seat 3: Croplayer1 (big blind) collected ($0.10)
Seat 4: 8th wonders folded before Flop (didn't bet)
Seat 5: Pokeaster folded before Flop (didn't bet)
Seat 6: Iarlei folded before Flop (didn't bet)



PokerStars Hand #166667795265:  Hold'em No Limit ($0.05/$0.10 USD) - 2017/02/23 16:07:40 ET
Table 'Nymphe II' 6-max Seat #6 is the button
Seat 1: jacktayra ($1.46 in chips) 
Seat 2: Newqbrown ($10.78 in chips) 
Seat 3: THIMUCHIN ($16.61 in chips) 
Seat 4: coolisses111 ($17.30 in chips) 
Seat 5: Yspenyanin ($21.66 in chips) 
Seat 6: Xander188 ($10 in chips) 
jacktayra: posts small blind $0.05
Newqbrown: posts big blind $0.10
*** HOLE CARDS ***
THIMUCHIN: folds 
coolisses111: folds 
Yspenyanin: raises $0.15 to $0.25
Xander188: folds 
jacktayra: calls $0.20
Newqbrown: folds 
*** FLOP *** [2d Js 2h]
jacktayra: bets $0.20
Yspenyanin: calls $0.20
*** TURN *** [2d Js 2h] [2c]
jacktayra: checks 
Yspenyanin: checks 
*** RIVER *** [2d Js 2h 2c] [Qd]
jacktayra: checks 
Yspenyanin: checks 
*** SHOW DOWN ***
jacktayra: shows [4s Ac] (three of a kind, Deuces)
Yspenyanin: shows [Td Tc] (a full house, Deuces full of Tens)
Yspenyanin collected $0.96 from pot
*** SUMMARY ***
Total pot $1 | Rake $0.04 
Board [2d Js 2h 2c Qd]
Seat 1: jacktayra (small blind) showed [4s Ac] and lost with three of a kind, Deuces
Seat 2: Newqbrown (big blind) folded before Flop
Seat 3: THIMUCHIN folded before Flop (didn't bet)
Seat 4: coolisses111 folded before Flop (didn't bet)
Seat 5: Yspenyanin showed [Td Tc] and won ($0.96) with a full house, Deuces full of Tens
Seat 6: Xander188 (button) folded before Flop (didn't bet)



PokerStars Hand #166667795285:  Hold'em No Limit ($0.05/$0.10 USD) - 2017/02/23 16:07:40 ET
Table 'Brambilla II' 6-max Seat #2 is the button
Seat 1: Rodik002 ($12.27 in chips) 
Seat 2: dwonder75 ($15.46 in chips) 
Seat 3: BORIS_ENEV ($13.82 in chips) 
Seat 4: david_sara83 ($11.82 in chips) 
Seat 5: FRAID358 ($10.15 in chips) 
Seat 6: boxer821 ($10 in chips) 
BORIS_ENEV: posts small blind $0.05
david_sara83: posts big blind $0.10
*** HOLE CARDS ***
FRAID358: folds 
boxer821: folds 
Rodik002: folds 
dwonder75: folds 
BORIS_ENEV: calls $0.05
david_sara83: checks 
*** FLOP *** [6s 7s Kc]
BORIS_ENEV: checks 
david_sara83: checks 
*** TURN *** [6s 7s Kc] [As]
BORIS_ENEV: checks 
david_sara83: checks 
*** RIVER *** [6s 7s Kc As] [7d]
BORIS_ENEV: bets $0.50
david_sara83: folds 
Uncalled bet ($0.50) returned to BORIS_ENEV
BORIS_ENEV collected $0.19 from pot
*** SUMMARY ***
Total pot $0.20 | Rake $0.01 
Board [6s 7s Kc As 7d]
Seat 1: Rodik002 folded before Flop (didn't bet)
Seat 2: dwonder75 (button) folded before Flop (didn't bet)
Seat 3: BORIS_ENEV (small blind) collected ($0.19)
Seat 4: david_sara83 (big blind) folded on the River
Seat 5: FRAID358 folded before Flop (didn't bet)
Seat 6: boxer821 folded before Flop (didn't bet)



PokerStars Hand #166667795860:  Hold'em No Limit ($0.05/$0.10 USD) - 2017/02/23 16:07:40 ET
Table 'Cassini' 6-max Seat #4 is the button
Seat 1: Pokeaster ($10.67 in chips) 
Seat 2: mhonielsen ($12.41 in chips) 
Seat 4: fortieth ($13.97 in chips) 
Seat 5: DrVzad ($9.90 in chips) 
Seat 6: MihaGr ($10 in chips) 
DrVzad: posts small blind $0.05
MihaGr: posts big blind $0.10
J1234T: sits out 
*** HOLE CARDS ***
Pokeaster: folds 
mhonielsen: folds 
fortieth: folds 
DrVzad: folds 
Uncalled bet ($0.05) returned to MihaGr
MihaGr collected $0.10 from pot
*** SUMMARY ***
Total pot $0.10 | Rake $0 
Seat 1: Pokeaster folded before Flop (didn't bet)
Seat 2: mhonielsen folded before Flop (didn't bet)
Seat 4: fortieth (button) folded before Flop (didn't bet)
Seat 5: DrVzad (small blind) folded before Flop
Seat 6: MihaGr (big blind) collected ($0.10)



PokerStars Hand #166667796005:  Hold'em No Limit ($0.05/$0.10 USD) - 2017/02/23 16:07:40 ET
Table 'Duhr II' 6-max Seat #5 is the button
Seat 1: Lucky HoBBiT ($10.75 in chips) 
Seat 2: Feverhead ($37.74 in chips) 
Seat 4: CHRO8 ($9.33 in chips) 
Seat 5: Dimka4 ($10.10 in chips) 
Seat 6: townerz1991 ($10.91 in chips) 
townerz1991: posts small blind $0.05
Lucky HoBBiT: posts big blind $0.10
Smitty03300: sits out 
*** HOLE CARDS ***
Feverhead: raises $0.20 to $0.30
CHRO8: folds 
Dimka4: folds 
townerz1991: folds 
Lucky HoBBiT: folds 
Uncalled bet ($0.20) returned to Feverhead
Feverhead collected $0.25 from pot
*** SUMMARY ***
Total pot $0.25 | Rake $0 
Seat 1: Lucky HoBBiT (big blind) folded before Flop
Seat 2: Feverhead collected ($0.25)
Seat 4: CHRO8 folded before Flop (didn't bet)
Seat 5: Dimka4 (button) folded before Flop (didn't bet)
Seat 6: townerz1991 (small blind) folded before Flop



PokerStars Hand #166667796344:  Hold'em No Limit ($0.05/$0.10 USD) - 2017/02/23 16:07:41 ET
Table 'Hyakutake' 6-max Seat #2 is the button
Seat 1: Asilvagoat ($12.32 in chips) 
Seat 2: boxer821 ($10.64 in chips) 
Seat 3: lenboysprite ($5.64 in chips) 
Seat 4: eniksenik ($14.41 in chips) 
Seat 5: RoJ1 ($11.14 in chips) 
Seat 6: maxiv608 ($13.42 in chips) 
lenboysprite: posts small blind $0.05
eniksenik: posts big blind $0.10
*** HOLE CARDS ***
RoJ1: folds 
maxiv608: folds 
Asilvagoat: folds 
boxer821: folds 
lenboysprite: folds 
Uncalled bet ($0.05) returned to eniksenik
eniksenik collected $0.10 from pot
*** SUMMARY ***
Total pot $0.10 | Rake $0 
Seat 1: Asilvagoat folded before Flop (didn't bet)
Seat 2: boxer821 (button) folded before Flop (didn't bet)
Seat 3: lenboysprite (small blind) folded before Flop
Seat 4: eniksenik (big blind) collected ($0.10)
Seat 5: RoJ1 folded before Flop (didn't bet)
Seat 6: maxiv608 folded before Flop (didn't bet)



PokerStars Hand #166667796558:  Hold'em No Limit ($0.05/$0.10 USD) - 2017/02/23 16:07:41 ET
Table 'Bootes' 6-max Seat #3 is the button
Seat 1: Namhkal ($11.25 in chips) 
Seat 2: Bird et al ($19.15 in chips) 
Seat 3: KA3AXCTAHEU, ($19.08 in chips) 
Seat 4: totonove ($6.93 in chips) 
Seat 5: Pekaml ($15.42 in chips) 
Seat 6: cherep61987 ($10.22 in chips) 
totonove: posts small blind $0.05
Pekaml: posts big blind $0.10
*** HOLE CARDS ***
cherep61987: folds 
Namhkal: folds 
Bird et al: folds 
KA3AXCTAHEU,: folds 
totonove: folds 
Uncalled bet ($0.05) returned to Pekaml
Pekaml collected $0.10 from pot
*** SUMMARY ***
Total pot $0.10 | Rake $0 
Seat 1: Namhkal folded before Flop (didn't bet)
Seat 2: Bird et al folded before Flop (didn't bet)
Seat 3: KA3AXCTAHEU, (button) folded before Flop (didn't bet)
Seat 4: totonove (small blind) folded before Flop
Seat 5: Pekaml (big blind) collected ($0.10)
Seat 6: cherep61987 folded before Flop (didn't bet)



PokerStars Hand #166667796891:  Hold'em No Limit ($0.05/$0.10 USD) - 2017/02/23 16:07:41 ET
Table 'Landi II' 6-max Seat #5 is the button
Seat 1: dersiemer ($12.51 in chips) 
Seat 2: Aescul@pius ($10.10 in chips) 
Seat 3: dr.goofy ($21.29 in chips) 
Seat 4: alesi13 ($6.58 in chips) 
Seat 5: Bird et al ($10.25 in chips) 
arti192837 will be allowed to play after the button
dersiemer: posts small blind $0.05
Aescul@pius: posts big blind $0.10
*** HOLE CARDS ***
dr.goofy: folds 
alesi13: raises $0.10 to $0.20
Bird et al: folds 
dersiemer: folds 
Aescul@pius: folds 
Uncalled bet ($0.10) returned to alesi13
alesi13 collected $0.25 from pot
*** SUMMARY ***
Total pot $0.25 | Rake $0 
Seat 1: dersiemer (small blind) folded before Flop
Seat 2: Aescul@pius (big blind) folded before Flop
Seat 3: dr.goofy folded before Flop (didn't bet)
Seat 4: alesi13 collected ($0.25)
Seat 5: Bird et al (button) folded before Flop (didn't bet)



PokerStars Hand #166667797323:  Hold'em No Limit ($0.05/$0.10 USD) - 2017/02/23 16:07:42 ET
Table 'Antielus II' 6-max Seat #4 is the button
Seat 1: Dcaro31 ($18.64 in chips) 
Seat 2: Orlangoor ($10 in chips) 
Seat 3: mcyi3at2 ($13.03 in chips) 
Seat 4: XwinX25 ($10 in chips) 
Seat 5: Hyd SK ($10.79 in chips) 
Seat 6: GiveTwoMe ($11.45 in chips) 
Hyd SK: posts small blind $0.05
GiveTwoMe: posts big blind $0.10
*** HOLE CARDS ***
Dcaro31: folds 
Orlangoor: folds 
mcyi3at2: folds 
XwinX25: raises $0.15 to $0.25
Hyd SK: raises $0.75 to $1
GiveTwoMe: folds 
XwinX25: folds 
Uncalled bet ($0.75) returned to Hyd SK
Hyd SK collected $0.60 from pot
*** SUMMARY ***
Total pot $0.60 | Rake $0 
Seat 1: Dcaro31 folded before Flop (didn't bet)
Seat 2: Orlangoor folded before Flop (didn't bet)
Seat 3: mcyi3at2 folded before Flop (didn't bet)
Seat 4: XwinX25 (button) folded before Flop
Seat 5: Hyd SK (small blind) collected ($0.60)
Seat 6: GiveTwoMe (big blind) folded before Flop



PokerStars Hand #166667797398:  Hold'em No Limit ($0.05/$0.10 USD) - 2017/02/23 16:07:42 ET
Table 'Xanthippe II' 6-max Seat #1 is the button
Seat 1: ade22345 ($4.06 in chips) 
Seat 2: Bird et al ($10.28 in chips) 
Seat 3: Dcaro31 ($10.92 in chips) 
Seat 5: yodzik ($14.90 in chips) 
Seat 6: Orlangoor ($13.03 in chips) 
Bird et al: posts small blind $0.05
Dcaro31: posts big blind $0.10
*** HOLE CARDS ***
yodzik: folds 
Orlangoor: folds 
ade22345: raises $0.90 to $1
Bird et al: folds 
Dcaro31: raises $9.92 to $10.92 and is all-in
ade22345: calls $3.06 and is all-in
Uncalled bet ($6.86) returned to Dcaro31
*** FLOP *** [Ac 3c 4s]
*** TURN *** [Ac 3c 4s] [8h]
*** RIVER *** [Ac 3c 4s 8h] [6h]
*** SHOW DOWN ***
Dcaro31: shows [9d 9s] (a pair of Nines)
ade22345: shows [Tc Js] (high card Ace)
Dcaro31 collected $7.80 from pot
*** SUMMARY ***
Total pot $8.17 | Rake $0.37 
Board [Ac 3c 4s 8h 6h]
Seat 1: ade22345 (button) showed [Tc Js] and lost with high card Ace
Seat 2: Bird et al (small blind) folded before Flop
Seat 3: Dcaro31 (big blind) showed [9d 9s] and won ($7.80) with a pair of Nines
Seat 5: yodzik folded before Flop (didn't bet)
Seat 6: Orlangoor folded before Flop (didn't bet)



PokerStars Hand #166667797432:  Hold'em No Limit ($0.05/$0.10 USD) - 2017/02/23 16:07:42 ET
Table 'Aconcagua' 6-max Seat #2 is the button
Seat 1: MLPlayer16 ($10.63 in chips) 
Seat 2: Kupi007 ($10 in chips) 
Seat 3: burtila1989 ($7.25 in chips) 
Seat 4: pivanki11 ($9.81 in chips) 
Seat 6: coolisses111 ($11.88 in chips) 
burtila1989: posts small blind $0.05
pivanki11: posts big blind $0.10
Andrei ProFF: sits out 
MLPlayer16: posts the ante $0.02
Kupi007: posts the ante $0.02
burtila1989: posts the ante $0.02
pivanki11: posts the ante $0.02
coolisses111: posts the ante $0.02
*** HOLE CARDS ***
coolisses111: folds 
MLPlayer16: raises $0.15 to $0.25
Kupi007: folds 
burtila1989: raises $0.25 to $0.50
pivanki11: folds 
MLPlayer16: calls $0.25
*** FLOP *** [9h 9c Ah]
burtila1989: checks 
MLPlayer16: checks 
*** TURN *** [9h 9c Ah] [3s]
burtila1989: checks 
MLPlayer16: checks 
*** RIVER *** [9h 9c Ah 3s] [6c]
burtila1989: bets $0.30
MLPlayer16: folds 
Uncalled bet ($0.30) returned to burtila1989
burtila1989 collected $1.15 from pot
*** SUMMARY ***
Total pot $1.20 | Rake $0.05 
Board [9h 9c Ah 3s 6c]
Seat 1: MLPlayer16 folded on the River
Seat 2: Kupi007 (button) folded before Flop (didn't bet)
Seat 3: burtila1989 (small blind) collected ($1.15)
Seat 4: pivanki11 (big blind) folded before Flop
Seat 6: coolisses111 folded before Flop (didn't bet)



PokerStars Hand #166667797891:  Hold'em No Limit ($0.05/$0.10 USD) - 2017/02/23 16:07:42 ET
Table 'Lederle' 6-max Seat #5 is the button
Seat 1: Sterjek ($10 in chips) 
Seat 2: truck1234 ($15 in chips) 
Seat 3: Kazacha ($11.20 in chips) 
Seat 4: Pokeaster ($13.76 in chips) 
Seat 5: 8th wonders ($14.18 in chips) 
Seat 6: pokekrk ($10 in chips) 
pokekrk: posts small blind $0.05
Sterjek: posts big blind $0.10
*** HOLE CARDS ***
truck1234: calls $0.10
Kazacha: folds 
Pokeaster: calls $0.10
8th wonders: raises $0.40 to $0.50
pokekrk: folds 
Sterjek: folds 
truck1234: calls $0.40
Pokeaster: folds 
*** FLOP *** [3d 4s 6h]
truck1234: bets $0.70
8th wonders: folds 
Uncalled bet ($0.70) returned to truck1234
truck1234 collected $1.19 from pot
*** SUMMARY ***
Total pot $1.25 | Rake $0.06 
Board [3d 4s 6h]
Seat 1: Sterjek (big blind) folded before Flop
Seat 2: truck1234 collected ($1.19)
Seat 3: Kazacha folded before Flop (didn't bet)
Seat 4: Pokeaster folded before Flop
Seat 5: 8th wonders (button) folded on the Flop
Seat 6: pokekrk (small blind) folded before Flop



PokerStars Hand #166667798321:  Hold'em No Limit ($0.05/$0.10 USD) - 2017/02/23 16:07:43 ET
Table 'Halawe II' 6-max Seat #6 is the button
Seat 1: DIGOR100 ($5.76 in chips) 
Seat 3: cherep61987 ($10.79 in chips) 
Seat 4: voledy ($12.45 in chips) 
Seat 5: takis nik ($12.28 in chips) 
Seat 6: Rodik002 ($21.56 in chips) 
DIGOR100: posts small blind $0.05
cherep61987: posts big blind $0.10
*** HOLE CARDS ***
voledy: raises $0.20 to $0.30
takis nik: folds 
Rodik002: folds 
DIGOR100: raises $0.70 to $1
cherep61987: folds 
voledy: folds 
Uncalled bet ($0.70) returned to DIGOR100
DIGOR100 collected $0.70 from pot
*** SUMMARY ***
Total pot $0.70 | Rake $0 
Seat 1: DIGOR100 (small blind) collected ($0.70)
Seat 3: cherep61987 (big blind) folded before Flop
Seat 4: voledy folded before Flop
Seat 5: takis nik folded before Flop (didn't bet)
Seat 6: Rodik002 (button) folded before Flop (didn't bet)



PokerStars Hand #166667798516:  Hold'em No Limit ($0.05/$0.10 USD) - 2017/02/23 16:07:43 ET
Table 'Cyane' 6-max Seat #4 is the button
Seat 1: KA3AXCTAHEU, ($10.30 in chips) 
Seat 2: sashi18 ($7.86 in chips) 
Seat 3: Mamm0nism ($12.89 in chips) 
Seat 4: truck1234 ($20.66 in chips) 
Seat 5: RoJ1 ($10.32 in chips) 
Seat 6: 8th wonders ($11.60 in chips) 
RoJ1: posts small blind $0.05
8th wonders: posts big blind $0.10
*** HOLE CARDS ***
KA3AXCTAHEU,: folds 
sashi18: folds 
Mamm0nism: raises $0.20 to $0.30
truck1234: raises $0.75 to $1.05
RoJ1: folds 
8th wonders: folds 
Mamm0nism: calls $0.75
*** FLOP *** [2s 4h Kh]
Mamm0nism: checks 
truck1234: bets $1.80
Mamm0nism: calls $1.80
*** TURN *** [2s 4h Kh] [8c]
Mamm0nism: checks 
truck1234: bets $4.50
Mamm0nism: calls $4.50
*** RIVER *** [2s 4h Kh 8c] [Qc]
Mamm0nism: checks 
truck1234: bets $7.09
Mamm0nism: calls $5.54 and is all-in
Uncalled bet ($1.55) returned to truck1234
*** SHOW DOWN ***
truck1234: shows [Qd Kd] (two pair, Kings and Queens)
Mamm0nism: shows [Js Ks] (a pair of Kings)
truck1234 collected $24.76 from pot
*** SUMMARY ***
Total pot $25.93 | Rake $1.17 
Board [2s 4h Kh 8c Qc]
Seat 1: KA3AXCTAHEU, folded before Flop (didn't bet)
Seat 2: sashi18 folded before Flop (didn't bet)
Seat 3: Mamm0nism showed [Js Ks] and lost with a pair of Kings
Seat 4: truck1234 (button) showed [Qd Kd] and won ($24.76) with two pair, Kings and Queens
Seat 5: RoJ1 (small blind) folded before Flop
Seat 6: 8th wonders (big blind) folded before Flop



PokerStars Hand #166667798646:  Hold'em No Limit ($0.05/$0.10 USD) - 2017/02/23 16:07:43 ET
Table 'Ostara III' 6-max Seat #1 is the button
Seat 1: MühliJr ($13.50 in chips) 
Seat 2: Action_Gibi ($6.57 in chips) 
Seat 3: vtalian ($12.98 in chips) 
Seat 6: FlopsterGB ($10 in chips) 
Action_Gibi: posts small blind $0.05
vtalian: posts big blind $0.10
*** HOLE CARDS ***
FlopsterGB: folds 
MühliJr: raises $0.15 to $0.25
Action_Gibi: calls $0.20
vtalian: folds 
*** FLOP *** [Jc 3d 7d]
Action_Gibi: checks 
MühliJr: bets $0.38
Action_Gibi: calls $0.38
*** TURN *** [Jc 3d 7d] [9s]
Action_Gibi: checks 
MühliJr: bets $9.10
Action_Gibi: calls $5.94 and is all-in
Uncalled bet ($3.16) returned to MühliJr
*** RIVER *** [Jc 3d 7d 9s] [7s]
*** SHOW DOWN ***
Action_Gibi: shows [Td 7c] (three of a kind, Sevens)
MühliJr: shows [Qh Qd] (two pair, Queens and Sevens)
Action_Gibi collected $12.64 from pot
*** SUMMARY ***
Total pot $13.24 | Rake $0.60 
Board [Jc 3d 7d 9s 7s]
Seat 1: MühliJr (button) showed [Qh Qd] and lost with two pair, Queens and Sevens
Seat 2: Action_Gibi (small blind) showed [Td 7c] and won ($12.64) with three of a kind, Sevens
Seat 3: vtalian (big blind) folded before Flop
Seat 6: FlopsterGB folded before Flop (didn't bet)



PokerStars Hand #166667798660:  Hold'em No Limit ($0.05/$0.10 USD) - 2017/02/23 16:07:43 ET
Table 'Martha' 6-max Seat #5 is the button
Seat 1: Peter0087 ($10.44 in chips) 
Seat 2: pauli95 ($10.03 in chips) 
Seat 3: Hyd SK ($12.52 in chips) 
Seat 4: dittoro ($10 in chips) 
Seat 5: MihaGr ($10 in chips) 
Seat 6: 8th wonders ($10.05 in chips) 
8th wonders: posts small blind $0.05
Peter0087: posts big blind $0.10
*** HOLE CARDS ***
pauli95: folds 
Hyd SK: folds 
dittoro: folds 
MihaGr: folds 
8th wonders: raises $0.20 to $0.30
Peter0087: folds 
Uncalled bet ($0.20) returned to 8th wonders
8th wonders collected $0.20 from pot
*** SUMMARY ***
Total pot $0.20 | Rake $0 
Seat 1: Peter0087 (big blind) folded before Flop
Seat 2: pauli95 folded before Flop (didn't bet)
Seat 3: Hyd SK folded before Flop (didn't bet)
Seat 4: dittoro folded before Flop (didn't bet)
Seat 5: MihaGr (button) folded before Flop (didn't bet)
Seat 6: 8th wonders (small blind) collected ($0.20)



PokerStars Hand #166667799188:  Hold'em No Limit ($0.05/$0.10 USD) - 2017/02/23 16:07:44 ET
Table 'Oongaq' 6-max Seat #4 is the button
Seat 1: Dmitrij218 ($13.90 in chips) 
Seat 2: homelessdan ($18.40 in chips) 
Seat 3: iDecMate ($10.09 in chips) 
Seat 4: Bird et al ($10 in chips) 
Seat 5: Dizzler1991 ($5.18 in chips) 
Seat 6: boxer821 ($10 in chips) 
Dizzler1991: posts small blind $0.05
boxer821: posts big blind $0.10
*** HOLE CARDS ***
Dmitrij218: calls $0.10
homelessdan: folds 
iDecMate: folds 
Bird et al: folds 
Dizzler1991: folds 
boxer821: checks 
*** FLOP *** [8d Th Ac]
boxer821: checks 
Dmitrij218: bets $0.10
boxer821: folds 
Uncalled bet ($0.10) returned to Dmitrij218
Dmitrij218 collected $0.24 from pot
*** SUMMARY ***
Total pot $0.25 | Rake $0.01 
Board [8d Th Ac]
Seat 1: Dmitrij218 collected ($0.24)
Seat 2: homelessdan folded before Flop (didn't bet)
Seat 3: iDecMate folded before Flop (didn't bet)
Seat 4: Bird et al (button) folded before Flop (didn't bet)
Seat 5: Dizzler1991 (small blind) folded before Flop
Seat 6: boxer821 (big blind) folded on the Flop



PokerStars Hand #166667799446:  Hold'em No Limit ($0.05/$0.10 USD) - 2017/02/23 16:07:44 ET
Table 'Thoas' 6-max Seat #6 is the button
Seat 1: Pekaml ($11.61 in chips) 
Seat 2: themacer24 ($8.52 in chips) 
Seat 3: iamkakaroto ($10 in chips) 
Seat 4: Morris_Chair ($18.52 in chips) 
Seat 5: Kow6oy ($10.17 in chips) 
Seat 6: takis nik ($10 in chips) 
Pekaml: posts small blind $0.05
themacer24: posts big blind $0.10
*** HOLE CARDS ***
iamkakaroto: folds 
Morris_Chair: folds 
Kow6oy: raises $0.20 to $0.30
takis nik: folds 
Pekaml: folds 
themacer24: calls $0.20
*** FLOP *** [8h Kd Qc]
themacer24: checks 
Kow6oy: checks 
*** TURN *** [8h Kd Qc] [Th]
themacer24: bets $0.62
Kow6oy: folds 
Uncalled bet ($0.62) returned to themacer24
themacer24 collected $0.62 from pot
*** SUMMARY ***
Total pot $0.65 | Rake $0.03 
Board [8h Kd Qc Th]
Seat 1: Pekaml (small blind) folded before Flop
Seat 2: themacer24 (big blind) collected ($0.62)
Seat 3: iamkakaroto folded before Flop (didn't bet)
Seat 4: Morris_Chair folded before Flop (didn't bet)
Seat 5: Kow6oy folded on the Turn
Seat 6: takis nik (button) folded before Flop (didn't bet)



PokerStars Hand #166667799695:  Hold'em No Limit ($0.05/$0.10 USD) - 2017/02/23 16:07:44 ET
Table 'Grietje' 6-max Seat #5 is the button
Seat 1: dragonste89 ($10.15 in chips) 
Seat 2: Feverhead ($12.72 in chips) 
Seat 3: GitoValdivia ($3.87 in chips) 
Seat 4: MihaGr ($10.71 in chips) 
Seat 5: iThreeBarrel ($10 in chips) 
Seat 6: Prometheu$8 ($24.07 in chips) 
Prometheu$8: posts small blind $0.05
dragonste89: posts big blind $0.10
*** HOLE CARDS ***
Feverhead: folds 
GitoValdivia: folds 
MihaGr: folds 
iThreeBarrel: folds 
Prometheu$8: raises $0.20 to $0.30
dragonste89: calls $0.20
*** FLOP *** [4s Th Kh]
Prometheu$8: bets $0.57
dragonste89: calls $0.57
*** TURN *** [4s Th Kh] [5h]
Prometheu$8: bets $1.66
dragonste89: calls $1.66
*** RIVER *** [4s Th Kh 5h] [Kd]
Prometheu$8: bets $21.54 and is all-in
dragonste89: folds 
Uncalled bet ($21.54) returned to Prometheu$8
Prometheu$8 collected $4.83 from pot
*** SUMMARY ***
Total pot $5.06 | Rake $0.23 
Board [4s Th Kh 5h Kd]
Seat 1: dragonste89 (big blind) folded on the River
Seat 2: Feverhead folded before Flop (didn't bet)
Seat 3: GitoValdivia folded before Flop (didn't bet)
Seat 4: MihaGr folded before Flop (didn't bet)
Seat 5: iThreeBarrel (button) folded before Flop (didn't bet)
Seat 6: Prometheu$8 (small blind) collected ($4.83)



PokerStars Hand #166667800139:  Hold'em No Limit ($0.05/$0.10 USD) - 2017/02/23 16:07:45 ET
Table 'Arduina' 6-max Seat #3 is the button
Seat 1: tauronex ($10 in chips) 
Seat 2: Andy Wolf ($14.45 in chips) 
Seat 3: Dcaro31 ($12.76 in chips) 
Seat 4: ChuikaPridi ($28.83 in chips) 
Seat 5: ettedallas ($7.51 in chips) 
Seat 6: dierri ($9.86 in chips) 
ChuikaPridi: posts small blind $0.05
ettedallas: posts big blind $0.10
*** HOLE CARDS ***
dierri: raises $0.20 to $0.30
tauronex: calls $0.30
Andy Wolf: folds 
Dcaro31: folds 
ChuikaPridi: folds 
ettedallas: calls $0.20
*** FLOP *** [2c Kd Qc]
ettedallas: checks 
dierri: checks 
tauronex: checks 
*** TURN *** [2c Kd Qc] [8s]
ettedallas: checks 
dierri: checks 
tauronex: bets $0.50
ettedallas: folds 
dierri: calls $0.50
*** RIVER *** [2c Kd Qc 8s] [4h]
dierri: checks 
tauronex: bets $1.10
dierri: folds 
Uncalled bet ($1.10) returned to tauronex
tauronex collected $1.86 from pot
*** SUMMARY ***
Total pot $1.95 | Rake $0.09 
Board [2c Kd Qc 8s 4h]
Seat 1: tauronex collected ($1.86)
Seat 2: Andy Wolf folded before Flop (didn't bet)
Seat 3: Dcaro31 (button) folded before Flop (didn't bet)
Seat 4: ChuikaPridi (small blind) folded before Flop
Seat 5: ettedallas (big blind) folded on the Turn
Seat 6: dierri folded on the River



PokerStars Hand #166667800171:  Hold'em No Limit ($0.05/$0.10 USD) - 2017/02/23 16:07:45 ET
Table 'Jokaste II' 6-max Seat #6 is the button
Seat 1: Hyd SK ($13.45 in chips) 
Seat 2: T9MS ($12.33 in chips) 
Seat 3: crazydevill ($11.33 in chips) 
Seat 4: FRAID358 ($15.21 in chips) 
Seat 5: Vrinni ($10.13 in chips) 
Seat 6: Adailton07 ($14.05 in chips) 
Hyd SK: posts small blind $0.05
T9MS: posts big blind $0.10
*** HOLE CARDS ***
crazydevill: folds 
FRAID358: folds 
Vrinni: folds 
Adailton07: folds 
Hyd SK: raises $0.25 to $0.35
T9MS: folds 
Uncalled bet ($0.25) returned to Hyd SK
Hyd SK collected $0.20 from pot
*** SUMMARY ***
Total pot $0.20 | Rake $0 
Seat 1: Hyd SK (small blind) collected ($0.20)
Seat 2: T9MS (big blind) folded before Flop
Seat 3: crazydevill folded before Flop (didn't bet)
Seat 4: FRAID358 folded before Flop (didn't bet)
Seat 5: Vrinni folded before Flop (didn't bet)
Seat 6: Adailton07 (button) folded before Flop (didn't bet)



PokerStars Hand #166667800172:  Hold'em No Limit ($0.05/$0.10 USD) - 2017/02/23 16:07:45 ET
Table 'Syringa II' 6-max Seat #4 is the button
Seat 1: GiveTwoMe ($15.17 in chips) 
Seat 2: Cluckh ($10.14 in chips) 
Seat 3: gaHy_HaXeP ($10.58 in chips) 
Seat 4: MBen10 ($12.75 in chips) 
Seat 5: Mishapok196 ($7.10 in chips) 
Seat 6: WinninBikini ($10 in chips) 
Mishapok196: posts small blind $0.05
WinninBikini: posts big blind $0.10
*** HOLE CARDS ***
GiveTwoMe: folds 
Cluckh: folds 
gaHy_HaXeP: folds 
MBen10: raises $0.15 to $0.25
Mishapok196: calls $0.20
WinninBikini: folds 
*** FLOP *** [6s Jd Ac]
Mishapok196: checks 
MBen10: bets $0.25
Mishapok196: calls $0.25
*** TURN *** [6s Jd Ac] [9d]
Mishapok196: checks 
MBen10: bets $0.69
Mishapok196: calls $0.69
*** RIVER *** [6s Jd Ac 9d] [9h]
Mishapok196: checks 
MBen10: checks 
*** SHOW DOWN ***
Mishapok196: shows [Qh Td] (a pair of Nines)
MBen10: shows [Ah 7s] (two pair, Aces and Nines)
MBen10 collected $2.37 from pot
*** SUMMARY ***
Total pot $2.48 | Rake $0.11 
Board [6s Jd Ac 9d 9h]
Seat 1: GiveTwoMe folded before Flop (didn't bet)
Seat 2: Cluckh folded before Flop (didn't bet)
Seat 3: gaHy_HaXeP folded before Flop (didn't bet)
Seat 4: MBen10 (button) showed [Ah 7s] and won ($2.37) with two pair, Aces and Nines
Seat 5: Mishapok196 (small blind) showed [Qh Td] and lost with a pair of Nines
Seat 6: WinninBikini (big blind) folded before Flop



PokerStars Hand #166667800286:  Hold'em No Limit ($0.05/$0.10 USD) - 2017/02/23 16:07:45 ET
Table 'Marbachia II' 6-max Seat #3 is the button
Seat 2: Yabidooo ($11.69 in chips) 
Seat 3: MisterX413 ($10.04 in chips) 
Seat 5: MihaGr ($10.05 in chips) 
marianoboni will be allowed to play after the button
MihaGr: posts small blind $0.05
DamDatsAnAce: is sitting out 
AC Evergreen: is sitting out 
Yabidooo: posts big blind $0.10
*** HOLE CARDS ***
DamDatsAnAce leaves the table
AC Evergreen leaves the table
MisterX413: raises $0.20 to $0.30
Andrei ProFF joins the table at seat #6 
MihaGr: folds 
Andrei ProFF leaves the table
Yabidooo: folds 
Uncalled bet ($0.20) returned to MisterX413
MisterX413 collected $0.25 from pot
*** SUMMARY ***
Total pot $0.25 | Rake $0 
Seat 2: Yabidooo (big blind) folded before Flop
Seat 3: MisterX413 (button) collected ($0.25)
Seat 5: MihaGr (small blind) folded before Flop



PokerStars Hand #166667800415:  Hold'em No Limit ($0.05/$0.10 USD) - 2017/02/23 16:07:45 ET
Table 'Atalante' 6-max Seat #2 is the button
Seat 1: OceanBlue100 ($4.94 in chips) 
Seat 2: CiisCi ($20.05 in chips) 
Seat 3: Kow6oy ($10.05 in chips) 
Seat 4: Dcaro31 ($24.17 in chips) 
Seat 5: eniksenik ($10.14 in chips) 
Seat 6: FlopsterGB ($31.19 in chips) 
Kow6oy: posts small blind $0.05
Dcaro31: posts big blind $0.10
*** HOLE CARDS ***
eniksenik: folds 
FlopsterGB: raises $0.20 to $0.30
OceanBlue100: folds 
CiisCi: folds 
Kow6oy: folds 
Dcaro31: calls $0.20
*** FLOP *** [Ac 3d 5c]
Dcaro31: checks 
FlopsterGB: checks 
*** TURN *** [Ac 3d 5c] [8s]
Dcaro31: checks 
FlopsterGB: bets $0.42
Dcaro31: folds 
Uncalled bet ($0.42) returned to FlopsterGB
FlopsterGB collected $0.62 from pot
*** SUMMARY ***
Total pot $0.65 | Rake $0.03 
Board [Ac 3d 5c 8s]
Seat 1: OceanBlue100 folded before Flop (didn't bet)
Seat 2: CiisCi (button) folded before Flop (didn't bet)
Seat 3: Kow6oy (small blind) folded before Flop
Seat 4: Dcaro31 (big blind) folded on the Turn
Seat 5: eniksenik folded before Flop (didn't bet)
Seat 6: FlopsterGB collected ($0.62)



PokerStars Hand #166667800630:  Hold'em No Limit ($0.05/$0.10 USD) - 2017/02/23 16:07:46 ET
Table 'Glarona' 6-max Seat #1 is the button
Seat 1: LarryTheStar ($10.20 in chips) 
Seat 2: BookWorm78 ($10.05 in chips) 
Seat 3: hoedje72 ($3.86 in chips) 
Seat 4: CrippledGod ($7.14 in chips) 
Seat 5: david_sara83 ($10.10 in chips) 
BookWorm78: posts small blind $0.05
hoedje72: posts big blind $0.10
marianoboni: sits out 
*** HOLE CARDS ***
CrippledGod: folds 
david_sara83: folds 
LarryTheStar: folds 
BookWorm78: folds 
Uncalled bet ($0.05) returned to hoedje72
hoedje72 collected $0.10 from pot
*** SUMMARY ***
Total pot $0.10 | Rake $0 
Seat 1: LarryTheStar (button) folded before Flop (didn't bet)
Seat 2: BookWorm78 (small blind) folded before Flop
Seat 3: hoedje72 (big blind) collected ($0.10)
Seat 4: CrippledGod folded before Flop (didn't bet)
Seat 5: david_sara83 folded before Flop (didn't bet)



PokerStars Hand #166667801027:  Hold'em No Limit ($0.05/$0.10 USD) - 2017/02/23 16:07:46 ET
Table 'Tomita II' 6-max Seat #5 is the button
Seat 2: mhonielsen ($10.15 in chips) 
Seat 4: Hyd SK ($11.26 in chips) 
Seat 5: ex3Lero86 ($10.10 in chips) 
Seat 6: saniasmir ($10 in chips) 
saniasmir: posts small blind $0.05
mhonielsen: posts big blind $0.10
D3NyA: sits out 
*** HOLE CARDS ***
Hyd SK: raises $0.25 to $0.35
ex3Lero86: folds 
saniasmir: folds 
mhonielsen: folds 
Uncalled bet ($0.25) returned to Hyd SK
Hyd SK collected $0.25 from pot
*** SUMMARY ***
Total pot $0.25 | Rake $0 
Seat 2: mhonielsen (big blind) folded before Flop
Seat 4: Hyd SK collected ($0.25)
Seat 5: ex3Lero86 (button) folded before Flop (didn't bet)
Seat 6: saniasmir (small blind) folded before Flop



PokerStars Hand #166667801189:  Hold'em No Limit ($0.05/$0.10 USD) - 2017/02/23 16:07:46 ET
Table 'Lampetia III' 6-max Seat #4 is the button
Seat 1: gaHy_HaXeP ($10.55 in chips) 
Seat 2: DamDatsAnAce ($10.32 in chips) 
Seat 3: Kow6oy ($10 in chips) 
Seat 4: IAntikI ($10.60 in chips) 
Seat 5: robson1235 ($20.47 in chips) 
Seat 6: bdixon_5 ($9.20 in chips) 
robson1235: posts small blind $0.05
bdixon_5: posts big blind $0.10
*** HOLE CARDS ***
gaHy_HaXeP: folds 
DamDatsAnAce: folds 
Kow6oy: folds 
IAntikI: folds 
robson1235: folds 
Uncalled bet ($0.05) returned to bdixon_5
bdixon_5 collected $0.10 from pot
*** SUMMARY ***
Total pot $0.10 | Rake $0 
Seat 1: gaHy_HaXeP folded before Flop (didn't bet)
Seat 2: DamDatsAnAce folded before Flop (didn't bet)
Seat 3: Kow6oy folded before Flop (didn't bet)
Seat 4: IAntikI (button) folded before Flop (didn't bet)
Seat 5: robson1235 (small blind) folded before Flop
Seat 6: bdixon_5 (big blind) collected ($0.10)



PokerStars Hand #166667801460:  Hold'em No Limit ($0.05/$0.10 USD) - 2017/02/23 16:07:46 ET
Table 'Virginia II' 6-max Seat #3 is the button
Seat 1: Iarlei ($11.41 in chips) 
Seat 2: Yspenyanin ($10 in chips) 
Seat 3: garigura ($15.73 in chips) 
Seat 4: onkelottoHH ($10.63 in chips) 
Seat 5: dr.goofy ($20.98 in chips) 
Seat 6: NvR.m1nD ($10.15 in chips) 
onkelottoHH: posts small blind $0.05
dr.goofy: posts big blind $0.10
*** HOLE CARDS ***
NvR.m1nD: raises $0.15 to $0.25
Iarlei: folds 
Yspenyanin: folds 
garigura: folds 
onkelottoHH: folds 
dr.goofy: folds 
Uncalled bet ($0.15) returned to NvR.m1nD
NvR.m1nD collected $0.25 from pot
*** SUMMARY ***
Total pot $0.25 | Rake $0 
Seat 1: Iarlei folded before Flop (didn't bet)
Seat 2: Yspenyanin folded before Flop (didn't bet)
Seat 3: garigura (button) folded before Flop (didn't bet)
Seat 4: onkelottoHH (small blind) folded before Flop
Seat 5: dr.goofy (big blind) folded before Flop
Seat 6: NvR.m1nD collected ($0.25)



PokerStars Hand #166667801502:  Hold'em No Limit ($0.05/$0.10 USD) - 2017/02/23 16:07:46 ET
Table 'Wilkens II' 6-max Seat #3 is the button
Seat 1: Islamiq-GuRL ($10.34 in chips) 
Seat 2: manashov ($10.75 in chips) 
Seat 3: Namhkal ($11.45 in chips) 
Seat 4: myevc ($10 in chips) 
Seat 5: patrick19111 ($11.58 in chips) 
Seat 6: XaXaTyH4uK ($14.01 in chips) 
myevc: posts small blind $0.05
patrick19111: posts big blind $0.10
*** HOLE CARDS ***
XaXaTyH4uK: folds 
Islamiq-GuRL: folds 
manashov: folds 
Namhkal: raises $0.10 to $0.20
myevc: folds 
patrick19111: calls $0.10
*** FLOP *** [Jd 7h Kd]
patrick19111: checks 
Namhkal: bets $0.22
patrick19111: folds 
Uncalled bet ($0.22) returned to Namhkal
Namhkal collected $0.43 from pot
*** SUMMARY ***
Total pot $0.45 | Rake $0.02 
Board [Jd 7h Kd]
Seat 1: Islamiq-GuRL folded before Flop (didn't bet)
Seat 2: manashov folded before Flop (didn't bet)
Seat 3: Namhkal (button) collected ($0.43)
Seat 4: myevc (small blind) folded before Flop
Seat 5: patrick19111 (big blind) folded on the Flop
Seat 6: XaXaTyH4uK folded before Flop (didn't bet)



PokerStars Hand #166667801524:  Hold'em No Limit ($0.05/$0.10 USD) - 2017/02/23 16:07:46 ET
Table 'Hestia' 6-max Seat #4 is the button
Seat 2: Kow6oy ($10.32 in chips) 
Seat 3: MBen10 ($12.56 in chips) 
Seat 4: Lucky HoBBiT ($10 in chips) 
Seat 5: CiisCi ($17.41 in chips) 
Seat 6: Smitty03300 ($10 in chips) 
CiisCi: posts small blind $0.05
Smitty03300: posts big blind $0.10
Pekaml: sits out 
*** HOLE CARDS ***
Kow6oy: folds 
MBen10: raises $0.15 to $0.25
Lucky HoBBiT: raises $0.55 to $0.80
CiisCi: folds 
Smitty03300: folds 
MBen10: calls $0.55
*** FLOP *** [Jd 4s Ts]
MBen10: checks 
Lucky HoBBiT: checks 
*** TURN *** [Jd 4s Ts] [As]
MBen10: bets $1.03
Lucky HoBBiT: folds 
Uncalled bet ($1.03) returned to MBen10
MBen10 collected $1.67 from pot
*** SUMMARY ***
Total pot $1.75 | Rake $0.08 
Board [Jd 4s Ts As]
Seat 2: Kow6oy folded before Flop (didn't bet)
Seat 3: MBen10 collected ($1.67)
Seat 4: Lucky HoBBiT (button) folded on the Turn
Seat 5: CiisCi (small blind) folded before Flop
Seat 6: Smitty03300 (big blind) folded before Flop



PokerStars Hand #166667801529:  Hold'em No Limit ($0.05/$0.10 USD) - 2017/02/23 16:07:46 ET
Table 'Huberta II' 6-max Seat #1 is the button
Seat 1: tr41n3r12 ($10 in chips) 
Seat 2: Ice_Isayev ($12.13 in chips) 
Seat 3: patrick19111 ($10 in chips) 
Seat 4: VAD21 ($11.96 in chips) 
Seat 5: Feverhead ($27.80 in chips) 
Seat 6: yodzik ($5.83 in chips) 
Ice_Isayev: posts small blind $0.05
patrick19111: posts big blind $0.10
*** HOLE CARDS ***
VAD21: folds 
Feverhead: folds 
yodzik: folds 
tr41n3r12: folds 
Ice_Isayev: raises $0.15 to $0.25
patrick19111: calls $0.15
*** FLOP *** [Tc Jh Ah]
Ice_Isayev: checks 
patrick19111: checks 
*** TURN *** [Tc Jh Ah] [As]
Ice_Isayev: checks 
patrick19111: bets $0.32
Ice_Isayev: folds 
Uncalled bet ($0.32) returned to patrick19111
patrick19111 collected $0.48 from pot
*** SUMMARY ***
Total pot $0.50 | Rake $0.02 
Board [Tc Jh Ah As]
Seat 1: tr41n3r12 (button) folded before Flop (didn't bet)
Seat 2: Ice_Isayev (small blind) folded on the Turn
Seat 3: patrick19111 (big blind) collected ($0.48)
Seat 4: VAD21 folded before Flop (didn't bet)
Seat 5: Feverhead folded before Flop (didn't bet)
Seat 6: yodzik folded before Flop (didn't bet)



PokerStars Hand #166667801722:  Hold'em No Limit ($0.05/$0.10 USD) - 2017/02/23 16:07:47 ET
Table 'Reginhild' 6-max Seat #3 is the button
Seat 1: iamkakaroto ($11.25 in chips) 
Seat 2: Kow6oy ($10.10 in chips) 
Seat 3: ARCHITECT83 ($8.03 in chips) 
Seat 4: Raymondo21 ($22.28 in chips) 
Seat 5: XCarlos610 ($29.58 in chips) 
Seat 6: eniksenik ($10 in chips) 
Raymondo21: posts small blind $0.05
XCarlos610: posts big blind $0.10
*** HOLE CARDS ***
eniksenik: folds 
iamkakaroto: folds 
Kow6oy: folds 
ARCHITECT83: folds 
Raymondo21: raises $0.10 to $0.20
XCarlos610: folds 
Uncalled bet ($0.10) returned to Raymondo21
Raymondo21 collected $0.20 from pot
*** SUMMARY ***
Total pot $0.20 | Rake $0 
Seat 1: iamkakaroto folded before Flop (didn't bet)
Seat 2: Kow6oy folded before Flop (didn't bet)
Seat 3: ARCHITECT83 (button) folded before Flop (didn't bet)
Seat 4: Raymondo21 (small blind) collected ($0.20)
Seat 5: XCarlos610 (big blind) folded before Flop
Seat 6: eniksenik folded before Flop (didn't bet)



PokerStars Hand #166667801952:  Hold'em No Limit ($0.05/$0.10 USD) - 2017/02/23 16:07:47 ET
Table 'Alnasl' 6-max Seat #4 is the button
Seat 1: KA3AXCTAHEU, ($11.20 in chips) 
Seat 2: saddur ($9.64 in chips) 
Seat 3: david_sara83 ($22.54 in chips) 
Seat 4: oddshoff ($10.18 in chips) 
Seat 5: 6ePeMeHHa9 ($10 in chips) 
Seat 6: Zooplack ($13.58 in chips) 
6ePeMeHHa9: posts small blind $0.05
Zooplack: posts big blind $0.10
*** HOLE CARDS ***
KA3AXCTAHEU,: folds 
saddur: folds 
david_sara83: folds 
oddshoff: folds 
6ePeMeHHa9: folds 
Uncalled bet ($0.05) returned to Zooplack
Zooplack collected $0.10 from pot
*** SUMMARY ***
Total pot $0.10 | Rake $0 
Seat 1: KA3AXCTAHEU, folded before Flop (didn't bet)
Seat 2: saddur folded before Flop (didn't bet)
Seat 3: david_sara83 folded before Flop (didn't bet)
Seat 4: oddshoff (button) folded before Flop (didn't bet)
Seat 5: 6ePeMeHHa9 (small blind) folded before Flop
Seat 6: Zooplack (big blind) collected ($0.10)



PokerStars Hand #166667802161:  Hold'em No Limit ($0.05/$0.10 USD) - 2017/02/23 16:07:47 ET
Table 'Hercynia III' 6-max Seat #2 is the button
Seat 1: Bird et al ($14.63 in chips) 
Seat 2: Action_Gibi ($6.99 in chips) 
Seat 3: Dcaro31 ($20.07 in chips) 
Seat 5: THIMUCHIN ($15.45 in chips) 
Seat 6: bdixon_5 ($11.59 in chips) 
Dcaro31: posts small blind $0.05
THIMUCHIN: posts big blind $0.10
*** HOLE CARDS ***
bdixon_5: folds 
Bird et al: folds 
Action_Gibi: calls $0.10
Dcaro31: folds 
THIMUCHIN: checks 
*** FLOP *** [Jh 9s Tc]
THIMUCHIN: checks 
Action_Gibi: bets $0.12
THIMUCHIN: folds 
Uncalled bet ($0.12) returned to Action_Gibi
Action_Gibi collected $0.24 from pot
*** SUMMARY ***
Total pot $0.25 | Rake $0.01 
Board [Jh 9s Tc]
Seat 1: Bird et al folded before Flop (didn't bet)
Seat 2: Action_Gibi (button) collected ($0.24)
Seat 3: Dcaro31 (small blind) folded before Flop
Seat 5: THIMUCHIN (big blind) folded on the Flop
Seat 6: bdixon_5 folded before Flop (didn't bet)



PokerStars Hand #166667802358:  Hold'em No Limit ($0.05/$0.10 USD) - 2017/02/23 16:07:47 ET
Table 'Caupolican II' 6-max Seat #1 is the button
Seat 1: Strelok1974 ($10 in chips) 
Seat 2: MBen10 ($21.51 in chips) 
Seat 4: GESPERIA ($21.42 in chips) 
Seat 5: ArcticBearDK ($15.45 in chips) 
Seat 6: pancernik21 ($13.15 in chips) 
MBen10: posts small blind $0.05
fedorka rus: is sitting out 
GESPERIA: posts big blind $0.10
*** HOLE CARDS ***
ArcticBearDK: folds 
pancernik21: folds 
Strelok1974: folds 
MBen10: calls $0.05
GESPERIA: checks 
*** FLOP *** [3c Qh 7s]
MBen10: checks 
GESPERIA: checks 
*** TURN *** [3c Qh 7s] [Ks]
MBen10: checks 
GESPERIA: checks 
*** RIVER *** [3c Qh 7s Ks] [Kh]
MBen10: checks 
GESPERIA: checks 
*** SHOW DOWN ***
MBen10: shows [2h 2c] (two pair, Kings and Deuces)
GESPERIA: mucks hand 
MBen10 collected $0.19 from pot
*** SUMMARY ***
Total pot $0.20 | Rake $0.01 
Board [3c Qh 7s Ks Kh]
Seat 1: Strelok1974 (button) folded before Flop (didn't bet)
Seat 2: MBen10 (small blind) showed [2h 2c] and won ($0.19) with two pair, Kings and Deuces
Seat 4: GESPERIA (big blind) mucked
Seat 5: ArcticBearDK folded before Flop (didn't bet)
Seat 6: pancernik21 folded before Flop (didn't bet)



PokerStars Hand #166667802678:  Hold'em No Limit ($0.05/$0.10 USD) - 2017/02/23 16:07:48 ET
Table 'Wabash' 6-max Seat #1 is the button
Seat 1: pivanki11 ($10 in chips) 
Seat 2: ex3Lero86 ($32.53 in chips) 
Seat 3: tauronex ($10 in chips) 
Seat 4: Nr847 ($10 in chips) 
Seat 5: popypaleta ($13.89 in chips) 
Seat 6: weez3r ($11.07 in chips) 
ex3Lero86: posts small blind $0.05
tauronex: posts big blind $0.10
*** HOLE CARDS ***
Nr847: folds 
popypaleta: folds 
weez3r: raises $0.20 to $0.30
pivanki11: folds 
ex3Lero86: folds 
tauronex: folds 
Uncalled bet ($0.20) returned to weez3r
weez3r collected $0.25 from pot
*** SUMMARY ***
Total pot $0.25 | Rake $0 
Seat 1: pivanki11 (button) folded before Flop (didn't bet)
Seat 2: ex3Lero86 (small blind) folded before Flop
Seat 3: tauronex (big blind) folded before Flop
Seat 4: Nr847 folded before Flop (didn't bet)
Seat 5: popypaleta folded before Flop (didn't bet)
Seat 6: weez3r collected ($0.25)



PokerStars Hand #166667802754:  Hold'em No Limit ($0.05/$0.10 USD) - 2017/02/23 16:07:48 ET
Table 'Thia' 6-max Seat #5 is the button
Seat 1: Eddys Edge ($11.02 in chips) 
Seat 2: sugrob86 ($18.29 in chips) 
Seat 3: northug18 ($9.67 in chips) 
Seat 4: Bandyaev ($10.20 in chips) 
Seat 5: ab260414 ($10.84 in chips) 
Seat 6: ex3Lero86 ($15.35 in chips) 
ex3Lero86: posts small blind $0.05
Eddys Edge: posts big blind $0.10
*** HOLE CARDS ***
sugrob86: folds 
northug18: calls $0.10
Bandyaev: calls $0.10
ab260414: folds 
ex3Lero86: raises $0.50 to $0.60
Eddys Edge: folds 
northug18: folds 
Bandyaev: folds 
Uncalled bet ($0.50) returned to ex3Lero86
ex3Lero86 collected $0.40 from pot
*** SUMMARY ***
Total pot $0.40 | Rake $0 
Seat 1: Eddys Edge (big blind) folded before Flop
Seat 2: sugrob86 folded before Flop (didn't bet)
Seat 3: northug18 folded before Flop
Seat 4: Bandyaev folded before Flop
Seat 5: ab260414 (button) folded before Flop (didn't bet)
Seat 6: ex3Lero86 (small blind) collected ($0.40)



PokerStars Hand #166667802836:  Hold'em No Limit ($0.05/$0.10 USD) - 2017/02/23 16:07:48 ET
Table 'Lesath III' 6-max Seat #6 is the button
Seat 1: Gogeta26 ($6.89 in chips) 
Seat 2: WinninBikini ($10.32 in chips) 
Seat 3: Giyorod ($10 in chips) 
Seat 4: Eddys Edge ($10.51 in chips) 
Seat 5: eniksenik ($16.15 in chips) 
Seat 6: patrick19111 ($10.21 in chips) 
Gogeta26: posts small blind $0.05
WinninBikini: posts big blind $0.10
*** HOLE CARDS ***
Giyorod: raises $0.20 to $0.30
Eddys Edge: folds 
eniksenik: calls $0.30
patrick19111: folds 
Gogeta26: calls $0.25
WinninBikini: folds 
*** FLOP *** [Jh 3h Tc]
Gogeta26: checks 
Giyorod: bets $0.62
eniksenik: folds 
Gogeta26: folds 
Uncalled bet ($0.62) returned to Giyorod
Giyorod collected $0.96 from pot
*** SUMMARY ***
Total pot $1 | Rake $0.04 
Board [Jh 3h Tc]
Seat 1: Gogeta26 (small blind) folded on the Flop
Seat 2: WinninBikini (big blind) folded before Flop
Seat 3: Giyorod collected ($0.96)
Seat 4: Eddys Edge folded before Flop (didn't bet)
Seat 5: eniksenik folded on the Flop
Seat 6: patrick19111 (button) folded before Flop (didn't bet)



PokerStars Hand #166667803329:  Hold'em No Limit ($0.05/$0.10 USD) - 2017/02/23 16:07:48 ET
Table 'Gelria' 6-max Seat #4 is the button
Seat 1: ab260414 ($10.57 in chips) 
Seat 2: fishhook5 ($10.57 in chips) 
Seat 3: Orlangoor ($11.78 in chips) 
Seat 4: eniksenik ($10 in chips) 
Seat 5: apenvel ($8.28 in chips) 
apenvel: posts small blind $0.05
Andrei ProFF: is sitting out 
ab260414: posts big blind $0.10
*** HOLE CARDS ***
Andrei ProFF leaves the table
fishhook5: folds 
Orlangoor: folds 
eniksenik: raises $0.20 to $0.30
x3ultimate joins the table at seat #6 
apenvel: folds 
ab260414: folds 
Uncalled bet ($0.20) returned to eniksenik
eniksenik collected $0.25 from pot
*** SUMMARY ***
Total pot $0.25 | Rake $0 
Seat 1: ab260414 (big blind) folded before Flop
Seat 2: fishhook5 folded before Flop (didn't bet)
Seat 3: Orlangoor folded before Flop (didn't bet)
Seat 4: eniksenik (button) collected ($0.25)
Seat 5: apenvel (small blind) folded before Flop



PokerStars Hand #166667803569:  Hold'em No Limit ($0.05/$0.10 USD) - 2017/02/23 16:07:49 ET
Table 'Crocus' 6-max Seat #6 is the button
Seat 1: truck1234 ($25.81 in chips) 
Seat 2: garigura ($10.69 in chips) 
Seat 4: patrick19111 ($12.61 in chips) 
Seat 6: Rodik002 ($10.08 in chips) 
truck1234: posts small blind $0.05
garigura: posts big blind $0.10
*** HOLE CARDS ***
patrick19111: folds 
Rodik002: raises $0.10 to $0.20
truck1234: folds 
garigura: calls $0.10
*** FLOP *** [Jc 2d 9h]
garigura: checks 
Rodik002: bets $0.30
garigura: raises $0.60 to $0.90
Rodik002: folds 
Uncalled bet ($0.60) returned to garigura
garigura collected $1 from pot
*** SUMMARY ***
Total pot $1.05 | Rake $0.05 
Board [Jc 2d 9h]
Seat 1: truck1234 (small blind) folded before Flop
Seat 2: garigura (big blind) collected ($1)
Seat 4: patrick19111 folded before Flop (didn't bet)
Seat 6: Rodik002 (button) folded on the Flop



PokerStars Hand #166667803888:  Hold'em No Limit ($0.05/$0.10 USD) - 2017/02/23 16:07:49 ET
Table 'Nikko II' 6-max Seat #6 is the button
Seat 1: bdixon_5 ($10.42 in chips) 
Seat 2: popypaleta ($10.10 in chips) 
Seat 3: Hyd SK ($11.66 in chips) 
Seat 4: Peter0087 ($10.31 in chips) 
Seat 5: Aescul@pius ($12.18 in chips) 
Seat 6: JahSoldier69 ($10 in chips) 
bdixon_5: posts small blind $0.05
popypaleta: posts big blind $0.10
*** HOLE CARDS ***
Hyd SK: folds 
Peter0087: raises $0.20 to $0.30
Aescul@pius: calls $0.30
JahSoldier69: folds 
bdixon_5: calls $0.25
popypaleta: folds 
*** FLOP *** [6s Ah 4c]
bdixon_5: checks 
Peter0087: checks 
Aescul@pius: checks 
*** TURN *** [6s Ah 4c] [4d]
bdixon_5: bets $0.50
Peter0087: folds 
Aescul@pius: calls $0.50
*** RIVER *** [6s Ah 4c 4d] [6d]
bdixon_5: checks 
Aescul@pius: bets $3.30
bdixon_5: folds 
Uncalled bet ($3.30) returned to Aescul@pius
Aescul@pius collected $1.91 from pot
*** SUMMARY ***
Total pot $2 | Rake $0.09 
Board [6s Ah 4c 4d 6d]
Seat 1: bdixon_5 (small blind) folded on the River
Seat 2: popypaleta (big blind) folded before Flop
Seat 3: Hyd SK folded before Flop (didn't bet)
Seat 4: Peter0087 folded on the Turn
Seat 5: Aescul@pius collected ($1.91)
Seat 6: JahSoldier69 (button) folded before Flop (didn't bet)



PokerStars Hand #166667803931:  Hold'em No Limit ($0.05/$0.10 USD) - 2017/02/23 16:07:49 ET
Table 'Rotraut' 6-max Seat #5 is the button
Seat 1: Hypermetal ($13.29 in chips) 
Seat 2: Newqbrown ($11.75 in chips) 
Seat 3: FlackoD ($12.26 in chips) 
Seat 5: Bird et al ($12.23 in chips) 
Seat 6: KokoulinV ($11.28 in chips) 
KokoulinV: posts small blind $0.05
Hypermetal: posts big blind $0.10
*** HOLE CARDS ***
Newqbrown: folds 
FlackoD: raises $0.10 to $0.20
Bird et al: folds 
KokoulinV: folds 
Hypermetal: folds 
Uncalled bet ($0.10) returned to FlackoD
FlackoD collected $0.25 from pot
*** SUMMARY ***
Total pot $0.25 | Rake $0 
Seat 1: Hypermetal (big blind) folded before Flop
Seat 2: Newqbrown folded before Flop (didn't bet)
Seat 3: FlackoD collected ($0.25)
Seat 5: Bird et al (button) folded before Flop (didn't bet)
Seat 6: KokoulinV (small blind) folded before Flop



PokerStars Hand #166667803935:  Hold'em No Limit ($0.05/$0.10 USD) - 2017/02/23 16:07:49 ET
Table 'Giclas' 6-max Seat #6 is the button
Seat 1: david_sara83 ($10 in chips) 
Seat 2: Crafty23@PS ($10.41 in chips) 
Seat 3: fidas1972 ($6.63 in chips) 
Seat 4: Eddys Edge ($13.94 in chips) 
Seat 5: dedea1989 ($24.97 in chips) 
Seat 6: eniksenik ($14.48 in chips) 
david_sara83: posts small blind $0.05
Crafty23@PS: posts big blind $0.10
*** HOLE CARDS ***
fidas1972: folds 
Eddys Edge: folds 
dedea1989: calls $0.10
eniksenik: folds 
david_sara83: calls $0.05
Crafty23@PS: checks 
*** FLOP *** [Jd 3c Tc]
david_sara83: checks 
Crafty23@PS: checks 
dedea1989: checks 
*** TURN *** [Jd 3c Tc] [4s]
david_sara83: checks 
Crafty23@PS: checks 
dedea1989: checks 
*** RIVER *** [Jd 3c Tc 4s] [Qs]
david_sara83: checks 
Crafty23@PS: checks 
dedea1989: checks 
*** SHOW DOWN ***
david_sara83: shows [Kc 8s] (high card King)
Crafty23@PS: mucks hand 
dedea1989: mucks hand 
david_sara83 collected $0.29 from pot
*** SUMMARY ***
Total pot $0.30 | Rake $0.01 
Board [Jd 3c Tc 4s Qs]
Seat 1: david_sara83 (small blind) showed [Kc 8s] and won ($0.29) with high card King
Seat 2: Crafty23@PS (big blind) mucked
Seat 3: fidas1972 folded before Flop (didn't bet)
Seat 4: Eddys Edge folded before Flop (didn't bet)
Seat 5: dedea1989 mucked
Seat 6: eniksenik (button) folded before Flop (didn't bet)



PokerStars Hand #166667803945:  Hold'em No Limit ($0.05/$0.10 USD) - 2017/02/23 16:07:49 ET
Table 'Gaika' 6-max Seat #5 is the button
Seat 1: oddshoff ($15.53 in chips) 
Seat 2: NvR.m1nD ($22.05 in chips) 
Seat 3: david_sara83 ($10 in chips) 
Seat 4: fortieth ($11.35 in chips) 
Seat 5: fedorka rus ($11.61 in chips) 
Seat 6: dr.goofy ($10 in chips) 
dr.goofy: posts small blind $0.05
oddshoff: posts big blind $0.10
*** HOLE CARDS ***
NvR.m1nD: raises $0.15 to $0.25
david_sara83: folds 
fortieth: folds 
fedorka rus: calls $0.25
dr.goofy: folds 
oddshoff: folds 
*** FLOP *** [4c 8h Td]
NvR.m1nD: checks 
fedorka rus: checks 
*** TURN *** [4c 8h Td] [5s]
NvR.m1nD: bets $0.26
fedorka rus: calls $0.26
*** RIVER *** [4c 8h Td 5s] [5c]
NvR.m1nD: bets $1.40
fedorka rus: folds 
Uncalled bet ($1.40) returned to NvR.m1nD
NvR.m1nD collected $1.12 from pot
*** SUMMARY ***
Total pot $1.17 | Rake $0.05 
Board [4c 8h Td 5s 5c]
Seat 1: oddshoff (big blind) folded before Flop
Seat 2: NvR.m1nD collected ($1.12)
Seat 3: david_sara83 folded before Flop (didn't bet)
Seat 4: fortieth folded before Flop (didn't bet)
Seat 5: fedorka rus (button) folded on the River
Seat 6: dr.goofy (small blind) folded before Flop



PokerStars Hand #166667804113:  Hold'em No Limit ($0.05/$0.10 USD) - 2017/02/23 16:07:49 ET
Table 'Cassini' 6-max Seat #5 is the button
Seat 1: Pokeaster ($10.67 in chips) 
Seat 2: mhonielsen ($12.41 in chips) 
Seat 4: fortieth ($13.97 in chips) 
Seat 5: DrVzad ($9.85 in chips) 
Seat 6: MihaGr ($10.05 in chips) 
MihaGr: posts small blind $0.05
Pokeaster: posts big blind $0.10
J1234T: sits out 
*** HOLE CARDS ***
mhonielsen: folds 
fortieth: folds 
DrVzad: folds 
MihaGr: raises $0.15 to $0.25
Pokeaster: calls $0.15
*** FLOP *** [Kd 2d 5c]
MihaGr: checks 
J1234T is disconnected 
Pokeaster: bets $0.36
MihaGr: calls $0.36
*** TURN *** [Kd 2d 5c] [Td]
MihaGr: checks 
Pokeaster: checks 
*** RIVER *** [Kd 2d 5c Td] [Tc]
MihaGr: checks 
Pokeaster: bets $1.17
MihaGr: folds 
Uncalled bet ($1.17) returned to Pokeaster
Pokeaster collected $1.17 from pot
*** SUMMARY ***
Total pot $1.22 | Rake $0.05 
Board [Kd 2d 5c Td Tc]
Seat 1: Pokeaster (big blind) collected ($1.17)
Seat 2: mhonielsen folded before Flop (didn't bet)
Seat 4: fortieth folded before Flop (didn't bet)
Seat 5: DrVzad (button) folded before Flop (didn't bet)
Seat 6: MihaGr (small blind) folded on the River



PokerStars Hand #166667804326:  Hold'em No Limit ($0.05/$0.10 USD) - 2017/02/23 16:07:49 ET
Table 'Garlena III' 6-max Seat #3 is the button
Seat 1: dittoro ($10 in chips) 
Seat 2: YY778 ($10.30 in chips) 
Seat 3: IAntikI ($10 in chips) 
Seat 4: mbkongstad ($10.05 in chips) 
Seat 5: steepfell ($10 in chips) 
Seat 6: iluzja12 ($9.85 in chips) 
mbkongstad: posts small blind $0.05
steepfell: posts big blind $0.10
*** HOLE CARDS ***
iluzja12: folds 
dittoro: raises $0.20 to $0.30
YY778: calls $0.30
IAntikI: folds 
mbkongstad: folds 
steepfell: calls $0.20
*** FLOP *** [7s Tc 5d]
steepfell: checks 
dittoro: checks 
YY778: bets $0.50
steepfell: calls $0.50
dittoro: calls $0.50
*** TURN *** [7s Tc 5d] [2d]
steepfell: checks 
dittoro: checks 
YY778: checks 
*** RIVER *** [7s Tc 5d 2d] [Kc]
steepfell: checks 
dittoro: bets $1.30
YY778: folds 
steepfell: folds 
Uncalled bet ($1.30) returned to dittoro
dittoro collected $2.34 from pot
*** SUMMARY ***
Total pot $2.45 | Rake $0.11 
Board [7s Tc 5d 2d Kc]
Seat 1: dittoro collected ($2.34)
Seat 2: YY778 folded on the River
Seat 3: IAntikI (button) folded before Flop (didn't bet)
Seat 4: mbkongstad (small blind) folded before Flop
Seat 5: steepfell (big blind) folded on the River
Seat 6: iluzja12 folded before Flop (didn't bet)



PokerStars Hand #166667804483:  Hold'em No Limit ($0.05/$0.10 USD) - 2017/02/23 16:07:50 ET
Table 'Stroobantia' 6-max Seat #2 is the button
Seat 1: mam9zyc ($9.19 in chips) 
Seat 2: XwinX25 ($10 in chips) 
Seat 3: Namhkal ($10.25 in chips) 
Seat 4: Yspenyanin ($10 in chips) 
Seat 5: boxer821 ($10.99 in chips) 
Seat 6: KokoulinV ($15.67 in chips) 
Namhkal: posts small blind $0.05
Yspenyanin: posts big blind $0.10
*** HOLE CARDS ***
boxer821: folds 
KokoulinV: folds 
mam9zyc: folds 
XwinX25: raises $0.15 to $0.25
Namhkal: raises $0.60 to $0.85
Yspenyanin: folds 
XwinX25: folds 
Uncalled bet ($0.60) returned to Namhkal
Namhkal collected $0.60 from pot
*** SUMMARY ***
Total pot $0.60 | Rake $0 
Seat 1: mam9zyc folded before Flop (didn't bet)
Seat 2: XwinX25 (button) folded before Flop
Seat 3: Namhkal (small blind) collected ($0.60)
Seat 4: Yspenyanin (big blind) folded before Flop
Seat 5: boxer821 folded before Flop (didn't bet)
Seat 6: KokoulinV folded before Flop (didn't bet)



PokerStars Hand #166667804697:  Hold'em No Limit ($0.05/$0.10 USD) - 2017/02/23 16:07:50 ET
Table 'Tirela' 6-max Seat #4 is the button
Seat 1: Smitty03300 ($10 in chips) 
Seat 2: Andrei ProFF ($17.34 in chips) 
Seat 3: aim444 ($15.74 in chips) 
Seat 4: ArcticBearDK ($10 in chips) 
Seat 5: KRZuff ($13.22 in chips) 
Seat 6: coolisses111 ($9.95 in chips) 
KRZuff: posts small blind $0.05
coolisses111: posts big blind $0.10
*** HOLE CARDS ***
Smitty03300: folds 
Andrei ProFF: folds 
aim444: folds 
ArcticBearDK: raises $0.17 to $0.27
KRZuff: raises $0.73 to $1
coolisses111: folds 
ArcticBearDK: folds 
Uncalled bet ($0.73) returned to KRZuff
KRZuff collected $0.64 from pot
*** SUMMARY ***
Total pot $0.64 | Rake $0 
Seat 1: Smitty03300 folded before Flop (didn't bet)
Seat 2: Andrei ProFF folded before Flop (didn't bet)
Seat 3: aim444 folded before Flop (didn't bet)
Seat 4: ArcticBearDK (button) folded before Flop
Seat 5: KRZuff (small blind) collected ($0.64)
Seat 6: coolisses111 (big blind) folded before Flop



PokerStars Hand #166667804807:  Hold'em No Limit ($0.05/$0.10 USD) - 2017/02/23 16:07:50 ET
Table 'Lacroute' 6-max Seat #6 is the button
Seat 1: Orlangoor ($10 in chips) 
Seat 2: Andy Wolf ($10 in chips) 
Seat 3: Croplayer1 ($14.45 in chips) 
Seat 4: st4tion ($17.37 in chips) 
Seat 5: steepfell ($10.19 in chips) 
Seat 6: IAntikI ($12.27 in chips) 
Orlangoor: posts small blind $0.05
Andy Wolf: posts big blind $0.10
*** HOLE CARDS ***
Croplayer1: folds 
st4tion: folds 
steepfell: folds 
IAntikI: raises $0.15 to $0.25
Orlangoor: folds 
Andy Wolf: calls $0.15
*** FLOP *** [Kc 3h Qh]
Andy Wolf: checks 
IAntikI: bets $0.35
Andy Wolf: calls $0.35
*** TURN *** [Kc 3h Qh] [Qs]
Andy Wolf: checks 
IAntikI: checks 
*** RIVER *** [Kc 3h Qh Qs] [7c]
Andy Wolf: bets $1.19
IAntikI: folds 
Uncalled bet ($1.19) returned to Andy Wolf
Andy Wolf collected $1.19 from pot
*** SUMMARY ***
Total pot $1.25 | Rake $0.06 
Board [Kc 3h Qh Qs 7c]
Seat 1: Orlangoor (small blind) folded before Flop
Seat 2: Andy Wolf (big blind) collected ($1.19)
Seat 3: Croplayer1 folded before Flop (didn't bet)
Seat 4: st4tion folded before Flop (didn't bet)
Seat 5: steepfell folded before Flop (didn't bet)
Seat 6: IAntikI (button) folded on the River



PokerStars Hand #166667805070:  Hold'em No Limit ($0.05/$0.10 USD) - 2017/02/23 16:07:50 ET
Table 'Aegle' 6-max Seat #4 is the button
Seat 1: phatts76 ($3.60 in chips) 
Seat 2: yodzik ($5 in chips) 
Seat 3: DrejAtom ($12.59 in chips) 
Seat 4: ab260414 ($10.22 in chips) 
Seat 5: KokoulinV ($11.39 in chips) 
Seat 6: CHRO8 ($20.56 in chips) 
KokoulinV: posts small blind $0.05
CHRO8: posts big blind $0.10
*** HOLE CARDS ***
phatts76: folds 
yodzik: raises $0.20 to $0.30
DrejAtom: calls $0.30
ab260414: folds 
KokoulinV: folds 
CHRO8: folds 
*** FLOP *** [6h Ks Jc]
yodzik: checks 
DrejAtom: checks 
*** TURN *** [6h Ks Jc] [3h]
yodzik: checks 
DrejAtom: checks 
*** RIVER *** [6h Ks Jc 3h] [7d]
yodzik: checks 
DrejAtom: checks 
*** SHOW DOWN ***
yodzik: shows [8c 8s] (a pair of Eights)
DrejAtom: mucks hand 
yodzik collected $0.72 from pot
*** SUMMARY ***
Total pot $0.75 | Rake $0.03 
Board [6h Ks Jc 3h 7d]
Seat 1: phatts76 folded before Flop (didn't bet)
Seat 2: yodzik showed [8c 8s] and won ($0.72) with a pair of Eights
Seat 3: DrejAtom mucked
Seat 4: ab260414 (button) folded before Flop (didn't bet)
Seat 5: KokoulinV (small blind) folded before Flop
Seat 6: CHRO8 (big blind) folded before Flop



PokerStars Hand #166667805074:  Hold'em No Limit ($0.05/$0.10 USD) - 2017/02/23 16:07:50 ET
Table 'Bootes' 6-max Seat #4 is the button
Seat 1: Namhkal ($11.25 in chips) 
Seat 2: Bird et al ($19.15 in chips) 
Seat 3: KA3AXCTAHEU, ($19.08 in chips) 
Seat 4: totonove ($6.88 in chips) 
Seat 5: Pekaml ($15.47 in chips) 
Seat 6: cherep61987 ($10.22 in chips) 
Pekaml: posts small blind $0.05
cherep61987: posts big blind $0.10
*** HOLE CARDS ***
Namhkal: folds 
Bird et al: raises $0.21 to $0.31
KA3AXCTAHEU,: calls $0.31
totonove: folds 
Pekaml: folds 
cherep61987: folds 
*** FLOP *** [Js Tc 4h]
Bird et al: checks 
KA3AXCTAHEU,: bets $0.44
Bird et al: calls $0.44
*** TURN *** [Js Tc 4h] [3s]
Bird et al: checks 
KA3AXCTAHEU,: bets $0.94
Bird et al: calls $0.94
*** RIVER *** [Js Tc 4h 3s] [As]
Bird et al: checks 
KA3AXCTAHEU,: checks 
*** SHOW DOWN ***
Bird et al: shows [Jd Qd] (a pair of Jacks)
KA3AXCTAHEU,: shows [Kd Ks] (a pair of Kings)
KA3AXCTAHEU, collected $3.37 from pot
*** SUMMARY ***
Total pot $3.53 | Rake $0.16 
Board [Js Tc 4h 3s As]
Seat 1: Namhkal folded before Flop (didn't bet)
Seat 2: Bird et al showed [Jd Qd] and lost with a pair of Jacks
Seat 3: KA3AXCTAHEU, showed [Kd Ks] and won ($3.37) with a pair of Kings
Seat 4: totonove (button) folded before Flop (didn't bet)
Seat 5: Pekaml (small blind) folded before Flop
Seat 6: cherep61987 (big blind) folded before Flop



PokerStars Hand #166667805079:  Hold'em No Limit ($0.05/$0.10 USD) - 2017/02/23 16:07:50 ET
Table 'Nekkar' 6-max Seat #6 is the button
Seat 2: Bird et al ($10.92 in chips) 
Seat 3: Zemz_Ru ($15.71 in chips) 
Seat 4: kingartur222 ($12.25 in chips) 
Seat 5: Vrinni ($12.19 in chips) 
Seat 6: Eddys Edge ($10.48 in chips) 
Bird et al: posts small blind $0.05
Zemz_Ru: posts big blind $0.10
*** HOLE CARDS ***
kingartur222: folds 
Vrinni: raises $0.15 to $0.25
Eddys Edge: folds 
Bird et al: folds 
Zemz_Ru: folds 
Uncalled bet ($0.15) returned to Vrinni
Vrinni collected $0.25 from pot
*** SUMMARY ***
Total pot $0.25 | Rake $0 
Seat 2: Bird et al (small blind) folded before Flop
Seat 3: Zemz_Ru (big blind) folded before Flop
Seat 4: kingartur222 folded before Flop (didn't bet)
Seat 5: Vrinni collected ($0.25)
Seat 6: Eddys Edge (button) folded before Flop (didn't bet)



PokerStars Hand #166667805127:  Hold'em No Limit ($0.05/$0.10 USD) - 2017/02/23 16:07:50 ET
Table 'Repsolda' 6-max Seat #4 is the button
Seat 1: fabadam ($10.65 in chips) 
Seat 2: MBen10 ($24.67 in chips) 
Seat 3: manashov ($14.82 in chips) 
Seat 4: MihaGr ($10 in chips) 
Seat 6: RkaczoR ($11.26 in chips) 
danky24: is sitting out 
danky24 leaves the table
RkaczoR: posts small blind $0.05
fabadam: posts big blind $0.10
*** HOLE CARDS ***
MBen10: folds 
manashov: raises $0.20 to $0.30
MihaGr: folds 
RkaczoR: folds 
matehouse. joins the table at seat #5 
fabadam: folds 
Uncalled bet ($0.20) returned to manashov
manashov collected $0.25 from pot
*** SUMMARY ***
Total pot $0.25 | Rake $0 
Seat 1: fabadam (big blind) folded before Flop
Seat 2: MBen10 folded before Flop (didn't bet)
Seat 3: manashov collected ($0.25)
Seat 4: MihaGr (button) folded before Flop (didn't bet)
Seat 6: RkaczoR (small blind) folded before Flop



PokerStars Hand #166667805779:  Hold'em No Limit ($0.05/$0.10 USD) - 2017/02/23 16:07:51 ET
Table 'Ebella II' 6-max Seat #4 is the button
Seat 1: gaHy_HaXeP ($10 in chips) 
Seat 2: Therodorus ($10 in chips) 
Seat 3: Torften2 ($17.09 in chips) 
Seat 4: ValdemorS ($11.35 in chips) 
Seat 5: Bird et al ($10.05 in chips) 
Seat 6: Joker51_wtf! ($11.24 in chips) 
Bird et al: posts small blind $0.05
Joker51_wtf!: posts big blind $0.10
*** HOLE CARDS ***
gaHy_HaXeP: folds 
Therodorus: folds 
Torften2: folds 
ValdemorS: folds 
Bird et al: folds 
Uncalled bet ($0.05) returned to Joker51_wtf!
Joker51_wtf! collected $0.10 from pot
*** SUMMARY ***
Total pot $0.10 | Rake $0 
Seat 1: gaHy_HaXeP folded before Flop (didn't bet)
Seat 2: Therodorus folded before Flop (didn't bet)
Seat 3: Torften2 folded before Flop (didn't bet)
Seat 4: ValdemorS (button) folded before Flop (didn't bet)
Seat 5: Bird et al (small blind) folded before Flop
Seat 6: Joker51_wtf! (big blind) collected ($0.10)



PokerStars Hand #166667805882:  Hold'em No Limit ($0.05/$0.10 USD) - 2017/02/23 16:07:51 ET
Table 'Nauheima II' 6-max Seat #2 is the button
Seat 2: Peter0087 ($10.62 in chips) 
Seat 3: KokoulinV ($13.04 in chips) 
Seat 6: bonyo71 ($5.04 in chips) 
Innerwuss leaves the table
KokoulinV: posts small blind $0.05
bambolejro is disconnected 
Fab_1512 joins the table at seat #4 
bambolejro has timed out while disconnected
bambolejro: is sitting out 
bonyo71: posts big blind $0.10
*** HOLE CARDS ***
Fab_1512 leaves the table
Peter0087: folds 
KokoulinV: folds 
Uncalled bet ($0.05) returned to bonyo71
JahSoldier69 joins the table at seat #4 
bonyo71 collected $0.10 from pot
*** SUMMARY ***
Total pot $0.10 | Rake $0 
Seat 2: Peter0087 (button) folded before Flop (didn't bet)
Seat 3: KokoulinV (small blind) folded before Flop
Seat 6: bonyo71 (big blind) collected ($0.10)



PokerStars Hand #166667806094:  Hold'em No Limit ($0.05/$0.10 USD) - 2017/02/23 16:07:51 ET
Table 'Clavel' 6-max Seat #1 is the button
Seat 1: KRZuff ($14.51 in chips) 
Seat 2: Namhkal ($10 in chips) 
Seat 4: Dcaro31 ($11.83 in chips) 
Seat 5: Vrinni ($10 in chips) 
Seat 6: Gra_anD77 ($4.99 in chips) 
Namhkal: posts small blind $0.05
Dcaro31: posts big blind $0.10
*** HOLE CARDS ***
Vrinni: folds 
Gra_anD77: calls $0.10
KRZuff: folds 
Namhkal: folds 
Dcaro31: checks 
*** FLOP *** [9s Kc Ts]
Dcaro31: checks 
Gra_anD77: checks 
*** TURN *** [9s Kc Ts] [4h]
Dcaro31: checks 
Gra_anD77: bets $0.10
Dcaro31: folds 
Uncalled bet ($0.10) returned to Gra_anD77
Gra_anD77 collected $0.24 from pot
*** SUMMARY ***
Total pot $0.25 | Rake $0.01 
Board [9s Kc Ts 4h]
Seat 1: KRZuff (button) folded before Flop (didn't bet)
Seat 2: Namhkal (small blind) folded before Flop
Seat 4: Dcaro31 (big blind) folded on the Turn
Seat 5: Vrinni folded before Flop (didn't bet)
Seat 6: Gra_anD77 collected ($0.24)



PokerStars Hand #166667806330:  Hold'em No Limit ($0.05/$0.10 USD) - 2017/02/23 16:07:52 ET
Table 'Deflotte' 6-max Seat #2 is the button
Seat 1: Zooplack ($16.16 in chips) 
Seat 2: MonteCris92 ($10 in chips) 
Seat 3: Croplayer1 ($10.20 in chips) 
Seat 4: 8th wonders ($10.17 in chips) 
Seat 5: Pokeaster ($11.47 in chips) 
Seat 6: Iarlei ($11.60 in chips) 
Croplayer1: posts small blind $0.05
8th wonders: posts big blind $0.10
*** HOLE CARDS ***
Pokeaster: folds 
Iarlei: folds 
Zooplack: folds 
MonteCris92: raises $0.10 to $0.20
Croplayer1: folds 
8th wonders: folds 
Uncalled bet ($0.10) returned to MonteCris92
MonteCris92 collected $0.25 from pot
*** SUMMARY ***
Total pot $0.25 | Rake $0 
Seat 1: Zooplack folded before Flop (didn't bet)
Seat 2: MonteCris92 (button) collected ($0.25)
Seat 3: Croplayer1 (small blind) folded before Flop
Seat 4: 8th wonders (big blind) folded before Flop
Seat 5: Pokeaster folded before Flop (didn't bet)
Seat 6: Iarlei folded before Flop (didn't bet)



PokerStars Hand #166667806689:  Hold'em No Limit ($0.05/$0.10 USD) - 2017/02/23 16:07:52 ET
Table 'Atropos' 6-max Seat #4 is the button
Seat 1: ScorpionF39 ($2.07 in chips) 
Seat 2: yodzik ($5 in chips) 
Seat 3: NvR.m1nD ($10.38 in chips) 
Seat 4: iDecMate ($10.97 in chips) 
Seat 5: KokoulinV ($11.84 in chips) 
Seat 6: Iarlei ($12.58 in chips) 
KokoulinV: posts small blind $0.05
Iarlei: posts big blind $0.10
*** HOLE CARDS ***
ScorpionF39: folds 
yodzik: folds 
NvR.m1nD: raises $0.15 to $0.25
iDecMate: folds 
KokoulinV: folds 
Iarlei: folds 
Uncalled bet ($0.15) returned to NvR.m1nD
NvR.m1nD collected $0.25 from pot
*** SUMMARY ***
Total pot $0.25 | Rake $0 
Seat 1: ScorpionF39 folded before Flop (didn't bet)
Seat 2: yodzik folded before Flop (didn't bet)
Seat 3: NvR.m1nD collected ($0.25)
Seat 4: iDecMate (button) folded before Flop (didn't bet)
Seat 5: KokoulinV (small blind) folded before Flop
Seat 6: Iarlei (big blind) folded before Flop



PokerStars Hand #166667806825:  Hold'em No Limit ($0.05/$0.10 USD) - 2017/02/23 16:07:52 ET
Table 'Goto II' 6-max Seat #5 is the button
Seat 1: FRAID358 ($12.16 in chips) 
Seat 2: 6ePeMeHHa9 ($11.82 in chips) 
Seat 3: Goroshkos88 ($10.81 in chips) 
Seat 4: KRZuff ($13.39 in chips) 
Seat 5: RoJ1 ($14.35 in chips) 
Seat 6: ermananb93 ($11.81 in chips) 
ermananb93: posts small blind $0.05
FRAID358: posts big blind $0.10
*** HOLE CARDS ***
6ePeMeHHa9: folds 
Goroshkos88: folds 
KRZuff: raises $0.20 to $0.30
RoJ1: folds 
ermananb93: calls $0.25
FRAID358: folds 
*** FLOP *** [9d Ah 3d]
ermananb93: checks 
KRZuff: bets $0.40
ermananb93: folds 
Uncalled bet ($0.40) returned to KRZuff
KRZuff collected $0.67 from pot
*** SUMMARY ***
Total pot $0.70 | Rake $0.03 
Board [9d Ah 3d]
Seat 1: FRAID358 (big blind) folded before Flop
Seat 2: 6ePeMeHHa9 folded before Flop (didn't bet)
Seat 3: Goroshkos88 folded before Flop (didn't bet)
Seat 4: KRZuff collected ($0.67)
Seat 5: RoJ1 (button) folded before Flop (didn't bet)
Seat 6: ermananb93 (small blind) folded on the Flop



PokerStars Hand #166667806947:  Hold'em No Limit ($0.05/$0.10 USD) - 2017/02/23 16:07:52 ET
Table 'Pallas II' 6-max Seat #1 is the button
Seat 1: mdelfin0 ($15.57 in chips) 
Seat 4: MisterX413 ($10 in chips) 
Seat 5: gaHy_HaXeP ($10 in chips) 
DEraser will be allowed to play after the button
popypaleta will be allowed to play after the button
MisterX413: posts small blind $0.05
gaHy_HaXeP: posts big blind $0.10
Smitty03300: sits out 
*** HOLE CARDS ***
mdelfin0: raises $0.12 to $0.22
MisterX413: raises $0.48 to $0.70
gaHy_HaXeP: folds 
mdelfin0: raises $0.94 to $1.64
MisterX413: folds 
Uncalled bet ($0.94) returned to mdelfin0
mdelfin0 collected $1.50 from pot
*** SUMMARY ***
Total pot $1.50 | Rake $0 
Seat 1: mdelfin0 (button) collected ($1.50)
Seat 4: MisterX413 (small blind) folded before Flop
Seat 5: gaHy_HaXeP (big blind) folded before Flop



PokerStars Hand #166667807068:  Hold'em No Limit ($0.05/$0.10 USD) - 2017/02/23 16:07:52 ET
Table 'Pompeja III' 6-max Seat #4 is the button
Seat 1: Iarlei ($11.94 in chips) 
Seat 2: steepfell ($10.15 in chips) 
Seat 3: Yspenyanin ($12.31 in chips) 
Seat 4: Cluckh ($13.57 in chips) 
Seat 5: Spud014 ($12.27 in chips) 
Seat 6: mega spasser ($4.80 in chips) 
Spud014: posts small blind $0.05
mega spasser: posts big blind $0.10
*** HOLE CARDS ***
Iarlei: folds 
steepfell: folds 
Yspenyanin: folds 
Cluckh: folds 
Spud014: raises $0.10 to $0.20
mega spasser: calls $0.10
*** FLOP *** [As Jc Qc]
Spud014: bets $0.19
mega spasser: folds 
Uncalled bet ($0.19) returned to Spud014
Spud014 collected $0.38 from pot
*** SUMMARY ***
Total pot $0.40 | Rake $0.02 
Board [As Jc Qc]
Seat 1: Iarlei folded before Flop (didn't bet)
Seat 2: steepfell folded before Flop (didn't bet)
Seat 3: Yspenyanin folded before Flop (didn't bet)
Seat 4: Cluckh (button) folded before Flop (didn't bet)
Seat 5: Spud014 (small blind) collected ($0.38)
Seat 6: mega spasser (big blind) folded on the Flop



PokerStars Hand #166667807263:  Hold'em No Limit ($0.05/$0.10 USD) - 2017/02/23 16:07:53 ET
Table 'Risha II' 6-max Seat #6 is the button
Seat 1: R. Lemonte ($14.45 in chips) 
Seat 2: KA3AXCTAHEU, ($12.65 in chips) 
Seat 3: steepfell ($10.15 in chips) 
Seat 4: Comeback3392 ($19.68 in chips) 
Seat 5: m.c-alkatraz ($10.05 in chips) 
Seat 6: univibe68 ($10.46 in chips) 
R. Lemonte: posts small blind $0.05
KA3AXCTAHEU,: posts big blind $0.10
*** HOLE CARDS ***
steepfell: folds 
Comeback3392: folds 
m.c-alkatraz: folds 
univibe68: raises $0.10 to $0.20
R. Lemonte: folds 
KA3AXCTAHEU,: folds 
Uncalled bet ($0.10) returned to univibe68
univibe68 collected $0.25 from pot
*** SUMMARY ***
Total pot $0.25 | Rake $0 
Seat 1: R. Lemonte (small blind) folded before Flop
Seat 2: KA3AXCTAHEU, (big blind) folded before Flop
Seat 3: steepfell folded before Flop (didn't bet)
Seat 4: Comeback3392 folded before Flop (didn't bet)
Seat 5: m.c-alkatraz folded before Flop (didn't bet)
Seat 6: univibe68 (button) collected ($0.25)



PokerStars Hand #166667807853:  Hold'em No Limit ($0.05/$0.10 USD) - 2017/02/23 16:07:53 ET
Table 'Kanda' 6-max Seat #2 is the button
Seat 1: Andy Wolf ($11.42 in chips) 
Seat 2: Pelotín ($5.42 in chips) 
Seat 3: XaXaTyH4uK ($10 in chips) 
Seat 4: Orlangoor ($10.19 in chips) 
Seat 5: Dimka4 ($10.10 in chips) 
Seat 6: oddshoff ($9.21 in chips) 
XaXaTyH4uK: posts small blind $0.05
Orlangoor: posts big blind $0.10
*** HOLE CARDS ***
Dimka4: folds 
oddshoff: folds 
Andy Wolf: folds 
Pelotín: folds 
XaXaTyH4uK: raises $0.20 to $0.30
Orlangoor: calls $0.20
*** FLOP *** [2s 9h 3s]
XaXaTyH4uK: bets $0.30
Orlangoor: folds 
Uncalled bet ($0.30) returned to XaXaTyH4uK
XaXaTyH4uK collected $0.57 from pot
*** SUMMARY ***
Total pot $0.60 | Rake $0.03 
Board [2s 9h 3s]
Seat 1: Andy Wolf folded before Flop (didn't bet)
Seat 2: Pelotín (button) folded before Flop (didn't bet)
Seat 3: XaXaTyH4uK (small blind) collected ($0.57)
Seat 4: Orlangoor (big blind) folded on the Flop
Seat 5: Dimka4 folded before Flop (didn't bet)
Seat 6: oddshoff folded before Flop (didn't bet)



PokerStars Hand #166667808012:  Hold'em No Limit ($0.05/$0.10 USD) - 2017/02/23 16:07:53 ET
Table 'Selinur' 6-max Seat #4 is the button
Seat 1: KA3AXCTAHEU, ($10 in chips) 
Seat 2: hoedje72 ($7.07 in chips) 
Seat 4: freezing666 ($12.47 in chips) 
Seat 6: homelessdan ($18.13 in chips) 
DrVzad will be allowed to play after the button
homelessdan: posts small blind $0.05
KA3AXCTAHEU,: posts big blind $0.10
*** HOLE CARDS ***
bambolejro is disconnected 
hoedje72: folds 
freezing666: raises $0.20 to $0.30
homelessdan: calls $0.25
KA3AXCTAHEU,: folds 
*** FLOP *** [2h Ks 7h]
homelessdan: checks 
freezing666: checks 
*** TURN *** [2h Ks 7h] [3s]
homelessdan: bets $0.50
freezing666: folds 
Uncalled bet ($0.50) returned to homelessdan
homelessdan collected $0.67 from pot
*** SUMMARY ***
Total pot $0.70 | Rake $0.03 
Board [2h Ks 7h 3s]
Seat 1: KA3AXCTAHEU, (big blind) folded before Flop
Seat 2: hoedje72 folded before Flop (didn't bet)
Seat 4: freezing666 (button) folded on the Turn
Seat 6: homelessdan (small blind) collected ($0.67)



PokerStars Hand #166667808541:  Hold'em No Limit ($0.05/$0.10 USD) - 2017/02/23 16:07:54 ET
Table 'Nehalennia III' 6-max Seat #5 is the button
Seat 1: boxer821 ($11.43 in chips) 
Seat 2: fortieth ($10.73 in chips) 
Seat 3: ValdemorS ($18.60 in chips) 
Seat 4: eniksenik ($10 in chips) 
Seat 5: wulffboy ($36.94 in chips) 
Seat 6: valzeny ($20.61 in chips) 
valzeny: posts small blind $0.05
boxer821: posts big blind $0.10
boxer821: posts the ante $0.02
fortieth: posts the ante $0.02
ValdemorS: posts the ante $0.02
eniksenik: posts the ante $0.02
wulffboy: posts the ante $0.02
valzeny: posts the ante $0.02
*** HOLE CARDS ***
fortieth: folds 
ValdemorS: raises $0.20 to $0.30
eniksenik: folds 
wulffboy: folds 
valzeny: folds 
boxer821: raises $0.70 to $1
ValdemorS: folds 
Uncalled bet ($0.70) returned to boxer821
boxer821 collected $0.77 from pot
*** SUMMARY ***
Total pot $0.77 | Rake $0 
Seat 1: boxer821 (big blind) collected ($0.77)
Seat 2: fortieth folded before Flop (didn't bet)
Seat 3: ValdemorS folded before Flop
Seat 4: eniksenik folded before Flop (didn't bet)
Seat 5: wulffboy (button) folded before Flop (didn't bet)
Seat 6: valzeny (small blind) folded before Flop



PokerStars Hand #166667808869:  Hold'em No Limit ($0.05/$0.10 USD) - 2017/02/23 16:07:54 ET
Table 'Hyakutake' 6-max Seat #3 is the button
Seat 1: Asilvagoat ($12.32 in chips) 
Seat 2: boxer821 ($10.64 in chips) 
Seat 3: lenboysprite ($5.59 in chips) 
Seat 4: eniksenik ($14.46 in chips) 
Seat 5: RoJ1 ($11.14 in chips) 
Seat 6: maxiv608 ($13.42 in chips) 
eniksenik: posts small blind $0.05
RoJ1: posts big blind $0.10
*** HOLE CARDS ***
maxiv608: folds 
Asilvagoat: folds 
boxer821: raises $0.20 to $0.30
lenboysprite: calls $0.30
eniksenik: calls $0.25
RoJ1: folds 
*** FLOP *** [3h 9d 7s]
eniksenik: bets $0.53
boxer821: calls $0.53
lenboysprite: calls $0.53
*** TURN *** [3h 9d 7s] [Qc]
eniksenik: checks 
boxer821: bets $1.25
lenboysprite: calls $1.25
eniksenik: folds 
*** RIVER *** [3h 9d 7s Qc] [6h]
boxer821: bets $4.86
lenboysprite: folds 
Uncalled bet ($4.86) returned to boxer821
boxer821 collected $4.86 from pot
*** SUMMARY ***
Total pot $5.09 | Rake $0.23 
Board [3h 9d 7s Qc 6h]
Seat 1: Asilvagoat folded before Flop (didn't bet)
Seat 2: boxer821 collected ($4.86)
Seat 3: lenboysprite (button) folded on the River
Seat 4: eniksenik (small blind) folded on the Turn
Seat 5: RoJ1 (big blind) folded before Flop
Seat 6: maxiv608 folded before Flop (didn't bet)



PokerStars Hand #166667809145:  Hold'em No Limit ($0.05/$0.10 USD) - 2017/02/23 16:07:55 ET
Table 'Pirola III' 6-max Seat #6 is the button
Seat 1: bdixon_5 ($9.37 in chips) 
Seat 2: Chodemuncher ($10 in chips) 
Seat 3: kingartur222 ($10.82 in chips) 
Seat 4: McCleans ($10.72 in chips) 
Seat 5: tequila_joop ($9.68 in chips) 
Seat 6: T9MS ($11.01 in chips) 
bdixon_5: posts small blind $0.05
Chodemuncher: posts big blind $0.10
*** HOLE CARDS ***
kingartur222: folds 
McCleans: raises $0.20 to $0.30
tequila_joop: folds 
T9MS: folds 
bdixon_5: folds 
Chodemuncher: folds 
Uncalled bet ($0.20) returned to McCleans
McCleans collected $0.25 from pot
*** SUMMARY ***
Total pot $0.25 | Rake $0 
Seat 1: bdixon_5 (small blind) folded before Flop
Seat 2: Chodemuncher (big blind) folded before Flop
Seat 3: kingartur222 folded before Flop (didn't bet)
Seat 4: McCleans collected ($0.25)
Seat 5: tequila_joop folded before Flop (didn't bet)
Seat 6: T9MS (button) folded before Flop (didn't bet)



PokerStars Hand #166667809370:  Hold'em No Limit ($0.05/$0.10 USD) - 2017/02/23 16:07:55 ET
Table 'Iapetus III' 6-max Seat #3 is the button
Seat 1: Czezar Life ($6.35 in chips) 
Seat 2: Crafty23@PS ($10 in chips) 
Seat 3: Goroshkos88 ($11 in chips) 
Seat 4: Raggibest ($8.22 in chips) 
Seat 5: homelessdan ($14.93 in chips) 
Seat 6: tauronex ($10.03 in chips) 
Raggibest: posts small blind $0.05
homelessdan: posts big blind $0.10
*** HOLE CARDS ***
tauronex: raises $0.20 to $0.30
Czezar Life: folds 
Crafty23@PS: folds 
Goroshkos88: calls $0.30
Raggibest: folds 
homelessdan: calls $0.20
*** FLOP *** [As 3s 8h]
homelessdan: bets $0.60
tauronex: folds 
Goroshkos88: folds 
Uncalled bet ($0.60) returned to homelessdan
homelessdan collected $0.91 from pot
*** SUMMARY ***
Total pot $0.95 | Rake $0.04 
Board [As 3s 8h]
Seat 1: Czezar Life folded before Flop (didn't bet)
Seat 2: Crafty23@PS folded before Flop (didn't bet)
Seat 3: Goroshkos88 (button) folded on the Flop
Seat 4: Raggibest (small blind) folded before Flop
Seat 5: homelessdan (big blind) collected ($0.91)
Seat 6: tauronex folded on the Flop



PokerStars Hand #166667809639:  Hold'em No Limit ($0.05/$0.10 USD) - 2017/02/23 16:07:55 ET
Table 'Heka II' 6-max Seat #5 is the button
Seat 1: Mamm0nism ($15.51 in chips) 
Seat 2: oddshoff ($11.22 in chips) 
Seat 3: MühliJr ($10 in chips) 
Seat 4: theNot0r1ous ($10.63 in chips) 
Seat 5: ArcticBearDK ($12.53 in chips) 
Seat 6: MonteCris92 ($10.41 in chips) 
MonteCris92: posts small blind $0.05
Mamm0nism: posts big blind $0.10
*** HOLE CARDS ***
oddshoff: folds 
MühliJr: folds 
theNot0r1ous: raises $0.20 to $0.30
ArcticBearDK: folds 
MonteCris92: folds 
Mamm0nism: folds 
Uncalled bet ($0.20) returned to theNot0r1ous
theNot0r1ous collected $0.25 from pot
*** SUMMARY ***
Total pot $0.25 | Rake $0 
Seat 1: Mamm0nism (big blind) folded before Flop
Seat 2: oddshoff folded before Flop (didn't bet)
Seat 3: MühliJr folded before Flop (didn't bet)
Seat 4: theNot0r1ous collected ($0.25)
Seat 5: ArcticBearDK (button) folded before Flop (didn't bet)
Seat 6: MonteCris92 (small blind) folded before Flop



PokerStars Hand #166667809883:  Hold'em No Limit ($0.05/$0.10 USD) - 2017/02/23 16:07:55 ET
Table 'Vaisala' 6-max Seat #2 is the button
Seat 1: Pekaml ($10 in chips) 
Seat 2: XaXaTyH4uK ($12.34 in chips) 
Seat 3: x3ultimate ($10 in chips) 
Seat 4: sexy_seagull ($10.02 in chips) 
x3ultimate: posts small blind $0.05
sexy_seagull: posts big blind $0.10
*** HOLE CARDS ***
Pekaml: folds 
XaXaTyH4uK: folds 
x3ultimate: raises $0.20 to $0.30
sexy_seagull: folds 
Uncalled bet ($0.20) returned to x3ultimate
x3ultimate collected $0.20 from pot
*** SUMMARY ***
Total pot $0.20 | Rake $0 
Seat 1: Pekaml folded before Flop (didn't bet)
Seat 2: XaXaTyH4uK (button) folded before Flop (didn't bet)
Seat 3: x3ultimate (small blind) collected ($0.20)
Seat 4: sexy_seagull (big blind) folded before Flop



PokerStars Hand #166667810154:  Hold'em No Limit ($0.05/$0.10 USD) - 2017/02/23 16:07:56 ET
Table 'Caprera III' 6-max Seat #2 is the button
Seat 1: Vrinni ($19.44 in chips) 
Seat 2: hg123454321 ($10.72 in chips) 
Seat 5: fedorka rus ($49.13 in chips) 
Seat 6: GESPERIA ($16.89 in chips) 
fedorka rus: posts small blind $0.05
GESPERIA: posts big blind $0.10
*** HOLE CARDS ***
Vrinni: folds 
hg123454321: folds 
fedorka rus: raises $0.20 to $0.30
GESPERIA: calls $0.20
*** FLOP *** [5h 4c Ah]
fedorka rus: bets $0.43
GESPERIA: calls $0.43
*** TURN *** [5h 4c Ah] [Jc]
fedorka rus: checks 
GESPERIA: bets $0.70
fedorka rus: calls $0.70
*** RIVER *** [5h 4c Ah Jc] [Ks]
fedorka rus: checks 
GESPERIA: checks 
*** SHOW DOWN ***
fedorka rus: shows [Ad Kh] (two pair, Aces and Kings)
GESPERIA: mucks hand 
fedorka rus collected $2.73 from pot
*** SUMMARY ***
Total pot $2.86 | Rake $0.13 
Board [5h 4c Ah Jc Ks]
Seat 1: Vrinni folded before Flop (didn't bet)
Seat 2: hg123454321 (button) folded before Flop (didn't bet)
Seat 5: fedorka rus (small blind) showed [Ad Kh] and won ($2.73) with two pair, Aces and Kings
Seat 6: GESPERIA (big blind) mucked



PokerStars Hand #166667810363:  Hold'em No Limit ($0.05/$0.10 USD) - 2017/02/23 16:07:56 ET
Table 'Isberga' 6-max Seat #1 is the button
Seat 1: Feverhead ($18.32 in chips) 
Seat 2: GESPERIA ($10 in chips) 
Seat 4: THIMUCHIN ($10.69 in chips) 
Seat 5: YoungGriff86 ($18.87 in chips) 
Seat 6: Goroshkos88 ($21.66 in chips) 
GESPERIA: posts small blind $0.05
THIMUCHIN: posts big blind $0.10
*** HOLE CARDS ***
YoungGriff86: folds 
Goroshkos88: folds 
Feverhead: raises $0.10 to $0.20
GESPERIA: folds 
THIMUCHIN: raises $0.65 to $0.85
Feverhead: folds 
Uncalled bet ($0.65) returned to THIMUCHIN
THIMUCHIN collected $0.45 from pot
*** SUMMARY ***
Total pot $0.45 | Rake $0 
Seat 1: Feverhead (button) folded before Flop
Seat 2: GESPERIA (small blind) folded before Flop
Seat 4: THIMUCHIN (big blind) collected ($0.45)
Seat 5: YoungGriff86 folded before Flop (didn't bet)
Seat 6: Goroshkos88 folded before Flop (didn't bet)



PokerStars Hand #166667810661:  Hold'em No Limit ($0.05/$0.10 USD) - 2017/02/23 16:07:56 ET
Table 'Tyndareus II' 6-max Seat #1 is the button
Seat 1: Makc1705 ($4.39 in chips) 
Seat 2: fishhook5 ($10 in chips) 
Seat 3: McCleans ($11.55 in chips) 
Seat 4: gaHy_HaXeP ($10.61 in chips) 
Seat 5: vtalian ($9.85 in chips) 
Seat 6: sexy_seagull ($10 in chips) 
fishhook5: posts small blind $0.05
McCleans: posts big blind $0.10
*** HOLE CARDS ***
gaHy_HaXeP: folds 
vtalian: folds 
sexy_seagull: raises $0.20 to $0.30
Makc1705: folds 
fishhook5: folds 
McCleans: folds 
Uncalled bet ($0.20) returned to sexy_seagull
sexy_seagull collected $0.25 from pot
*** SUMMARY ***
Total pot $0.25 | Rake $0 
Seat 1: Makc1705 (button) folded before Flop (didn't bet)
Seat 2: fishhook5 (small blind) folded before Flop
Seat 3: McCleans (big blind) folded before Flop
Seat 4: gaHy_HaXeP folded before Flop (didn't bet)
Seat 5: vtalian folded before Flop (didn't bet)
Seat 6: sexy_seagull collected ($0.25)



PokerStars Hand #166667810852:  Hold'em No Limit ($0.05/$0.10 USD) - 2017/02/23 16:07:56 ET
Table 'Cuyo' 6-max Seat #2 is the button
Seat 1: Bandyaev ($11.09 in chips) 
Seat 2: Therodorus ($10.25 in chips) 
Seat 6: iluzja12 ($8.72 in chips) 
Hergie88 will be allowed to play after the button
DrVzad will be allowed to play after the button
iluzja12: posts small blind $0.05
Bandyaev: posts big blind $0.10
*** HOLE CARDS ***
bambolejro is disconnected 
Therodorus: folds 
iluzja12: folds 
Uncalled bet ($0.05) returned to Bandyaev
Bandyaev collected $0.10 from pot
*** SUMMARY ***
Total pot $0.10 | Rake $0 
Seat 1: Bandyaev (big blind) collected ($0.10)
Seat 2: Therodorus (button) folded before Flop (didn't bet)
Seat 6: iluzja12 (small blind) folded before Flop



PokerStars Hand #166667811269:  Hold'em No Limit ($0.05/$0.10 USD) - 2017/02/23 16:07:57 ET
Table 'Krethon' 6-max Seat #1 is the button
Seat 1: boxer821 ($10.77 in chips) 
Seat 2: manashov ($12.11 in chips) 
Seat 4: chimera252 ($14.79 in chips) 
Seat 5: popypaleta ($10.25 in chips) 
manashov: posts small blind $0.05
D3NyA: is sitting out 
chimera252: posts big blind $0.10
fabadam: sits out 
*** HOLE CARDS ***
popypaleta: folds 
boxer821: folds 
manashov: folds 
Uncalled bet ($0.05) returned to chimera252
chimera252 collected $0.10 from pot
*** SUMMARY ***
Total pot $0.10 | Rake $0 
Seat 1: boxer821 (button) folded before Flop (didn't bet)
Seat 2: manashov (small blind) folded before Flop
Seat 4: chimera252 (big blind) collected ($0.10)
Seat 5: popypaleta folded before Flop (didn't bet)



PokerStars Hand #166667811331:  Hold'em No Limit ($0.05/$0.10 USD) - 2017/02/23 16:07:57 ET
Table 'Sirius II' 6-max Seat #6 is the button
Seat 1: Ampped87 ($14.10 in chips) 
Seat 2: Buddy8711 ($8.08 in chips) 
Seat 3: Spud014 ($10.25 in chips) 
Seat 5: pokekrk ($10.17 in chips) 
Seat 6: MihaGr ($10 in chips) 
Ampped87: posts small blind $0.05
Buddy8711: posts big blind $0.10
*** HOLE CARDS ***
Spud014: folds 
pokekrk: folds 
MihaGr: folds 
Ampped87: folds 
Uncalled bet ($0.05) returned to Buddy8711
Buddy8711 collected $0.10 from pot
*** SUMMARY ***
Total pot $0.10 | Rake $0 
Seat 1: Ampped87 (small blind) folded before Flop
Seat 2: Buddy8711 (big blind) collected ($0.10)
Seat 3: Spud014 folded before Flop (didn't bet)
Seat 5: pokekrk folded before Flop (didn't bet)
Seat 6: MihaGr (button) folded before Flop (didn't bet)



PokerStars Hand #166667811723:  Hold'em No Limit ($0.05/$0.10 USD) - 2017/02/23 16:07:57 ET
Table 'Sheragul III' 6-max Seat #1 is the button
Seat 1: danky24 ($17.45 in chips) 
Seat 2: Bird et al ($10.46 in chips) 
Seat 3: FRAID358 ($10 in chips) 
Seat 4: maxiv608 ($10.43 in chips) 
Seat 5: Bandyaev ($15.97 in chips) 
Seat 6: Andrei ProFF ($11.91 in chips) 
Bird et al: posts small blind $0.05
FRAID358: posts big blind $0.10
*** HOLE CARDS ***
maxiv608: folds 
Bandyaev: folds 
Andrei ProFF: folds 
danky24: calls $0.10
Bird et al: folds 
FRAID358: checks 
*** FLOP *** [7h 9h 3c]
FRAID358: checks 
danky24: checks 
*** TURN *** [7h 9h 3c] [Kc]
FRAID358: checks 
danky24: bets $0.10
FRAID358: folds 
Uncalled bet ($0.10) returned to danky24
danky24 collected $0.24 from pot
*** SUMMARY ***
Total pot $0.25 | Rake $0.01 
Board [7h 9h 3c Kc]
Seat 1: danky24 (button) collected ($0.24)
Seat 2: Bird et al (small blind) folded before Flop
Seat 3: FRAID358 (big blind) folded on the Turn
Seat 4: maxiv608 folded before Flop (didn't bet)
Seat 5: Bandyaev folded before Flop (didn't bet)
Seat 6: Andrei ProFF folded before Flop (didn't bet)



PokerStars Hand #166667812041:  Hold'em No Limit ($0.05/$0.10 USD) - 2017/02/23 16:07:58 ET
Table 'Serpens' 6-max Seat #5 is the button
Seat 1: Namhkal ($10.30 in chips) 
Seat 2: KA3AXCTAHEU, ($19.63 in chips) 
Seat 3: homelessdan ($29.29 in chips) 
Seat 4: Ragazzi3 ($9.30 in chips) 
Seat 5: XwinX25 ($11.97 in chips) 
Seat 6: Croplayer1 ($10.23 in chips) 
Croplayer1: posts small blind $0.05
Namhkal: posts big blind $0.10
*** HOLE CARDS ***
KA3AXCTAHEU,: folds 
homelessdan: folds 
Ragazzi3: raises $0.20 to $0.30
XwinX25: folds 
Croplayer1: folds 
Namhkal: folds 
Uncalled bet ($0.20) returned to Ragazzi3
Ragazzi3 collected $0.25 from pot
*** SUMMARY ***
Total pot $0.25 | Rake $0 
Seat 1: Namhkal (big blind) folded before Flop
Seat 2: KA3AXCTAHEU, folded before Flop (didn't bet)
Seat 3: homelessdan folded before Flop (didn't bet)
Seat 4: Ragazzi3 collected ($0.25)
Seat 5: XwinX25 (button) folded before Flop (didn't bet)
Seat 6: Croplayer1 (small blind) folded before Flop



PokerStars Hand #166667812516:  Hold'em No Limit ($0.05/$0.10 USD) - 2017/02/23 16:07:58 ET
Table 'Gaika II' 6-max Seat #2 is the button
Seat 1: Ice_Isayev ($10 in chips) 
Seat 2: steepfell ($10.17 in chips) 
Seat 3: iDecMate ($18.78 in chips) 
Seat 4: Hyd SK ($12.08 in chips) 
Seat 5: KokoulinV ($12.56 in chips) 
Seat 6: bartabs2 ($9.07 in chips) 
iDecMate: posts small blind $0.05
Hyd SK: posts big blind $0.10
*** HOLE CARDS ***
KokoulinV: folds 
bartabs2: raises $0.10 to $0.20
Ice_Isayev: folds 
steepfell: raises $0.40 to $0.60
iDecMate: folds 
Hyd SK: raises $1 to $1.60
bartabs2: folds 
steepfell: calls $1
*** FLOP *** [4h 3d 7d]
Hyd SK: checks 
steepfell: bets $2.20
Hyd SK: folds 
Uncalled bet ($2.20) returned to steepfell
steepfell collected $3.29 from pot
*** SUMMARY ***
Total pot $3.45 | Rake $0.16 
Board [4h 3d 7d]
Seat 1: Ice_Isayev folded before Flop (didn't bet)
Seat 2: steepfell (button) collected ($3.29)
Seat 3: iDecMate (small blind) folded before Flop
Seat 4: Hyd SK (big blind) folded on the Flop
Seat 5: KokoulinV folded before Flop (didn't bet)
Seat 6: bartabs2 folded before Flop



PokerStars Hand #166667812709:  Hold'em No Limit ($0.05/$0.10 USD) - 2017/02/23 16:07:58 ET
Table 'Alzirr II' 6-max Seat #5 is the button
Seat 1: KA3AXCTAHEU, ($10.31 in chips) 
Seat 2: popypaleta ($10 in chips) 
Seat 3: devon_red ($7.50 in chips) 
Seat 5: yodzik ($5.93 in chips) 
Seat 6: AM-L-SL ($4.83 in chips) 
AM-L-SL: posts small blind $0.05
KA3AXCTAHEU,: posts big blind $0.10
*** HOLE CARDS ***
popypaleta: raises $0.20 to $0.30
devon_red: folds 
yodzik: folds 
AM-L-SL: folds 
KA3AXCTAHEU,: folds 
Uncalled bet ($0.20) returned to popypaleta
popypaleta collected $0.25 from pot
*** SUMMARY ***
Total pot $0.25 | Rake $0 
Seat 1: KA3AXCTAHEU, (big blind) folded before Flop
Seat 2: popypaleta collected ($0.25)
Seat 3: devon_red folded before Flop (didn't bet)
Seat 5: yodzik (button) folded before Flop (didn't bet)
Seat 6: AM-L-SL (small blind) folded before Flop



PokerStars Hand #166667812744:  Hold'em No Limit ($0.05/$0.10 USD) - 2017/02/23 16:07:59 ET
Table 'Markab II' 6-max Seat #3 is the button
Seat 1: david_sara83 ($10.22 in chips) 
Seat 2: truck1234 ($10.90 in chips) 
Seat 3: sexy_seagull ($10.15 in chips) 
Seat 4: Crafty23@PS ($11.59 in chips) 
Seat 5: Rodik002 ($19.92 in chips) 
Seat 6: Comeback3392 ($10 in chips) 
Crafty23@PS: posts small blind $0.05
Rodik002: posts big blind $0.10
*** HOLE CARDS ***
Comeback3392: folds 
david_sara83: folds 
truck1234: raises $0.20 to $0.30
sexy_seagull: folds 
Crafty23@PS: calls $0.25
Rodik002: folds 
*** FLOP *** [6d Qh Qc]
Crafty23@PS: checks 
truck1234: bets $0.50
Crafty23@PS: folds 
Uncalled bet ($0.50) returned to truck1234
truck1234 collected $0.67 from pot
*** SUMMARY ***
Total pot $0.70 | Rake $0.03 
Board [6d Qh Qc]
Seat 1: david_sara83 folded before Flop (didn't bet)
Seat 2: truck1234 collected ($0.67)
Seat 3: sexy_seagull (button) folded before Flop (didn't bet)
Seat 4: Crafty23@PS (small blind) folded on the Flop
Seat 5: Rodik002 (big blind) folded before Flop
Seat 6: Comeback3392 folded before Flop (didn't bet)



PokerStars Hand #166667812778:  Hold'em No Limit ($0.05/$0.10 USD) - 2017/02/23 16:07:59 ET
Table 'Antinous' 6-max Seat #3 is the button
Seat 1: Andrei ProFF ($15.98 in chips) 
Seat 2: Nr847 ($13.60 in chips) 
Seat 3: dittoro ($10 in chips) 
Seat 4: Pekaml ($15.32 in chips) 
Seat 5: Covetsoles ($3.62 in chips) 
Seat 6: coolisses111 ($10 in chips) 
Pekaml: posts small blind $0.05
Covetsoles: posts big blind $0.10
*** HOLE CARDS ***
coolisses111: folds 
Andrei ProFF: folds 
Nr847: folds 
dittoro: folds 
Pekaml: raises $0.10 to $0.20
Covetsoles: calls $0.10
*** FLOP *** [8s 7s Kh]
Pekaml: bets $0.29
Covetsoles: folds 
Uncalled bet ($0.29) returned to Pekaml
Pekaml collected $0.38 from pot
*** SUMMARY ***
Total pot $0.40 | Rake $0.02 
Board [8s 7s Kh]
Seat 1: Andrei ProFF folded before Flop (didn't bet)
Seat 2: Nr847 folded before Flop (didn't bet)
Seat 3: dittoro (button) folded before Flop (didn't bet)
Seat 4: Pekaml (small blind) collected ($0.38)
Seat 5: Covetsoles (big blind) folded on the Flop
Seat 6: coolisses111 folded before Flop (didn't bet)



PokerStars Hand #166667813184:  Hold'em No Limit ($0.05/$0.10 USD) - 2017/02/23 16:07:59 ET
Table 'Aisakos II' 6-max Seat #5 is the button
Seat 1: Crafty23@PS ($10.50 in chips) 
Seat 2: svaika24 ($16.83 in chips) 
Seat 3: iamkakaroto ($10.82 in chips) 
Seat 4: T9MS ($10.15 in chips) 
Seat 5: KokoulinV ($11.75 in chips) 
Seat 6: LarryTheStar ($10.13 in chips) 
LarryTheStar: posts small blind $0.05
Crafty23@PS: posts big blind $0.10
*** HOLE CARDS ***
svaika24: calls $0.10
iamkakaroto: folds 
T9MS: folds 
KokoulinV: folds 
LarryTheStar: calls $0.05
Crafty23@PS: checks 
*** FLOP *** [2d 7c 2h]
LarryTheStar: checks 
Crafty23@PS: checks 
svaika24: checks 
*** TURN *** [2d 7c 2h] [Ah]
LarryTheStar: checks 
Crafty23@PS: checks 
svaika24: bets $0.10
LarryTheStar: folds 
Crafty23@PS: folds 
Uncalled bet ($0.10) returned to svaika24
svaika24 collected $0.29 from pot
*** SUMMARY ***
Total pot $0.30 | Rake $0.01 
Board [2d 7c 2h Ah]
Seat 1: Crafty23@PS (big blind) folded on the Turn
Seat 2: svaika24 collected ($0.29)
Seat 3: iamkakaroto folded before Flop (didn't bet)
Seat 4: T9MS folded before Flop (didn't bet)
Seat 5: KokoulinV (button) folded before Flop (didn't bet)
Seat 6: LarryTheStar (small blind) folded on the Turn



PokerStars Hand #166667813200:  Hold'em No Limit ($0.05/$0.10 USD) - 2017/02/23 16:07:59 ET
Table 'Marbachia II' 6-max Seat #5 is the button
Seat 2: Yabidooo ($11.59 in chips) 
Seat 3: MisterX413 ($10.19 in chips) 
Seat 5: MihaGr ($10 in chips) 
Yabidooo: posts small blind $0.05
MisterX413: posts big blind $0.10
marianoboni: sits out 
*** HOLE CARDS ***
arti192837 joins the table at seat #6 
MihaGr: raises $0.20 to $0.30
crooso joins the table at seat #1 
Yabidooo: calls $0.25
MisterX413: folds 
*** FLOP *** [3s Ts 2s]
Yabidooo: bets $0.34
MihaGr: calls $0.34
*** TURN *** [3s Ts 2s] [5c]
Yabidooo: bets $0.66
MihaGr: calls $0.66
*** RIVER *** [3s Ts 2s 5c] [2d]
Yabidooo: checks 
MihaGr: bets $1.50
Yabidooo: calls $1.50
*** SHOW DOWN ***
MihaGr: shows [4s 7s] (a flush, Ten high)
Yabidooo: mucks hand 
MihaGr collected $5.44 from pot
*** SUMMARY ***
Total pot $5.70 | Rake $0.26 
Board [3s Ts 2s 5c 2d]
Seat 2: Yabidooo (small blind) mucked
Seat 3: MisterX413 (big blind) folded before Flop
Seat 5: MihaGr (button) showed [4s 7s] and won ($5.44) with a flush, Ten high



PokerStars Hand #166667813282:  Hold'em No Limit ($0.05/$0.10 USD) - 2017/02/23 16:07:59 ET
Table 'Wil' 6-max Seat #4 is the button
Seat 1: jwhelan94 ($24.19 in chips) 
Seat 2: Vrinni ($21.95 in chips) 
Seat 3: Namhkal ($10 in chips) 
Seat 4: x3ultimate ($10 in chips) 
Seat 5: Feverhead ($13.96 in chips) 
Seat 6: Comeback3392 ($13.78 in chips) 
Feverhead: posts small blind $0.05
Comeback3392: posts big blind $0.10
*** HOLE CARDS ***
jwhelan94: raises $0.20 to $0.30
Vrinni: folds 
Namhkal: folds 
x3ultimate: folds 
Feverhead: calls $0.25
Comeback3392: folds 
*** FLOP *** [Ts 3h Qh]
Feverhead: checks 
jwhelan94: checks 
*** TURN *** [Ts 3h Qh] [Ah]
Feverhead: checks 
jwhelan94: bets $0.50
Feverhead: calls $0.50
*** RIVER *** [Ts 3h Qh Ah] [3c]
Feverhead: checks 
jwhelan94: checks 
*** SHOW DOWN ***
Feverhead: shows [Th Tc] (a full house, Tens full of Threes)
jwhelan94: mucks hand 
Feverhead collected $1.62 from pot
*** SUMMARY ***
Total pot $1.70 | Rake $0.08 
Board [Ts 3h Qh Ah 3c]
Seat 1: jwhelan94 mucked
Seat 2: Vrinni folded before Flop (didn't bet)
Seat 3: Namhkal folded before Flop (didn't bet)
Seat 4: x3ultimate (button) folded before Flop (didn't bet)
Seat 5: Feverhead (small blind) showed [Th Tc] and won ($1.62) with a full house, Tens full of Threes
Seat 6: Comeback3392 (big blind) folded before Flop



PokerStars Hand #166667813448:  Hold'em No Limit ($0.05/$0.10 USD) - 2017/02/23 16:07:59 ET
Table 'Wingolfia II' 6-max Seat #2 is the button
Seat 1: BahiaMinhaP ($10.17 in chips) 
Seat 2: NvR.m1nD ($10.25 in chips) 
Seat 3: truck1234 ($10.26 in chips) 
Seat 4: zlobslob ($18.02 in chips) 
Seat 5: tr41n3r12 ($11.58 in chips) 
Seat 6: EphemeralBen ($11.99 in chips) 
truck1234: posts small blind $0.05
zlobslob: posts big blind $0.10
*** HOLE CARDS ***
tr41n3r12: folds 
EphemeralBen: raises $0.20 to $0.30
BahiaMinhaP: folds 
NvR.m1nD: folds 
truck1234: folds 
zlobslob: folds 
Uncalled bet ($0.20) returned to EphemeralBen
EphemeralBen collected $0.25 from pot
*** SUMMARY ***
Total pot $0.25 | Rake $0 
Seat 1: BahiaMinhaP folded before Flop (didn't bet)
Seat 2: NvR.m1nD (button) folded before Flop (didn't bet)
Seat 3: truck1234 (small blind) folded before Flop
Seat 4: zlobslob (big blind) folded before Flop
Seat 5: tr41n3r12 folded before Flop (didn't bet)
Seat 6: EphemeralBen collected ($0.25)



PokerStars Hand #166667813735:  Hold'em No Limit ($0.05/$0.10 USD) - 2017/02/23 16:08:00 ET
Table 'Ophelia' 6-max Seat #2 is the button
Seat 1: ralfi37 ($10.82 in chips) 
Seat 2: popypaleta ($16.48 in chips) 
Seat 3: mvp0013 ($10.70 in chips) 
Seat 4: Cluckh ($12.14 in chips) 
Seat 5: truck1234 ($13.56 in chips) 
Seat 6: Yabidooo ($11.13 in chips) 
mvp0013: posts small blind $0.05
Cluckh: posts big blind $0.10
*** HOLE CARDS ***
truck1234: folds 
Yabidooo: folds 
ralfi37: folds 
popypaleta: folds 
mvp0013: raises $0.20 to $0.30
Cluckh: folds 
Uncalled bet ($0.20) returned to mvp0013
mvp0013 collected $0.20 from pot
*** SUMMARY ***
Total pot $0.20 | Rake $0 
Seat 1: ralfi37 folded before Flop (didn't bet)
Seat 2: popypaleta (button) folded before Flop (didn't bet)
Seat 3: mvp0013 (small blind) collected ($0.20)
Seat 4: Cluckh (big blind) folded before Flop
Seat 5: truck1234 folded before Flop (didn't bet)
Seat 6: Yabidooo folded before Flop (didn't bet)



PokerStars Hand #166667814064:  Hold'em No Limit ($0.05/$0.10 USD) - 2017/02/23 16:08:00 ET
Table 'Alnasl' 6-max Seat #5 is the button
Seat 1: KA3AXCTAHEU, ($11.20 in chips) 
Seat 2: saddur ($9.64 in chips) 
Seat 3: david_sara83 ($22.54 in chips) 
Seat 4: oddshoff ($10.18 in chips) 
Seat 5: 6ePeMeHHa9 ($10 in chips) 
Seat 6: Zooplack ($13.63 in chips) 
Zooplack: posts small blind $0.05
KA3AXCTAHEU,: posts big blind $0.10
*** HOLE CARDS ***
saddur: folds 
david_sara83: folds 
oddshoff: folds 
6ePeMeHHa9: raises $0.14 to $0.24
Zooplack: folds 
KA3AXCTAHEU,: folds 
Uncalled bet ($0.14) returned to 6ePeMeHHa9
6ePeMeHHa9 collected $0.25 from pot
*** SUMMARY ***
Total pot $0.25 | Rake $0 
Seat 1: KA3AXCTAHEU, (big blind) folded before Flop
Seat 2: saddur folded before Flop (didn't bet)
Seat 3: david_sara83 folded before Flop (didn't bet)
Seat 4: oddshoff folded before Flop (didn't bet)
Seat 5: 6ePeMeHHa9 (button) collected ($0.25)
Seat 6: Zooplack (small blind) folded before Flop



PokerStars Hand #166667814442:  Hold'em No Limit ($0.05/$0.10 USD) - 2017/02/23 16:08:00 ET
Table 'Pulcova II' 6-max Seat #6 is the button
Seat 1: sexy_seagull ($10.88 in chips) 
Seat 2: Kazacha ($10 in chips) 
Seat 3: Lao Tsy ($14.22 in chips) 
Seat 4: VioXion ($12.88 in chips) 
Seat 5: mdelfin0 ($10.09 in chips) 
Seat 6: Ice_Isayev ($10.50 in chips) 
sexy_seagull: posts small blind $0.05
Kazacha: posts big blind $0.10
*** HOLE CARDS ***
Lao Tsy: folds 
VioXion: calls $0.10
mdelfin0: folds 
Ice_Isayev: raises $0.20 to $0.30
sexy_seagull: folds 
Kazacha: raises $0.70 to $1
VioXion: folds 
Ice_Isayev: folds 
Uncalled bet ($0.70) returned to Kazacha
Kazacha collected $0.75 from pot
*** SUMMARY ***
Total pot $0.75 | Rake $0 
Seat 1: sexy_seagull (small blind) folded before Flop
Seat 2: Kazacha (big blind) collected ($0.75)
Seat 3: Lao Tsy folded before Flop (didn't bet)
Seat 4: VioXion folded before Flop
Seat 5: mdelfin0 folded before Flop (didn't bet)
Seat 6: Ice_Isayev (button) folded before Flop



PokerStars Hand #166667814683:  Hold'em No Limit ($0.05/$0.10 USD) - 2017/02/23 16:08:01 ET
Table 'Gyldenia II' 6-max Seat #5 is the button
Seat 1: KokoulinV ($10.48 in chips) 
Seat 2: Bandyaev ($10 in chips) 
Seat 5: CHRO8 ($15.47 in chips) 
Seat 6: 8th wonders ($12.73 in chips) 
8th wonders: posts small blind $0.05
KokoulinV: posts big blind $0.10
D3NyA: sits out 
*** HOLE CARDS ***
Bandyaev: folds 
CHRO8: folds 
8th wonders: folds 
Uncalled bet ($0.05) returned to KokoulinV
KokoulinV collected $0.10 from pot
*** SUMMARY ***
Total pot $0.10 | Rake $0 
Seat 1: KokoulinV (big blind) collected ($0.10)
Seat 2: Bandyaev folded before Flop (didn't bet)
Seat 5: CHRO8 (button) folded before Flop (didn't bet)
Seat 6: 8th wonders (small blind) folded before Flop



PokerStars Hand #166667814785:  Hold'em No Limit ($0.05/$0.10 USD) - 2017/02/23 16:08:01 ET
Table 'Tyche III' 6-max Seat #3 is the button
Seat 1: milt65 ($10.09 in chips) 
Seat 3: ChuikaPridi ($10.10 in chips) 
Seat 4: Kazacha ($10 in chips) 
Seat 5: chimera252 ($14.51 in chips) 
Seat 6: Ice_Isayev ($10 in chips) 
Kazacha: posts small blind $0.05
chimera252: posts big blind $0.10
arti192837: sits out 
*** HOLE CARDS ***
Ice_Isayev: folds 
milt65: raises $0.15 to $0.25
ChuikaPridi: calls $0.25
Kazacha: folds 
chimera252: folds 
*** FLOP *** [Jd Kh 5s]
milt65: bets $0.40
ChuikaPridi: folds 
Uncalled bet ($0.40) returned to milt65
milt65 collected $0.62 from pot
*** SUMMARY ***
Total pot $0.65 | Rake $0.03 
Board [Jd Kh 5s]
Seat 1: milt65 collected ($0.62)
Seat 3: ChuikaPridi (button) folded on the Flop
Seat 4: Kazacha (small blind) folded before Flop
Seat 5: chimera252 (big blind) folded before Flop
Seat 6: Ice_Isayev folded before Flop (didn't bet)



PokerStars Hand #166667814929:  Hold'em No Limit ($0.05/$0.10 USD) - 2017/02/23 16:08:01 ET
Table 'Pyrrhus III' 6-max Seat #3 is the button
Seat 2: univibe68 ($18.94 in chips) 
Seat 3: coolisses111 ($9.66 in chips) 
Seat 4: ex3Lero86 ($23.20 in chips) 
Seat 5: eniksenik ($10 in chips) 
Seat 6: MLPlayer16 ($21.38 in chips) 
ex3Lero86: posts small blind $0.05
eniksenik: posts big blind $0.10
univibe68: posts the ante $0.02
coolisses111: posts the ante $0.02
ex3Lero86: posts the ante $0.02
eniksenik: posts the ante $0.02
MLPlayer16: posts the ante $0.02
*** HOLE CARDS ***
MLPlayer16: folds 
univibe68: raises $0.20 to $0.30
coolisses111: folds 
ex3Lero86: raises $0.80 to $1.10
eniksenik: folds 
univibe68: calls $0.80
*** FLOP *** [Ac 2d 3d]
ex3Lero86: bets $1.14
univibe68: calls $1.14
*** TURN *** [Ac 2d 3d] [4d]
ex3Lero86: bets $2.68
univibe68: calls $2.68
*** RIVER *** [Ac 2d 3d 4d] [7h]
ex3Lero86: checks 
univibe68: bets $3.30
ex3Lero86: calls $3.30
*** SHOW DOWN ***
univibe68: shows [4h Ah] (two pair, Aces and Fours)
ex3Lero86: mucks hand 
univibe68 collected $15.89 from pot
*** SUMMARY ***
Total pot $16.64 | Rake $0.75 
Board [Ac 2d 3d 4d 7h]
Seat 2: univibe68 showed [4h Ah] and won ($15.89) with two pair, Aces and Fours
Seat 3: coolisses111 (button) folded before Flop (didn't bet)
Seat 4: ex3Lero86 (small blind) mucked
Seat 5: eniksenik (big blind) folded before Flop
Seat 6: MLPlayer16 folded before Flop (didn't bet)



PokerStars Hand #166667815744:  Hold'em No Limit ($0.05/$0.10 USD) - 2017/02/23 16:08:02 ET
Table 'Arpola' 6-max Seat #4 is the button
Seat 1: dincimus ($11.12 in chips) 
Seat 2: patrick19111 ($10 in chips) 
Seat 4: Orlangoor ($18.85 in chips) 
Seat 5: truck1234 ($11.56 in chips) 
truck1234: posts small blind $0.05
Andrei ProFF: is sitting out 
dincimus: posts big blind $0.10
*** HOLE CARDS ***
patrick19111: folds 
Andrei ProFF leaves the table
Orlangoor: raises $0.12 to $0.22
truck1234: folds 
dincimus: folds 
Uncalled bet ($0.12) returned to Orlangoor
Orlangoor collected $0.25 from pot
*** SUMMARY ***
Total pot $0.25 | Rake $0 
Seat 1: dincimus (big blind) folded before Flop
Seat 2: patrick19111 folded before Flop (didn't bet)
Seat 4: Orlangoor (button) collected ($0.25)
Seat 5: truck1234 (small blind) folded before Flop



PokerStars Hand #166667816125:  Hold'em No Limit ($0.05/$0.10 USD) - 2017/02/23 16:08:02 ET
Table 'Unitas II' 6-max Seat #1 is the button
Seat 1: Peter0087 ($9.84 in chips) 
Seat 2: steepfell ($10.15 in chips) 
Seat 3: BahiaMinhaP ($10 in chips) 
Seat 4: truck1234 ($10.94 in chips) 
Seat 5: chimera252 ($24.48 in chips) 
Seat 6: paxit71 ($9.58 in chips) 
steepfell: posts small blind $0.05
BahiaMinhaP: posts big blind $0.10
*** HOLE CARDS ***
truck1234: folds 
chimera252: folds 
paxit71: folds 
Peter0087: raises $0.20 to $0.30
steepfell: folds 
BahiaMinhaP: folds 
Uncalled bet ($0.20) returned to Peter0087
Peter0087 collected $0.25 from pot
*** SUMMARY ***
Total pot $0.25 | Rake $0 
Seat 1: Peter0087 (button) collected ($0.25)
Seat 2: steepfell (small blind) folded before Flop
Seat 3: BahiaMinhaP (big blind) folded before Flop
Seat 4: truck1234 folded before Flop (didn't bet)
Seat 5: chimera252 folded before Flop (didn't bet)
Seat 6: paxit71 folded before Flop (didn't bet)



PokerStars Hand #166667816130:  Hold'em No Limit ($0.05/$0.10 USD) - 2017/02/23 16:08:02 ET
Table 'Tomyris II' 6-max Seat #2 is the button
Seat 1: ArcticBearDK ($21.83 in chips) 
Seat 2: Yspenyanin ($12.62 in chips) 
Seat 3: robertsabb ($12.03 in chips) 
Seat 4: Dcaro31 ($10.15 in chips) 
Seat 5: 6ePeMeHHa9 ($11.80 in chips) 
Seat 6: StackSmakka ($9.89 in chips) 
robertsabb: posts small blind $0.05
Dcaro31: posts big blind $0.10
*** HOLE CARDS ***
6ePeMeHHa9: folds 
StackSmakka: raises $0.20 to $0.30
ArcticBearDK: folds 
Yspenyanin: folds 
robertsabb: folds 
Dcaro31: folds 
Uncalled bet ($0.20) returned to StackSmakka
StackSmakka collected $0.25 from pot
*** SUMMARY ***
Total pot $0.25 | Rake $0 
Seat 1: ArcticBearDK folded before Flop (didn't bet)
Seat 2: Yspenyanin (button) folded before Flop (didn't bet)
Seat 3: robertsabb (small blind) folded before Flop
Seat 4: Dcaro31 (big blind) folded before Flop
Seat 5: 6ePeMeHHa9 folded before Flop (didn't bet)
Seat 6: StackSmakka collected ($0.25)



PokerStars Hand #166667816934:  Hold'em No Limit ($0.05/$0.10 USD) - 2017/02/23 16:08:03 ET
Table 'Cuyo' 6-max Seat #6 is the button
Seat 1: Bandyaev ($11.14 in chips) 
Seat 2: Therodorus ($10.25 in chips) 
Seat 3: Hergie88 ($10 in chips) 
Seat 6: iluzja12 ($8.67 in chips) 
Bandyaev: posts small blind $0.05
Therodorus: posts big blind $0.10
Hergie88: posts big blind $0.10
DrVzad: sits out 
*** HOLE CARDS ***
Hergie88: checks 
iluzja12: raises $0.20 to $0.30
Bandyaev: folds 
Therodorus: folds 
Hergie88: calls $0.20
*** FLOP *** [6s 4h Kd]
Hergie88: bets $0.30
iluzja12: calls $0.30
*** TURN *** [6s 4h Kd] [7s]
Hergie88: bets $0.30
iluzja12: raises $0.60 to $0.90
Hergie88: folds 
Uncalled bet ($0.60) returned to iluzja12
iluzja12 collected $1.86 from pot
*** SUMMARY ***
Total pot $1.95 | Rake $0.09 
Board [6s 4h Kd 7s]
Seat 1: Bandyaev (small blind) folded before Flop
Seat 2: Therodorus (big blind) folded before Flop
Seat 3: Hergie88 folded on the Turn
Seat 6: iluzja12 (button) collected ($1.86)



PokerStars Hand #166667817330:  Hold'em No Limit ($0.05/$0.10 USD) - 2017/02/23 16:08:04 ET
Table 'Lampetia' 6-max Seat #5 is the button
Seat 1: WinninBikini ($10 in chips) 
Seat 2: ex3Lero86 ($10.30 in chips) 
Seat 3: Ice_Isayev ($19.89 in chips) 
Seat 4: Rodik002 ($10 in chips) 
Seat 5: luisantrs ($10.57 in chips) 
Seat 6: Scanner17 ($12.14 in chips) 
Scanner17: posts small blind $0.05
WinninBikini: posts big blind $0.10
*** HOLE CARDS ***
ex3Lero86: folds 
Ice_Isayev: folds 
Rodik002: folds 
luisantrs: raises $0.10 to $0.20
Scanner17: folds 
WinninBikini: calls $0.10
*** FLOP *** [6d Kh Qh]
WinninBikini: checks 
luisantrs: checks 
*** TURN *** [6d Kh Qh] [3c]
WinninBikini: checks 
luisantrs: checks 
*** RIVER *** [6d Kh Qh 3c] [Jh]
WinninBikini: checks 
luisantrs: checks 
*** SHOW DOWN ***
WinninBikini: shows [Qc 7c] (a pair of Queens)
luisantrs: mucks hand 
WinninBikini collected $0.43 from pot
*** SUMMARY ***
Total pot $0.45 | Rake $0.02 
Board [6d Kh Qh 3c Jh]
Seat 1: WinninBikini (big blind) showed [Qc 7c] and won ($0.43) with a pair of Queens
Seat 2: ex3Lero86 folded before Flop (didn't bet)
Seat 3: Ice_Isayev folded before Flop (didn't bet)
Seat 4: Rodik002 folded before Flop (didn't bet)
Seat 5: luisantrs (button) mucked
Seat 6: Scanner17 (small blind) folded before Flop



PokerStars Hand #166667817465:  Hold'em No Limit ($0.05/$0.10 USD) - 2017/02/23 16:08:04 ET
Table 'Tyndareus III' 6-max Seat #3 is the button
Seat 1: MBen10 ($19.24 in chips) 
Seat 2: MihaGr ($10.42 in chips) 
Seat 3: XaXaTyH4uK ($10 in chips) 
Seat 4: tequila_joop ($9.90 in chips) 
Seat 5: yodzik ($5 in chips) 
Seat 6: Hb-309 ($10.14 in chips) 
tequila_joop: posts small blind $0.05
yodzik: posts big blind $0.10
*** HOLE CARDS ***
Hb-309: folds 
MBen10: folds 
MihaGr: folds 
XaXaTyH4uK: folds 
tequila_joop: raises $0.20 to $0.30
yodzik: folds 
Uncalled bet ($0.20) returned to tequila_joop
tequila_joop collected $0.20 from pot
*** SUMMARY ***
Total pot $0.20 | Rake $0 
Seat 1: MBen10 folded before Flop (didn't bet)
Seat 2: MihaGr folded before Flop (didn't bet)
Seat 3: XaXaTyH4uK (button) folded before Flop (didn't bet)
Seat 4: tequila_joop (small blind) collected ($0.20)
Seat 5: yodzik (big blind) folded before Flop
Seat 6: Hb-309 folded before Flop (didn't bet)



PokerStars Hand #166667817479:  Hold'em No Limit ($0.05/$0.10 USD) - 2017/02/23 16:08:04 ET
Table 'Pandora III' 6-max Seat #2 is the button
Seat 1: Pokeaster ($11.09 in chips) 
Seat 2: garigura ($11.54 in chips) 
Seat 3: Chodemuncher ($10 in chips) 
Seat 4: mhonielsen ($10 in chips) 
Seat 5: MühliJr ($10.57 in chips) 
Seat 6: yodzik ($5 in chips) 
Chodemuncher: posts small blind $0.05
mhonielsen: posts big blind $0.10
*** HOLE CARDS ***
MühliJr: folds 
yodzik: folds 
Pokeaster: folds 
garigura: folds 
Chodemuncher: folds 
Uncalled bet ($0.05) returned to mhonielsen
mhonielsen collected $0.10 from pot
*** SUMMARY ***
Total pot $0.10 | Rake $0 
Seat 1: Pokeaster folded before Flop (didn't bet)
Seat 2: garigura (button) folded before Flop (didn't bet)
Seat 3: Chodemuncher (small blind) folded before Flop
Seat 4: mhonielsen (big blind) collected ($0.10)
Seat 5: MühliJr folded before Flop (didn't bet)
Seat 6: yodzik folded before Flop (didn't bet)



PokerStars Hand #166667817992:  Hold'em No Limit ($0.05/$0.10 USD) - 2017/02/23 16:08:04 ET
Table 'Lampetia III' 6-max Seat #5 is the button
Seat 1: gaHy_HaXeP ($10.55 in chips) 
Seat 2: DamDatsAnAce ($10.32 in chips) 
Seat 3: Kow6oy ($10 in chips) 
Seat 4: IAntikI ($10.60 in chips) 
Seat 5: robson1235 ($20.42 in chips) 
Seat 6: bdixon_5 ($9.25 in chips) 
bdixon_5: posts small blind $0.05
gaHy_HaXeP: posts big blind $0.10
*** HOLE CARDS ***
DamDatsAnAce: folds 
Kow6oy: folds 
IAntikI: folds 
robson1235: folds 
bdixon_5: folds 
Uncalled bet ($0.05) returned to gaHy_HaXeP
gaHy_HaXeP collected $0.10 from pot
*** SUMMARY ***
Total pot $0.10 | Rake $0 
Seat 1: gaHy_HaXeP (big blind) collected ($0.10)
Seat 2: DamDatsAnAce folded before Flop (didn't bet)
Seat 3: Kow6oy folded before Flop (didn't bet)
Seat 4: IAntikI folded before Flop (didn't bet)
Seat 5: robson1235 (button) folded before Flop (didn't bet)
Seat 6: bdixon_5 (small blind) folded before Flop



PokerStars Hand #166667818178:  Hold'em No Limit ($0.05/$0.10 USD) - 2017/02/23 16:08:04 ET
Table 'Phereclos II' 6-max Seat #6 is the button
Seat 1: Croplayer1 ($10 in chips) 
Seat 2: Kazacha ($10.40 in chips) 
Seat 3: BJamesB2014 ($5.60 in chips) 
Seat 4: DamDatsAnAce ($10.53 in chips) 
Seat 5: crazydevill ($12.19 in chips) 
Seat 6: mhonielsen ($16.39 in chips) 
Croplayer1: posts small blind $0.05
Kazacha: posts big blind $0.10
*** HOLE CARDS ***
BJamesB2014: raises $0.10 to $0.20
DamDatsAnAce: folds 
crazydevill: folds 
mhonielsen: folds 
Croplayer1: folds 
Kazacha: folds 
Uncalled bet ($0.10) returned to BJamesB2014
BJamesB2014 collected $0.25 from pot
*** SUMMARY ***
Total pot $0.25 | Rake $0 
Seat 1: Croplayer1 (small blind) folded before Flop
Seat 2: Kazacha (big blind) folded before Flop
Seat 3: BJamesB2014 collected ($0.25)
Seat 4: DamDatsAnAce folded before Flop (didn't bet)
Seat 5: crazydevill folded before Flop (didn't bet)
Seat 6: mhonielsen (button) folded before Flop (didn't bet)



PokerStars Hand #166667818394:  Hold'em No Limit ($0.05/$0.10 USD) - 2017/02/23 16:08:05 ET
Table 'Landi II' 6-max Seat #1 is the button
Seat 1: dersiemer ($12.46 in chips) 
Seat 2: Aescul@pius ($10 in chips) 
Seat 4: alesi13 ($6.73 in chips) 
Seat 5: Bird et al ($10.25 in chips) 
Aescul@pius: posts small blind $0.05
dr.goofy: is sitting out 
alesi13: posts big blind $0.10
arti192837: sits out 
*** HOLE CARDS ***
Bird et al: folds 
dersiemer: raises $0.10 to $0.20
Aescul@pius: folds 
dr.goofy leaves the table
alesi13: calls $0.10
*** FLOP *** [4d 3c 7d]
x3ultimate joins the table at seat #3 
alesi13: bets $0.22
dersiemer: calls $0.22
*** TURN *** [4d 3c 7d] [Jc]
alesi13: checks 
dersiemer: bets $0.40
alesi13: folds 
Uncalled bet ($0.40) returned to dersiemer
dersiemer collected $0.85 from pot
*** SUMMARY ***
Total pot $0.89 | Rake $0.04 
Board [4d 3c 7d Jc]
Seat 1: dersiemer (button) collected ($0.85)
Seat 2: Aescul@pius (small blind) folded before Flop
Seat 4: alesi13 (big blind) folded on the Turn
Seat 5: Bird et al folded before Flop (didn't bet)



PokerStars Hand #166667818395:  Hold'em No Limit ($0.05/$0.10 USD) - 2017/02/23 16:08:05 ET
Table 'Duhr II' 6-max Seat #6 is the button
Seat 1: Lucky HoBBiT ($10.65 in chips) 
Seat 2: Feverhead ($37.89 in chips) 
Seat 4: CHRO8 ($9.33 in chips) 
Seat 5: Dimka4 ($10.10 in chips) 
Seat 6: townerz1991 ($10.86 in chips) 
Lucky HoBBiT: posts small blind $0.05
Feverhead: posts big blind $0.10
Smitty03300: sits out 
*** HOLE CARDS ***
CHRO8: raises $0.20 to $0.30
Dimka4: folds 
townerz1991: calls $0.30
Lucky HoBBiT: folds 
Feverhead: folds 
*** FLOP *** [7d Qd Kh]
CHRO8: checks 
townerz1991: bets $0.40
CHRO8: folds 
Uncalled bet ($0.40) returned to townerz1991
townerz1991 collected $0.72 from pot
*** SUMMARY ***
Total pot $0.75 | Rake $0.03 
Board [7d Qd Kh]
Seat 1: Lucky HoBBiT (small blind) folded before Flop
Seat 2: Feverhead (big blind) folded before Flop
Seat 4: CHRO8 folded on the Flop
Seat 5: Dimka4 folded before Flop (didn't bet)
Seat 6: townerz1991 (button) collected ($0.72)



PokerStars Hand #166667818838:  Hold'em No Limit ($0.05/$0.10 USD) - 2017/02/23 16:08:05 ET
Table 'Vaisala' 6-max Seat #3 is the button
Seat 2: XaXaTyH4uK ($12.34 in chips) 
Seat 3: x3ultimate ($10.10 in chips) 
Seat 4: sexy_seagull ($10 in chips) 
sexy_seagull: posts small blind $0.05
Pekaml: is sitting out 
XaXaTyH4uK: posts big blind $0.10
*** HOLE CARDS ***
x3ultimate: raises $0.15 to $0.25
Pekaml leaves the table
sexy_seagull: raises $0.55 to $0.80
XaXaTyH4uK: folds 
univibe68 joins the table at seat #5 
x3ultimate: calls $0.55
*** FLOP *** [3d Js 8d]
sexy_seagull: checks 
x3ultimate: checks 
*** TURN *** [3d Js 8d] [6h]
sexy_seagull: bets $0.90
x3ultimate: raises $1.90 to $2.80
sexy_seagull: folds 
Uncalled bet ($1.90) returned to x3ultimate
x3ultimate collected $3.34 from pot
*** SUMMARY ***
Total pot $3.50 | Rake $0.16 
Board [3d Js 8d 6h]
Seat 2: XaXaTyH4uK (big blind) folded before Flop
Seat 3: x3ultimate (button) collected ($3.34)
Seat 4: sexy_seagull (small blind) folded on the Turn



PokerStars Hand #166667818839:  Hold'em No Limit ($0.05/$0.10 USD) - 2017/02/23 16:08:05 ET
Table 'Martha' 6-max Seat #6 is the button
Seat 1: Peter0087 ($10.34 in chips) 
Seat 2: pauli95 ($10.03 in chips) 
Seat 3: Hyd SK ($12.52 in chips) 
Seat 4: dittoro ($10 in chips) 
Seat 5: MihaGr ($10 in chips) 
Seat 6: 8th wonders ($10.15 in chips) 
Peter0087: posts small blind $0.05
pauli95: posts big blind $0.10
*** HOLE CARDS ***
Hyd SK: folds 
dittoro: folds 
MihaGr: folds 
8th wonders: raises $0.10 to $0.20
Peter0087: folds 
pauli95: calls $0.10
*** FLOP *** [5c 6h Ks]
pauli95: bets $0.43
8th wonders: folds 
Uncalled bet ($0.43) returned to pauli95
pauli95 collected $0.43 from pot
*** SUMMARY ***
Total pot $0.45 | Rake $0.02 
Board [5c 6h Ks]
Seat 1: Peter0087 (small blind) folded before Flop
Seat 2: pauli95 (big blind) collected ($0.43)
Seat 3: Hyd SK folded before Flop (didn't bet)
Seat 4: dittoro folded before Flop (didn't bet)
Seat 5: MihaGr folded before Flop (didn't bet)
Seat 6: 8th wonders (button) folded on the Flop



PokerStars Hand #166667818928:  Hold'em No Limit ($0.05/$0.10 USD) - 2017/02/23 16:08:05 ET
Table 'Jokaste II' 6-max Seat #1 is the button
Seat 1: Hyd SK ($13.55 in chips) 
Seat 2: T9MS ($12.23 in chips) 
Seat 3: crazydevill ($11.33 in chips) 
Seat 4: FRAID358 ($15.21 in chips) 
Seat 5: Vrinni ($10.13 in chips) 
Seat 6: Adailton07 ($14.05 in chips) 
T9MS: posts small blind $0.05
crazydevill: posts big blind $0.10
*** HOLE CARDS ***
FRAID358: folds 
Vrinni: folds 
Adailton07: raises $0.25 to $0.35
Hyd SK: folds 
T9MS: folds 
crazydevill: calls $0.25
*** FLOP *** [Ac Qh Jd]
crazydevill: bets $0.50
Adailton07: folds 
Uncalled bet ($0.50) returned to crazydevill
crazydevill collected $0.72 from pot
*** SUMMARY ***
Total pot $0.75 | Rake $0.03 
Board [Ac Qh Jd]
Seat 1: Hyd SK (button) folded before Flop (didn't bet)
Seat 2: T9MS (small blind) folded before Flop
Seat 3: crazydevill (big blind) collected ($0.72)
Seat 4: FRAID358 folded before Flop (didn't bet)
Seat 5: Vrinni folded before Flop (didn't bet)
Seat 6: Adailton07 folded on the Flop



PokerStars Hand #166667819385:  Hold'em No Limit ($0.05/$0.10 USD) - 2017/02/23 16:08:06 ET
Table 'Ebella II' 6-max Seat #5 is the button
Seat 1: gaHy_HaXeP ($10 in chips) 
Seat 2: Therodorus ($10 in chips) 
Seat 3: Torften2 ($17.09 in chips) 
Seat 4: ValdemorS ($11.35 in chips) 
Seat 5: Bird et al ($10 in chips) 
Seat 6: Joker51_wtf! ($11.29 in chips) 
Joker51_wtf!: posts small blind $0.05
gaHy_HaXeP: posts big blind $0.10
*** HOLE CARDS ***
Therodorus: folds 
Torften2: raises $0.20 to $0.30
ValdemorS: folds 
Bird et al: calls $0.30
Joker51_wtf!: folds 
gaHy_HaXeP: folds 
*** FLOP *** [Ah Jc 3c]
Torften2: checks 
Bird et al: checks 
*** TURN *** [Ah Jc 3c] [7c]
Torften2: bets $0.40
Bird et al: folds 
Uncalled bet ($0.40) returned to Torften2
Torften2 collected $0.72 from pot
*** SUMMARY ***
Total pot $0.75 | Rake $0.03 
Board [Ah Jc 3c 7c]
Seat 1: gaHy_HaXeP (big blind) folded before Flop
Seat 2: Therodorus folded before Flop (didn't bet)
Seat 3: Torften2 collected ($0.72)
Seat 4: ValdemorS folded before Flop (didn't bet)
Seat 5: Bird et al (button) folded on the Turn
Seat 6: Joker51_wtf! (small blind) folded before Flop



PokerStars Hand #166667819409:  Hold'em No Limit ($0.05/$0.10 USD) - 2017/02/23 16:08:06 ET
Table 'Kochera' 6-max Seat #2 is the button
Seat 1: chimera252 ($11.67 in chips) 
Seat 2: bartabs2 ($10.39 in chips) 
Seat 3: KA3AXCTAHEU, ($10.36 in chips) 
Seat 4: dany_de_vit ($10 in chips) 
Seat 5: univibe68 ($11.65 in chips) 
Seat 6: oddshoff ($9.63 in chips) 
KA3AXCTAHEU,: posts small blind $0.05
dany_de_vit: posts big blind $0.10
*** HOLE CARDS ***
univibe68: folds 
oddshoff: folds 
chimera252: folds 
bartabs2: folds 
KA3AXCTAHEU,: folds 
Uncalled bet ($0.05) returned to dany_de_vit
dany_de_vit collected $0.10 from pot
*** SUMMARY ***
Total pot $0.10 | Rake $0 
Seat 1: chimera252 folded before Flop (didn't bet)
Seat 2: bartabs2 (button) folded before Flop (didn't bet)
Seat 3: KA3AXCTAHEU, (small blind) folded before Flop
Seat 4: dany_de_vit (big blind) collected ($0.10)
Seat 5: univibe68 folded before Flop (didn't bet)
Seat 6: oddshoff folded before Flop (didn't bet)



PokerStars Hand #166667819431:  Hold'em No Limit ($0.05/$0.10 USD) - 2017/02/23 16:08:06 ET
Table 'Caupolican' 6-max Seat #2 is the button
Seat 1: kingartur222 ($11.49 in chips) 
Seat 2: garigura ($18.75 in chips) 
Seat 4: mhonielsen ($15.12 in chips) 
Seat 5: Kazacha ($12.40 in chips) 
Seat 6: crazydevill ($10 in chips) 
ducksheep82 will be allowed to play after the button
mhonielsen: posts small blind $0.05
Kazacha: posts big blind $0.10
*** HOLE CARDS ***
crazydevill: folds 
kingartur222: folds 
garigura: folds 
mhonielsen: folds 
Uncalled bet ($0.05) returned to Kazacha
Kazacha collected $0.10 from pot
*** SUMMARY ***
Total pot $0.10 | Rake $0 
Seat 1: kingartur222 folded before Flop (didn't bet)
Seat 2: garigura (button) folded before Flop (didn't bet)
Seat 4: mhonielsen (small blind) folded before Flop
Seat 5: Kazacha (big blind) collected ($0.10)
Seat 6: crazydevill folded before Flop (didn't bet)



PokerStars Hand #166667819498:  Hold'em No Limit ($0.05/$0.10 USD) - 2017/02/23 16:08:06 ET
Table 'Rostia' 6-max Seat #5 is the button
Seat 1: paxit71 ($7.58 in chips) 
Seat 2: david_sara83 ($19.01 in chips) 
Seat 3: iThreeBarrel ($10.15 in chips) 
Seat 4: Hyd SK ($11.68 in chips) 
Seat 5: silsilviu ($7.67 in chips) 
Seat 6: Giyorod ($10.60 in chips) 
Giyorod: posts small blind $0.05
paxit71: posts big blind $0.10
*** HOLE CARDS ***
david_sara83: raises $0.20 to $0.30
iThreeBarrel: folds 
Hyd SK: folds 
silsilviu: folds 
Giyorod: folds 
paxit71: calls $0.20
*** FLOP *** [8s 9c 7c]
paxit71: checks 
david_sara83: bets $0.41
paxit71: calls $0.41
*** TURN *** [8s 9c 7c] [Kc]
paxit71: checks 
david_sara83: checks 
*** RIVER *** [8s 9c 7c Kc] [3d]
paxit71: bets $0.40
david_sara83: calls $0.40
*** SHOW DOWN ***
paxit71: shows [Ac Js] (high card Ace)
david_sara83: shows [Jd Jh] (a pair of Jacks)
david_sara83 collected $2.17 from pot
*** SUMMARY ***
Total pot $2.27 | Rake $0.10 
Board [8s 9c 7c Kc 3d]
Seat 1: paxit71 (big blind) showed [Ac Js] and lost with high card Ace
Seat 2: david_sara83 showed [Jd Jh] and won ($2.17) with a pair of Jacks
Seat 3: iThreeBarrel folded before Flop (didn't bet)
Seat 4: Hyd SK folded before Flop (didn't bet)
Seat 5: silsilviu (button) folded before Flop (didn't bet)
Seat 6: Giyorod (small blind) folded before Flop



PokerStars Hand #166667819602:  Hold'em No Limit ($0.05/$0.10 USD) - 2017/02/23 16:08:06 ET
Table 'Lobelia II' 6-max Seat #3 is the button
Seat 1: facewald ($22.65 in chips) 
Seat 2: Dcaro31 ($17.46 in chips) 
Seat 3: oddshoff ($19.10 in chips) 
Seat 5: Feverhead ($18.51 in chips) 
Seat 6: NvR.m1nD ($10.62 in chips) 
arti192837 will be allowed to play after the button
Feverhead: posts small blind $0.05
NvR.m1nD: posts big blind $0.10
*** HOLE CARDS ***
facewald: folds 
Dcaro31: folds 
oddshoff: raises $0.10 to $0.20
Feverhead: folds 
NvR.m1nD: calls $0.10
*** FLOP *** [Ks 2c Qs]
NvR.m1nD: checks 
oddshoff: bets $0.28
NvR.m1nD: calls $0.28
*** TURN *** [Ks 2c Qs] [7c]
NvR.m1nD: checks 
oddshoff: bets $0.64
NvR.m1nD: folds 
Uncalled bet ($0.64) returned to oddshoff
oddshoff collected $0.96 from pot
*** SUMMARY ***
Total pot $1.01 | Rake $0.05 
Board [Ks 2c Qs 7c]
Seat 1: facewald folded before Flop (didn't bet)
Seat 2: Dcaro31 folded before Flop (didn't bet)
Seat 3: oddshoff (button) collected ($0.96)
Seat 5: Feverhead (small blind) folded before Flop
Seat 6: NvR.m1nD (big blind) folded on the Turn



PokerStars Hand #166667819650:  Hold'em No Limit ($0.05/$0.10 USD) - 2017/02/23 16:08:06 ET
Table 'Nekkar' 6-max Seat #2 is the button
Seat 2: Bird et al ($10.87 in chips) 
Seat 3: Zemz_Ru ($15.61 in chips) 
Seat 4: kingartur222 ($12.25 in chips) 
Seat 5: Vrinni ($12.34 in chips) 
Seat 6: Eddys Edge ($10.48 in chips) 
Zemz_Ru: posts small blind $0.05
kingartur222: posts big blind $0.10
*** HOLE CARDS ***
Vrinni: folds 
Eddys Edge: folds 
Bird et al: folds 
Zemz_Ru: raises $0.10 to $0.20
kingartur222: folds 
Uncalled bet ($0.10) returned to Zemz_Ru
Zemz_Ru collected $0.20 from pot
*** SUMMARY ***
Total pot $0.20 | Rake $0 
Seat 2: Bird et al (button) folded before Flop (didn't bet)
Seat 3: Zemz_Ru (small blind) collected ($0.20)
Seat 4: kingartur222 (big blind) folded before Flop
Seat 5: Vrinni folded before Flop (didn't bet)
Seat 6: Eddys Edge folded before Flop (didn't bet)



PokerStars Hand #166667819901:  Hold'em No Limit ($0.05/$0.10 USD) - 2017/02/23 16:08:06 ET
Table 'Glarona' 6-max Seat #2 is the button
Seat 1: LarryTheStar ($10.20 in chips) 
Seat 2: BookWorm78 ($10 in chips) 
Seat 3: hoedje72 ($3.91 in chips) 
Seat 4: CrippledGod ($7.14 in chips) 
Seat 5: david_sara83 ($10.10 in chips) 
hoedje72: posts small blind $0.05
CrippledGod: posts big blind $0.10
marianoboni: sits out 
*** HOLE CARDS ***
david_sara83: raises $0.20 to $0.30
LarryTheStar: folds 
BookWorm78: folds 
hoedje72: calls $0.25
CrippledGod: folds 
*** FLOP *** [Js Ks 7c]
hoedje72: checks 
david_sara83: bets $0.39
hoedje72: calls $0.39
*** TURN *** [Js Ks 7c] [8s]
hoedje72: checks 
david_sara83: bets $0.99
hoedje72: calls $0.99
*** RIVER *** [Js Ks 7c 8s] [Kc]
hoedje72: checks 
david_sara83: bets $1.99
hoedje72: raises $0.24 to $2.23 and is all-in
david_sara83: calls $0.24
*** SHOW DOWN ***
hoedje72: shows [Ad Jh] (two pair, Kings and Jacks)
david_sara83: shows [6s 7s] (a flush, King high)
david_sara83 collected $7.56 from pot
*** SUMMARY ***
Total pot $7.92 | Rake $0.36 
Board [Js Ks 7c 8s Kc]
Seat 1: LarryTheStar folded before Flop (didn't bet)
Seat 2: BookWorm78 (button) folded before Flop (didn't bet)
Seat 3: hoedje72 (small blind) showed [Ad Jh] and lost with two pair, Kings and Jacks
Seat 4: CrippledGod (big blind) folded before Flop
Seat 5: david_sara83 showed [6s 7s] and won ($7.56) with a flush, King high



PokerStars Hand #166667820246:  Hold'em No Limit ($0.05/$0.10 USD) - 2017/02/23 16:08:07 ET
Table 'Armenia' 6-max Seat #6 is the button
Seat 1: tr41n3r12 ($11.57 in chips) 
Seat 2: Yabidooo ($10.98 in chips) 
Seat 3: Crimsonr ($5 in chips) 
Seat 4: mbkongstad ($9.60 in chips) 
Seat 6: mega spasser ($7.44 in chips) 
tr41n3r12: posts small blind $0.05
Yabidooo: posts big blind $0.10
Crimsonr: posts big blind $0.10
DrVzad: sits out 
*** HOLE CARDS ***
Crimsonr: checks 
mbkongstad: folds 
mega spasser: folds 
tr41n3r12: folds 
Yabidooo: checks 
*** FLOP *** [8h Jh 7h]
Yabidooo: checks 
Crimsonr: checks 
*** TURN *** [8h Jh 7h] [9c]
Yabidooo: checks 
Crimsonr: bets $0.50
Yabidooo: folds 
Uncalled bet ($0.50) returned to Crimsonr
Crimsonr collected $0.24 from pot
*** SUMMARY ***
Total pot $0.25 | Rake $0.01 
Board [8h Jh 7h 9c]
Seat 1: tr41n3r12 (small blind) folded before Flop
Seat 2: Yabidooo (big blind) folded on the Turn
Seat 3: Crimsonr collected ($0.24)
Seat 4: mbkongstad folded before Flop (didn't bet)
Seat 6: mega spasser (button) folded before Flop (didn't bet)



PokerStars Hand #166667820451:  Hold'em No Limit ($0.05/$0.10 USD) - 2017/02/23 16:08:07 ET
Table 'Joella' 6-max Seat #6 is the button
Seat 1: Dcaro31 ($12.58 in chips) 
Seat 2: Kaelyns_Bark ($9.34 in chips) 
Seat 3: Joker51_wtf! ($11.66 in chips) 
Seat 5: Anestakis777 ($3.84 in chips) 
Seat 6: dr.goofy ($10.70 in chips) 
Dcaro31: posts small blind $0.05
Kaelyns_Bark: posts big blind $0.10
KRZuff: sits out 
*** HOLE CARDS ***
Joker51_wtf!: folds 
Anestakis777: calls $0.10
dr.goofy: raises $0.30 to $0.40
Dcaro31: folds 
Kaelyns_Bark: calls $0.30
Anestakis777: calls $0.30
*** FLOP *** [6s 9h As]
Kaelyns_Bark: checks 
Anestakis777: bets $0.20
dr.goofy: raises $1.20 to $1.40
Kaelyns_Bark: folds 
Anestakis777: calls $1.20
*** TURN *** [6s 9h As] [Jc]
Anestakis777: checks 
dr.goofy: bets $2.30
Anestakis777: folds 
Uncalled bet ($2.30) returned to dr.goofy
dr.goofy collected $3.87 from pot
*** SUMMARY ***
Total pot $4.05 | Rake $0.18 
Board [6s 9h As Jc]
Seat 1: Dcaro31 (small blind) folded before Flop
Seat 2: Kaelyns_Bark (big blind) folded on the Flop
Seat 3: Joker51_wtf! folded before Flop (didn't bet)
Seat 5: Anestakis777 folded on the Turn
Seat 6: dr.goofy (button) collected ($3.87)



PokerStars Hand #166667820494:  Hold'em No Limit ($0.05/$0.10 USD) - 2017/02/23 16:08:07 ET
Table 'Virginia II' 6-max Seat #4 is the button
Seat 1: Iarlei ($11.41 in chips) 
Seat 2: Yspenyanin ($10 in chips) 
Seat 3: garigura ($15.73 in chips) 
Seat 4: onkelottoHH ($10.58 in chips) 
Seat 5: dr.goofy ($20.88 in chips) 
Seat 6: NvR.m1nD ($10.30 in chips) 
dr.goofy: posts small blind $0.05
NvR.m1nD: posts big blind $0.10
*** HOLE CARDS ***
Iarlei: folds 
Yspenyanin: folds 
garigura: folds 
onkelottoHH: folds 
dr.goofy: folds 
Uncalled bet ($0.05) returned to NvR.m1nD
NvR.m1nD collected $0.10 from pot
*** SUMMARY ***
Total pot $0.10 | Rake $0 
Seat 1: Iarlei folded before Flop (didn't bet)
Seat 2: Yspenyanin folded before Flop (didn't bet)
Seat 3: garigura folded before Flop (didn't bet)
Seat 4: onkelottoHH (button) folded before Flop (didn't bet)
Seat 5: dr.goofy (small blind) folded before Flop
Seat 6: NvR.m1nD (big blind) collected ($0.10)



PokerStars Hand #166667820824:  Hold'em No Limit ($0.05/$0.10 USD) - 2017/02/23 16:08:07 ET
Table 'Siebohme II' 6-max Seat #6 is the button
Seat 1: homelessdan ($17.72 in chips) 
Seat 2: townerz1991 ($14.17 in chips) 
Seat 3: D3NyA ($10.33 in chips) 
Seat 4: POT_TRADER ($12.14 in chips) 
Seat 5: NvR.m1nD ($11.04 in chips) 
Seat 6: Fozzy690 ($9.57 in chips) 
homelessdan: posts small blind $0.05
townerz1991: posts big blind $0.10
*** HOLE CARDS ***
D3NyA: folds 
POT_TRADER: folds 
NvR.m1nD: raises $0.15 to $0.25
Fozzy690: folds 
homelessdan: folds 
townerz1991: folds 
Uncalled bet ($0.15) returned to NvR.m1nD
NvR.m1nD collected $0.25 from pot
*** SUMMARY ***
Total pot $0.25 | Rake $0 
Seat 1: homelessdan (small blind) folded before Flop
Seat 2: townerz1991 (big blind) folded before Flop
Seat 3: D3NyA folded before Flop (didn't bet)
Seat 4: POT_TRADER folded before Flop (didn't bet)
Seat 5: NvR.m1nD collected ($0.25)
Seat 6: Fozzy690 (button) folded before Flop (didn't bet)



PokerStars Hand #166667820914:  Hold'em No Limit ($0.05/$0.10 USD) - 2017/02/23 16:08:07 ET
Table 'Fechtig III' 6-max Seat #6 is the button
Seat 1: Scanner17 ($12.14 in chips) 
Seat 2: GV82 ($17.33 in chips) 
Seat 3: eniksenik ($10 in chips) 
Seat 4: Kow6oy ($10 in chips) 
Seat 5: ksandr_hom ($10.10 in chips) 
Seat 6: Glatzemandse ($17.87 in chips) 
Scanner17: posts small blind $0.05
GV82: posts big blind $0.10
*** HOLE CARDS ***
eniksenik: folds 
Kow6oy: folds 
ksandr_hom: folds 
Glatzemandse: calls $0.10
Scanner17: calls $0.05
GV82: checks 
*** FLOP *** [9c 2d As]
Scanner17: checks 
GV82: bets $0.15
Glatzemandse: calls $0.15
Scanner17: folds 
*** TURN *** [9c 2d As] [6s]
GV82: bets $0.29
Glatzemandse: calls $0.29
*** RIVER *** [9c 2d As 6s] [5c]
GV82: checks 
Glatzemandse: bets $1.13
GV82: folds 
Uncalled bet ($1.13) returned to Glatzemandse
Glatzemandse collected $1.13 from pot
*** SUMMARY ***
Total pot $1.18 | Rake $0.05 
Board [9c 2d As 6s 5c]
Seat 1: Scanner17 (small blind) folded on the Flop
Seat 2: GV82 (big blind) folded on the River
Seat 3: eniksenik folded before Flop (didn't bet)
Seat 4: Kow6oy folded before Flop (didn't bet)
Seat 5: ksandr_hom folded before Flop (didn't bet)
Seat 6: Glatzemandse (button) collected ($1.13)



PokerStars Hand #166667820955:  Hold'em No Limit ($0.05/$0.10 USD) - 2017/02/23 16:08:08 ET
Table 'Nemo III' 6-max Seat #4 is the button
Seat 1: Kow6oy ($10 in chips) 
Seat 2: Bandyaev ($11.11 in chips) 
Seat 3: Dimka4 ($10 in chips) 
Seat 4: vtalian ($10.81 in chips) 
Seat 5: Joker51_wtf! ($11.18 in chips) 
Seat 6: maxiv608 ($10.15 in chips) 
Joker51_wtf!: posts small blind $0.05
maxiv608: posts big blind $0.10
*** HOLE CARDS ***
Kow6oy: folds 
Bandyaev: folds 
Dimka4: folds 
vtalian: raises $0.20 to $0.30
Joker51_wtf!: folds 
maxiv608: calls $0.20
*** FLOP *** [5c 6h 4d]
maxiv608: checks 
vtalian: bets $0.45
maxiv608: folds 
Uncalled bet ($0.45) returned to vtalian
vtalian collected $0.62 from pot
*** SUMMARY ***
Total pot $0.65 | Rake $0.03 
Board [5c 6h 4d]
Seat 1: Kow6oy folded before Flop (didn't bet)
Seat 2: Bandyaev folded before Flop (didn't bet)
Seat 3: Dimka4 folded before Flop (didn't bet)
Seat 4: vtalian (button) collected ($0.62)
Seat 5: Joker51_wtf! (small blind) folded before Flop
Seat 6: maxiv608 (big blind) folded on the Flop



PokerStars Hand #166667821123:  Hold'em No Limit ($0.05/$0.10 USD) - 2017/02/23 16:08:08 ET
Table 'Epimetheus' 6-max Seat #3 is the button
Seat 1: 6ePeMeHHa9 ($10.29 in chips) 
Seat 2: patrick19111 ($15.51 in chips) 
Seat 3: dineldidi ($9.84 in chips) 
Seat 4: Namhkal ($10 in chips) 
Seat 5: afca128 ($23.83 in chips) 
Seat 6: voledy ($10.60 in chips) 
Namhkal: posts small blind $0.05
afca128: posts big blind $0.10
*** HOLE CARDS ***
voledy: folds 
6ePeMeHHa9: folds 
patrick19111: folds 
dineldidi: folds 
Namhkal: raises $0.15 to $0.25
afca128: raises $0.50 to $0.75
Namhkal: folds 
Uncalled bet ($0.50) returned to afca128
afca128 collected $0.50 from pot
*** SUMMARY ***
Total pot $0.50 | Rake $0 
Seat 1: 6ePeMeHHa9 folded before Flop (didn't bet)
Seat 2: patrick19111 folded before Flop (didn't bet)
Seat 3: dineldidi (button) folded before Flop (didn't bet)
Seat 4: Namhkal (small blind) folded before Flop
Seat 5: afca128 (big blind) collected ($0.50)
Seat 6: voledy folded before Flop (didn't bet)



PokerStars Hand #166667821155:  Hold'em No Limit ($0.05/$0.10 USD) - 2017/02/23 16:08:08 ET
Table 'Esperanto II' 6-max Seat #4 is the button
Seat 1: kurasd ($10.50 in chips) 
Seat 2: MihaGr ($10.30 in chips) 
Seat 3: Namhkal ($11.95 in chips) 
Seat 4: Andrei ProFF ($10.20 in chips) 
Seat 5: FRAID358 ($10 in chips) 
Seat 6: ArcticBearDK ($13.65 in chips) 
FRAID358: posts small blind $0.05
ArcticBearDK: posts big blind $0.10
*** HOLE CARDS ***
kurasd: calls $0.10
MihaGr: folds 
Namhkal: folds 
Andrei ProFF: raises $0.30 to $0.40
FRAID358: raises $0.90 to $1.30
ArcticBearDK: folds 
kurasd: folds 
Andrei ProFF: folds 
Uncalled bet ($0.90) returned to FRAID358
FRAID358 collected $1 from pot
*** SUMMARY ***
Total pot $1 | Rake $0 
Seat 1: kurasd folded before Flop
Seat 2: MihaGr folded before Flop (didn't bet)
Seat 3: Namhkal folded before Flop (didn't bet)
Seat 4: Andrei ProFF (button) folded before Flop
Seat 5: FRAID358 (small blind) collected ($1)
Seat 6: ArcticBearDK (big blind) folded before Flop



PokerStars Hand #166667821213:  Hold'em No Limit ($0.05/$0.10 USD) - 2017/02/23 16:08:08 ET
Table 'Nata II' 6-max Seat #5 is the button
Seat 1: luisantrs ($8.65 in chips) 
Seat 2: CHRO8 ($16.02 in chips) 
Seat 3: 8th wonders ($10 in chips) 
Seat 4: Comeback3392 ($10 in chips) 
Seat 5: RoJ1 ($12.08 in chips) 
luisantrs: posts small blind $0.05
CHRO8: posts big blind $0.10
*** HOLE CARDS ***
8th wonders: raises $0.20 to $0.30
Comeback3392: folds 
RoJ1: folds 
luisantrs: folds 
CHRO8: calls $0.20
*** FLOP *** [9d 5d Qh]
CHRO8: checks 
8th wonders: bets $0.40
Andrei ProFF joins the table at seat #6 
Andrei ProFF leaves the table
CHRO8: calls $0.40
*** TURN *** [9d 5d Qh] [Jc]
RGhearted joins the table at seat #6 
CHRO8: checks 
8th wonders: bets $0.80
CHRO8: raises $1 to $1.80
8th wonders: calls $1
*** RIVER *** [9d 5d Qh Jc] [7h]
CHRO8: bets $13.52 and is all-in
8th wonders: folds 
Uncalled bet ($13.52) returned to CHRO8
CHRO8 collected $4.82 from pot
*** SUMMARY ***
Total pot $5.05 | Rake $0.23 
Board [9d 5d Qh Jc 7h]
Seat 1: luisantrs (small blind) folded before Flop
Seat 2: CHRO8 (big blind) collected ($4.82)
Seat 3: 8th wonders folded on the River
Seat 4: Comeback3392 folded before Flop (didn't bet)
Seat 5: RoJ1 (button) folded before Flop (didn't bet)



PokerStars Hand #166667821220:  Hold'em No Limit ($0.05/$0.10 USD) - 2017/02/23 16:08:08 ET
Table 'Tomita II' 6-max Seat #6 is the button
Seat 2: mhonielsen ($10.05 in chips) 
Seat 3: D3NyA ($10 in chips) 
Seat 4: Hyd SK ($11.41 in chips) 
Seat 5: ex3Lero86 ($10.10 in chips) 
Seat 6: saniasmir ($10 in chips) 
mhonielsen: posts small blind $0.05
D3NyA: posts big blind $0.10
*** HOLE CARDS ***
Hyd SK: folds 
ex3Lero86: folds 
saniasmir: folds 
mhonielsen: raises $0.10 to $0.20
D3NyA: folds 
Uncalled bet ($0.10) returned to mhonielsen
mhonielsen collected $0.20 from pot
*** SUMMARY ***
Total pot $0.20 | Rake $0 
Seat 2: mhonielsen (small blind) collected ($0.20)
Seat 3: D3NyA (big blind) folded before Flop
Seat 4: Hyd SK folded before Flop (didn't bet)
Seat 5: ex3Lero86 folded before Flop (didn't bet)
Seat 6: saniasmir (button) folded before Flop (didn't bet)



PokerStars Hand #166667821317:  Hold'em No Limit ($0.05/$0.10 USD) - 2017/02/23 16:08:08 ET
Table 'Lorbach' 6-max Seat #3 is the button
Seat 1: LarryTheStar ($17.49 in chips) 
Seat 3: ArcticBearDK ($10 in chips) 
Seat 4: McCleans ($10 in chips) 
Seat 5: Vanpoker84 ($8 in chips) 
Seat 6: Worlz ($15.73 in chips) 
McCleans: posts small blind $0.05
Vanpoker84: posts big blind $0.10
fabadam: sits out 
*** HOLE CARDS ***
Worlz: folds 
LarryTheStar: folds 
ArcticBearDK: folds 
McCleans: raises $0.20 to $0.30
Vanpoker84: calls $0.20
*** FLOP *** [Qc 3h 6s]
McCleans: bets $0.40
Vanpoker84: folds 
Uncalled bet ($0.40) returned to McCleans
McCleans collected $0.57 from pot
*** SUMMARY ***
Total pot $0.60 | Rake $0.03 
Board [Qc 3h 6s]
Seat 1: LarryTheStar folded before Flop (didn't bet)
Seat 3: ArcticBearDK (button) folded before Flop (didn't bet)
Seat 4: McCleans (small blind) collected ($0.57)
Seat 5: Vanpoker84 (big blind) folded on the Flop
Seat 6: Worlz folded before Flop (didn't bet)



PokerStars Hand #166667821366:  Hold'em No Limit ($0.05/$0.10 USD) - 2017/02/23 16:08:08 ET
Table 'Tristan III' 6-max Seat #4 is the button
Seat 1: CHRO8 ($18.18 in chips) 
Seat 2: Hyd SK ($13.88 in chips) 
Seat 3: fedorka rus ($26.67 in chips) 
Seat 4: Feverhead ($11.18 in chips) 
Seat 5: david_sara83 ($10.25 in chips) 
Seat 6: fredrik10528 ($10.05 in chips) 
david_sara83: posts small blind $0.05
fredrik10528: posts big blind $0.10
*** HOLE CARDS ***
CHRO8: calls $0.10
Hyd SK: folds 
fedorka rus: folds 
Feverhead: folds 
david_sara83: raises $0.30 to $0.40
fredrik10528: folds 
CHRO8: calls $0.30
*** FLOP *** [9s 3s 3d]
david_sara83: bets $0.49
CHRO8: calls $0.49
*** TURN *** [9s 3s 3d] [3c]
david_sara83: checks 
CHRO8: bets $1
david_sara83: folds 
Uncalled bet ($1) returned to CHRO8
CHRO8 collected $1.80 from pot
*** SUMMARY ***
Total pot $1.88 | Rake $0.08 
Board [9s 3s 3d 3c]
Seat 1: CHRO8 collected ($1.80)
Seat 2: Hyd SK folded before Flop (didn't bet)
Seat 3: fedorka rus folded before Flop (didn't bet)
Seat 4: Feverhead (button) folded before Flop (didn't bet)
Seat 5: david_sara83 (small blind) folded on the Turn
Seat 6: fredrik10528 (big blind) folded before Flop



PokerStars Hand #166667821394:  Hold'em No Limit ($0.05/$0.10 USD) - 2017/02/23 16:08:08 ET
Table 'Antielus II' 6-max Seat #5 is the button
Seat 1: Dcaro31 ($18.64 in chips) 
Seat 2: Orlangoor ($10 in chips) 
Seat 3: mcyi3at2 ($13.03 in chips) 
Seat 4: XwinX25 ($10 in chips) 
Seat 5: Hyd SK ($11.14 in chips) 
Seat 6: GiveTwoMe ($11.35 in chips) 
GiveTwoMe: posts small blind $0.05
Dcaro31: posts big blind $0.10
*** HOLE CARDS ***
Orlangoor: folds 
mcyi3at2: raises $0.20 to $0.30
XwinX25: calls $0.30
Hyd SK: raises $1 to $1.30
GiveTwoMe: folds 
Dcaro31: folds 
mcyi3at2: calls $1
XwinX25: folds 
*** FLOP *** [6h 4h Th]
mcyi3at2: checks 
Hyd SK: bets $1.46
mcyi3at2: folds 
Uncalled bet ($1.46) returned to Hyd SK
Hyd SK collected $2.91 from pot
*** SUMMARY ***
Total pot $3.05 | Rake $0.14 
Board [6h 4h Th]
Seat 1: Dcaro31 (big blind) folded before Flop
Seat 2: Orlangoor folded before Flop (didn't bet)
Seat 3: mcyi3at2 folded on the Flop
Seat 4: XwinX25 folded before Flop
Seat 5: Hyd SK (button) collected ($2.91)
Seat 6: GiveTwoMe (small blind) folded before Flop



PokerStars Hand #166667821647:  Hold'em No Limit ($0.05/$0.10 USD) - 2017/02/23 16:08:08 ET
Table 'Wabash' 6-max Seat #2 is the button
Seat 1: pivanki11 ($10 in chips) 
Seat 2: ex3Lero86 ($32.48 in chips) 
Seat 3: tauronex ($10 in chips) 
Seat 4: Nr847 ($10 in chips) 
Seat 5: popypaleta ($13.89 in chips) 
Seat 6: weez3r ($11.22 in chips) 
tauronex: posts small blind $0.05
Nr847: posts big blind $0.10
*** HOLE CARDS ***
popypaleta: folds 
weez3r: folds 
pivanki11: calls $0.10
ex3Lero86: folds 
tauronex: folds 
Nr847: raises $0.30 to $0.40
pivanki11: calls $0.30
*** FLOP *** [9c 6h Jc]
Nr847: bets $0.61
pivanki11: calls $0.61
*** TURN *** [9c 6h Jc] [Qc]
Nr847: bets $1.49
pivanki11: folds 
Uncalled bet ($1.49) returned to Nr847
Nr847 collected $1.98 from pot
*** SUMMARY ***
Total pot $2.07 | Rake $0.09 
Board [9c 6h Jc Qc]
Seat 1: pivanki11 folded on the Turn
Seat 2: ex3Lero86 (button) folded before Flop (didn't bet)
Seat 3: tauronex (small blind) folded before Flop
Seat 4: Nr847 (big blind) collected ($1.98)
Seat 5: popypaleta folded before Flop (didn't bet)
Seat 6: weez3r folded before Flop (didn't bet)



PokerStars Hand #166667821690:  Hold'em No Limit ($0.05/$0.10 USD) - 2017/02/23 16:08:08 ET
Table 'Union' 6-max Seat #2 is the button
Seat 1: IAntikI ($10 in chips) 
Seat 2: Zooplack ($10 in chips) 
Seat 3: Rodik002 ($11.91 in chips) 
Seat 4: Croplayer1 ($14.95 in chips) 
Seat 5: Chodemuncher ($16.15 in chips) 
Seat 6: bonyo71 ($4 in chips) 
Rodik002: posts small blind $0.05
Croplayer1: posts big blind $0.10
*** HOLE CARDS ***
Chodemuncher: folds 
bonyo71: folds 
IAntikI: folds 
Zooplack: raises $0.15 to $0.25
Rodik002: folds 
Croplayer1: folds 
Uncalled bet ($0.15) returned to Zooplack
Zooplack collected $0.25 from pot
*** SUMMARY ***
Total pot $0.25 | Rake $0 
Seat 1: IAntikI folded before Flop (didn't bet)
Seat 2: Zooplack (button) collected ($0.25)
Seat 3: Rodik002 (small blind) folded before Flop
Seat 4: Croplayer1 (big blind) folded before Flop
Seat 5: Chodemuncher folded before Flop (didn't bet)
Seat 6: bonyo71 folded before Flop (didn't bet)



PokerStars Hand #166667821947:  Hold'em No Limit ($0.05/$0.10 USD) - 2017/02/23 16:08:09 ET
Table 'Hunnia' 6-max Seat #4 is the button
Seat 1: univibe68 ($21.18 in chips) 
Seat 2: mhonielsen ($10.94 in chips) 
Seat 3: 6ePeMeHHa9 ($10.56 in chips) 
Seat 4: Jalida3 ($13.04 in chips) 
Seat 5: Smarkon ($15.04 in chips) 
Seat 6: ChuikaPridi ($10 in chips) 
Smarkon: posts small blind $0.05
ChuikaPridi: posts big blind $0.10
*** HOLE CARDS ***
univibe68: folds 
mhonielsen: folds 
6ePeMeHHa9: folds 
Jalida3: raises $0.20 to $0.30
Smarkon: calls $0.25
ChuikaPridi: calls $0.20
*** FLOP *** [4c 9s Td]
Smarkon: checks 
ChuikaPridi: checks 
Jalida3: bets $0.86
Smarkon: folds 
ChuikaPridi: raises $1.74 to $2.60
Jalida3: folds 
Uncalled bet ($1.74) returned to ChuikaPridi
ChuikaPridi collected $2.50 from pot
*** SUMMARY ***
Total pot $2.62 | Rake $0.12 
Board [4c 9s Td]
Seat 1: univibe68 folded before Flop (didn't bet)
Seat 2: mhonielsen folded before Flop (didn't bet)
Seat 3: 6ePeMeHHa9 folded before Flop (didn't bet)
Seat 4: Jalida3 (button) folded on the Flop
Seat 5: Smarkon (small blind) folded on the Flop
Seat 6: ChuikaPridi (big blind) collected ($2.50)



PokerStars Hand #166667822209:  Hold'em No Limit ($0.05/$0.10 USD) - 2017/02/23 16:08:09 ET
Table 'Risha II' 6-max Seat #1 is the button
Seat 1: R. Lemonte ($14.40 in chips) 
Seat 2: KA3AXCTAHEU, ($12.55 in chips) 
Seat 3: steepfell ($10.15 in chips) 
Seat 4: Comeback3392 ($19.68 in chips) 
Seat 5: m.c-alkatraz ($10.05 in chips) 
Seat 6: univibe68 ($10.61 in chips) 
KA3AXCTAHEU,: posts small blind $0.05
steepfell: posts big blind $0.10
*** HOLE CARDS ***
Comeback3392: folds 
m.c-alkatraz: folds 
univibe68: folds 
R. Lemonte: raises $0.20 to $0.30
KA3AXCTAHEU,: folds 
steepfell: folds 
Uncalled bet ($0.20) returned to R. Lemonte
R. Lemonte collected $0.25 from pot
*** SUMMARY ***
Total pot $0.25 | Rake $0 
Seat 1: R. Lemonte (button) collected ($0.25)
Seat 2: KA3AXCTAHEU, (small blind) folded before Flop
Seat 3: steepfell (big blind) folded before Flop
Seat 4: Comeback3392 folded before Flop (didn't bet)
Seat 5: m.c-alkatraz folded before Flop (didn't bet)
Seat 6: univibe68 folded before Flop (didn't bet)



PokerStars Hand #166667822696:  Hold'em No Limit ($0.05/$0.10 USD) - 2017/02/23 16:08:09 ET
Table 'Samitchell III' 6-max Seat #3 is the button
Seat 2: scorpionfish ($12.98 in chips) 
Seat 3: Vanne11 ($9.55 in chips) 
Seat 4: DEraser ($8.50 in chips) 
DEraser: posts small blind $0.05
steepfell: is sitting out 
fedorka rus: is sitting out 
dr.goofy: is sitting out 
scorpionfish: posts big blind $0.10
*** HOLE CARDS ***
Vanne11: folds 
DEraser: folds 
Uncalled bet ($0.05) returned to scorpionfish
scorpionfish collected $0.10 from pot
*** SUMMARY ***
Total pot $0.10 | Rake $0 
Seat 2: scorpionfish (big blind) collected ($0.10)
Seat 3: Vanne11 (button) folded before Flop (didn't bet)
Seat 4: DEraser (small blind) folded before Flop



PokerStars Hand #166667822870:  Hold'em No Limit ($0.05/$0.10 USD) - 2017/02/23 16:08:10 ET
Table 'Lehigh' 6-max Seat #3 is the button
Seat 1: kowe4ka565 ($8.51 in chips) 
Seat 2: Sbozzz ($13.22 in chips) 
Seat 3: Therodorus ($12.44 in chips) 
Seat 4: Chodemuncher ($10 in chips) 
Seat 5: Xander188 ($10.32 in chips) 
Seat 6: CallByValue ($9.70 in chips) 
Chodemuncher: posts small blind $0.05
Xander188: posts big blind $0.10
*** HOLE CARDS ***
CallByValue: folds 
kowe4ka565: folds 
Sbozzz: folds 
Therodorus: folds 
Chodemuncher: folds 
Uncalled bet ($0.05) returned to Xander188
CallByValue leaves the table
Xander188 collected $0.10 from pot
*** SUMMARY ***
Total pot $0.10 | Rake $0 
Seat 1: kowe4ka565 folded before Flop (didn't bet)
Seat 2: Sbozzz folded before Flop (didn't bet)
Seat 3: Therodorus (button) folded before Flop (didn't bet)
Seat 4: Chodemuncher (small blind) folded before Flop
Seat 5: Xander188 (big blind) collected ($0.10)
Seat 6: CallByValue folded before Flop (didn't bet)



PokerStars Hand #166667822874:  Hold'em No Limit ($0.05/$0.10 USD) - 2017/02/23 16:08:10 ET
Table 'Kunigunde II' 6-max Seat #1 is the button
Seat 1: facewald ($10.20 in chips) 
Seat 3: pancernik21 ($18.49 in chips) 
Seat 4: david_sara83 ($13.42 in chips) 
Seat 5: mdelfin0 ($11.44 in chips) 
Seat 6: Zooplack ($10 in chips) 
DrVzad will be allowed to play after the button
pancernik21: posts small blind $0.05
david_sara83: posts big blind $0.10
*** HOLE CARDS ***
mdelfin0: folds 
Zooplack: folds 
facewald: folds 
pancernik21: raises $0.20 to $0.30
david_sara83: raises $0.58 to $0.88
pancernik21: folds 
Uncalled bet ($0.58) returned to david_sara83
david_sara83 collected $0.60 from pot
*** SUMMARY ***
Total pot $0.60 | Rake $0 
Seat 1: facewald (button) folded before Flop (didn't bet)
Seat 3: pancernik21 (small blind) folded before Flop
Seat 4: david_sara83 (big blind) collected ($0.60)
Seat 5: mdelfin0 folded before Flop (didn't bet)
Seat 6: Zooplack folded before Flop (didn't bet)



PokerStars Hand #166667822975:  Hold'em No Limit ($0.05/$0.10 USD) - 2017/02/23 16:08:10 ET
Table 'Mesarthim' 6-max Seat #1 is the button
Seat 1: Mancuso2010 ($15.85 in chips) 
Seat 2: MühliJr ($13.04 in chips) 
Seat 3: Damage514 ($9.59 in chips) 
Seat 4: Strelok1974 ($10.11 in chips) 
Seat 5: Iarlei ($10 in chips) 
Seat 6: bdixon_5 ($8.81 in chips) 
MühliJr: posts small blind $0.05
Damage514: posts big blind $0.10
*** HOLE CARDS ***
Strelok1974: folds 
Iarlei: raises $0.20 to $0.30
bdixon_5: folds 
Mancuso2010: folds 
MühliJr: folds 
Damage514: folds 
Uncalled bet ($0.20) returned to Iarlei
Iarlei collected $0.25 from pot
*** SUMMARY ***
Total pot $0.25 | Rake $0 
Seat 1: Mancuso2010 (button) folded before Flop (didn't bet)
Seat 2: MühliJr (small blind) folded before Flop
Seat 3: Damage514 (big blind) folded before Flop
Seat 4: Strelok1974 folded before Flop (didn't bet)
Seat 5: Iarlei collected ($0.25)
Seat 6: bdixon_5 folded before Flop (didn't bet)



PokerStars Hand #166667823139:  Hold'em No Limit ($0.05/$0.10 USD) - 2017/02/23 16:08:10 ET
Table 'Eurydome II' 6-max Seat #5 is the button
Seat 1: rusu_rapid ($11.83 in chips) 
Seat 3: gaHy_HaXeP ($12.09 in chips) 
Seat 4: Smitty03300 ($10.32 in chips) 
Seat 5: kush-killa87 ($10.37 in chips) 
Seat 6: Jucatorul823 ($4.57 in chips) 
Jucatorul823: posts small blind $0.05
rusu_rapid: posts big blind $0.10
*** HOLE CARDS ***
gaHy_HaXeP: folds 
Smitty03300: raises $0.15 to $0.25
kush-killa87: calls $0.25
Jucatorul823: folds 
rusu_rapid: folds 
*** FLOP *** [2h 8h 5h]
Smitty03300: checks 
kush-killa87: checks 
*** TURN *** [2h 8h 5h] [Ah]
Smitty03300: checks 
kush-killa87: bets $0.30
Smitty03300: folds 
Uncalled bet ($0.30) returned to kush-killa87
kush-killa87 collected $0.62 from pot
*** SUMMARY ***
Total pot $0.65 | Rake $0.03 
Board [2h 8h 5h Ah]
Seat 1: rusu_rapid (big blind) folded before Flop
Seat 3: gaHy_HaXeP folded before Flop (didn't bet)
Seat 4: Smitty03300 folded on the Turn
Seat 5: kush-killa87 (button) collected ($0.62)
Seat 6: Jucatorul823 (small blind) folded before Flop



PokerStars Hand #166667823164:  Hold'em No Limit ($0.05/$0.10 USD) - 2017/02/23 16:08:10 ET
Table 'Manto II' 6-max Seat #5 is the button
Seat 1: ex3Lero86 ($10 in chips) 
Seat 2: voledy ($10.57 in chips) 
Seat 3: Komap511 ($9.55 in chips) 
Seat 4: dr.goofy ($14.96 in chips) 
Seat 5: ArcticBearDK ($32.54 in chips) 
Seat 6: pancernik21 ($16.25 in chips) 
pancernik21: posts small blind $0.05
ex3Lero86: posts big blind $0.10
*** HOLE CARDS ***
voledy: folds 
Komap511: raises $0.20 to $0.30
dr.goofy: folds 
ArcticBearDK: folds 
pancernik21: folds 
ex3Lero86: folds 
Uncalled bet ($0.20) returned to Komap511
Komap511 collected $0.25 from pot
*** SUMMARY ***
Total pot $0.25 | Rake $0 
Seat 1: ex3Lero86 (big blind) folded before Flop
Seat 2: voledy folded before Flop (didn't bet)
Seat 3: Komap511 collected ($0.25)
Seat 4: dr.goofy folded before Flop (didn't bet)
Seat 5: ArcticBearDK (button) folded before Flop (didn't bet)
Seat 6: pancernik21 (small blind) folded before Flop



PokerStars Hand #166667823241:  Hold'em No Limit ($0.05/$0.10 USD) - 2017/02/23 16:08:10 ET
Table 'Halawe II' 6-max Seat #1 is the button
Seat 1: DIGOR100 ($6.16 in chips) 
Seat 3: cherep61987 ($10.69 in chips) 
Seat 4: voledy ($12.15 in chips) 
Seat 5: takis nik ($12.28 in chips) 
Seat 6: Rodik002 ($21.56 in chips) 
cherep61987: posts small blind $0.05
voledy: posts big blind $0.10
*** HOLE CARDS ***
takis nik: raises $0.20 to $0.30
Rodik002: raises $0.70 to $1
DIGOR100: folds 
cherep61987: folds 
voledy: folds 
takis nik: folds 
Uncalled bet ($0.70) returned to Rodik002
Rodik002 collected $0.75 from pot
*** SUMMARY ***
Total pot $0.75 | Rake $0 
Seat 1: DIGOR100 (button) folded before Flop (didn't bet)
Seat 3: cherep61987 (small blind) folded before Flop
Seat 4: voledy (big blind) folded before Flop
Seat 5: takis nik folded before Flop
Seat 6: Rodik002 collected ($0.75)



PokerStars Hand #166667823437:  Hold'em No Limit ($0.05/$0.10 USD) - 2017/02/23 16:08:10 ET
Table 'Peiroos' 6-max Seat #5 is the button
Seat 1: ksandr_hom ($10 in chips) 
Seat 2: Nr847 ($10.95 in chips) 
Seat 3: atlx0711 ($25.69 in chips) 
Seat 4: Peter0087 ($9.85 in chips) 
Seat 5: sergio-cb164 ($8.50 in chips) 
Seat 6: DevonMiles88 ($5.55 in chips) 
DevonMiles88: posts small blind $0.05
ksandr_hom: posts big blind $0.10
*** HOLE CARDS ***
Nr847: folds 
atlx0711: folds 
Peter0087: folds 
sergio-cb164: folds 
DevonMiles88: raises $0.20 to $0.30
ksandr_hom: folds 
Uncalled bet ($0.20) returned to DevonMiles88
DevonMiles88 collected $0.20 from pot
*** SUMMARY ***
Total pot $0.20 | Rake $0 
Seat 1: ksandr_hom (big blind) folded before Flop
Seat 2: Nr847 folded before Flop (didn't bet)
Seat 3: atlx0711 folded before Flop (didn't bet)
Seat 4: Peter0087 folded before Flop (didn't bet)
Seat 5: sergio-cb164 (button) folded before Flop (didn't bet)
Seat 6: DevonMiles88 (small blind) collected ($0.20)



PokerStars Hand #166667823531:  Hold'em No Limit ($0.05/$0.10 USD) - 2017/02/23 16:08:10 ET
Table 'Girtab' 6-max Seat #1 is the button
Seat 1: pokekrk ($17.17 in chips) 
Seat 2: MühliJr ($10 in chips) 
Seat 3: kingartur222 ($10.45 in chips) 
Seat 4: Hyd SK ($10.88 in chips) 
Seat 5: sexy_seagull ($11.20 in chips) 
Seat 6: iluzja12 ($10 in chips) 
MühliJr: posts small blind $0.05
kingartur222: posts big blind $0.10
*** HOLE CARDS ***
Hyd SK: folds 
sexy_seagull: folds 
iluzja12: folds 
pokekrk: raises $0.10 to $0.20
MühliJr: folds 
kingartur222: folds 
Uncalled bet ($0.10) returned to pokekrk
pokekrk collected $0.25 from pot
*** SUMMARY ***
Total pot $0.25 | Rake $0 
Seat 1: pokekrk (button) collected ($0.25)
Seat 2: MühliJr (small blind) folded before Flop
Seat 3: kingartur222 (big blind) folded before Flop
Seat 4: Hyd SK folded before Flop (didn't bet)
Seat 5: sexy_seagull folded before Flop (didn't bet)
Seat 6: iluzja12 folded before Flop (didn't bet)



PokerStars Hand #166667823871:  Hold'em No Limit ($0.05/$0.10 USD) - 2017/02/23 16:08:11 ET
Table 'Grietje' 6-max Seat #6 is the button
Seat 1: dragonste89 ($10 in chips) 
Seat 2: Feverhead ($12.72 in chips) 
Seat 3: GitoValdivia ($3.87 in chips) 
Seat 4: MihaGr ($10.71 in chips) 
Seat 5: iThreeBarrel ($10 in chips) 
Seat 6: Prometheu$8 ($26.37 in chips) 
dragonste89: posts small blind $0.05
Feverhead: posts big blind $0.10
*** HOLE CARDS ***
GitoValdivia: folds 
MihaGr: folds 
iThreeBarrel: folds 
Prometheu$8: raises $0.15 to $0.25
dragonste89: folds 
Feverhead: folds 
Uncalled bet ($0.15) returned to Prometheu$8
Prometheu$8 collected $0.25 from pot
*** SUMMARY ***
Total pot $0.25 | Rake $0 
Seat 1: dragonste89 (small blind) folded before Flop
Seat 2: Feverhead (big blind) folded before Flop
Seat 3: GitoValdivia folded before Flop (didn't bet)
Seat 4: MihaGr folded before Flop (didn't bet)
Seat 5: iThreeBarrel folded before Flop (didn't bet)
Seat 6: Prometheu$8 (button) collected ($0.25)



PokerStars Hand #166667824028:  Hold'em No Limit ($0.05/$0.10 USD) - 2017/02/23 16:08:11 ET
Table 'Jacchia' 6-max Seat #3 is the button
Seat 1: viklundm ($35.63 in chips) 
Seat 2: VAD21 ($20.06 in chips) 
Seat 3: maxiv608 ($10 in chips) 
Seat 4: paterthomas ($9.56 in chips) 
Seat 5: arti192837 ($11.59 in chips) 
Seat 6: RoJ1 ($12.11 in chips) 
paterthomas: posts small blind $0.05
arti192837: posts big blind $0.10
*** HOLE CARDS ***
RoJ1: folds 
viklundm: calls $0.10
VAD21: raises $0.30 to $0.40
maxiv608: folds 
paterthomas: folds 
arti192837: folds 
viklundm: calls $0.30
*** FLOP *** [As Jc 7d]
viklundm: checks 
VAD21: checks 
*** TURN *** [As Jc 7d] [8d]
viklundm: bets $0.50
VAD21: calls $0.50
*** RIVER *** [As Jc 7d 8d] [7h]
viklundm: bets $0.90
VAD21: raises $1.30 to $2.20
viklundm: calls $1.30
*** SHOW DOWN ***
VAD21: shows [Ad Kh] (two pair, Aces and Sevens)
viklundm: mucks hand 
VAD21 collected $6.06 from pot
*** SUMMARY ***
Total pot $6.35 | Rake $0.29 
Board [As Jc 7d 8d 7h]
Seat 1: viklundm mucked
Seat 2: VAD21 showed [Ad Kh] and won ($6.06) with two pair, Aces and Sevens
Seat 3: maxiv608 (button) folded before Flop (didn't bet)
Seat 4: paterthomas (small blind) folded before Flop
Seat 5: arti192837 (big blind) folded before Flop
Seat 6: RoJ1 folded before Flop (didn't bet)



PokerStars Hand #166667825038:  Hold'em No Limit ($0.05/$0.10 USD) - 2017/02/23 16:08:12 ET
Table 'Rotraut' 6-max Seat #6 is the button
Seat 1: Hypermetal ($13.19 in chips) 
Seat 2: Newqbrown ($11.75 in chips) 
Seat 3: FlackoD ($12.41 in chips) 
Seat 5: Bird et al ($12.23 in chips) 
Seat 6: KokoulinV ($11.23 in chips) 
Hypermetal: posts small blind $0.05
Newqbrown: posts big blind $0.10
*** HOLE CARDS ***
FlackoD: raises $0.10 to $0.20
Bird et al: folds 
KokoulinV: folds 
Hypermetal: folds 
Newqbrown: calls $0.10
*** FLOP *** [8h 6c 9s]
Newqbrown: checks 
FlackoD: bets $0.30
Newqbrown: calls $0.30
*** TURN *** [8h 6c 9s] [Ks]
Newqbrown: checks 
FlackoD: bets $0.60
Newqbrown: calls $0.60
*** RIVER *** [8h 6c 9s Ks] [4h]
Newqbrown: checks 
FlackoD: checks 
*** SHOW DOWN ***
Newqbrown: shows [Ts Qs] (high card King)
FlackoD: shows [As 6s] (a pair of Sixes)
FlackoD collected $2.15 from pot
*** SUMMARY ***
Total pot $2.25 | Rake $0.10 
Board [8h 6c 9s Ks 4h]
Seat 1: Hypermetal (small blind) folded before Flop
Seat 2: Newqbrown (big blind) showed [Ts Qs] and lost with high card King
Seat 3: FlackoD showed [As 6s] and won ($2.15) with a pair of Sixes
Seat 5: Bird et al folded before Flop (didn't bet)
Seat 6: KokoulinV (button) folded before Flop (didn't bet)



PokerStars Hand #166667825698:  Hold'em No Limit ($0.05/$0.10 USD) - 2017/02/23 16:08:13 ET
Table 'Orthos III' 6-max Seat #1 is the button
Seat 1: sexy_seagull ($11.12 in chips) 
Seat 2: Xander188 ($19.36 in chips) 
Seat 3: koka4cs ($5.75 in chips) 
Seat 4: FlopsterGB ($16.50 in chips) 
Seat 5: Bird et al ($18.31 in chips) 
Seat 6: RoJ1 ($10.64 in chips) 
Xander188: posts small blind $0.05
koka4cs: posts big blind $0.10
*** HOLE CARDS ***
FlopsterGB: folds 
Bird et al: folds 
RoJ1: folds 
sexy_seagull: folds 
Xander188: folds 
Uncalled bet ($0.05) returned to koka4cs
koka4cs collected $0.10 from pot
*** SUMMARY ***
Total pot $0.10 | Rake $0 
Seat 1: sexy_seagull (button) folded before Flop (didn't bet)
Seat 2: Xander188 (small blind) folded before Flop
Seat 3: koka4cs (big blind) collected ($0.10)
Seat 4: FlopsterGB folded before Flop (didn't bet)
Seat 5: Bird et al folded before Flop (didn't bet)
Seat 6: RoJ1 folded before Flop (didn't bet)



PokerStars Hand #166667825850:  Hold'em No Limit ($0.05/$0.10 USD) - 2017/02/23 16:08:13 ET
Table 'Reginhild' 6-max Seat #4 is the button
Seat 1: iamkakaroto ($11.25 in chips) 
Seat 2: Kow6oy ($10.10 in chips) 
Seat 3: ARCHITECT83 ($8.03 in chips) 
Seat 4: Raymondo21 ($22.38 in chips) 
Seat 5: XCarlos610 ($29.48 in chips) 
Seat 6: eniksenik ($10 in chips) 
XCarlos610: posts small blind $0.05
eniksenik: posts big blind $0.10
*** HOLE CARDS ***
iamkakaroto: folds 
Kow6oy: raises $0.25 to $0.35
ARCHITECT83: folds 
Raymondo21: calls $0.35
XCarlos610: folds 
eniksenik: calls $0.25
*** FLOP *** [5s Td 6d]
eniksenik: checks 
Kow6oy: checks 
Raymondo21: bets $0.60
eniksenik: folds 
Kow6oy: folds 
Uncalled bet ($0.60) returned to Raymondo21
Raymondo21 collected $1.05 from pot
*** SUMMARY ***
Total pot $1.10 | Rake $0.05 
Board [5s Td 6d]
Seat 1: iamkakaroto folded before Flop (didn't bet)
Seat 2: Kow6oy folded on the Flop
Seat 3: ARCHITECT83 folded before Flop (didn't bet)
Seat 4: Raymondo21 (button) collected ($1.05)
Seat 5: XCarlos610 (small blind) folded before Flop
Seat 6: eniksenik (big blind) folded on the Flop



PokerStars Hand #166667825921:  Hold'em No Limit ($0.05/$0.10 USD) - 2017/02/23 16:08:13 ET
Table 'Peiroos III' 6-max Seat #1 is the button
Seat 1: tequila_joop ($9.93 in chips) 
Seat 3: nabatov.m ($6.31 in chips) 
Seat 4: pivanki11 ($10.88 in chips) 
Seat 5: ChuikaPridi ($10.21 in chips) 
Seat 6: CHRO8 ($10.43 in chips) 
nabatov.m: posts small blind $0.05
pivanki11: posts big blind $0.10
tequila_joop: posts the ante $0.02
nabatov.m: posts the ante $0.02
pivanki11: posts the ante $0.02
ChuikaPridi: posts the ante $0.02
CHRO8: posts the ante $0.02
*** HOLE CARDS ***
ChuikaPridi: raises $0.20 to $0.30
CHRO8: folds 
tequila_joop: calls $0.30
nabatov.m: folds 
pivanki11: calls $0.20
*** FLOP *** [Ad As 2c]
pivanki11: checks 
ChuikaPridi: checks 
tequila_joop: checks 
*** TURN *** [Ad As 2c] [5d]
pivanki11: checks 
ChuikaPridi: checks 
tequila_joop: checks 
*** RIVER *** [Ad As 2c 5d] [7d]
pivanki11: checks 
ChuikaPridi: checks 
tequila_joop: checks 
*** SHOW DOWN ***
pivanki11: shows [Kc Td] (a pair of Aces)
ChuikaPridi: shows [7c 6c] (two pair, Aces and Sevens)
tequila_joop: mucks hand 
ChuikaPridi collected $1 from pot
*** SUMMARY ***
Total pot $1.05 | Rake $0.05 
Board [Ad As 2c 5d 7d]
Seat 1: tequila_joop (button) mucked
Seat 3: nabatov.m (small blind) folded before Flop
Seat 4: pivanki11 (big blind) showed [Kc Td] and lost with a pair of Aces
Seat 5: ChuikaPridi showed [7c 6c] and won ($1) with two pair, Aces and Sevens
Seat 6: CHRO8 folded before Flop (didn't bet)



PokerStars Hand #166667826133:  Hold'em No Limit ($0.05/$0.10 USD) - 2017/02/23 16:08:13 ET
Table 'Iduberga II' 6-max Seat #4 is the button
Seat 1: mhonielsen ($11.06 in chips) 
Seat 2: popypaleta ($12.95 in chips) 
Seat 3: scorpionfish ($11.43 in chips) 
Seat 4: Peter0087 ($9.68 in chips) 
Seat 5: Pokeaster ($11.57 in chips) 
Seat 6: tblocos ($11.09 in chips) 
Pokeaster: posts small blind $0.05
tblocos: posts big blind $0.10
*** HOLE CARDS ***
mhonielsen: folds 
popypaleta: folds 
scorpionfish: folds 
Peter0087: folds 
Pokeaster: folds 
Uncalled bet ($0.05) returned to tblocos
tblocos collected $0.10 from pot
*** SUMMARY ***
Total pot $0.10 | Rake $0 
Seat 1: mhonielsen folded before Flop (didn't bet)
Seat 2: popypaleta folded before Flop (didn't bet)
Seat 3: scorpionfish folded before Flop (didn't bet)
Seat 4: Peter0087 (button) folded before Flop (didn't bet)
Seat 5: Pokeaster (small blind) folded before Flop
Seat 6: tblocos (big blind) collected ($0.10)



PokerStars Hand #166667826457:  Hold'em No Limit ($0.05/$0.10 USD) - 2017/02/23 16:08:14 ET
Table 'Stroobantia' 6-max Seat #3 is the button
Seat 1: mam9zyc ($9.19 in chips) 
Seat 2: XwinX25 ($10 in chips) 
Seat 3: Namhkal ($10.60 in chips) 
Seat 4: Yspenyanin ($10 in chips) 
Seat 5: boxer821 ($10.99 in chips) 
Seat 6: KokoulinV ($15.67 in chips) 
Yspenyanin: posts small blind $0.05
boxer821: posts big blind $0.10
*** HOLE CARDS ***
KokoulinV: folds 
mam9zyc: folds 
XwinX25: raises $0.20 to $0.30
Namhkal: raises $0.60 to $0.90
Yspenyanin: folds 
boxer821: folds 
XwinX25: folds 
Uncalled bet ($0.60) returned to Namhkal
Namhkal collected $0.75 from pot
*** SUMMARY ***
Total pot $0.75 | Rake $0 
Seat 1: mam9zyc folded before Flop (didn't bet)
Seat 2: XwinX25 folded before Flop
Seat 3: Namhkal (button) collected ($0.75)
Seat 4: Yspenyanin (small blind) folded before Flop
Seat 5: boxer821 (big blind) folded before Flop
Seat 6: KokoulinV folded before Flop (didn't bet)



PokerStars Hand #166667826666:  Hold'em No Limit ($0.05/$0.10 USD) - 2017/02/23 16:08:14 ET
Table 'Tyndareus II' 6-max Seat #2 is the button
Seat 1: Makc1705 ($4.39 in chips) 
Seat 2: fishhook5 ($10 in chips) 
Seat 3: McCleans ($11.45 in chips) 
Seat 4: gaHy_HaXeP ($10.61 in chips) 
Seat 5: vtalian ($9.85 in chips) 
Seat 6: sexy_seagull ($10.15 in chips) 
McCleans: posts small blind $0.05
gaHy_HaXeP: posts big blind $0.10
*** HOLE CARDS ***
vtalian: folds 
sexy_seagull: raises $0.20 to $0.30
Makc1705: folds 
fishhook5: folds 
McCleans: folds 
gaHy_HaXeP: folds 
Uncalled bet ($0.20) returned to sexy_seagull
sexy_seagull collected $0.25 from pot
*** SUMMARY ***
Total pot $0.25 | Rake $0 
Seat 1: Makc1705 folded before Flop (didn't bet)
Seat 2: fishhook5 (button) folded before Flop (didn't bet)
Seat 3: McCleans (small blind) folded before Flop
Seat 4: gaHy_HaXeP (big blind) folded before Flop
Seat 5: vtalian folded before Flop (didn't bet)
Seat 6: sexy_seagull collected ($0.25)



PokerStars Hand #166667826741:  Hold'em No Limit ($0.05/$0.10 USD) - 2017/02/23 16:08:14 ET
Table 'Kobresia II' 6-max Seat #2 is the button
Seat 1: RoJ1 ($13.94 in chips) 
Seat 2: Dcaro31 ($13.14 in chips) 
Seat 3: FRAID358 ($10.74 in chips) 
Seat 5: Goroshkos88 ($12.32 in chips) 
Seat 6: WinninBikini ($10 in chips) 
FRAID358: posts small blind $0.05
Goroshkos88: posts big blind $0.10
*** HOLE CARDS ***
WinninBikini: folds 
armstv leaves the table
RoJ1: folds 
Namhkal joins the table at seat #4 
Namhkal leaves the table
Dcaro31: folds 
FRAID358: folds 
Uncalled bet ($0.05) returned to Goroshkos88
Goroshkos88 collected $0.10 from pot
*** SUMMARY ***
Total pot $0.10 | Rake $0 
Seat 1: RoJ1 folded before Flop (didn't bet)
Seat 2: Dcaro31 (button) folded before Flop (didn't bet)
Seat 3: FRAID358 (small blind) folded before Flop
Seat 5: Goroshkos88 (big blind) collected ($0.10)
Seat 6: WinninBikini folded before Flop (didn't bet)



PokerStars Hand #166667826831:  Hold'em No Limit ($0.05/$0.10 USD) - 2017/02/23 16:08:14 ET
Table 'Crommelin II' 6-max Seat #1 is the button
Seat 1: THIMUCHIN ($11.42 in chips) 
Seat 2: Bird et al ($10.05 in chips) 
Seat 3: Strelok1974 ($19.78 in chips) 
Seat 4: Pequeño Clau ($12.97 in chips) 
Seat 5: Action_Gibi ($19.30 in chips) 
Bird et al: posts small blind $0.05
Strelok1974: posts big blind $0.10
*** HOLE CARDS ***
Pequeño Clau: folds 
Action_Gibi: folds 
THIMUCHIN: folds 
Bird et al: folds 
Uncalled bet ($0.05) returned to Strelok1974
Strelok1974 collected $0.10 from pot
*** SUMMARY ***
Total pot $0.10 | Rake $0 
Seat 1: THIMUCHIN (button) folded before Flop (didn't bet)
Seat 2: Bird et al (small blind) folded before Flop
Seat 3: Strelok1974 (big blind) collected ($0.10)
Seat 4: Pequeño Clau folded before Flop (didn't bet)
Seat 5: Action_Gibi folded before Flop (didn't bet)



PokerStars Hand #166667826857:  Hold'em No Limit ($0.05/$0.10 USD) - 2017/02/23 16:08:14 ET
Table 'Lagrula' 6-max Seat #2 is the button
Seat 1: Ice_Isayev ($10 in chips) 
Seat 2: KRZuff ($10 in chips) 
Seat 3: micke667 ($15.64 in chips) 
Seat 4: Calimero2408 ($13.18 in chips) 
Seat 5: Iarlei ($10 in chips) 
Seat 6: Spud014 ($10 in chips) 
micke667: posts small blind $0.05
Calimero2408: posts big blind $0.10
*** HOLE CARDS ***
Iarlei: folds 
Spud014: folds 
Ice_Isayev: folds 
KRZuff: folds 
micke667: calls $0.05
Calimero2408: checks 
*** FLOP *** [6s Td 9s]
micke667: checks 
Calimero2408: checks 
*** TURN *** [6s Td 9s] [4d]
micke667: bets $0.10
Calimero2408: calls $0.10
*** RIVER *** [6s Td 9s 4d] [3c]
micke667: bets $0.20
Calimero2408: calls $0.20
*** SHOW DOWN ***
micke667: shows [8h Ts] (a pair of Tens)
Calimero2408: mucks hand 
micke667 collected $0.76 from pot
*** SUMMARY ***
Total pot $0.80 | Rake $0.04 
Board [6s Td 9s 4d 3c]
Seat 1: Ice_Isayev folded before Flop (didn't bet)
Seat 2: KRZuff (button) folded before Flop (didn't bet)
Seat 3: micke667 (small blind) showed [8h Ts] and won ($0.76) with a pair of Tens
Seat 4: Calimero2408 (big blind) mucked
Seat 5: Iarlei folded before Flop (didn't bet)
Seat 6: Spud014 folded before Flop (didn't bet)



PokerStars Hand #166667826919:  Hold'em No Limit ($0.05/$0.10 USD) - 2017/02/23 16:08:14 ET
Table 'Oongaq' 6-max Seat #5 is the button
Seat 1: Dmitrij218 ($14.04 in chips) 
Seat 2: homelessdan ($18.40 in chips) 
Seat 3: iDecMate ($10.09 in chips) 
Seat 4: Bird et al ($10 in chips) 
Seat 5: Dizzler1991 ($5.13 in chips) 
Seat 6: boxer821 ($10 in chips) 
boxer821: posts small blind $0.05
Dmitrij218: posts big blind $0.10
*** HOLE CARDS ***
homelessdan: folds 
iDecMate: raises $0.20 to $0.30
Bird et al: folds 
Dizzler1991: folds 
boxer821: calls $0.25
Dmitrij218: folds 
*** FLOP *** [Ah 3s 8h]
boxer821: checks 
iDecMate: bets $0.45
boxer821: folds 
Uncalled bet ($0.45) returned to iDecMate
iDecMate collected $0.67 from pot
*** SUMMARY ***
Total pot $0.70 | Rake $0.03 
Board [Ah 3s 8h]
Seat 1: Dmitrij218 (big blind) folded before Flop
Seat 2: homelessdan folded before Flop (didn't bet)
Seat 3: iDecMate collected ($0.67)
Seat 4: Bird et al folded before Flop (didn't bet)
Seat 5: Dizzler1991 (button) folded before Flop (didn't bet)
Seat 6: boxer821 (small blind) folded on the Flop



PokerStars Hand #166667827027:  Hold'em No Limit ($0.05/$0.10 USD) - 2017/02/23 16:08:14 ET
Table 'Deflotte' 6-max Seat #3 is the button
Seat 1: Zooplack ($16.16 in chips) 
Seat 2: MonteCris92 ($10.15 in chips) 
Seat 3: Croplayer1 ($10.15 in chips) 
Seat 4: 8th wonders ($10.07 in chips) 
Seat 5: Pokeaster ($11.47 in chips) 
Seat 6: Iarlei ($11.60 in chips) 
8th wonders: posts small blind $0.05
Pokeaster: posts big blind $0.10
*** HOLE CARDS ***
Iarlei: folds 
Zooplack: folds 
MonteCris92: folds 
Croplayer1: raises $0.10 to $0.20
8th wonders: raises $0.60 to $0.80
Pokeaster: folds 
Croplayer1: folds 
Uncalled bet ($0.60) returned to 8th wonders
8th wonders collected $0.50 from pot
*** SUMMARY ***
Total pot $0.50 | Rake $0 
Seat 1: Zooplack folded before Flop (didn't bet)
Seat 2: MonteCris92 folded before Flop (didn't bet)
Seat 3: Croplayer1 (button) folded before Flop
Seat 4: 8th wonders (small blind) collected ($0.50)
Seat 5: Pokeaster (big blind) folded before Flop
Seat 6: Iarlei folded before Flop (didn't bet)



PokerStars Hand #166667827028:  Hold'em No Limit ($0.05/$0.10 USD) - 2017/02/23 16:08:14 ET
Table 'Xanthippe II' 6-max Seat #2 is the button
Seat 2: Bird et al ($10.23 in chips) 
Seat 3: Dcaro31 ($14.66 in chips) 
Seat 6: Orlangoor ($13.03 in chips) 
Dcaro31: posts small blind $0.05
yodzik: is sitting out 
Orlangoor: posts big blind $0.10
*** HOLE CARDS ***
Bird et al: folds 
Dcaro31: folds 
Uncalled bet ($0.05) returned to Orlangoor
ade22345 leaves the table
Orlangoor collected $0.10 from pot
*** SUMMARY ***
Total pot $0.10 | Rake $0 
Seat 2: Bird et al (button) folded before Flop (didn't bet)
Seat 3: Dcaro31 (small blind) folded before Flop
Seat 6: Orlangoor (big blind) collected ($0.10)



PokerStars Hand #166667827250:  Hold'em No Limit ($0.05/$0.10 USD) - 2017/02/23 16:08:14 ET
Table 'Pirola III' 6-max Seat #1 is the button
Seat 1: bdixon_5 ($9.32 in chips) 
Seat 2: Chodemuncher ($10 in chips) 
Seat 3: kingartur222 ($10.82 in chips) 
Seat 4: McCleans ($10.87 in chips) 
Seat 5: tequila_joop ($9.68 in chips) 
Seat 6: T9MS ($11.01 in chips) 
Chodemuncher: posts small blind $0.05
kingartur222: posts big blind $0.10
*** HOLE CARDS ***
McCleans: folds 
tequila_joop: folds 
T9MS: folds 
bdixon_5: folds 
Chodemuncher: folds 
Uncalled bet ($0.05) returned to kingartur222
kingartur222 collected $0.10 from pot
*** SUMMARY ***
Total pot $0.10 | Rake $0 
Seat 1: bdixon_5 (button) folded before Flop (didn't bet)
Seat 2: Chodemuncher (small blind) folded before Flop
Seat 3: kingartur222 (big blind) collected ($0.10)
Seat 4: McCleans folded before Flop (didn't bet)
Seat 5: tequila_joop folded before Flop (didn't bet)
Seat 6: T9MS folded before Flop (didn't bet)



PokerStars Hand #166667827264:  Hold'em No Limit ($0.05/$0.10 USD) - 2017/02/23 16:08:14 ET
Table 'Camilla II' 6-max Seat #1 is the button
Seat 1: paxit71 ($7.90 in chips) 
Seat 2: Giyorod ($13.36 in chips) 
Seat 3: Andy Wolf ($12.84 in chips) 
Seat 4: chimera252 ($12.41 in chips) 
Seat 5: LarryTheStar ($11.12 in chips) 
Seat 6: david_sara83 ($10 in chips) 
Giyorod: posts small blind $0.05
Andy Wolf: posts big blind $0.10
*** HOLE CARDS ***
chimera252: folds 
LarryTheStar: raises $0.20 to $0.30
david_sara83: folds 
paxit71: calls $0.30
Giyorod: folds 
Andy Wolf: folds 
*** FLOP *** [3s 6c 8h]
LarryTheStar: checks 
paxit71: bets $0.36
LarryTheStar: folds 
Uncalled bet ($0.36) returned to paxit71
paxit71 collected $0.72 from pot
*** SUMMARY ***
Total pot $0.75 | Rake $0.03 
Board [3s 6c 8h]
Seat 1: paxit71 (button) collected ($0.72)
Seat 2: Giyorod (small blind) folded before Flop
Seat 3: Andy Wolf (big blind) folded before Flop
Seat 4: chimera252 folded before Flop (didn't bet)
Seat 5: LarryTheStar folded on the Flop
Seat 6: david_sara83 folded before Flop (didn't bet)



PokerStars Hand #166667827641:  Hold'em No Limit ($0.05/$0.10 USD) - 2017/02/23 16:08:15 ET
Table 'Thia' 6-max Seat #6 is the button
Seat 1: Eddys Edge ($10.92 in chips) 
Seat 2: sugrob86 ($18.29 in chips) 
Seat 3: northug18 ($9.57 in chips) 
Seat 4: Bandyaev ($10.10 in chips) 
Seat 5: ab260414 ($10.84 in chips) 
Seat 6: ex3Lero86 ($15.65 in chips) 
Eddys Edge: posts small blind $0.05
sugrob86: posts big blind $0.10
*** HOLE CARDS ***
northug18: folds 
Bandyaev: folds 
ab260414: folds 
ex3Lero86: folds 
Eddys Edge: folds 
Uncalled bet ($0.05) returned to sugrob86
sugrob86 collected $0.10 from pot
*** SUMMARY ***
Total pot $0.10 | Rake $0 
Seat 1: Eddys Edge (small blind) folded before Flop
Seat 2: sugrob86 (big blind) collected ($0.10)
Seat 3: northug18 folded before Flop (didn't bet)
Seat 4: Bandyaev folded before Flop (didn't bet)
Seat 5: ab260414 folded before Flop (didn't bet)
Seat 6: ex3Lero86 (button) folded before Flop (didn't bet)



PokerStars Hand #166667827669:  Hold'em No Limit ($0.05/$0.10 USD) - 2017/02/23 16:08:15 ET
Table 'Gyldenia II' 6-max Seat #6 is the button
Seat 1: KokoulinV ($10.53 in chips) 
Seat 2: Bandyaev ($10 in chips) 
Seat 5: CHRO8 ($15.47 in chips) 
Seat 6: 8th wonders ($12.68 in chips) 
KokoulinV: posts small blind $0.05
Bandyaev: posts big blind $0.10
D3NyA: sits out 
*** HOLE CARDS ***
CHRO8: folds 
8th wonders: folds 
KokoulinV: raises $0.20 to $0.30
Bandyaev: folds 
Uncalled bet ($0.20) returned to KokoulinV
KokoulinV collected $0.20 from pot
*** SUMMARY ***
Total pot $0.20 | Rake $0 
Seat 1: KokoulinV (small blind) collected ($0.20)
Seat 2: Bandyaev (big blind) folded before Flop
Seat 5: CHRO8 folded before Flop (didn't bet)
Seat 6: 8th wonders (button) folded before Flop (didn't bet)



PokerStars Hand #166667827935:  Hold'em No Limit ($0.05/$0.10 USD) - 2017/02/23 16:08:15 ET
Table 'Alnasl II' 6-max Seat #6 is the button
Seat 1: dragonste89 ($13.95 in chips) 
Seat 2: Therodorus ($10.56 in chips) 
Seat 3: ICBM-RS26 ($15.72 in chips) 
Seat 4: Eddys Edge ($10 in chips) 
Seat 5: mdelfin0 ($12.61 in chips) 
Seat 6: Bommer78 ($4.76 in chips) 
dragonste89: posts small blind $0.05
Therodorus: posts big blind $0.10
*** HOLE CARDS ***
ICBM-RS26: folds 
Eddys Edge: folds 
mdelfin0: folds 
Bommer78: calls $0.10
dragonste89: folds 
Therodorus: raises $0.35 to $0.45
Bommer78: calls $0.35
*** FLOP *** [Td Ah 5h]
Therodorus: bets $0.60
Bommer78: raises $0.80 to $1.40
Therodorus: folds 
Uncalled bet ($0.80) returned to Bommer78
Bommer78 collected $2.05 from pot
*** SUMMARY ***
Total pot $2.15 | Rake $0.10 
Board [Td Ah 5h]
Seat 1: dragonste89 (small blind) folded before Flop
Seat 2: Therodorus (big blind) folded on the Flop
Seat 3: ICBM-RS26 folded before Flop (didn't bet)
Seat 4: Eddys Edge folded before Flop (didn't bet)
Seat 5: mdelfin0 folded before Flop (didn't bet)
Seat 6: Bommer78 (button) collected ($2.05)



PokerStars Hand #166667828038:  Hold'em No Limit ($0.05/$0.10 USD) - 2017/02/23 16:08:15 ET
Table 'Atropos' 6-max Seat #5 is the button
Seat 1: ScorpionF39 ($2.07 in chips) 
Seat 2: yodzik ($5 in chips) 
Seat 3: NvR.m1nD ($10.53 in chips) 
Seat 4: iDecMate ($10.97 in chips) 
Seat 5: KokoulinV ($11.79 in chips) 
Seat 6: Iarlei ($12.48 in chips) 
Iarlei: posts small blind $0.05
ScorpionF39: posts big blind $0.10
*** HOLE CARDS ***
yodzik: folds 
NvR.m1nD: folds 
iDecMate: folds 
KokoulinV: folds 
Iarlei: folds 
Uncalled bet ($0.05) returned to ScorpionF39
ScorpionF39 collected $0.10 from pot
*** SUMMARY ***
Total pot $0.10 | Rake $0 
Seat 1: ScorpionF39 (big blind) collected ($0.10)
Seat 2: yodzik folded before Flop (didn't bet)
Seat 3: NvR.m1nD folded before Flop (didn't bet)
Seat 4: iDecMate folded before Flop (didn't bet)
Seat 5: KokoulinV (button) folded before Flop (didn't bet)
Seat 6: Iarlei (small blind) folded before Flop



PokerStars Hand #166667828346:  Hold'em No Limit ($0.05/$0.10 USD) - 2017/02/23 16:08:16 ET
Table 'Syringa' 6-max Seat #2 is the button
Seat 1: bdixon_5 ($9.16 in chips) 
Seat 2: Goroshkos88 ($10.41 in chips) 
Seat 3: Yspenyanin ($13.42 in chips) 
Seat 4: tangler19 ($12.78 in chips) 
Seat 5: Andrei ProFF ($14.81 in chips) 
Seat 6: ibara000 ($15.28 in chips) 
Yspenyanin: posts small blind $0.05
tangler19: posts big blind $0.10
*** HOLE CARDS ***
Andrei ProFF: folds 
ibara000: raises $0.16 to $0.26
bdixon_5: folds 
Goroshkos88: calls $0.26
Yspenyanin: folds 
tangler19: folds 
*** FLOP *** [Jd 3c Ah]
ibara000: checks 
tangler19 leaves the table
voledy joins the table at seat #4 
Goroshkos88: bets $0.32
ibara000: calls $0.32
*** TURN *** [Jd 3c Ah] [As]
ibara000: checks 
Goroshkos88: bets $0.65
ibara000: folds 
Uncalled bet ($0.65) returned to Goroshkos88
Goroshkos88 collected $1.25 from pot
*** SUMMARY ***
Total pot $1.31 | Rake $0.06 
Board [Jd 3c Ah As]
Seat 1: bdixon_5 folded before Flop (didn't bet)
Seat 2: Goroshkos88 (button) collected ($1.25)
Seat 3: Yspenyanin (small blind) folded before Flop
Seat 4: tangler19 (big blind) folded before Flop
Seat 5: Andrei ProFF folded before Flop (didn't bet)
Seat 6: ibara000 folded on the Turn



PokerStars Hand #166667828423:  Hold'em No Limit ($0.05/$0.10 USD) - 2017/02/23 16:08:16 ET
Table 'Gelria' 6-max Seat #5 is the button
Seat 1: ab260414 ($10.47 in chips) 
Seat 2: fishhook5 ($10.57 in chips) 
Seat 3: Orlangoor ($11.78 in chips) 
Seat 4: eniksenik ($10.15 in chips) 
Seat 5: apenvel ($8.23 in chips) 
x3ultimate will be allowed to play after the button
ab260414: posts small blind $0.05
fishhook5: posts big blind $0.10
*** HOLE CARDS ***
Orlangoor: folds 
eniksenik: folds 
apenvel: folds 
ab260414: folds 
Uncalled bet ($0.05) returned to fishhook5
fishhook5 collected $0.10 from pot
*** SUMMARY ***
Total pot $0.10 | Rake $0 
Seat 1: ab260414 (small blind) folded before Flop
Seat 2: fishhook5 (big blind) collected ($0.10)
Seat 3: Orlangoor folded before Flop (didn't bet)
Seat 4: eniksenik folded before Flop (didn't bet)
Seat 5: apenvel (button) folded before Flop (didn't bet)



PokerStars Hand #166667828547:  Hold'em No Limit ($0.05/$0.10 USD) - 2017/02/23 16:08:16 ET
Table 'Pandora III' 6-max Seat #3 is the button
Seat 1: Pokeaster ($11.09 in chips) 
Seat 2: garigura ($11.54 in chips) 
Seat 3: Chodemuncher ($10 in chips) 
Seat 4: mhonielsen ($10.05 in chips) 
Seat 5: MühliJr ($10.57 in chips) 
Seat 6: yodzik ($5 in chips) 
mhonielsen: posts small blind $0.05
MühliJr: posts big blind $0.10
*** HOLE CARDS ***
yodzik: folds 
Pokeaster: folds 
garigura: folds 
Chodemuncher: folds 
mhonielsen: folds 
Uncalled bet ($0.05) returned to MühliJr
MühliJr collected $0.10 from pot
*** SUMMARY ***
Total pot $0.10 | Rake $0 
Seat 1: Pokeaster folded before Flop (didn't bet)
Seat 2: garigura folded before Flop (didn't bet)
Seat 3: Chodemuncher (button) folded before Flop (didn't bet)
Seat 4: mhonielsen (small blind) folded before Flop
Seat 5: MühliJr (big blind) collected ($0.10)
Seat 6: yodzik folded before Flop (didn't bet)



PokerStars Hand #166667828565:  Hold'em No Limit ($0.05/$0.10 USD) - 2017/02/23 16:08:16 ET
Table 'Aludra II' 6-max Seat #5 is the button
Seat 1: voledy ($10.23 in chips) 
Seat 2: JahSoldier69 ($13.75 in chips) 
Seat 3: mbkongstad ($9.85 in chips) 
Seat 4: MihaGr ($10 in chips) 
Seat 5: kingartur222 ($15.72 in chips) 
Seat 6: call me haaa ($14.89 in chips) 
call me haaa: posts small blind $0.05
voledy: posts big blind $0.10
*** HOLE CARDS ***
JahSoldier69: folds 
mbkongstad: folds 
MihaGr: raises $0.20 to $0.30
kingartur222: raises $0.60 to $0.90
call me haaa: folds 
voledy: folds 
MihaGr: folds 
Uncalled bet ($0.60) returned to kingartur222
kingartur222 collected $0.75 from pot
*** SUMMARY ***
Total pot $0.75 | Rake $0 
Seat 1: voledy (big blind) folded before Flop
Seat 2: JahSoldier69 folded before Flop (didn't bet)
Seat 3: mbkongstad folded before Flop (didn't bet)
Seat 4: MihaGr folded before Flop
Seat 5: kingartur222 (button) collected ($0.75)
Seat 6: call me haaa (small blind) folded before Flop



PokerStars Hand #166667828606:  Hold'em No Limit ($0.05/$0.10 USD) - 2017/02/23 16:08:16 ET
Table 'Tirela' 6-max Seat #5 is the button
Seat 1: Smitty03300 ($10 in chips) 
Seat 2: Andrei ProFF ($17.34 in chips) 
Seat 3: aim444 ($15.74 in chips) 
Seat 4: ArcticBearDK ($10 in chips) 
Seat 5: KRZuff ($13.59 in chips) 
Seat 6: coolisses111 ($9.85 in chips) 
coolisses111: posts small blind $0.05
Smitty03300: posts big blind $0.10
*** HOLE CARDS ***
Andrei ProFF: folds 
aim444: raises $0.10 to $0.20
ArcticBearDK: raises $0.40 to $0.60
KRZuff: folds 
coolisses111: folds 
Smitty03300: folds 
aim444: calls $0.40
*** FLOP *** [5d 4s 6s]
aim444: checks 
ArcticBearDK: checks 
*** TURN *** [5d 4s 6s] [9s]
aim444: checks 
ArcticBearDK: checks 
*** RIVER *** [5d 4s 6s 9s] [9d]
aim444: checks 
ArcticBearDK: checks 
*** SHOW DOWN ***
aim444: shows [4c Ad] (two pair, Nines and Fours)
ArcticBearDK: mucks hand 
aim444 collected $1.29 from pot
*** SUMMARY ***
Total pot $1.35 | Rake $0.06 
Board [5d 4s 6s 9s 9d]
Seat 1: Smitty03300 (big blind) folded before Flop
Seat 2: Andrei ProFF folded before Flop (didn't bet)
Seat 3: aim444 showed [4c Ad] and won ($1.29) with two pair, Nines and Fours
Seat 4: ArcticBearDK mucked
Seat 5: KRZuff (button) folded before Flop (didn't bet)
Seat 6: coolisses111 (small blind) folded before Flop



PokerStars Hand #166667828665:  Hold'em No Limit ($0.05/$0.10 USD) - 2017/02/23 16:08:16 ET
Table 'Amalia' 6-max Seat #6 is the button
Seat 1: voledy ($12.68 in chips) 
Seat 2: DamDatsAnAce ($11.10 in chips) 
Seat 3: kickereens ($10.08 in chips) 
Seat 4: Rodik002 ($16.36 in chips) 
Seat 5: coolisses111 ($10.95 in chips) 
Seat 6: oktomber778 ($23.01 in chips) 
voledy: posts small blind $0.05
DamDatsAnAce: posts big blind $0.10
*** HOLE CARDS ***
kickereens: folds 
kickereens leaves the table
Kow6oy joins the table at seat #3 
Rodik002: raises $0.20 to $0.30
coolisses111: folds 
oktomber778: folds 
voledy: folds 
DamDatsAnAce: folds 
Uncalled bet ($0.20) returned to Rodik002
Rodik002 collected $0.25 from pot
*** SUMMARY ***
Total pot $0.25 | Rake $0 
Seat 1: voledy (small blind) folded before Flop
Seat 2: DamDatsAnAce (big blind) folded before Flop
Seat 3: kickereens folded before Flop (didn't bet)
Seat 4: Rodik002 collected ($0.25)
Seat 5: coolisses111 folded before Flop (didn't bet)
Seat 6: oktomber778 (button) folded before Flop (didn't bet)



PokerStars Hand #166667828711:  Hold'em No Limit ($0.05/$0.10 USD) - 2017/02/23 16:08:16 ET
Table 'Huberta II' 6-max Seat #2 is the button
Seat 1: tr41n3r12 ($10 in chips) 
Seat 2: Ice_Isayev ($11.88 in chips) 
Seat 3: patrick19111 ($10.23 in chips) 
Seat 4: VAD21 ($11.96 in chips) 
Seat 5: Feverhead ($27.80 in chips) 
Seat 6: yodzik ($5.83 in chips) 
patrick19111: posts small blind $0.05
VAD21: posts big blind $0.10
*** HOLE CARDS ***
Feverhead: folds 
yodzik: folds 
tr41n3r12: folds 
Ice_Isayev: folds 
patrick19111: folds 
Uncalled bet ($0.05) returned to VAD21
VAD21 collected $0.10 from pot
*** SUMMARY ***
Total pot $0.10 | Rake $0 
Seat 1: tr41n3r12 folded before Flop (didn't bet)
Seat 2: Ice_Isayev (button) folded before Flop (didn't bet)
Seat 3: patrick19111 (small blind) folded before Flop
Seat 4: VAD21 (big blind) collected ($0.10)
Seat 5: Feverhead folded before Flop (didn't bet)
Seat 6: yodzik folded before Flop (didn't bet)



PokerStars Hand #166667828975:  Hold'em No Limit ($0.05/$0.10 USD) - 2017/02/23 16:08:16 ET
Table 'Emma II' 6-max Seat #4 is the button
Seat 1: LarryTheStar ($10.10 in chips) 
Seat 2: T9MS ($11.64 in chips) 
Seat 3: oddshoff ($9.32 in chips) 
Seat 4: Jucatorul823 ($6.51 in chips) 
Seat 5: Scanner17 ($10.86 in chips) 
Seat 6: CHRO8 ($14.82 in chips) 
Scanner17: posts small blind $0.05
CHRO8: posts big blind $0.10
*** HOLE CARDS ***
LarryTheStar: folds 
T9MS: folds 
oddshoff: raises $0.15 to $0.25
Jucatorul823: folds 
Scanner17: folds 
CHRO8: folds 
Uncalled bet ($0.15) returned to oddshoff
oddshoff collected $0.25 from pot
*** SUMMARY ***
Total pot $0.25 | Rake $0 
Seat 1: LarryTheStar folded before Flop (didn't bet)
Seat 2: T9MS folded before Flop (didn't bet)
Seat 3: oddshoff collected ($0.25)
Seat 4: Jucatorul823 (button) folded before Flop (didn't bet)
Seat 5: Scanner17 (small blind) folded before Flop
Seat 6: CHRO8 (big blind) folded before Flop



PokerStars Hand #166667829085:  Hold'em No Limit ($0.05/$0.10 USD) - 2017/02/23 16:08:16 ET
Table 'Nymphe II' 6-max Seat #1 is the button
Seat 1: jacktayra ($1.01 in chips) 
Seat 2: Newqbrown ($10.68 in chips) 
Seat 3: THIMUCHIN ($16.61 in chips) 
Seat 4: coolisses111 ($17.30 in chips) 
Seat 6: Xander188 ($10 in chips) 
Newqbrown: posts small blind $0.05
THIMUCHIN: posts big blind $0.10
*** HOLE CARDS ***
coolisses111: folds 
Xander188: folds 
jacktayra: folds 
Newqbrown: folds 
Uncalled bet ($0.05) returned to THIMUCHIN
THIMUCHIN collected $0.10 from pot
*** SUMMARY ***
Total pot $0.10 | Rake $0 
Seat 1: jacktayra (button) folded before Flop (didn't bet)
Seat 2: Newqbrown (small blind) folded before Flop
Seat 3: THIMUCHIN (big blind) collected ($0.10)
Seat 4: coolisses111 folded before Flop (didn't bet)
Seat 6: Xander188 folded before Flop (didn't bet)



PokerStars Hand #166667829164:  Hold'em No Limit ($0.05/$0.10 USD) - 2017/02/23 16:08:17 ET
Table 'Wilkens II' 6-max Seat #4 is the button
Seat 1: Islamiq-GuRL ($10.34 in chips) 
Seat 2: manashov ($10.75 in chips) 
Seat 3: Namhkal ($11.68 in chips) 
Seat 4: myevc ($10 in chips) 
Seat 5: patrick19111 ($11.38 in chips) 
Seat 6: XaXaTyH4uK ($14.01 in chips) 
patrick19111: posts small blind $0.05
XaXaTyH4uK: posts big blind $0.10
*** HOLE CARDS ***
Islamiq-GuRL: folds 
manashov: folds 
Namhkal: folds 
myevc: folds 
patrick19111: folds 
Uncalled bet ($0.05) returned to XaXaTyH4uK
XaXaTyH4uK collected $0.10 from pot
*** SUMMARY ***
Total pot $0.10 | Rake $0 
Seat 1: Islamiq-GuRL folded before Flop (didn't bet)
Seat 2: manashov folded before Flop (didn't bet)
Seat 3: Namhkal folded before Flop (didn't bet)
Seat 4: myevc (button) folded before Flop (didn't bet)
Seat 5: patrick19111 (small blind) folded before Flop
Seat 6: XaXaTyH4uK (big blind) collected ($0.10)



PokerStars Hand #166667829311:  Hold'em No Limit ($0.05/$0.10 USD) - 2017/02/23 16:08:17 ET
Table 'Hirons' 6-max Seat #3 is the button
Seat 1: RoJ1 ($11.91 in chips) 
Seat 2: coolisses111 ($7.64 in chips) 
Seat 3: czeczen7 ($14.73 in chips) 
Seat 4: Smitty03300 ($10.40 in chips) 
Seat 5: Pekaml ($10.14 in chips) 
Seat 6: garigura ($13.63 in chips) 
Smitty03300: posts small blind $0.05
Pekaml: posts big blind $0.10
*** HOLE CARDS ***
garigura: folds 
RoJ1: raises $0.12 to $0.22
coolisses111: folds 
czeczen7: calls $0.22
Smitty03300: folds 
Pekaml: folds 
*** FLOP *** [Th 5c Kd]
RoJ1: checks 
czeczen7: checks 
*** TURN *** [Th 5c Kd] [9h]
RoJ1: checks 
czeczen7: checks 
*** RIVER *** [Th 5c Kd 9h] [Td]
RoJ1: checks 
czeczen7: bets $0.10
RoJ1: calls $0.10
*** SHOW DOWN ***
czeczen7: shows [7s 8d] (a pair of Tens)
RoJ1: shows [9c 7c] (two pair, Tens and Nines)
RoJ1 collected $0.75 from pot
*** SUMMARY ***
Total pot $0.79 | Rake $0.04 
Board [Th 5c Kd 9h Td]
Seat 1: RoJ1 showed [9c 7c] and won ($0.75) with two pair, Tens and Nines
Seat 2: coolisses111 folded before Flop (didn't bet)
Seat 3: czeczen7 (button) showed [7s 8d] and lost with a pair of Tens
Seat 4: Smitty03300 (small blind) folded before Flop
Seat 5: Pekaml (big blind) folded before Flop
Seat 6: garigura folded before Flop (didn't bet)



PokerStars Hand #166667829634:  Hold'em No Limit ($0.05/$0.10 USD) - 2017/02/23 16:08:17 ET
Table 'Torrence II' 6-max Seat #2 is the button
Seat 1: Starbooks ($7.21 in chips) 
Seat 2: scorpionfish ($15.80 in chips) 
Seat 3: coolisses111 ($9.94 in chips) 
Seat 4: Zooplack ($10 in chips) 
Seat 5: Kow6oy ($12.18 in chips) 
Seat 6: mhonielsen ($10 in chips) 
coolisses111: posts small blind $0.05
Zooplack: posts big blind $0.10
*** HOLE CARDS ***
Kow6oy: folds 
mhonielsen: folds 
Starbooks: calls $0.10
scorpionfish: raises $0.20 to $0.30
coolisses111: folds 
Zooplack: folds 
Starbooks: calls $0.20
*** FLOP *** [3s 8s 8d]
Starbooks: checks 
scorpionfish: bets $0.40
Starbooks: folds 
Uncalled bet ($0.40) returned to scorpionfish
scorpionfish collected $0.72 from pot
*** SUMMARY ***
Total pot $0.75 | Rake $0.03 
Board [3s 8s 8d]
Seat 1: Starbooks folded on the Flop
Seat 2: scorpionfish (button) collected ($0.72)
Seat 3: coolisses111 (small blind) folded before Flop
Seat 4: Zooplack (big blind) folded before Flop
Seat 5: Kow6oy folded before Flop (didn't bet)
Seat 6: mhonielsen folded before Flop (didn't bet)



PokerStars Hand #166667829821:  Hold'em No Limit ($0.05/$0.10 USD) - 2017/02/23 16:08:17 ET
Table 'Kraz II' 6-max Seat #5 is the button
Seat 1: bdixon_5 ($9.25 in chips) 
Seat 2: shellyld ($10 in chips) 
Seat 3: Eddys Edge ($10 in chips) 
Seat 5: Joker51_wtf! ($10 in chips) 
Seat 6: tr41n3r12 ($11.16 in chips) 
tr41n3r12: posts small blind $0.05
bdixon_5: posts big blind $0.10
DrVzad: sits out 
*** HOLE CARDS ***
shellyld: folds 
Eddys Edge: raises $0.15 to $0.25
Joker51_wtf!: folds 
tr41n3r12: folds 
bdixon_5: folds 
Uncalled bet ($0.15) returned to Eddys Edge
Eddys Edge collected $0.25 from pot
*** SUMMARY ***
Total pot $0.25 | Rake $0 
Seat 1: bdixon_5 (big blind) folded before Flop
Seat 2: shellyld folded before Flop (didn't bet)
Seat 3: Eddys Edge collected ($0.25)
Seat 5: Joker51_wtf! (button) folded before Flop (didn't bet)
Seat 6: tr41n3r12 (small blind) folded before Flop



PokerStars Hand #166667829972:  Hold'em No Limit ($0.05/$0.10 USD) - 2017/02/23 16:08:17 ET
Table 'Sham' 6-max Seat #3 is the button
Seat 1: pancernik21 ($10 in chips) 
Seat 2: ex3Lero86 ($10.30 in chips) 
Seat 3: weez3r ($14.48 in chips) 
Seat 4: VAD21 ($14.26 in chips) 
Seat 5: T9MS ($10 in chips) 
Seat 6: bdixon_5 ($19.50 in chips) 
VAD21: posts small blind $0.05
T9MS: posts big blind $0.10
*** HOLE CARDS ***
bdixon_5: folds 
pancernik21: raises $0.20 to $0.30
ex3Lero86: folds 
weez3r: folds 
VAD21: folds 
T9MS: folds 
Uncalled bet ($0.20) returned to pancernik21
pancernik21 collected $0.25 from pot
*** SUMMARY ***
Total pot $0.25 | Rake $0 
Seat 1: pancernik21 collected ($0.25)
Seat 2: ex3Lero86 folded before Flop (didn't bet)
Seat 3: weez3r (button) folded before Flop (didn't bet)
Seat 4: VAD21 (small blind) folded before Flop
Seat 5: T9MS (big blind) folded before Flop
Seat 6: bdixon_5 folded before Flop (didn't bet)



PokerStars Hand #166667830117:  Hold'em No Limit ($0.05/$0.10 USD) - 2017/02/23 16:08:18 ET
Table 'Krethon' 6-max Seat #2 is the button
Seat 1: boxer821 ($10.77 in chips) 
Seat 2: manashov ($12.06 in chips) 
Seat 4: chimera252 ($14.84 in chips) 
Seat 5: popypaleta ($10.25 in chips) 
chimera252: posts small blind $0.05
popypaleta: posts big blind $0.10
fabadam: sits out 
*** HOLE CARDS ***
boxer821: folds 
manashov: raises $0.10 to $0.20
chimera252: folds 
popypaleta: calls $0.10
*** FLOP *** [Tc 9s 9d]
popypaleta: bets $0.20
D3NyA leaves the table
manashov: calls $0.20
*** TURN *** [Tc 9s 9d] [4c]
popypaleta: bets $0.50
manashov: raises $0.90 to $1.40
popypaleta: folds 
Uncalled bet ($0.90) returned to manashov
manashov collected $1.77 from pot
*** SUMMARY ***
Total pot $1.85 | Rake $0.08 
Board [Tc 9s 9d 4c]
Seat 1: boxer821 folded before Flop (didn't bet)
Seat 2: manashov (button) collected ($1.77)
Seat 4: chimera252 (small blind) folded before Flop
Seat 5: popypaleta (big blind) folded on the Turn



PokerStars Hand #166667830412:  Hold'em No Limit ($0.05/$0.10 USD) - 2017/02/23 16:08:18 ET
Table 'Mizar II' 6-max Seat #1 is the button
Seat 1: Cole Jaq ($8 in chips) 
Seat 2: rusu_rapid ($10 in chips) 
Seat 3: Therodorus ($10 in chips) 
rusu_rapid: posts small blind $0.05
Therodorus: posts big blind $0.10
*** HOLE CARDS ***
Cole Jaq: calls $0.10
rusu_rapid: raises $0.30 to $0.40
Therodorus: raises $0.95 to $1.35
Cole Jaq: calls $1.25
rusu_rapid: folds 
*** FLOP *** [Kd 3s 9s]
Therodorus: bets $2.15
Cole Jaq: folds 
Uncalled bet ($2.15) returned to Therodorus
Therodorus collected $2.96 from pot
*** SUMMARY ***
Total pot $3.10 | Rake $0.14 
Board [Kd 3s 9s]
Seat 1: Cole Jaq (button) folded on the Flop
Seat 2: rusu_rapid (small blind) folded before Flop
Seat 3: Therodorus (big blind) collected ($2.96)



PokerStars Hand #166667830703:  Hold'em No Limit ($0.05/$0.10 USD) - 2017/02/23 16:08:18 ET
Table 'Heka II' 6-max Seat #6 is the button
Seat 1: Mamm0nism ($15.41 in chips) 
Seat 2: oddshoff ($11.22 in chips) 
Seat 3: MühliJr ($10 in chips) 
Seat 4: theNot0r1ous ($10.78 in chips) 
Seat 5: ArcticBearDK ($12.53 in chips) 
Seat 6: MonteCris92 ($10.36 in chips) 
Mamm0nism: posts small blind $0.05
oddshoff: posts big blind $0.10
*** HOLE CARDS ***
MühliJr: folds 
theNot0r1ous: raises $0.20 to $0.30
ArcticBearDK: folds 
MonteCris92: folds 
Mamm0nism: folds 
oddshoff: folds 
Uncalled bet ($0.20) returned to theNot0r1ous
theNot0r1ous collected $0.25 from pot
*** SUMMARY ***
Total pot $0.25 | Rake $0 
Seat 1: Mamm0nism (small blind) folded before Flop
Seat 2: oddshoff (big blind) folded before Flop
Seat 3: MühliJr folded before Flop (didn't bet)
Seat 4: theNot0r1ous collected ($0.25)
Seat 5: ArcticBearDK folded before Flop (didn't bet)
Seat 6: MonteCris92 (button) folded before Flop (didn't bet)



PokerStars Hand #166667830963:  Hold'em No Limit ($0.05/$0.10 USD) - 2017/02/23 16:08:19 ET
Table 'Ophelia' 6-max Seat #3 is the button
Seat 1: ralfi37 ($10.82 in chips) 
Seat 2: popypaleta ($16.48 in chips) 
Seat 3: mvp0013 ($10.80 in chips) 
Seat 4: Cluckh ($12.04 in chips) 
Seat 5: truck1234 ($13.56 in chips) 
Seat 6: Yabidooo ($11.13 in chips) 
Cluckh: posts small blind $0.05
truck1234: posts big blind $0.10
*** HOLE CARDS ***
Yabidooo: folds 
ralfi37: raises $0.20 to $0.30
popypaleta: folds 
mvp0013: folds 
Cluckh: folds 
truck1234: calls $0.20
*** FLOP *** [2d 5h 5s]
truck1234: checks 
ralfi37: checks 
*** TURN *** [2d 5h 5s] [As]
truck1234: checks 
ralfi37: checks 
*** RIVER *** [2d 5h 5s As] [Td]
truck1234: checks 
ralfi37: bets $0.30
truck1234: folds 
Uncalled bet ($0.30) returned to ralfi37
ralfi37 collected $0.62 from pot
*** SUMMARY ***
Total pot $0.65 | Rake $0.03 
Board [2d 5h 5s As Td]
Seat 1: ralfi37 collected ($0.62)
Seat 2: popypaleta folded before Flop (didn't bet)
Seat 3: mvp0013 (button) folded before Flop (didn't bet)
Seat 4: Cluckh (small blind) folded before Flop
Seat 5: truck1234 (big blind) folded on the River
Seat 6: Yabidooo folded before Flop (didn't bet)



PokerStars Hand #166667831158:  Hold'em No Limit ($0.05/$0.10 USD) - 2017/02/23 16:08:19 ET
Table 'Alzirr II' 6-max Seat #6 is the button
Seat 1: KA3AXCTAHEU, ($10.21 in chips) 
Seat 2: popypaleta ($10.15 in chips) 
Seat 3: devon_red ($7.50 in chips) 
Seat 5: yodzik ($5.93 in chips) 
Seat 6: AM-L-SL ($4.78 in chips) 
KA3AXCTAHEU,: posts small blind $0.05
popypaleta: posts big blind $0.10
*** HOLE CARDS ***
devon_red: folds 
yodzik: folds 
AM-L-SL: calls $0.10
KA3AXCTAHEU,: raises $0.25 to $0.35
popypaleta: folds 
AM-L-SL: calls $0.25
*** FLOP *** [2h 5s Jh]
KA3AXCTAHEU,: bets $0.57
AM-L-SL: folds 
Uncalled bet ($0.57) returned to KA3AXCTAHEU,
KA3AXCTAHEU, collected $0.76 from pot
*** SUMMARY ***
Total pot $0.80 | Rake $0.04 
Board [2h 5s Jh]
Seat 1: KA3AXCTAHEU, (small blind) collected ($0.76)
Seat 2: popypaleta (big blind) folded before Flop
Seat 3: devon_red folded before Flop (didn't bet)
Seat 5: yodzik folded before Flop (didn't bet)
Seat 6: AM-L-SL (button) folded on the Flop



PokerStars Hand #166667831392:  Hold'em No Limit ($0.05/$0.10 USD) - 2017/02/23 16:08:19 ET
Table 'Samitchell III' 6-max Seat #4 is the button
Seat 2: scorpionfish ($13.03 in chips) 
Seat 3: Vanne11 ($9.55 in chips) 
Seat 4: DEraser ($8.45 in chips) 
scorpionfish: posts small blind $0.05
Vanne11: posts big blind $0.10
*** HOLE CARDS ***
dr.goofy leaves the table
steepfell leaves the table
DEraser: raises $0.15 to $0.25
scorpionfish: folds 
Vanne11: folds 
Uncalled bet ($0.15) returned to DEraser
DEraser collected $0.25 from pot
*** SUMMARY ***
Total pot $0.25 | Rake $0 
Seat 2: scorpionfish (small blind) folded before Flop
Seat 3: Vanne11 (big blind) folded before Flop
Seat 4: DEraser (button) collected ($0.25)



PokerStars Hand #166667831977:  Hold'em No Limit ($0.05/$0.10 USD) - 2017/02/23 16:08:20 ET
Table 'Apollonia' 6-max Seat #3 is the button
Seat 1: ex3Lero86 ($10.26 in chips) 
Seat 2: ibara000 ($18.43 in chips) 
Seat 3: steepfell ($10 in chips) 
Seat 4: Goroshkos88 ($17.77 in chips) 
Seat 6: iluzja12 ($10 in chips) 
Goroshkos88: posts small blind $0.05
iluzja12: posts big blind $0.10
*** HOLE CARDS ***
ex3Lero86: folds 
ibara000: folds 
steepfell: raises $0.15 to $0.25
Goroshkos88: folds 
iluzja12: folds 
Uncalled bet ($0.15) returned to steepfell
steepfell collected $0.25 from pot
*** SUMMARY ***
Total pot $0.25 | Rake $0 
Seat 1: ex3Lero86 folded before Flop (didn't bet)
Seat 2: ibara000 folded before Flop (didn't bet)
Seat 3: steepfell (button) collected ($0.25)
Seat 4: Goroshkos88 (small blind) folded before Flop
Seat 6: iluzja12 (big blind) folded before Flop



PokerStars Hand #166667832355:  Hold'em No Limit ($0.05/$0.10 USD) - 2017/02/23 16:08:20 ET
Table 'Kanda' 6-max Seat #3 is the button
Seat 1: Andy Wolf ($11.42 in chips) 
Seat 2: Pelotín ($5.42 in chips) 
Seat 3: XaXaTyH4uK ($10.27 in chips) 
Seat 4: Orlangoor ($10 in chips) 
Seat 5: Dimka4 ($10.10 in chips) 
Seat 6: oddshoff ($9.21 in chips) 
Orlangoor: posts small blind $0.05
Dimka4: posts big blind $0.10
*** HOLE CARDS ***
oddshoff: folds 
Andy Wolf: raises $0.20 to $0.30
Pelotín: folds 
XaXaTyH4uK: folds 
Orlangoor: folds 
Dimka4: folds 
Uncalled bet ($0.20) returned to Andy Wolf
Andy Wolf collected $0.25 from pot
*** SUMMARY ***
Total pot $0.25 | Rake $0 
Seat 1: Andy Wolf collected ($0.25)
Seat 2: Pelotín folded before Flop (didn't bet)
Seat 3: XaXaTyH4uK (button) folded before Flop (didn't bet)
Seat 4: Orlangoor (small blind) folded before Flop
Seat 5: Dimka4 (big blind) folded before Flop
Seat 6: oddshoff folded before Flop (didn't bet)



PokerStars Hand #166667832502:  Hold'em No Limit ($0.05/$0.10 USD) - 2017/02/23 16:08:20 ET
Table 'Lederle' 6-max Seat #6 is the button
Seat 1: Sterjek ($9.90 in chips) 
Seat 2: truck1234 ($15.69 in chips) 
Seat 3: Kazacha ($11.20 in chips) 
Seat 4: Pokeaster ($13.66 in chips) 
Seat 5: 8th wonders ($13.68 in chips) 
Seat 6: pokekrk ($10 in chips) 
Sterjek: posts small blind $0.05
truck1234: posts big blind $0.10
*** HOLE CARDS ***
Kazacha: raises $0.14 to $0.24
Pokeaster: folds 
8th wonders: folds 
pokekrk: folds 
Sterjek: folds 
truck1234: folds 
Uncalled bet ($0.14) returned to Kazacha
Kazacha collected $0.25 from pot
*** SUMMARY ***
Total pot $0.25 | Rake $0 
Seat 1: Sterjek (small blind) folded before Flop
Seat 2: truck1234 (big blind) folded before Flop
Seat 3: Kazacha collected ($0.25)
Seat 4: Pokeaster folded before Flop (didn't bet)
Seat 5: 8th wonders folded before Flop (didn't bet)
Seat 6: pokekrk (button) folded before Flop (didn't bet)



PokerStars Hand #166667832716:  Hold'em No Limit ($0.05/$0.10 USD) - 2017/02/23 16:08:20 ET
Table 'Laetitia II' 6-max Seat #1 is the button
Seat 1: Cluckh ($10.83 in chips) 
Seat 2: manashov ($10 in chips) 
Seat 3: 6ePeMeHHa9 ($10.14 in chips) 
Seat 4: Feverhead ($16.66 in chips) 
Seat 5: D3NyA ($17.36 in chips) 
Seat 6: Dima91360 ($5.39 in chips) 
manashov: posts small blind $0.05
6ePeMeHHa9: posts big blind $0.10
*** HOLE CARDS ***
Feverhead: folds 
D3NyA: folds 
Dima91360: calls $0.10
Cluckh: folds 
manashov: folds 
6ePeMeHHa9: raises $0.30 to $0.40
Dima91360: calls $0.30
*** FLOP *** [9s Th 5s]
6ePeMeHHa9: checks 
Dima91360: checks 
*** TURN *** [9s Th 5s] [As]
6ePeMeHHa9: checks 
Dima91360: bets $0.30
6ePeMeHHa9: folds 
Uncalled bet ($0.30) returned to Dima91360
Dima91360 collected $0.81 from pot
*** SUMMARY ***
Total pot $0.85 | Rake $0.04 
Board [9s Th 5s As]
Seat 1: Cluckh (button) folded before Flop (didn't bet)
Seat 2: manashov (small blind) folded before Flop
Seat 3: 6ePeMeHHa9 (big blind) folded on the Turn
Seat 4: Feverhead folded before Flop (didn't bet)
Seat 5: D3NyA folded before Flop (didn't bet)
Seat 6: Dima91360 collected ($0.81)



PokerStars Hand #166667832718:  Hold'em No Limit ($0.05/$0.10 USD) - 2017/02/23 16:08:20 ET
Table 'Marghanna II' 6-max Seat #2 is the button
Seat 1: Goroshkos88 ($10 in chips) 
Seat 2: Namhkal ($11.26 in chips) 
Seat 4: D3NyA ($11.92 in chips) 
Seat 5: ofl21189 ($7.10 in chips) 
Seat 6: VAD21 ($13.28 in chips) 
Andrei ProFF will be allowed to play after the button
D3NyA: posts small blind $0.05
ofl21189: posts big blind $0.10
*** HOLE CARDS ***
VAD21: folds 
Goroshkos88: folds 
Namhkal: raises $0.10 to $0.20
D3NyA: folds 
ofl21189: calls $0.10
*** FLOP *** [Jd Jh Qd]
ofl21189: checks 
Namhkal: bets $0.29
ofl21189: calls $0.29
*** TURN *** [Jd Jh Qd] [7d]
ofl21189: checks 
Namhkal: bets $0.74
ofl21189: calls $0.74
*** RIVER *** [Jd Jh Qd 7d] [5d]
ofl21189: bets $2.40
Namhkal: raises $5.40 to $7.80
ofl21189: folds 
Uncalled bet ($5.40) returned to Namhkal
Namhkal collected $6.98 from pot
*** SUMMARY ***
Total pot $7.31 | Rake $0.33 
Board [Jd Jh Qd 7d 5d]
Seat 1: Goroshkos88 folded before Flop (didn't bet)
Seat 2: Namhkal (button) collected ($6.98)
Seat 4: D3NyA (small blind) folded before Flop
Seat 5: ofl21189 (big blind) folded on the River
Seat 6: VAD21 folded before Flop (didn't bet)



PokerStars Hand #166667832814:  Hold'em No Limit ($0.05/$0.10 USD) - 2017/02/23 16:08:21 ET
Table 'Goto II' 6-max Seat #6 is the button
Seat 1: FRAID358 ($12.06 in chips) 
Seat 2: 6ePeMeHHa9 ($11.82 in chips) 
Seat 3: Goroshkos88 ($10.81 in chips) 
Seat 4: KRZuff ($13.76 in chips) 
Seat 5: RoJ1 ($14.35 in chips) 
Seat 6: ermananb93 ($11.51 in chips) 
FRAID358: posts small blind $0.05
6ePeMeHHa9: posts big blind $0.10
*** HOLE CARDS ***
Goroshkos88: folds 
KRZuff: folds 
RoJ1: raises $0.12 to $0.22
ermananb93: folds 
FRAID358: folds 
6ePeMeHHa9: folds 
Uncalled bet ($0.12) returned to RoJ1
RoJ1 collected $0.25 from pot
*** SUMMARY ***
Total pot $0.25 | Rake $0 
Seat 1: FRAID358 (small blind) folded before Flop
Seat 2: 6ePeMeHHa9 (big blind) folded before Flop
Seat 3: Goroshkos88 folded before Flop (didn't bet)
Seat 4: KRZuff folded before Flop (didn't bet)
Seat 5: RoJ1 collected ($0.25)
Seat 6: ermananb93 (button) folded before Flop (didn't bet)



PokerStars Hand #166667832904:  Hold'em No Limit ($0.05/$0.10 USD) - 2017/02/23 16:08:21 ET
Table 'Clavel' 6-max Seat #2 is the button
Seat 1: KRZuff ($14.51 in chips) 
Seat 2: Namhkal ($10 in chips) 
Seat 4: Dcaro31 ($11.73 in chips) 
Seat 5: Vrinni ($10 in chips) 
Seat 6: Gra_anD77 ($5.13 in chips) 
Dcaro31: posts small blind $0.05
Vrinni: posts big blind $0.10
*** HOLE CARDS ***
Gra_anD77: folds 
KRZuff: folds 
Namhkal: raises $0.10 to $0.20
Dcaro31: folds 
Vrinni: folds 
Uncalled bet ($0.10) returned to Namhkal
Namhkal collected $0.25 from pot
*** SUMMARY ***
Total pot $0.25 | Rake $0 
Seat 1: KRZuff folded before Flop (didn't bet)
Seat 2: Namhkal (button) collected ($0.25)
Seat 4: Dcaro31 (small blind) folded before Flop
Seat 5: Vrinni (big blind) folded before Flop
Seat 6: Gra_anD77 folded before Flop (didn't bet)



PokerStars Hand #166667833134:  Hold'em No Limit ($0.05/$0.10 USD) - 2017/02/23 16:08:21 ET
Table 'Lehigh' 6-max Seat #4 is the button
Seat 1: kowe4ka565 ($8.51 in chips) 
Seat 2: Sbozzz ($13.22 in chips) 
Seat 3: Therodorus ($12.44 in chips) 
Seat 4: Chodemuncher ($10 in chips) 
Seat 5: Xander188 ($10.37 in chips) 
Xander188: posts small blind $0.05
kowe4ka565: posts big blind $0.10
*** HOLE CARDS ***
Sbozzz: raises $0.20 to $0.30
Therodorus: calls $0.30
Chodemuncher: folds 
Xander188: folds 
kowe4ka565: calls $0.20
*** FLOP *** [As 4h 5d]
kowe4ka565: checks 
Sbozzz: checks 
Therodorus: checks 
*** TURN *** [As 4h 5d] [Ah]
kowe4ka565: checks 
Sbozzz: bets $0.46
Therodorus: folds 
kowe4ka565: raises $0.46 to $0.92
Sbozzz: raises $0.46 to $1.38
kowe4ka565: calls $0.46
*** RIVER *** [As 4h 5d Ah] [8s]
kowe4ka565: checks 
Sbozzz: bets $5.10
kowe4ka565: raises $1.73 to $6.83 and is all-in
Sbozzz: calls $1.73
*** SHOW DOWN ***
kowe4ka565: shows [9c Ac] (three of a kind, Aces)
Sbozzz: shows [4s 4c] (a full house, Fours full of Aces)
Sbozzz collected $16.59 from pot
*** SUMMARY ***
Total pot $17.37 | Rake $0.78 
Board [As 4h 5d Ah 8s]
Seat 1: kowe4ka565 (big blind) showed [9c Ac] and lost with three of a kind, Aces
Seat 2: Sbozzz showed [4s 4c] and won ($16.59) with a full house, Fours full of Aces
Seat 3: Therodorus folded on the Turn
Seat 4: Chodemuncher (button) folded before Flop (didn't bet)
Seat 5: Xander188 (small blind) folded before Flop



PokerStars Hand #166667833250:  Hold'em No Limit ($0.05/$0.10 USD) - 2017/02/23 16:08:21 ET
Table 'Nuki' 6-max Seat #3 is the button
Seat 1: bdixon_5 ($7.80 in chips) 
Seat 2: ArcticBearDK ($18.88 in chips) 
Seat 3: david_sara83 ($13.24 in chips) 
Seat 4: GESPERIA ($28.48 in chips) 
Seat 5: fabadam ($11.13 in chips) 
Seat 6: Zooplack ($25.77 in chips) 
GESPERIA: posts small blind $0.05
fabadam: posts big blind $0.10
*** HOLE CARDS ***
Zooplack: folds 
bdixon_5: folds 
ArcticBearDK: raises $0.12 to $0.22
david_sara83: folds 
GESPERIA: folds 
fabadam: folds 
Uncalled bet ($0.12) returned to ArcticBearDK
ArcticBearDK collected $0.25 from pot
*** SUMMARY ***
Total pot $0.25 | Rake $0 
Seat 1: bdixon_5 folded before Flop (didn't bet)
Seat 2: ArcticBearDK collected ($0.25)
Seat 3: david_sara83 (button) folded before Flop (didn't bet)
Seat 4: GESPERIA (small blind) folded before Flop
Seat 5: fabadam (big blind) folded before Flop
Seat 6: Zooplack folded before Flop (didn't bet)



PokerStars Hand #166667833484:  Hold'em No Limit ($0.05/$0.10 USD) - 2017/02/23 16:08:21 ET
Table 'Hercynia III' 6-max Seat #3 is the button
Seat 1: Bird et al ($14.63 in chips) 
Seat 2: Action_Gibi ($7.13 in chips) 
Seat 3: Dcaro31 ($20.02 in chips) 
Seat 5: THIMUCHIN ($15.35 in chips) 
Seat 6: bdixon_5 ($11.59 in chips) 
THIMUCHIN: posts small blind $0.05
bdixon_5: posts big blind $0.10
*** HOLE CARDS ***
Bird et al: folds 
Action_Gibi: folds 
Dcaro31: folds 
THIMUCHIN: folds 
Uncalled bet ($0.05) returned to bdixon_5
bdixon_5 collected $0.10 from pot
*** SUMMARY ***
Total pot $0.10 | Rake $0 
Seat 1: Bird et al folded before Flop (didn't bet)
Seat 2: Action_Gibi folded before Flop (didn't bet)
Seat 3: Dcaro31 (button) folded before Flop (didn't bet)
Seat 5: THIMUCHIN (small blind) folded before Flop
Seat 6: bdixon_5 (big blind) collected ($0.10)



PokerStars Hand #166667833642:  Hold'em No Limit ($0.05/$0.10 USD) - 2017/02/23 16:08:21 ET
Table 'Themisto II' 6-max Seat #3 is the button
Seat 2: CA225 ($11.96 in chips) 
Seat 3: eniksenik ($15.69 in chips) 
Seat 5: ex3Lero86 ($10.12 in chips) 
Seat 6: noobigrok ($3.60 in chips) 
DrVzad will be allowed to play after the button
ex3Lero86: posts small blind $0.05
noobigrok: posts big blind $0.10
ChuikaPridi: sits out 
*** HOLE CARDS ***
CA225: folds 
eniksenik: folds 
ex3Lero86: raises $0.30 to $0.40
noobigrok: folds 
Uncalled bet ($0.30) returned to ex3Lero86
ex3Lero86 collected $0.20 from pot
*** SUMMARY ***
Total pot $0.20 | Rake $0 
Seat 2: CA225 folded before Flop (didn't bet)
Seat 3: eniksenik (button) folded before Flop (didn't bet)
Seat 5: ex3Lero86 (small blind) collected ($0.20)
Seat 6: noobigrok (big blind) folded before Flop



PokerStars Hand #166667833961:  Hold'em No Limit ($0.05/$0.10 USD) - 2017/02/23 16:08:22 ET
Table 'Lampetia III' 6-max Seat #6 is the button
Seat 1: gaHy_HaXeP ($10.60 in chips) 
Seat 2: DamDatsAnAce ($10.32 in chips) 
Seat 3: Kow6oy ($10 in chips) 
Seat 4: IAntikI ($10.60 in chips) 
Seat 5: robson1235 ($20.42 in chips) 
Seat 6: bdixon_5 ($9.20 in chips) 
gaHy_HaXeP: posts small blind $0.05
DamDatsAnAce: posts big blind $0.10
*** HOLE CARDS ***
Kow6oy: folds 
IAntikI: raises $0.20 to $0.30
robson1235: folds 
bdixon_5: folds 
gaHy_HaXeP: folds 
DamDatsAnAce: calls $0.20
*** FLOP *** [5d 8c Js]
DamDatsAnAce: checks 
IAntikI: checks 
*** TURN *** [5d 8c Js] [8d]
DamDatsAnAce: bets $0.41
IAntikI: folds 
Uncalled bet ($0.41) returned to DamDatsAnAce
DamDatsAnAce collected $0.62 from pot
*** SUMMARY ***
Total pot $0.65 | Rake $0.03 
Board [5d 8c Js 8d]
Seat 1: gaHy_HaXeP (small blind) folded before Flop
Seat 2: DamDatsAnAce (big blind) collected ($0.62)
Seat 3: Kow6oy folded before Flop (didn't bet)
Seat 4: IAntikI folded on the Turn
Seat 5: robson1235 folded before Flop (didn't bet)
Seat 6: bdixon_5 (button) folded before Flop (didn't bet)



PokerStars Hand #166667834554:  Hold'em No Limit ($0.05/$0.10 USD) - 2017/02/23 16:08:22 ET
Table 'Nehalennia III' 6-max Seat #6 is the button
Seat 1: boxer821 ($11.88 in chips) 
Seat 2: fortieth ($10.71 in chips) 
Seat 3: ValdemorS ($18.28 in chips) 
Seat 4: eniksenik ($10 in chips) 
Seat 5: wulffboy ($36.92 in chips) 
Seat 6: valzeny ($20.54 in chips) 
boxer821: posts small blind $0.05
fortieth: posts big blind $0.10
boxer821: posts the ante $0.02
fortieth: posts the ante $0.02
ValdemorS: posts the ante $0.02
eniksenik: posts the ante $0.02
wulffboy: posts the ante $0.02
valzeny: posts the ante $0.02
*** HOLE CARDS ***
ValdemorS: folds 
eniksenik: folds 
wulffboy: folds 
valzeny: folds 
boxer821: folds 
Uncalled bet ($0.05) returned to fortieth
fortieth collected $0.22 from pot
*** SUMMARY ***
Total pot $0.22 | Rake $0 
Seat 1: boxer821 (small blind) folded before Flop
Seat 2: fortieth (big blind) collected ($0.22)
Seat 3: ValdemorS folded before Flop (didn't bet)
Seat 4: eniksenik folded before Flop (didn't bet)
Seat 5: wulffboy folded before Flop (didn't bet)
Seat 6: valzeny (button) folded before Flop (didn't bet)



PokerStars Hand #166667834964:  Hold'em No Limit ($0.05/$0.10 USD) - 2017/02/23 16:08:23 ET
Table 'Luanda' 6-max Seat #6 is the button
Seat 1: AM-L-SL ($1.42 in chips) 
Seat 2: Xander188 ($10.04 in chips) 
Seat 3: DamDatsAnAce ($12.85 in chips) 
Seat 5: st4tion ($13.45 in chips) 
Seat 6: KA3AXCTAHEU, ($11.43 in chips) 
AM-L-SL: posts small blind $0.05
Xander188: posts big blind $0.10
*** HOLE CARDS ***
DamDatsAnAce: folds 
st4tion: raises $0.15 to $0.25
KA3AXCTAHEU,: folds 
AM-L-SL: raises $1.17 to $1.42 and is all-in
Xander188: folds 
st4tion: calls $1.17
*** FLOP *** [5h Kc 8c]
*** TURN *** [5h Kc 8c] [Th]
*** RIVER *** [5h Kc 8c Th] [7h]
*** SHOW DOWN ***
AM-L-SL: shows [Ah Jh] (a flush, Ace high)
st4tion: shows [4d Ad] (high card Ace)
AM-L-SL collected $2.81 from pot
*** SUMMARY ***
Total pot $2.94 | Rake $0.13 
Board [5h Kc 8c Th 7h]
Seat 1: AM-L-SL (small blind) showed [Ah Jh] and won ($2.81) with a flush, Ace high
Seat 2: Xander188 (big blind) folded before Flop
Seat 3: DamDatsAnAce folded before Flop (didn't bet)
Seat 5: st4tion showed [4d Ad] and lost with high card Ace
Seat 6: KA3AXCTAHEU, (button) folded before Flop (didn't bet)



PokerStars Hand #166667835005:  Hold'em No Limit ($0.05/$0.10 USD) - 2017/02/23 16:08:23 ET
Table 'Rosalia' 6-max Seat #6 is the button
Seat 1: Hyd SK ($10 in chips) 
Seat 2: Bandyaev ($10.99 in chips) 
Seat 3: Andy Wolf ($11.98 in chips) 
Seat 4: THIMUCHIN ($10 in chips) 
Seat 5: miron762 ($19.71 in chips) 
Seat 6: facewald ($17.84 in chips) 
Hyd SK: posts small blind $0.05
Bandyaev: posts big blind $0.10
*** HOLE CARDS ***
Andy Wolf: folds 
THIMUCHIN: folds 
miron762: folds 
facewald: raises $0.19 to $0.29
Hyd SK: folds 
Bandyaev: folds 
Uncalled bet ($0.19) returned to facewald
facewald collected $0.25 from pot
*** SUMMARY ***
Total pot $0.25 | Rake $0 
Seat 1: Hyd SK (small blind) folded before Flop
Seat 2: Bandyaev (big blind) folded before Flop
Seat 3: Andy Wolf folded before Flop (didn't bet)
Seat 4: THIMUCHIN folded before Flop (didn't bet)
Seat 5: miron762 folded before Flop (didn't bet)
Seat 6: facewald (button) collected ($0.25)



PokerStars Hand #166667835079:  Hold'em No Limit ($0.05/$0.10 USD) - 2017/02/23 16:08:23 ET
Table 'Wingolfia II' 6-max Seat #3 is the button
Seat 1: BahiaMinhaP ($10.17 in chips) 
Seat 2: NvR.m1nD ($10.25 in chips) 
Seat 3: truck1234 ($10.21 in chips) 
Seat 4: zlobslob ($17.92 in chips) 
Seat 5: tr41n3r12 ($11.58 in chips) 
Seat 6: EphemeralBen ($12.14 in chips) 
zlobslob: posts small blind $0.05
tr41n3r12: posts big blind $0.10
*** HOLE CARDS ***
EphemeralBen: folds 
BahiaMinhaP: folds 
NvR.m1nD: raises $0.15 to $0.25
truck1234: folds 
zlobslob: folds 
tr41n3r12: folds 
Uncalled bet ($0.15) returned to NvR.m1nD
NvR.m1nD collected $0.25 from pot
*** SUMMARY ***
Total pot $0.25 | Rake $0 
Seat 1: BahiaMinhaP folded before Flop (didn't bet)
Seat 2: NvR.m1nD collected ($0.25)
Seat 3: truck1234 (button) folded before Flop (didn't bet)
Seat 4: zlobslob (small blind) folded before Flop
Seat 5: tr41n3r12 (big blind) folded before Flop
Seat 6: EphemeralBen folded before Flop (didn't bet)



PokerStars Hand #166667835363:  Hold'em No Limit ($0.05/$0.10 USD) - 2017/02/23 16:08:23 ET
Table 'Persephone' 6-max Seat #4 is the button
Seat 1: dragonste89 ($14.60 in chips) 
Seat 2: AM-L-SL ($5.50 in chips) 
Seat 4: 2G28 ($10 in chips) 
Seat 5: ab260414 ($10.61 in chips) 
Seat 6: popypaleta ($14.71 in chips) 
ab260414: posts small blind $0.05
popypaleta: posts big blind $0.10
*** HOLE CARDS ***
dragonste89: folds 
DasoII leaves the table
Andrei ProFF joins the table at seat #3 
Andrei ProFF leaves the table
AM-L-SL: folds 
Mooneye19 joins the table at seat #3 
2G28: raises $0.15 to $0.25
ab260414: folds 
popypaleta: calls $0.15
*** FLOP *** [8c Ts 5s]
popypaleta: checks 
2G28: checks 
*** TURN *** [8c Ts 5s] [Qh]
popypaleta: bets $0.27
2G28: raises $0.76 to $1.03
popypaleta: calls $0.76
*** RIVER *** [8c Ts 5s Qh] [Ac]
popypaleta: checks 
2G28: bets $2.50
popypaleta: folds 
Uncalled bet ($2.50) returned to 2G28
2G28 collected $2.49 from pot
*** SUMMARY ***
Total pot $2.61 | Rake $0.12 
Board [8c Ts 5s Qh Ac]
Seat 1: dragonste89 folded before Flop (didn't bet)
Seat 2: AM-L-SL folded before Flop (didn't bet)
Seat 4: 2G28 (button) collected ($2.49)
Seat 5: ab260414 (small blind) folded before Flop
Seat 6: popypaleta (big blind) folded on the River



PokerStars Hand #166667835418:  Hold'em No Limit ($0.05/$0.10 USD) - 2017/02/23 16:08:23 ET
Table 'Peiroos' 6-max Seat #6 is the button
Seat 1: ksandr_hom ($10 in chips) 
Seat 2: Nr847 ($10.95 in chips) 
Seat 3: atlx0711 ($25.69 in chips) 
Seat 4: Peter0087 ($9.85 in chips) 
Seat 5: sergio-cb164 ($8.50 in chips) 
Seat 6: DevonMiles88 ($5.65 in chips) 
ksandr_hom: posts small blind $0.05
Nr847: posts big blind $0.10
*** HOLE CARDS ***
atlx0711: folds 
Peter0087: raises $0.20 to $0.30
sergio-cb164: calls $0.30
DevonMiles88: raises $5.35 to $5.65 and is all-in
ksandr_hom: folds 
Nr847: folds 
Peter0087: raises $4.20 to $9.85 and is all-in
sergio-cb164: folds 
Uncalled bet ($4.20) returned to Peter0087
*** FLOP *** [7c 6c 3s]
*** TURN *** [7c 6c 3s] [2s]
*** RIVER *** [7c 6c 3s 2s] [9d]
*** SHOW DOWN ***
Peter0087: shows [Ad Kc] (high card Ace)
DevonMiles88: shows [Jd Js] (a pair of Jacks)
DevonMiles88 collected $11.22 from pot
*** SUMMARY ***
Total pot $11.75 | Rake $0.53 
Board [7c 6c 3s 2s 9d]
Seat 1: ksandr_hom (small blind) folded before Flop
Seat 2: Nr847 (big blind) folded before Flop
Seat 3: atlx0711 folded before Flop (didn't bet)
Seat 4: Peter0087 showed [Ad Kc] and lost with high card Ace
Seat 5: sergio-cb164 folded before Flop
Seat 6: DevonMiles88 (button) showed [Jd Js] and won ($11.22) with a pair of Jacks



PokerStars Hand #166667835765:  Hold'em No Limit ($0.05/$0.10 USD) - 2017/02/23 16:08:24 ET
Table 'Isberga' 6-max Seat #2 is the button
Seat 1: Feverhead ($18.12 in chips) 
Seat 2: GESPERIA ($10 in chips) 
Seat 4: THIMUCHIN ($10.94 in chips) 
Seat 5: YoungGriff86 ($18.87 in chips) 
Seat 6: Goroshkos88 ($21.66 in chips) 
THIMUCHIN: posts small blind $0.05
YoungGriff86: posts big blind $0.10
*** HOLE CARDS ***
Goroshkos88: folds 
Feverhead: folds 
GESPERIA: raises $0.20 to $0.30
THIMUCHIN: calls $0.25
YoungGriff86: folds 
*** FLOP *** [Jh 4h 7d]
THIMUCHIN: checks 
GESPERIA: bets $0.44
THIMUCHIN: folds 
Uncalled bet ($0.44) returned to GESPERIA
GESPERIA collected $0.67 from pot
*** SUMMARY ***
Total pot $0.70 | Rake $0.03 
Board [Jh 4h 7d]
Seat 1: Feverhead folded before Flop (didn't bet)
Seat 2: GESPERIA (button) collected ($0.67)
Seat 4: THIMUCHIN (small blind) folded on the Flop
Seat 5: YoungGriff86 (big blind) folded before Flop
Seat 6: Goroshkos88 folded before Flop (didn't bet)



PokerStars Hand #166667835970:  Hold'em No Limit ($0.05/$0.10 USD) - 2017/02/23 16:08:24 ET
Table 'Caupolican' 6-max Seat #4 is the button
Seat 1: kingartur222 ($11.49 in chips) 
Seat 2: garigura ($18.75 in chips) 
Seat 3: ducksheep82 ($5 in chips) 
Seat 4: mhonielsen ($15.07 in chips) 
Seat 5: Kazacha ($12.45 in chips) 
Seat 6: crazydevill ($10 in chips) 
Kazacha: posts small blind $0.05
crazydevill: posts big blind $0.10
ducksheep82: posts big blind $0.10
*** HOLE CARDS ***
kingartur222: raises $0.20 to $0.30
garigura: folds 
ducksheep82: folds 
mhonielsen: folds 
Kazacha: folds 
crazydevill: folds 
Uncalled bet ($0.20) returned to kingartur222
kingartur222 collected $0.35 from pot
*** SUMMARY ***
Total pot $0.35 | Rake $0 
Seat 1: kingartur222 collected ($0.35)
Seat 2: garigura folded before Flop (didn't bet)
Seat 3: ducksheep82 folded before Flop
Seat 4: mhonielsen (button) folded before Flop (didn't bet)
Seat 5: Kazacha (small blind) folded before Flop
Seat 6: crazydevill (big blind) folded before Flop



PokerStars Hand #166667836062:  Hold'em No Limit ($0.05/$0.10 USD) - 2017/02/23 16:08:24 ET
Table 'California II' 6-max Seat #3 is the button
Seat 1: fedorka rus ($10 in chips) 
Seat 2: homelessdan ($10 in chips) 
Seat 3: Bird et al ($10.05 in chips) 
Seat 4: pokekrk ($14.32 in chips) 
Seat 5: Nikolai77798 ($4.05 in chips) 
Seat 6: chiko4040 ($8.56 in chips) 
pokekrk: posts small blind $0.05
Nikolai77798: posts big blind $0.10
*** HOLE CARDS ***
chiko4040: raises $0.20 to $0.30
fedorka rus: folds 
homelessdan: folds 
Bird et al: calls $0.30
pokekrk: folds 
Nikolai77798: folds 
*** FLOP *** [4c 8c Jd]
chiko4040: bets $0.36
Bird et al: folds 
Uncalled bet ($0.36) returned to chiko4040
chiko4040 collected $0.72 from pot
*** SUMMARY ***
Total pot $0.75 | Rake $0.03 
Board [4c 8c Jd]
Seat 1: fedorka rus folded before Flop (didn't bet)
Seat 2: homelessdan folded before Flop (didn't bet)
Seat 3: Bird et al (button) folded on the Flop
Seat 4: pokekrk (small blind) folded before Flop
Seat 5: Nikolai77798 (big blind) folded before Flop
Seat 6: chiko4040 collected ($0.72)



PokerStars Hand #166667836108:  Hold'em No Limit ($0.05/$0.10 USD) - 2017/02/23 16:08:24 ET
Table 'Bengt' 6-max Seat #6 is the button
Seat 1: Lucky HoBBiT ($12.40 in chips) 
Seat 2: ChefRocco ($20.63 in chips) 
Seat 3: nantes15 ($13.23 in chips) 
Seat 4: 8th wonders ($10 in chips) 
Seat 5: RoJ1 ($10.16 in chips) 
Seat 6: Goroshkos88 ($11.01 in chips) 
Lucky HoBBiT: posts small blind $0.05
ChefRocco: posts big blind $0.10
*** HOLE CARDS ***
nantes15: raises $0.15 to $0.25
8th wonders: folds 
RoJ1: folds 
Goroshkos88: calls $0.25
Lucky HoBBiT: folds 
ChefRocco: calls $0.15
*** FLOP *** [9h 5d 7s]
ChefRocco: checks 
nantes15: checks 
Goroshkos88: checks 
*** TURN *** [9h 5d 7s] [8s]
ChefRocco: checks 
nantes15: bets $0.63
Goroshkos88: calls $0.63
ChefRocco: folds 
*** RIVER *** [9h 5d 7s 8s] [Kc]
nantes15: bets $1.10
Goroshkos88: calls $1.10
*** SHOW DOWN ***
nantes15: shows [Ah 6h] (a straight, Five to Nine)
Goroshkos88: shows [6s Qs] (a straight, Five to Nine)
nantes15 collected $2.04 from pot
Goroshkos88 collected $2.03 from pot
*** SUMMARY ***
Total pot $4.26 | Rake $0.19 
Board [9h 5d 7s 8s Kc]
Seat 1: Lucky HoBBiT (small blind) folded before Flop
Seat 2: ChefRocco (big blind) folded on the Turn
Seat 3: nantes15 showed [Ah 6h] and won ($2.04) with a straight, Five to Nine
Seat 4: 8th wonders folded before Flop (didn't bet)
Seat 5: RoJ1 folded before Flop (didn't bet)
Seat 6: Goroshkos88 (button) showed [6s Qs] and won ($2.03) with a straight, Five to Nine



PokerStars Hand #166667836205:  Hold'em No Limit ($0.05/$0.10 USD) - 2017/02/23 16:08:24 ET
Table 'Nekkar' 6-max Seat #3 is the button
Seat 2: Bird et al ($10.87 in chips) 
Seat 3: Zemz_Ru ($15.71 in chips) 
Seat 4: kingartur222 ($12.15 in chips) 
Seat 5: Vrinni ($12.34 in chips) 
Seat 6: Eddys Edge ($10.48 in chips) 
kingartur222: posts small blind $0.05
Vrinni: posts big blind $0.10
*** HOLE CARDS ***
Eddys Edge: folds 
Bird et al: folds 
Zemz_Ru: raises $0.10 to $0.20
kingartur222: folds 
Vrinni: folds 
Uncalled bet ($0.10) returned to Zemz_Ru
Zemz_Ru collected $0.25 from pot
*** SUMMARY ***
Total pot $0.25 | Rake $0 
Seat 2: Bird et al folded before Flop (didn't bet)
Seat 3: Zemz_Ru (button) collected ($0.25)
Seat 4: kingartur222 (small blind) folded before Flop
Seat 5: Vrinni (big blind) folded before Flop
Seat 6: Eddys Edge folded before Flop (didn't bet)



PokerStars Hand #166667836211:  Hold'em No Limit ($0.05/$0.10 USD) - 2017/02/23 16:08:24 ET
Table 'Nymphe II' 6-max Seat #2 is the button
Seat 1: jacktayra ($1.01 in chips) 
Seat 2: Newqbrown ($10.63 in chips) 
Seat 3: THIMUCHIN ($16.66 in chips) 
Seat 4: coolisses111 ($17.30 in chips) 
Seat 6: Xander188 ($10 in chips) 
THIMUCHIN: posts small blind $0.05
coolisses111: posts big blind $0.10
*** HOLE CARDS ***
Xander188: folds 
jacktayra: folds 
Newqbrown: folds 
6ePeMeHHa9 joins the table at seat #5 
6ePeMeHHa9 leaves the table
THIMUCHIN: raises $0.15 to $0.25
Kow6oy joins the table at seat #5 
Kow6oy leaves the table
coolisses111: folds 
Uncalled bet ($0.15) returned to THIMUCHIN
THIMUCHIN collected $0.20 from pot
*** SUMMARY ***
Total pot $0.20 | Rake $0 
Seat 1: jacktayra folded before Flop (didn't bet)
Seat 2: Newqbrown (button) folded before Flop (didn't bet)
Seat 3: THIMUCHIN (small blind) collected ($0.20)
Seat 4: coolisses111 (big blind) folded before Flop
Seat 6: Xander188 folded before Flop (didn't bet)



PokerStars Hand #166667836845:  Hold'em No Limit ($0.05/$0.10 USD) - 2017/02/23 16:08:25 ET
Table 'Nauheima II' 6-max Seat #3 is the button
Seat 2: Peter0087 ($10.62 in chips) 
Seat 3: KokoulinV ($12.99 in chips) 
Seat 6: bonyo71 ($5.09 in chips) 
JahSoldier69 will be allowed to play after the button
bonyo71: posts small blind $0.05
Peter0087: posts big blind $0.10
*** HOLE CARDS ***
JahSoldier69 leaves the table
KokoulinV: folds 
bonyo71: folds 
Uncalled bet ($0.05) returned to Peter0087
Peter0087 collected $0.10 from pot
*** SUMMARY ***
Total pot $0.10 | Rake $0 
Seat 2: Peter0087 (big blind) collected ($0.10)
Seat 3: KokoulinV (button) folded before Flop (didn't bet)
Seat 6: bonyo71 (small blind) folded before Flop



PokerStars Hand #166667837037:  Hold'em No Limit ($0.05/$0.10 USD) - 2017/02/23 16:08:25 ET
Table 'Vesta II' 6-max Seat #4 is the button
Seat 1: Yabidooo ($17.27 in chips) 
Seat 2: Dimka4 ($10 in chips) 
Seat 3: Pokeaster ($12.56 in chips) 
Seat 4: Dcaro31 ($10 in chips) 
Seat 5: ChuikaPridi ($10 in chips) 
Seat 6: XaXaTyH4uK ($11.01 in chips) 
ChuikaPridi: posts small blind $0.05
XaXaTyH4uK: posts big blind $0.10
*** HOLE CARDS ***
Yabidooo: raises $0.20 to $0.30
Dimka4: folds 
Pokeaster: folds 
Dcaro31: folds 
ChuikaPridi: folds 
XaXaTyH4uK: folds 
Uncalled bet ($0.20) returned to Yabidooo
Yabidooo collected $0.25 from pot
*** SUMMARY ***
Total pot $0.25 | Rake $0 
Seat 1: Yabidooo collected ($0.25)
Seat 2: Dimka4 folded before Flop (didn't bet)
Seat 3: Pokeaster folded before Flop (didn't bet)
Seat 4: Dcaro31 (button) folded before Flop (didn't bet)
Seat 5: ChuikaPridi (small blind) folded before Flop
Seat 6: XaXaTyH4uK (big blind) folded before Flop



PokerStars Hand #166667837420:  Hold'em No Limit ($0.05/$0.10 USD) - 2017/02/23 16:08:25 ET
Table 'Postrema' 6-max Seat #3 is the button
Seat 1: CHRO8 ($10.51 in chips) 
Seat 2: pancernik21 ($13.44 in chips) 
Seat 3: edcc19 ($5.65 in chips) 
Seat 4: ChuikaPridi ($13.53 in chips) 
Seat 5: Comeback3392 ($11.37 in chips) 
Seat 6: Scanner17 ($10 in chips) 
ChuikaPridi: posts small blind $0.05
Comeback3392: posts big blind $0.10
*** HOLE CARDS ***
Scanner17: folds 
CHRO8 has timed out
CHRO8: folds 
pancernik21: folds 
edcc19: calls $0.10
ChuikaPridi: folds 
Comeback3392: checks 
*** FLOP *** [7h 9s 7c]
Comeback3392: checks 
edcc19: checks 
*** TURN *** [7h 9s 7c] [8c]
Comeback3392: bets $0.15
edcc19: calls $0.15
*** RIVER *** [7h 9s 7c 8c] [Qc]
Comeback3392: checks 
edcc19: bets $0.30
Comeback3392: calls $0.30
*** SHOW DOWN ***
edcc19: shows [Kh 6c] (a pair of Sevens)
Comeback3392: shows [8d 5h] (two pair, Eights and Sevens)
Comeback3392 collected $1.10 from pot
*** SUMMARY ***
Total pot $1.15 | Rake $0.05 
Board [7h 9s 7c 8c Qc]
Seat 1: CHRO8 folded before Flop (didn't bet)
Seat 2: pancernik21 folded before Flop (didn't bet)
Seat 3: edcc19 (button) showed [Kh 6c] and lost with a pair of Sevens
Seat 4: ChuikaPridi (small blind) folded before Flop
Seat 5: Comeback3392 (big blind) showed [8d 5h] and won ($1.10) with two pair, Eights and Sevens
Seat 6: Scanner17 folded before Flop (didn't bet)



PokerStars Hand #166667837491:  Hold'em No Limit ($0.05/$0.10 USD) - 2017/02/23 16:08:25 ET
Table 'Sinon II' 6-max Seat #2 is the button
Seat 1: Aescul@pius ($10 in chips) 
Seat 2: ÄissesHai ($25.63 in chips) 
Seat 3: crazydevill ($10 in chips) 
Seat 4: Bandyaev ($14.83 in chips) 
Seat 5: ab260414 ($11.06 in chips) 
Seat 6: hartmut2012 ($5.13 in chips) 
crazydevill: posts small blind $0.05
Bandyaev: posts big blind $0.10
*** HOLE CARDS ***
ab260414: folds 
hartmut2012: calls $0.10
Aescul@pius: folds 
ÄissesHai: calls $0.10
crazydevill: calls $0.05
Bandyaev: checks 
*** FLOP *** [Jh 7d 5s]
crazydevill: bets $0.20
Bandyaev: folds 
hartmut2012: calls $0.20
ÄissesHai: calls $0.20
*** TURN *** [Jh 7d 5s] [6d]
crazydevill: bets $0.50
hartmut2012: calls $0.50
ÄissesHai: calls $0.50
*** RIVER *** [Jh 7d 5s 6d] [Ac]
crazydevill: checks 
hartmut2012: bets $2.40
ÄissesHai: folds 
crazydevill: folds 
Uncalled bet ($2.40) returned to hartmut2012
hartmut2012 collected $2.39 from pot
*** SUMMARY ***
Total pot $2.50 | Rake $0.11 
Board [Jh 7d 5s 6d Ac]
Seat 1: Aescul@pius folded before Flop (didn't bet)
Seat 2: ÄissesHai (button) folded on the River
Seat 3: crazydevill (small blind) folded on the River
Seat 4: Bandyaev (big blind) folded on the Flop
Seat 5: ab260414 folded before Flop (didn't bet)
Seat 6: hartmut2012 collected ($2.39)



PokerStars Hand #166667837497:  Hold'em No Limit ($0.05/$0.10 USD) - 2017/02/23 16:08:25 ET
Table 'Xanthippe II' 6-max Seat #3 is the button
Seat 2: Bird et al ($10.23 in chips) 
Seat 3: Dcaro31 ($14.61 in chips) 
Seat 6: Orlangoor ($13.08 in chips) 
Orlangoor: posts small blind $0.05
RoJ1: is sitting out 
RoJ1 leaves the table
Bird et al: posts big blind $0.10
*** HOLE CARDS ***
Dcaro31: raises $0.20 to $0.30
Orlangoor: folds 
Bird et al: folds 
Uncalled bet ($0.20) returned to Dcaro31
Dcaro31 collected $0.25 from pot
*** SUMMARY ***
Total pot $0.25 | Rake $0 
Seat 2: Bird et al (big blind) folded before Flop
Seat 3: Dcaro31 (button) collected ($0.25)
Seat 6: Orlangoor (small blind) folded before Flop



PokerStars Hand #166667838019:  Hold'em No Limit ($0.05/$0.10 USD) - 2017/02/23 16:08:26 ET
Table 'Caprera III' 6-max Seat #5 is the button
Seat 1: Vrinni ($19.44 in chips) 
Seat 2: hg123454321 ($10.72 in chips) 
Seat 5: fedorka rus ($50.43 in chips) 
Seat 6: GESPERIA ($15.46 in chips) 
GESPERIA: posts small blind $0.05
Vrinni: posts big blind $0.10
*** HOLE CARDS ***
hg123454321: folds 
fedorka rus: folds 
GESPERIA: raises $0.20 to $0.30
Vrinni: folds 
Uncalled bet ($0.20) returned to GESPERIA
GESPERIA collected $0.20 from pot
*** SUMMARY ***
Total pot $0.20 | Rake $0 
Seat 1: Vrinni (big blind) folded before Flop
Seat 2: hg123454321 folded before Flop (didn't bet)
Seat 5: fedorka rus (button) folded before Flop (didn't bet)
Seat 6: GESPERIA (small blind) collected ($0.20)



PokerStars Hand #166667838229:  Hold'em No Limit ($0.05/$0.10 USD) - 2017/02/23 16:08:26 ET
Table 'Risha II' 6-max Seat #2 is the button
Seat 1: R. Lemonte ($14.55 in chips) 
Seat 2: KA3AXCTAHEU, ($12.50 in chips) 
Seat 3: steepfell ($10.05 in chips) 
Seat 4: Comeback3392 ($19.68 in chips) 
Seat 5: m.c-alkatraz ($10.05 in chips) 
Seat 6: univibe68 ($10.61 in chips) 
steepfell: posts small blind $0.05
Comeback3392: posts big blind $0.10
*** HOLE CARDS ***
m.c-alkatraz has timed out
m.c-alkatraz: folds 
univibe68: raises $0.20 to $0.30
R. Lemonte: folds 
KA3AXCTAHEU,: folds 
steepfell: folds 
Comeback3392: folds 
Uncalled bet ($0.20) returned to univibe68
univibe68 collected $0.25 from pot
*** SUMMARY ***
Total pot $0.25 | Rake $0 
Seat 1: R. Lemonte folded before Flop (didn't bet)
Seat 2: KA3AXCTAHEU, (button) folded before Flop (didn't bet)
Seat 3: steepfell (small blind) folded before Flop
Seat 4: Comeback3392 (big blind) folded before Flop
Seat 5: m.c-alkatraz folded before Flop (didn't bet)
Seat 6: univibe68 collected ($0.25)



PokerStars Hand #166667838577:  Hold'em No Limit ($0.05/$0.10 USD) - 2017/02/23 16:08:27 ET
Table 'Serpens' 6-max Seat #6 is the button
Seat 1: Namhkal ($10.20 in chips) 
Seat 2: KA3AXCTAHEU, ($19.63 in chips) 
Seat 3: homelessdan ($29.29 in chips) 
Seat 4: Ragazzi3 ($9.45 in chips) 
Seat 5: XwinX25 ($11.97 in chips) 
Seat 6: Croplayer1 ($10.18 in chips) 
Namhkal: posts small blind $0.05
KA3AXCTAHEU,: posts big blind $0.10
*** HOLE CARDS ***
homelessdan: calls $0.10
Ragazzi3: folds 
XwinX25: folds 
Croplayer1: folds 
Namhkal: raises $0.35 to $0.45
KA3AXCTAHEU,: folds 
homelessdan: calls $0.35
*** FLOP *** [2s 5d 8h]
Namhkal: bets $0.48
homelessdan: calls $0.48
*** TURN *** [2s 5d 8h] [7c]
Namhkal: checks 
homelessdan: bets $1.10
Namhkal: folds 
Uncalled bet ($1.10) returned to homelessdan
homelessdan collected $1.87 from pot
*** SUMMARY ***
Total pot $1.96 | Rake $0.09 
Board [2s 5d 8h 7c]
Seat 1: Namhkal (small blind) folded on the Turn
Seat 2: KA3AXCTAHEU, (big blind) folded before Flop
Seat 3: homelessdan collected ($1.87)
Seat 4: Ragazzi3 folded before Flop (didn't bet)
Seat 5: XwinX25 folded before Flop (didn't bet)
Seat 6: Croplayer1 (button) folded before Flop (didn't bet)



PokerStars Hand #166667838888:  Hold'em No Limit ($0.05/$0.10 USD) - 2017/02/23 16:08:27 ET
Table 'Tomyris II' 6-max Seat #3 is the button
Seat 1: ArcticBearDK ($21.83 in chips) 
Seat 2: Yspenyanin ($12.62 in chips) 
Seat 3: robertsabb ($11.98 in chips) 
Seat 4: Dcaro31 ($10.05 in chips) 
Seat 5: 6ePeMeHHa9 ($11.80 in chips) 
Seat 6: StackSmakka ($10.04 in chips) 
Dcaro31: posts small blind $0.05
6ePeMeHHa9: posts big blind $0.10
*** HOLE CARDS ***
StackSmakka: folds 
ArcticBearDK: folds 
Yspenyanin: folds 
robertsabb: raises $0.10 to $0.20
Dcaro31: folds 
6ePeMeHHa9: folds 
Uncalled bet ($0.10) returned to robertsabb
robertsabb collected $0.25 from pot
*** SUMMARY ***
Total pot $0.25 | Rake $0 
Seat 1: ArcticBearDK folded before Flop (didn't bet)
Seat 2: Yspenyanin folded before Flop (didn't bet)
Seat 3: robertsabb (button) collected ($0.25)
Seat 4: Dcaro31 (small blind) folded before Flop
Seat 5: 6ePeMeHHa9 (big blind) folded before Flop
Seat 6: StackSmakka folded before Flop (didn't bet)



PokerStars Hand #166667839189:  Hold'em No Limit ($0.05/$0.10 USD) - 2017/02/23 16:08:27 ET
Table 'Ostara III' 6-max Seat #2 is the button
Seat 1: MühliJr ($10 in chips) 
Seat 2: Action_Gibi ($12.64 in chips) 
Seat 3: vtalian ($12.88 in chips) 
Seat 4: Goovr ($28.91 in chips) 
Seat 6: FlopsterGB ($10 in chips) 
vtalian: posts small blind $0.05
Goovr: posts big blind $0.10
*** HOLE CARDS ***
MühliJr said, "nh"
FlopsterGB: raises $0.15 to $0.25
MühliJr: calls $0.25
Action_Gibi said, "ty"
Action_Gibi: calls $0.25
vtalian: folds 
Goovr: folds 
*** FLOP *** [Ks 6d 3s]
dzesio18 leaves the table
FlopsterGB: bets $0.41
MühliJr: folds 
Action_Gibi: calls $0.41
*** TURN *** [Ks 6d 3s] [8c]
FlopsterGB: checks 
Action_Gibi: checks 
*** RIVER *** [Ks 6d 3s 8c] [Jc]
THIMUCHIN joins the table at seat #5 
FlopsterGB: checks 
Action_Gibi: bets $0.82
FlopsterGB: folds 
Uncalled bet ($0.82) returned to Action_Gibi
Action_Gibi collected $1.64 from pot
*** SUMMARY ***
Total pot $1.72 | Rake $0.08 
Board [Ks 6d 3s 8c Jc]
Seat 1: MühliJr folded on the Flop
Seat 2: Action_Gibi (button) collected ($1.64)
Seat 3: vtalian (small blind) folded before Flop
Seat 4: Goovr (big blind) folded before Flop
Seat 6: FlopsterGB folded on the River



PokerStars Hand #166667839254:  Hold'em No Limit ($0.05/$0.10 USD) - 2017/02/23 16:08:27 ET
Table 'Sirius II' 6-max Seat #1 is the button
Seat 1: Ampped87 ($14.05 in chips) 
Seat 2: Buddy8711 ($8.13 in chips) 
Seat 3: Spud014 ($10.25 in chips) 
Seat 5: pokekrk ($10.17 in chips) 
Seat 6: MihaGr ($10 in chips) 
Buddy8711: posts small blind $0.05
Spud014: posts big blind $0.10
*** HOLE CARDS ***
pokekrk: folds 
MihaGr: folds 
Ampped87: raises $0.10 to $0.20
Buddy8711: calls $0.15
Spud014: folds 
*** FLOP *** [4h Kc Qd]
Buddy8711: bets $0.50
Ampped87: folds 
Uncalled bet ($0.50) returned to Buddy8711
Buddy8711 collected $0.48 from pot
*** SUMMARY ***
Total pot $0.50 | Rake $0.02 
Board [4h Kc Qd]
Seat 1: Ampped87 (button) folded on the Flop
Seat 2: Buddy8711 (small blind) collected ($0.48)
Seat 3: Spud014 (big blind) folded before Flop
Seat 5: pokekrk folded before Flop (didn't bet)
Seat 6: MihaGr folded before Flop (didn't bet)



PokerStars Hand #166667839435:  Hold'em No Limit ($0.05/$0.10 USD) - 2017/02/23 16:08:28 ET
Table 'Grietje' 6-max Seat #1 is the button
Seat 1: dragonste89 ($10 in chips) 
Seat 2: Feverhead ($12.62 in chips) 
Seat 3: GitoValdivia ($3.87 in chips) 
Seat 4: MihaGr ($10.71 in chips) 
Seat 5: iThreeBarrel ($10 in chips) 
Seat 6: Prometheu$8 ($26.52 in chips) 
Feverhead: posts small blind $0.05
GitoValdivia: posts big blind $0.10
*** HOLE CARDS ***
MihaGr: folds 
iThreeBarrel: folds 
Prometheu$8: folds 
dragonste89: raises $0.15 to $0.25
Feverhead: raises $0.60 to $0.85
GitoValdivia: calls $0.75
dragonste89: folds 
*** FLOP *** [Ks Kc 2s]
Feverhead: bets $1
GitoValdivia: calls $1
*** TURN *** [Ks Kc 2s] [Th]
Feverhead: checks 
GitoValdivia: bets $2.02 and is all-in
Feverhead: calls $2.02
*** RIVER *** [Ks Kc 2s Th] [7d]
*** SHOW DOWN ***
Feverhead: shows [As Js] (a pair of Kings)
GitoValdivia: shows [Tc Ac] (two pair, Kings and Tens)
GitoValdivia collected $7.63 from pot
*** SUMMARY ***
Total pot $7.99 | Rake $0.36 
Board [Ks Kc 2s Th 7d]
Seat 1: dragonste89 (button) folded before Flop
Seat 2: Feverhead (small blind) showed [As Js] and lost with a pair of Kings
Seat 3: GitoValdivia (big blind) showed [Tc Ac] and won ($7.63) with two pair, Kings and Tens
Seat 4: MihaGr folded before Flop (didn't bet)
Seat 5: iThreeBarrel folded before Flop (didn't bet)
Seat 6: Prometheu$8 folded before Flop (didn't bet)



PokerStars Hand #166667839544:  Hold'em No Limit ($0.05/$0.10 USD) - 2017/02/23 16:08:28 ET
Table 'Antinous' 6-max Seat #4 is the button
Seat 1: Andrei ProFF ($15.98 in chips) 
Seat 2: Nr847 ($13.60 in chips) 
Seat 3: dittoro ($10 in chips) 
Seat 4: Pekaml ($15.50 in chips) 
Seat 5: Covetsoles ($3.42 in chips) 
Seat 6: coolisses111 ($10 in chips) 
Covetsoles: posts small blind $0.05
coolisses111: posts big blind $0.10
*** HOLE CARDS ***
Andrei ProFF: folds 
Nr847: folds 
dittoro: folds 
Pekaml: raises $0.10 to $0.20
Covetsoles: folds 
coolisses111: folds 
Uncalled bet ($0.10) returned to Pekaml
Pekaml collected $0.25 from pot
*** SUMMARY ***
Total pot $0.25 | Rake $0 
Seat 1: Andrei ProFF folded before Flop (didn't bet)
Seat 2: Nr847 folded before Flop (didn't bet)
Seat 3: dittoro folded before Flop (didn't bet)
Seat 4: Pekaml (button) collected ($0.25)
Seat 5: Covetsoles (small blind) folded before Flop
Seat 6: coolisses111 (big blind) folded before Flop



PokerStars Hand #166667839890:  Hold'em No Limit ($0.05/$0.10 USD) - 2017/02/23 16:08:28 ET
Table 'Veniakaverin' 6-max Seat #1 is the button
Seat 1: pivanki11 ($6.21 in chips) 
Seat 2: david_sara83 ($10.32 in chips) 
Seat 3: Hyd SK ($29.73 in chips) 
Seat 5: Tox1cel ($13.64 in chips) 
Seat 6: bdixon_5 ($9.30 in chips) 
david_sara83: posts small blind $0.05
Hyd SK: posts big blind $0.10
FRAID358: sits out 
*** HOLE CARDS ***
Tox1cel: raises $0.10 to $0.20
bdixon_5: folds 
pivanki11: calls $0.20
david_sara83: calls $0.15
Hyd SK: raises $1 to $1.20
Tox1cel: calls $1
pivanki11: calls $1
david_sara83: folds 
*** FLOP *** [9h Js 2s]
Hyd SK: checks 
Tox1cel: bets $0.30
pivanki11: calls $0.30
Hyd SK: calls $0.30
*** TURN *** [9h Js 2s] [Tc]
Hyd SK: checks 
Tox1cel: bets $0.70
pivanki11: raises $4.01 to $4.71 and is all-in
Hyd SK: folds 
Tox1cel: calls $4.01
*** RIVER *** [9h Js 2s Tc] [Qh]
*** SHOW DOWN ***
Tox1cel: shows [Jc Ah] (a pair of Jacks)
pivanki11: shows [Kc Qd] (a straight, Nine to King)
pivanki11 collected $13.48 from pot
*** SUMMARY ***
Total pot $14.12 | Rake $0.64 
Board [9h Js 2s Tc Qh]
Seat 1: pivanki11 (button) showed [Kc Qd] and won ($13.48) with a straight, Nine to King
Seat 2: david_sara83 (small blind) folded before Flop
Seat 3: Hyd SK (big blind) folded on the Turn
Seat 5: Tox1cel showed [Jc Ah] and lost with a pair of Jacks
Seat 6: bdixon_5 folded before Flop (didn't bet)



PokerStars Hand #166667840210:  Hold'em No Limit ($0.05/$0.10 USD) - 2017/02/23 16:08:28 ET
Table 'Lorbach' 6-max Seat #4 is the button
Seat 1: LarryTheStar ($17.49 in chips) 
Seat 3: ArcticBearDK ($10 in chips) 
Seat 4: McCleans ($10.27 in chips) 
Seat 5: Vanpoker84 ($7.70 in chips) 
Seat 6: Worlz ($15.73 in chips) 
Vanpoker84: posts small blind $0.05
Worlz: posts big blind $0.10
fabadam: sits out 
*** HOLE CARDS ***
LarryTheStar: folds 
ArcticBearDK: folds 
McCleans: raises $0.15 to $0.25
Vanpoker84: folds 
Worlz: calls $0.15
*** FLOP *** [Kh Jd 2c]
Vanpoker84 leaves the table
Worlz: checks 
McCleans: checks 
*** TURN *** [Kh Jd 2c] [2d]
Worlz: bets $0.27
McCleans: calls $0.27
*** RIVER *** [Kh Jd 2c 2d] [7d]
Worlz: checks 
McCleans: bets $1.04
Worlz: folds 
Uncalled bet ($1.04) returned to McCleans
McCleans collected $1.04 from pot
*** SUMMARY ***
Total pot $1.09 | Rake $0.05 
Board [Kh Jd 2c 2d 7d]
Seat 1: LarryTheStar folded before Flop (didn't bet)
Seat 3: ArcticBearDK folded before Flop (didn't bet)
Seat 4: McCleans (button) collected ($1.04)
Seat 5: Vanpoker84 (small blind) folded before Flop
Seat 6: Worlz (big blind) folded on the River



PokerStars Hand #166667840357:  Hold'em No Limit ($0.05/$0.10 USD) - 2017/02/23 16:08:29 ET
Table 'Kobresia II' 6-max Seat #3 is the button
Seat 1: RoJ1 ($13.94 in chips) 
Seat 2: Dcaro31 ($13.14 in chips) 
Seat 3: FRAID358 ($10.69 in chips) 
Seat 5: Goroshkos88 ($12.37 in chips) 
Goroshkos88: posts small blind $0.05
WinninBikini: is sitting out 
WinninBikini leaves the table
RoJ1: posts big blind $0.10
*** HOLE CARDS ***
Dcaro31: folds 
FRAID358: raises $0.15 to $0.25
Goroshkos88: folds 
Sbozzz joins the table at seat #4 
RoJ1: calls $0.15
*** FLOP *** [Ad 9d 2d]
RoJ1: checks 
FRAID358: checks 
*** TURN *** [Ad 9d 2d] [2c]
RoJ1: bets $0.38
Sbozzz leaves the table
FRAID358: calls $0.38
*** RIVER *** [Ad 9d 2d 2c] [4s]
RoJ1: bets $1.08
FRAID358: calls $1.08
*** SHOW DOWN ***
RoJ1: shows [2h Th] (three of a kind, Deuces)
FRAID358: mucks hand 
RoJ1 collected $3.31 from pot
*** SUMMARY ***
Total pot $3.47 | Rake $0.16 
Board [Ad 9d 2d 2c 4s]
Seat 1: RoJ1 (big blind) showed [2h Th] and won ($3.31) with three of a kind, Deuces
Seat 2: Dcaro31 folded before Flop (didn't bet)
Seat 3: FRAID358 (button) mucked
Seat 5: Goroshkos88 (small blind) folded before Flop



PokerStars Hand #166667840422:  Hold'em No Limit ($0.05/$0.10 USD) - 2017/02/23 16:08:29 ET
Table 'Iduberga II' 6-max Seat #5 is the button
Seat 1: mhonielsen ($11.06 in chips) 
Seat 2: popypaleta ($12.95 in chips) 
Seat 3: scorpionfish ($11.43 in chips) 
Seat 4: Peter0087 ($9.68 in chips) 
Seat 5: Pokeaster ($11.52 in chips) 
Seat 6: tblocos ($11.14 in chips) 
tblocos: posts small blind $0.05
mhonielsen: posts big blind $0.10
*** HOLE CARDS ***
popypaleta: folds 
scorpionfish: folds 
Peter0087: raises $0.20 to $0.30
Pokeaster: calls $0.30
tblocos: folds 
mhonielsen: calls $0.20
*** FLOP *** [6s Js 3c]
mhonielsen: checks 
Peter0087: bets $0.91
Pokeaster: calls $0.91
mhonielsen: folds 
*** TURN *** [6s Js 3c] [Td]
Peter0087: bets $2.65
Pokeaster: folds 
Uncalled bet ($2.65) returned to Peter0087
Peter0087 collected $2.65 from pot
*** SUMMARY ***
Total pot $2.77 | Rake $0.12 
Board [6s Js 3c Td]
Seat 1: mhonielsen (big blind) folded on the Flop
Seat 2: popypaleta folded before Flop (didn't bet)
Seat 3: scorpionfish folded before Flop (didn't bet)
Seat 4: Peter0087 collected ($2.65)
Seat 5: Pokeaster (button) folded on the Turn
Seat 6: tblocos (small blind) folded before Flop



PokerStars Hand #166667840462:  Hold'em No Limit ($0.05/$0.10 USD) - 2017/02/23 16:08:29 ET
Table 'Izar' 6-max Seat #2 is the button
Seat 2: mvp0013 ($7.93 in chips) 
Seat 3: Yspenyanin ($11.07 in chips) 
Seat 4: Matee92 ($6.24 in chips) 
Seat 5: fishhook5 ($11.30 in chips) 
Seat 6: yodzik ($7.79 in chips) 
Yspenyanin: posts small blind $0.05
Matee92: posts big blind $0.10
*** HOLE CARDS ***
fishhook5: folds 
yodzik: folds 
mvp0013: raises $0.20 to $0.30
Yspenyanin: folds 
Matee92: folds 
Uncalled bet ($0.20) returned to mvp0013
mvp0013 collected $0.25 from pot
*** SUMMARY ***
Total pot $0.25 | Rake $0 
Seat 2: mvp0013 (button) collected ($0.25)
Seat 3: Yspenyanin (small blind) folded before Flop
Seat 4: Matee92 (big blind) folded before Flop
Seat 5: fishhook5 folded before Flop (didn't bet)
Seat 6: yodzik folded before Flop (didn't bet)



PokerStars Hand #166667840566:  Hold'em No Limit ($0.05/$0.10 USD) - 2017/02/23 16:08:29 ET
Table 'Pompeja III' 6-max Seat #5 is the button
Seat 1: Iarlei ($11.94 in chips) 
Seat 2: steepfell ($10.15 in chips) 
Seat 3: Yspenyanin ($12.31 in chips) 
Seat 4: Cluckh ($13.57 in chips) 
Seat 5: Spud014 ($12.45 in chips) 
Seat 6: mega spasser ($4.60 in chips) 
mega spasser: posts small blind $0.05
Iarlei: posts big blind $0.10
*** HOLE CARDS ***
steepfell: folds 
Yspenyanin: folds 
Cluckh: folds 
Spud014: folds 
mega spasser: calls $0.05
Iarlei: checks 
*** FLOP *** [9c 7d 3d]
mega spasser: checks 
Iarlei: bets $0.10
mega spasser: folds 
Uncalled bet ($0.10) returned to Iarlei
Iarlei collected $0.19 from pot
*** SUMMARY ***
Total pot $0.20 | Rake $0.01 
Board [9c 7d 3d]
Seat 1: Iarlei (big blind) collected ($0.19)
Seat 2: steepfell folded before Flop (didn't bet)
Seat 3: Yspenyanin folded before Flop (didn't bet)
Seat 4: Cluckh folded before Flop (didn't bet)
Seat 5: Spud014 (button) folded before Flop (didn't bet)
Seat 6: mega spasser (small blind) folded on the Flop



PokerStars Hand #166667840702:  Hold'em No Limit ($0.05/$0.10 USD) - 2017/02/23 16:08:29 ET
Table 'Orthos III' 6-max Seat #2 is the button
Seat 1: sexy_seagull ($11.12 in chips) 
Seat 2: Xander188 ($19.31 in chips) 
Seat 3: koka4cs ($5.80 in chips) 
Seat 4: FlopsterGB ($16.50 in chips) 
Seat 5: Bird et al ($18.31 in chips) 
Seat 6: RoJ1 ($10.64 in chips) 
koka4cs: posts small blind $0.05
FlopsterGB: posts big blind $0.10
*** HOLE CARDS ***
Bird et al: folds 
RoJ1: folds 
sexy_seagull: folds 
Xander188: folds 
koka4cs: calls $0.05
FlopsterGB: checks 
*** FLOP *** [8d 3c 4d]
koka4cs: bets $0.10
FlopsterGB: calls $0.10
*** TURN *** [8d 3c 4d] [Qh]
koka4cs: bets $0.30
FlopsterGB: calls $0.30
*** RIVER *** [8d 3c 4d Qh] [4s]
koka4cs: checks 
FlopsterGB: bets $0.46
koka4cs: folds 
Uncalled bet ($0.46) returned to FlopsterGB
FlopsterGB collected $0.96 from pot
*** SUMMARY ***
Total pot $1 | Rake $0.04 
Board [8d 3c 4d Qh 4s]
Seat 1: sexy_seagull folded before Flop (didn't bet)
Seat 2: Xander188 (button) folded before Flop (didn't bet)
Seat 3: koka4cs (small blind) folded on the River
Seat 4: FlopsterGB (big blind) collected ($0.96)
Seat 5: Bird et al folded before Flop (didn't bet)
Seat 6: RoJ1 folded before Flop (didn't bet)



PokerStars Hand #166667840771:  Hold'em No Limit ($0.05/$0.10 USD) - 2017/02/23 16:08:29 ET
Table 'Arpola' 6-max Seat #5 is the button
Seat 1: dincimus ($11.02 in chips) 
Seat 2: patrick19111 ($10 in chips) 
Seat 4: Orlangoor ($19 in chips) 
Seat 5: truck1234 ($11.51 in chips) 
dincimus: posts small blind $0.05
patrick19111: posts big blind $0.10
*** HOLE CARDS ***
Orlangoor: raises $0.15 to $0.25
DasoII joins the table at seat #6 
truck1234: folds 
dincimus: folds 
patrick19111: raises $0.65 to $0.90
Orlangoor: folds 
Uncalled bet ($0.65) returned to patrick19111
patrick19111 collected $0.55 from pot
*** SUMMARY ***
Total pot $0.55 | Rake $0 
Seat 1: dincimus (small blind) folded before Flop
Seat 2: patrick19111 (big blind) collected ($0.55)
Seat 4: Orlangoor folded before Flop
Seat 5: truck1234 (button) folded before Flop (didn't bet)



PokerStars Hand #166667840794:  Hold'em No Limit ($0.05/$0.10 USD) - 2017/02/23 16:08:29 ET
Table 'Aegle' 6-max Seat #5 is the button
Seat 1: phatts76 ($3.60 in chips) 
Seat 2: yodzik ($5.42 in chips) 
Seat 3: DrejAtom ($12.29 in chips) 
Seat 4: ab260414 ($10.22 in chips) 
Seat 5: KokoulinV ($11.34 in chips) 
Seat 6: CHRO8 ($20.46 in chips) 
CHRO8: posts small blind $0.05
phatts76: posts big blind $0.10
*** HOLE CARDS ***
yodzik: folds 
DrejAtom: raises $0.10 to $0.20
ab260414: raises $0.60 to $0.80
KokoulinV: folds 
CHRO8: folds 
phatts76: folds 
DrejAtom: raises $1.75 to $2.55
ab260414: raises $7.67 to $10.22 and is all-in
DrejAtom: folds 
Uncalled bet ($7.67) returned to ab260414
ab260414 collected $5.25 from pot
*** SUMMARY ***
Total pot $5.25 | Rake $0 
Seat 1: phatts76 (big blind) folded before Flop
Seat 2: yodzik folded before Flop (didn't bet)
Seat 3: DrejAtom folded before Flop
Seat 4: ab260414 collected ($5.25)
Seat 5: KokoulinV (button) folded before Flop (didn't bet)
Seat 6: CHRO8 (small blind) folded before Flop



PokerStars Hand #166667841015:  Hold'em No Limit ($0.05/$0.10 USD) - 2017/02/23 16:08:29 ET
Table 'Thoas' 6-max Seat #1 is the button
Seat 1: Pekaml ($11.56 in chips) 
Seat 2: themacer24 ($8.84 in chips) 
Seat 3: iamkakaroto ($10 in chips) 
Seat 4: Morris_Chair ($18.52 in chips) 
Seat 5: Kow6oy ($10 in chips) 
Seat 6: takis nik ($10 in chips) 
themacer24: posts small blind $0.05
iamkakaroto: posts big blind $0.10
*** HOLE CARDS ***
Morris_Chair: folds 
Kow6oy: folds 
takis nik: folds 
Pekaml: raises $0.10 to $0.20
themacer24: folds 
iamkakaroto: calls $0.10
*** FLOP *** [Jd Ad 3d]
iamkakaroto: checks 
Pekaml: bets $0.22
iamkakaroto: calls $0.22
*** TURN *** [Jd Ad 3d] [4s]
iamkakaroto: checks 
Pekaml: checks 
*** RIVER *** [Jd Ad 3d 4s] [2s]
iamkakaroto: checks 
Pekaml: checks 
*** SHOW DOWN ***
iamkakaroto: shows [Jh Qh] (a pair of Jacks)
Pekaml: mucks hand 
iamkakaroto collected $0.85 from pot
*** SUMMARY ***
Total pot $0.89 | Rake $0.04 
Board [Jd Ad 3d 4s 2s]
Seat 1: Pekaml (button) mucked
Seat 2: themacer24 (small blind) folded before Flop
Seat 3: iamkakaroto (big blind) showed [Jh Qh] and won ($0.85) with a pair of Jacks
Seat 4: Morris_Chair folded before Flop (didn't bet)
Seat 5: Kow6oy folded before Flop (didn't bet)
Seat 6: takis nik folded before Flop (didn't bet)



PokerStars Hand #166667841430:  Hold'em No Limit ($0.05/$0.10 USD) - 2017/02/23 16:08:30 ET
Table 'Atalante' 6-max Seat #3 is the button
Seat 1: OceanBlue100 ($4.94 in chips) 
Seat 2: CiisCi ($20.05 in chips) 
Seat 3: Kow6oy ($10 in chips) 
Seat 4: Dcaro31 ($23.87 in chips) 
Seat 5: eniksenik ($10.14 in chips) 
Seat 6: FlopsterGB ($31.51 in chips) 
Dcaro31: posts small blind $0.05
eniksenik: posts big blind $0.10
*** HOLE CARDS ***
FlopsterGB: folds 
OceanBlue100: folds 
CiisCi: folds 
Kow6oy: folds 
Dcaro31: folds 
Uncalled bet ($0.05) returned to eniksenik
eniksenik collected $0.10 from pot
*** SUMMARY ***
Total pot $0.10 | Rake $0 
Seat 1: OceanBlue100 folded before Flop (didn't bet)
Seat 2: CiisCi folded before Flop (didn't bet)
Seat 3: Kow6oy (button) folded before Flop (didn't bet)
Seat 4: Dcaro31 (small blind) folded before Flop
Seat 5: eniksenik (big blind) collected ($0.10)
Seat 6: FlopsterGB folded before Flop (didn't bet)



PokerStars Hand #166667841432:  Hold'em No Limit ($0.05/$0.10 USD) - 2017/02/23 16:08:30 ET
Table 'Eurykleia' 6-max Seat #6 is the button
Seat 1: Giyorod ($10.05 in chips) 
Seat 2: x3ultimate ($10.74 in chips) 
Seat 3: boxer821 ($20.41 in chips) 
Seat 4: 6ePeMeHHa9 ($16.59 in chips) 
Seat 5: fishhook5 ($10 in chips) 
Seat 6: afca128 ($7.16 in chips) 
Giyorod: posts small blind $0.05
x3ultimate: posts big blind $0.10
*** HOLE CARDS ***
boxer821: folds 
6ePeMeHHa9: folds 
fishhook5: folds 
afca128: folds 
Giyorod: raises $0.20 to $0.30
x3ultimate: folds 
Uncalled bet ($0.20) returned to Giyorod
Giyorod collected $0.20 from pot
*** SUMMARY ***
Total pot $0.20 | Rake $0 
Seat 1: Giyorod (small blind) collected ($0.20)
Seat 2: x3ultimate (big blind) folded before Flop
Seat 3: boxer821 folded before Flop (didn't bet)
Seat 4: 6ePeMeHHa9 folded before Flop (didn't bet)
Seat 5: fishhook5 folded before Flop (didn't bet)
Seat 6: afca128 (button) folded before Flop (didn't bet)



PokerStars Hand #166667841473:  Hold'em No Limit ($0.05/$0.10 USD) - 2017/02/23 16:08:30 ET
Table 'Atropos' 6-max Seat #6 is the button
Seat 1: ScorpionF39 ($2.12 in chips) 
Seat 2: yodzik ($5 in chips) 
Seat 3: NvR.m1nD ($10.53 in chips) 
Seat 4: iDecMate ($10.97 in chips) 
Seat 5: KokoulinV ($11.79 in chips) 
Seat 6: Iarlei ($12.43 in chips) 
ScorpionF39: posts small blind $0.05
yodzik: posts big blind $0.10
*** HOLE CARDS ***
NvR.m1nD: folds 
iDecMate: folds 
KokoulinV: folds 
Iarlei: raises $0.15 to $0.25
ScorpionF39: folds 
yodzik: folds 
Uncalled bet ($0.15) returned to Iarlei
Iarlei collected $0.25 from pot
*** SUMMARY ***
Total pot $0.25 | Rake $0 
Seat 1: ScorpionF39 (small blind) folded before Flop
Seat 2: yodzik (big blind) folded before Flop
Seat 3: NvR.m1nD folded before Flop (didn't bet)
Seat 4: iDecMate folded before Flop (didn't bet)
Seat 5: KokoulinV folded before Flop (didn't bet)
Seat 6: Iarlei (button) collected ($0.25)



PokerStars Hand #166667841505:  Hold'em No Limit ($0.05/$0.10 USD) - 2017/02/23 16:08:30 ET
Table 'Bootes' 6-max Seat #5 is the button
Seat 1: Namhkal ($11.25 in chips) 
Seat 2: Bird et al ($17.46 in chips) 
Seat 3: KA3AXCTAHEU, ($20.76 in chips) 
Seat 4: totonove ($6.88 in chips) 
Seat 5: Pekaml ($15.42 in chips) 
Seat 6: cherep61987 ($10.12 in chips) 
cherep61987: posts small blind $0.05
Namhkal: posts big blind $0.10
*** HOLE CARDS ***
Bird et al: folds 
KA3AXCTAHEU,: folds 
totonove: folds 
Pekaml: folds 
cherep61987: folds 
Uncalled bet ($0.05) returned to Namhkal
Namhkal collected $0.10 from pot
*** SUMMARY ***
Total pot $0.10 | Rake $0 
Seat 1: Namhkal (big blind) collected ($0.10)
Seat 2: Bird et al folded before Flop (didn't bet)
Seat 3: KA3AXCTAHEU, folded before Flop (didn't bet)
Seat 4: totonove folded before Flop (didn't bet)
Seat 5: Pekaml (button) folded before Flop (didn't bet)
Seat 6: cherep61987 (small blind) folded before Flop



PokerStars Hand #166667841760:  Hold'em No Limit ($0.05/$0.10 USD) - 2017/02/23 16:08:30 ET
Table 'Thia' 6-max Seat #1 is the button
Seat 1: Eddys Edge ($10.87 in chips) 
Seat 2: sugrob86 ($18.34 in chips) 
Seat 3: northug18 ($9.57 in chips) 
Seat 4: Bandyaev ($10.10 in chips) 
Seat 5: ab260414 ($10.84 in chips) 
Seat 6: ex3Lero86 ($15.65 in chips) 
sugrob86: posts small blind $0.05
northug18: posts big blind $0.10
*** HOLE CARDS ***
Bandyaev: folds 
ab260414: raises $0.20 to $0.30
ex3Lero86: folds 
Eddys Edge: folds 
sugrob86: calls $0.25
northug18: calls $0.20
*** FLOP *** [5c 4h 9h]
sugrob86: checks 
northug18: checks 
ab260414: bets $0.57
sugrob86: raises $2.03 to $2.60
northug18: folds 
ab260414: folds 
Uncalled bet ($2.03) returned to sugrob86
sugrob86 collected $1.95 from pot
*** SUMMARY ***
Total pot $2.04 | Rake $0.09 
Board [5c 4h 9h]
Seat 1: Eddys Edge (button) folded before Flop (didn't bet)
Seat 2: sugrob86 (small blind) collected ($1.95)
Seat 3: northug18 (big blind) folded on the Flop
Seat 4: Bandyaev folded before Flop (didn't bet)
Seat 5: ab260414 folded on the Flop
Seat 6: ex3Lero86 folded before Flop (didn't bet)



PokerStars Hand #166667841830:  Hold'em No Limit ($0.05/$0.10 USD) - 2017/02/23 16:08:30 ET
Table 'Alnasl' 6-max Seat #6 is the button
Seat 1: KA3AXCTAHEU, ($11.10 in chips) 
Seat 2: saddur ($9.64 in chips) 
Seat 3: david_sara83 ($22.54 in chips) 
Seat 4: oddshoff ($10.18 in chips) 
Seat 5: 6ePeMeHHa9 ($10.15 in chips) 
Seat 6: Zooplack ($13.58 in chips) 
KA3AXCTAHEU,: posts small blind $0.05
saddur: posts big blind $0.10
*** HOLE CARDS ***
david_sara83: folds 
oddshoff: raises $0.20 to $0.30
6ePeMeHHa9: folds 
Zooplack: folds 
KA3AXCTAHEU,: folds 
saddur: calls $0.20
*** FLOP *** [9h Ad 6c]
saddur: checks 
oddshoff: bets $0.50
saddur: folds 
Uncalled bet ($0.50) returned to oddshoff
oddshoff collected $0.62 from pot
*** SUMMARY ***
Total pot $0.65 | Rake $0.03 
Board [9h Ad 6c]
Seat 1: KA3AXCTAHEU, (small blind) folded before Flop
Seat 2: saddur (big blind) folded on the Flop
Seat 3: david_sara83 folded before Flop (didn't bet)
Seat 4: oddshoff collected ($0.62)
Seat 5: 6ePeMeHHa9 folded before Flop (didn't bet)
Seat 6: Zooplack (button) folded before Flop (didn't bet)



PokerStars Hand #166667842387:  Hold'em No Limit ($0.05/$0.10 USD) - 2017/02/23 16:08:31 ET
Table 'Selinur' 6-max Seat #6 is the button
Seat 1: KA3AXCTAHEU, ($10 in chips) 
Seat 2: hoedje72 ($7.07 in chips) 
Seat 4: freezing666 ($12.17 in chips) 
Seat 6: homelessdan ($18.50 in chips) 
KA3AXCTAHEU,: posts small blind $0.05
hoedje72: posts big blind $0.10
DrVzad: sits out 
*** HOLE CARDS ***
freezing666: folds 
homelessdan: folds 
KA3AXCTAHEU,: folds 
Uncalled bet ($0.05) returned to hoedje72
hoedje72 collected $0.10 from pot
*** SUMMARY ***
Total pot $0.10 | Rake $0 
Seat 1: KA3AXCTAHEU, (small blind) folded before Flop
Seat 2: hoedje72 (big blind) collected ($0.10)
Seat 4: freezing666 folded before Flop (didn't bet)
Seat 6: homelessdan (button) folded before Flop (didn't bet)



PokerStars Hand #166667842394:  Hold'em No Limit ($0.05/$0.10 USD) - 2017/02/23 16:08:31 ET
Table 'Manto II' 6-max Seat #6 is the button
Seat 1: ex3Lero86 ($10 in chips) 
Seat 2: voledy ($10.57 in chips) 
Seat 3: Komap511 ($9.70 in chips) 
Seat 4: dr.goofy ($14.96 in chips) 
Seat 5: ArcticBearDK ($32.54 in chips) 
Seat 6: pancernik21 ($16.20 in chips) 
ex3Lero86: posts small blind $0.05
voledy: posts big blind $0.10
*** HOLE CARDS ***
Komap511: raises $0.20 to $0.30
dr.goofy: raises $0.60 to $0.90
ArcticBearDK: folds 
pancernik21: folds 
ex3Lero86: folds 
voledy: folds 
Komap511: calls $0.60
*** FLOP *** [9s 7s Jh]
Komap511: checks 
dr.goofy: checks 
*** TURN *** [9s 7s Jh] [Tc]
Komap511: checks 
dr.goofy: checks 
*** RIVER *** [9s 7s Jh Tc] [Qs]
Komap511: checks 
dr.goofy: bets $1.40
Komap511: calls $1.40
*** SHOW DOWN ***
dr.goofy: shows [Kc Ac] (a straight, Ten to Ace)
Komap511: mucks hand 
dr.goofy collected $4.54 from pot
*** SUMMARY ***
Total pot $4.75 | Rake $0.21 
Board [9s 7s Jh Tc Qs]
Seat 1: ex3Lero86 (small blind) folded before Flop
Seat 2: voledy (big blind) folded before Flop
Seat 3: Komap511 mucked
Seat 4: dr.goofy showed [Kc Ac] and won ($4.54) with a straight, Ten to Ace
Seat 5: ArcticBearDK folded before Flop (didn't bet)
Seat 6: pancernik21 (button) folded before Flop (didn't bet)



PokerStars Hand #166667842699:  Hold'em No Limit ($0.05/$0.10 USD) - 2017/02/23 16:08:31 ET
Table 'Virginia II' 6-max Seat #5 is the button
Seat 1: Iarlei ($11.41 in chips) 
Seat 2: Yspenyanin ($10 in chips) 
Seat 3: garigura ($15.73 in chips) 
Seat 4: onkelottoHH ($10.58 in chips) 
Seat 5: dr.goofy ($20.83 in chips) 
Seat 6: NvR.m1nD ($10.35 in chips) 
NvR.m1nD: posts small blind $0.05
Iarlei: posts big blind $0.10
*** HOLE CARDS ***
Yspenyanin: raises $0.15 to $0.25
garigura: folds 
onkelottoHH: folds 
dr.goofy: raises $0.65 to $0.90
NvR.m1nD: folds 
Iarlei: folds 
Yspenyanin: calls $0.65
*** FLOP *** [Ad 2d 9s]
Yspenyanin: checks 
dr.goofy: checks 
*** TURN *** [Ad 2d 9s] [Th]
Yspenyanin: checks 
dr.goofy: checks 
*** RIVER *** [Ad 2d 9s Th] [2s]
Yspenyanin: checks 
dr.goofy: checks 
*** SHOW DOWN ***
Yspenyanin: shows [6s 6c] (two pair, Sixes and Deuces)
dr.goofy: shows [Qd Qs] (two pair, Queens and Deuces)
dr.goofy collected $1.86 from pot
*** SUMMARY ***
Total pot $1.95 | Rake $0.09 
Board [Ad 2d 9s Th 2s]
Seat 1: Iarlei (big blind) folded before Flop
Seat 2: Yspenyanin showed [6s 6c] and lost with two pair, Sixes and Deuces
Seat 3: garigura folded before Flop (didn't bet)
Seat 4: onkelottoHH folded before Flop (didn't bet)
Seat 5: dr.goofy (button) showed [Qd Qs] and won ($1.86) with two pair, Queens and Deuces
Seat 6: NvR.m1nD (small blind) folded before Flop



PokerStars Hand #166667842702:  Hold'em No Limit ($0.05/$0.10 USD) - 2017/02/23 16:08:31 ET
Table 'Walpurga' 6-max Seat #4 is the button
Seat 1: chimera252 ($12.07 in chips) 
Seat 2: paxit71 ($5.25 in chips) 
Seat 3: marianoboni ($16.21 in chips) 
Seat 4: oddshoff ($12.89 in chips) 
Seat 5: Fremara ($9.80 in chips) 
Fremara: posts small blind $0.05
chimera252: posts big blind $0.10
*** HOLE CARDS ***
paxit71: folds 
marianoboni: folds 
oddshoff: folds 
Fremara: folds 
Uncalled bet ($0.05) returned to chimera252
chimera252 collected $0.10 from pot
*** SUMMARY ***
Total pot $0.10 | Rake $0 
Seat 1: chimera252 (big blind) collected ($0.10)
Seat 2: paxit71 folded before Flop (didn't bet)
Seat 3: marianoboni folded before Flop (didn't bet)
Seat 4: oddshoff (button) folded before Flop (didn't bet)
Seat 5: Fremara (small blind) folded before Flop



PokerStars Hand #166667842825:  Hold'em No Limit ($0.05/$0.10 USD) - 2017/02/23 16:08:31 ET
Table 'Siebohme II' 6-max Seat #1 is the button
Seat 1: homelessdan ($17.67 in chips) 
Seat 2: townerz1991 ($14.07 in chips) 
Seat 3: D3NyA ($10.33 in chips) 
Seat 4: POT_TRADER ($12.14 in chips) 
Seat 5: NvR.m1nD ($11.19 in chips) 
Seat 6: Fozzy690 ($9.57 in chips) 
townerz1991: posts small blind $0.05
D3NyA: posts big blind $0.10
*** HOLE CARDS ***
POT_TRADER: folds 
NvR.m1nD: folds 
Fozzy690: calls $0.10
homelessdan: folds 
townerz1991: raises $0.30 to $0.40
D3NyA: raises $0.70 to $1.10
Fozzy690: folds 
townerz1991: calls $0.70
*** FLOP *** [4s 3d 7d]
townerz1991: checks 
D3NyA: bets $0.66
townerz1991: folds 
Uncalled bet ($0.66) returned to D3NyA
D3NyA collected $2.20 from pot
*** SUMMARY ***
Total pot $2.30 | Rake $0.10 
Board [4s 3d 7d]
Seat 1: homelessdan (button) folded before Flop (didn't bet)
Seat 2: townerz1991 (small blind) folded on the Flop
Seat 3: D3NyA (big blind) collected ($2.20)
Seat 4: POT_TRADER folded before Flop (didn't bet)
Seat 5: NvR.m1nD folded before Flop (didn't bet)
Seat 6: Fozzy690 folded before Flop



PokerStars Hand #166667842826:  Hold'em No Limit ($0.05/$0.10 USD) - 2017/02/23 16:08:31 ET
Table 'Gyldenia II' 6-max Seat #1 is the button
Seat 1: KokoulinV ($10.63 in chips) 
Seat 5: CHRO8 ($15.47 in chips) 
Seat 6: 8th wonders ($12.68 in chips) 
D3NyA will be allowed to play after the button
CHRO8: posts small blind $0.05
8th wonders: posts big blind $0.10
*** HOLE CARDS ***
KokoulinV: raises $0.15 to $0.25
6ePeMeHHa9 joins the table at seat #2 
6ePeMeHHa9 leaves the table
RoJ1 joins the table at seat #2 
CHRO8: folds 
D3NyA leaves the table
mhonielsen joins the table at seat #3 
8th wonders: raises $0.75 to $1
KokoulinV: calls $0.75
*** FLOP *** [Js 7c 2s]
8th wonders: checks 
KokoulinV: bets $1.20
8th wonders: folds 
Uncalled bet ($1.20) returned to KokoulinV
KokoulinV collected $1.96 from pot
*** SUMMARY ***
Total pot $2.05 | Rake $0.09 
Board [Js 7c 2s]
Seat 1: KokoulinV (button) collected ($1.96)
Seat 5: CHRO8 (small blind) folded before Flop
Seat 6: 8th wonders (big blind) folded on the Flop



PokerStars Hand #166667843041:  Hold'em No Limit ($0.05/$0.10 USD) - 2017/02/23 16:08:32 ET
Table 'Nehalennia III' 6-max Seat #1 is the button
Seat 1: boxer821 ($11.81 in chips) 
Seat 2: fortieth ($10.86 in chips) 
Seat 3: ValdemorS ($18.26 in chips) 
Seat 4: eniksenik ($10 in chips) 
Seat 5: wulffboy ($36.90 in chips) 
Seat 6: valzeny ($20.52 in chips) 
fortieth: posts small blind $0.05
ValdemorS: posts big blind $0.10
boxer821: posts the ante $0.02
fortieth: posts the ante $0.02
ValdemorS: posts the ante $0.02
eniksenik: posts the ante $0.02
wulffboy: posts the ante $0.02
valzeny: posts the ante $0.02
*** HOLE CARDS ***
eniksenik: raises $0.20 to $0.30
wulffboy: calls $0.30
valzeny: folds 
boxer821: folds 
fortieth: raises $1 to $1.30
ValdemorS: folds 
eniksenik: folds 
wulffboy: folds 
Uncalled bet ($1) returned to fortieth
fortieth collected $1.12 from pot
*** SUMMARY ***
Total pot $1.12 | Rake $0 
Seat 1: boxer821 (button) folded before Flop (didn't bet)
Seat 2: fortieth (small blind) collected ($1.12)
Seat 3: ValdemorS (big blind) folded before Flop
Seat 4: eniksenik folded before Flop
Seat 5: wulffboy folded before Flop
Seat 6: valzeny folded before Flop (didn't bet)



PokerStars Hand #166667843296:  Hold'em No Limit ($0.05/$0.10 USD) - 2017/02/23 16:08:32 ET
Table 'Ushakaron II' 6-max Seat #1 is the button
Seat 1: Kow6oy ($10 in chips) 
Seat 2: Iarlei ($12.49 in chips) 
Seat 3: Rodik002 ($11.22 in chips) 
Seat 4: avintage176 ($29.73 in chips) 
Seat 5: 1limewax1 ($16.23 in chips) 
Seat 6: eniksenik ($10 in chips) 
Iarlei: posts small blind $0.05
Rodik002: posts big blind $0.10
*** HOLE CARDS ***
avintage176: folds 
1limewax1: folds 
eniksenik: folds 
Kow6oy: folds 
Iarlei: folds 
Uncalled bet ($0.05) returned to Rodik002
Rodik002 collected $0.10 from pot
*** SUMMARY ***
Total pot $0.10 | Rake $0 
Seat 1: Kow6oy (button) folded before Flop (didn't bet)
Seat 2: Iarlei (small blind) folded before Flop
Seat 3: Rodik002 (big blind) collected ($0.10)
Seat 4: avintage176 folded before Flop (didn't bet)
Seat 5: 1limewax1 folded before Flop (didn't bet)
Seat 6: eniksenik folded before Flop (didn't bet)



PokerStars Hand #166667843514:  Hold'em No Limit ($0.05/$0.10 USD) - 2017/02/23 16:08:32 ET
Table 'Iapetus III' 6-max Seat #4 is the button
Seat 1: Czezar Life ($6.35 in chips) 
Seat 2: Crafty23@PS ($10 in chips) 
Seat 3: Goroshkos88 ($10.70 in chips) 
Seat 4: Raggibest ($8.17 in chips) 
Seat 5: homelessdan ($15.54 in chips) 
Seat 6: tauronex ($10 in chips) 
homelessdan: posts small blind $0.05
tauronex: posts big blind $0.10
*** HOLE CARDS ***
Czezar Life: folds 
Crafty23@PS: folds 
Goroshkos88: folds 
Raggibest: calls $0.10
homelessdan: folds 
tauronex: raises $0.40 to $0.50
Raggibest: folds 
Uncalled bet ($0.40) returned to tauronex
tauronex collected $0.25 from pot
*** SUMMARY ***
Total pot $0.25 | Rake $0 
Seat 1: Czezar Life folded before Flop (didn't bet)
Seat 2: Crafty23@PS folded before Flop (didn't bet)
Seat 3: Goroshkos88 folded before Flop (didn't bet)
Seat 4: Raggibest (button) folded before Flop
Seat 5: homelessdan (small blind) folded before Flop
Seat 6: tauronex (big blind) collected ($0.25)



PokerStars Hand #166667844040:  Hold'em No Limit ($0.05/$0.10 USD) - 2017/02/23 16:08:33 ET
Table 'Carina' 6-max Seat #1 is the button
Seat 1: Kupi007 ($10 in chips) 
Seat 3: LarryTheStar ($12.49 in chips) 
Seat 4: steepfell ($10 in chips) 
Seat 5: IAntikI ($10 in chips) 
Seat 6: alexweezer ($8.35 in chips) 
XwinX25 will be allowed to play after the button
LarryTheStar: posts small blind $0.05
steepfell: posts big blind $0.10
*** HOLE CARDS ***
IAntikI: folds 
alexweezer: calls $0.10
Kupi007: folds 
LarryTheStar: folds 
steepfell: checks 
*** FLOP *** [4h 5d 9d]
steepfell: bets $0.16
alexweezer: calls $0.16
*** TURN *** [4h 5d 9d] [6s]
steepfell: bets $0.36
alexweezer: calls $0.36
*** RIVER *** [4h 5d 9d 6s] [5h]
steepfell: bets $0.82
alexweezer: folds 
Uncalled bet ($0.82) returned to steepfell
steepfell collected $1.23 from pot
*** SUMMARY ***
Total pot $1.29 | Rake $0.06 
Board [4h 5d 9d 6s 5h]
Seat 1: Kupi007 (button) folded before Flop (didn't bet)
Seat 3: LarryTheStar (small blind) folded before Flop
Seat 4: steepfell (big blind) collected ($1.23)
Seat 5: IAntikI folded before Flop (didn't bet)
Seat 6: alexweezer folded on the River



PokerStars Hand #166667844764:  Hold'em No Limit ($0.05/$0.10 USD) - 2017/02/23 16:08:34 ET
Table 'Tyndareus II' 6-max Seat #3 is the button
Seat 1: Makc1705 ($4.39 in chips) 
Seat 2: fishhook5 ($10 in chips) 
Seat 3: McCleans ($11.40 in chips) 
Seat 4: gaHy_HaXeP ($10.51 in chips) 
Seat 5: vtalian ($9.85 in chips) 
Seat 6: sexy_seagull ($10.30 in chips) 
gaHy_HaXeP: posts small blind $0.05
vtalian: posts big blind $0.10
*** HOLE CARDS ***
sexy_seagull: folds 
Makc1705: folds 
fishhook5: folds 
McCleans: folds 
gaHy_HaXeP: raises $0.20 to $0.30
vtalian: calls $0.20
*** FLOP *** [Ts 6h Qs]
gaHy_HaXeP: checks 
vtalian: bets $0.33
gaHy_HaXeP: folds 
Uncalled bet ($0.33) returned to vtalian
vtalian collected $0.57 from pot
*** SUMMARY ***
Total pot $0.60 | Rake $0.03 
Board [Ts 6h Qs]
Seat 1: Makc1705 folded before Flop (didn't bet)
Seat 2: fishhook5 folded before Flop (didn't bet)
Seat 3: McCleans (button) folded before Flop (didn't bet)
Seat 4: gaHy_HaXeP (small blind) folded on the Flop
Seat 5: vtalian (big blind) collected ($0.57)
Seat 6: sexy_seagull folded before Flop (didn't bet)



PokerStars Hand #166667844831:  Hold'em No Limit ($0.05/$0.10 USD) - 2017/02/23 16:08:34 ET
Table 'Gelria' 6-max Seat #1 is the button
Seat 1: ab260414 ($10.42 in chips) 
Seat 2: fishhook5 ($10.62 in chips) 
Seat 3: Orlangoor ($11.78 in chips) 
Seat 4: eniksenik ($10.15 in chips) 
Seat 5: apenvel ($8.23 in chips) 
fishhook5: posts small blind $0.05
Orlangoor: posts big blind $0.10
x3ultimate: sits out 
*** HOLE CARDS ***
eniksenik: folds 
apenvel: folds 
ab260414: raises $0.15 to $0.25
fishhook5: raises $0.55 to $0.80
Orlangoor: calls $0.70
ab260414: folds 
*** FLOP *** [3c 7s 5d]
fishhook5: bets $1
Orlangoor: folds 
Uncalled bet ($1) returned to fishhook5
fishhook5 collected $1.77 from pot
*** SUMMARY ***
Total pot $1.85 | Rake $0.08 
Board [3c 7s 5d]
Seat 1: ab260414 (button) folded before Flop
Seat 2: fishhook5 (small blind) collected ($1.77)
Seat 3: Orlangoor (big blind) folded on the Flop
Seat 4: eniksenik folded before Flop (didn't bet)
Seat 5: apenvel folded before Flop (didn't bet)



PokerStars Hand #166667845080:  Hold'em No Limit ($0.05/$0.10 USD) - 2017/02/23 16:08:34 ET
Table 'Epimetheus' 6-max Seat #4 is the button
Seat 1: 6ePeMeHHa9 ($10.29 in chips) 
Seat 2: patrick19111 ($15.51 in chips) 
Seat 3: dineldidi ($9.84 in chips) 
Seat 4: Namhkal ($10 in chips) 
Seat 5: afca128 ($24.08 in chips) 
Seat 6: voledy ($10.60 in chips) 
afca128: posts small blind $0.05
voledy: posts big blind $0.10
*** HOLE CARDS ***
6ePeMeHHa9: folds 
patrick19111: folds 
dineldidi: folds 
Namhkal: folds 
afca128: raises $0.20 to $0.30
voledy: folds 
Uncalled bet ($0.20) returned to afca128
afca128 collected $0.20 from pot
*** SUMMARY ***
Total pot $0.20 | Rake $0 
Seat 1: 6ePeMeHHa9 folded before Flop (didn't bet)
Seat 2: patrick19111 folded before Flop (didn't bet)
Seat 3: dineldidi folded before Flop (didn't bet)
Seat 4: Namhkal (button) folded before Flop (didn't bet)
Seat 5: afca128 (small blind) collected ($0.20)
Seat 6: voledy (big blind) folded before Flop



PokerStars Hand #166667845204:  Hold'em No Limit ($0.05/$0.10 USD) - 2017/02/23 16:08:34 ET
Table 'Apollonia' 6-max Seat #4 is the button
Seat 1: ex3Lero86 ($10.26 in chips) 
Seat 2: ibara000 ($18.43 in chips) 
Seat 3: steepfell ($10.15 in chips) 
Seat 4: Goroshkos88 ($17.72 in chips) 
Seat 6: iluzja12 ($9.90 in chips) 
iluzja12: posts small blind $0.05
ex3Lero86: posts big blind $0.10
*** HOLE CARDS ***
ibara000: folds 
steepfell: folds 
Goroshkos88: raises $0.15 to $0.25
iluzja12: calls $0.20
ex3Lero86: folds 
*** FLOP *** [Qs 9d Qd]
iluzja12: checks 
Goroshkos88: checks 
*** TURN *** [Qs 9d Qd] [4h]
iluzja12: bets $0.30
Goroshkos88: folds 
Uncalled bet ($0.30) returned to iluzja12
iluzja12 collected $0.57 from pot
*** SUMMARY ***
Total pot $0.60 | Rake $0.03 
Board [Qs 9d Qd 4h]
Seat 1: ex3Lero86 (big blind) folded before Flop
Seat 2: ibara000 folded before Flop (didn't bet)
Seat 3: steepfell folded before Flop (didn't bet)
Seat 4: Goroshkos88 (button) folded on the Turn
Seat 6: iluzja12 (small blind) collected ($0.57)



PokerStars Hand #166667845411:  Hold'em No Limit ($0.05/$0.10 USD) - 2017/02/23 16:08:34 ET
Table 'Martha' 6-max Seat #1 is the button
Seat 1: Peter0087 ($10.29 in chips) 
Seat 2: pauli95 ($10.26 in chips) 
Seat 3: Hyd SK ($12.52 in chips) 
Seat 4: dittoro ($10 in chips) 
Seat 5: MihaGr ($10 in chips) 
Seat 6: 8th wonders ($10 in chips) 
pauli95: posts small blind $0.05
Hyd SK: posts big blind $0.10
*** HOLE CARDS ***
dittoro: raises $0.20 to $0.30
MihaGr: folds 
8th wonders: folds 
Peter0087: folds 
pauli95: folds 
Hyd SK: folds 
Uncalled bet ($0.20) returned to dittoro
dittoro collected $0.25 from pot
*** SUMMARY ***
Total pot $0.25 | Rake $0 
Seat 1: Peter0087 (button) folded before Flop (didn't bet)
Seat 2: pauli95 (small blind) folded before Flop
Seat 3: Hyd SK (big blind) folded before Flop
Seat 4: dittoro collected ($0.25)
Seat 5: MihaGr folded before Flop (didn't bet)
Seat 6: 8th wonders folded before Flop (didn't bet)



PokerStars Hand #166667845892:  Hold'em No Limit ($0.05/$0.10 USD) - 2017/02/23 16:08:35 ET
Table 'Pallas II' 6-max Seat #4 is the button
Seat 1: mdelfin0 ($16.37 in chips) 
Seat 4: MisterX413 ($10 in chips) 
Seat 5: gaHy_HaXeP ($10 in chips) 
Seat 6: Smitty03300 ($10 in chips) 
gaHy_HaXeP: posts small blind $0.05
Smitty03300: posts big blind $0.10
DEraser: sits out 
popypaleta: sits out 
*** HOLE CARDS ***
mdelfin0: folds 
MisterX413: folds 
gaHy_HaXeP: raises $0.20 to $0.30
Smitty03300: folds 
Uncalled bet ($0.20) returned to gaHy_HaXeP
gaHy_HaXeP collected $0.20 from pot
*** SUMMARY ***
Total pot $0.20 | Rake $0 
Seat 1: mdelfin0 folded before Flop (didn't bet)
Seat 4: MisterX413 (button) folded before Flop (didn't bet)
Seat 5: gaHy_HaXeP (small blind) collected ($0.20)
Seat 6: Smitty03300 (big blind) folded before Flop



PokerStars Hand #166667845926:  Hold'em No Limit ($0.05/$0.10 USD) - 2017/02/23 16:08:35 ET
Table 'Nauheima II' 6-max Seat #6 is the button
Seat 2: Peter0087 ($10.67 in chips) 
Seat 3: KokoulinV ($12.99 in chips) 
Seat 6: bonyo71 ($5.04 in chips) 
Peter0087: posts small blind $0.05
KokoulinV: posts big blind $0.10
*** HOLE CARDS ***
bonyo71: folds 
Peter0087: raises $0.10 to $0.20
KokoulinV: calls $0.10
*** FLOP *** [Qd Qh 2c]
Peter0087: bets $0.20
Yspenyanin joins the table at seat #4 
KokoulinV: calls $0.20
*** TURN *** [Qd Qh 2c] [8s]
Yspenyanin leaves the table
Peter0087: checks 
KokoulinV: bets $0.50
Peter0087: folds 
Uncalled bet ($0.50) returned to KokoulinV
KokoulinV collected $0.76 from pot
*** SUMMARY ***
Total pot $0.80 | Rake $0.04 
Board [Qd Qh 2c 8s]
Seat 2: Peter0087 (small blind) folded on the Turn
Seat 3: KokoulinV (big blind) collected ($0.76)
Seat 6: bonyo71 (button) folded before Flop (didn't bet)



PokerStars Hand #166667846458:  Hold'em No Limit ($0.05/$0.10 USD) - 2017/02/23 16:08:35 ET
Table 'Samitchell III' 6-max Seat #3 is the button
Seat 2: scorpionfish ($12.98 in chips) 
Seat 3: Vanne11 ($9.45 in chips) 
Vanne11: posts small blind $0.05
DEraser: is sitting out 
scorpionfish: posts big blind $0.10
*** HOLE CARDS ***
Vanne11: folds 
Uncalled bet ($0.05) returned to scorpionfish
scorpionfish collected $0.10 from pot
*** SUMMARY ***
Total pot $0.10 | Rake $0 
Seat 2: scorpionfish (big blind) collected ($0.10)
Seat 3: Vanne11 (button) (small blind) folded before Flop



PokerStars Hand #166667846573:  Hold'em No Limit ($0.05/$0.10 USD) - 2017/02/23 16:08:36 ET
Table 'Lesath III' 6-max Seat #1 is the button
Seat 1: Gogeta26 ($6.59 in chips) 
Seat 2: WinninBikini ($10.22 in chips) 
Seat 3: Giyorod ($10.66 in chips) 
Seat 4: Eddys Edge ($10.51 in chips) 
Seat 5: eniksenik ($15.85 in chips) 
Seat 6: patrick19111 ($10.21 in chips) 
WinninBikini: posts small blind $0.05
Giyorod: posts big blind $0.10
*** HOLE CARDS ***
Eddys Edge: raises $0.20 to $0.30
eniksenik: folds 
patrick19111: folds 
Gogeta26: folds 
WinninBikini: folds 
Giyorod: folds 
Uncalled bet ($0.20) returned to Eddys Edge
Eddys Edge collected $0.25 from pot
*** SUMMARY ***
Total pot $0.25 | Rake $0 
Seat 1: Gogeta26 (button) folded before Flop (didn't bet)
Seat 2: WinninBikini (small blind) folded before Flop
Seat 3: Giyorod (big blind) folded before Flop
Seat 4: Eddys Edge collected ($0.25)
Seat 5: eniksenik folded before Flop (didn't bet)
Seat 6: patrick19111 folded before Flop (didn't bet)



PokerStars Hand #166667846597:  Hold'em No Limit ($0.05/$0.10 USD) - 2017/02/23 16:08:36 ET
Table 'Hamal II' 6-max Seat #1 is the button
Seat 1: saxoalto2011 ($7.64 in chips) 
Seat 2: pancernik21 ($10.38 in chips) 
Seat 3: Cluckh ($10.99 in chips) 
Seat 4: ArcticBearDK ($11.06 in chips) 
Seat 5: eniksenik ($10.89 in chips) 
Seat 6: LarryTheStar ($11.34 in chips) 
pancernik21: posts small blind $0.05
Cluckh: posts big blind $0.10
*** HOLE CARDS ***
ArcticBearDK: folds 
eniksenik: folds 
LarryTheStar: folds 
saxoalto2011: raises $0.20 to $0.30
pancernik21: raises $0.60 to $0.90
Cluckh: folds 
saxoalto2011: calls $0.60
*** FLOP *** [9s Kd Ad]
pancernik21: bets $0.94
saxoalto2011: folds 
Uncalled bet ($0.94) returned to pancernik21
pancernik21 collected $1.81 from pot
*** SUMMARY ***
Total pot $1.90 | Rake $0.09 
Board [9s Kd Ad]
Seat 1: saxoalto2011 (button) folded on the Flop
Seat 2: pancernik21 (small blind) collected ($1.81)
Seat 3: Cluckh (big blind) folded before Flop
Seat 4: ArcticBearDK folded before Flop (didn't bet)
Seat 5: eniksenik folded before Flop (didn't bet)
Seat 6: LarryTheStar folded before Flop (didn't bet)



PokerStars Hand #166667846662:  Hold'em No Limit ($0.05/$0.10 USD) - 2017/02/23 16:08:36 ET
Table 'Juliet II' 6-max Seat #5 is the button
Seat 1: alexpolevaja ($11.29 in chips) 
Seat 2: KA3AXCTAHEU, ($15.68 in chips) 
Seat 3: patrick19111 ($11.42 in chips) 
Seat 4: x3ultimate ($10.40 in chips) 
Seat 5: Dcaro31 ($19.91 in chips) 
Seat 6: BookWorm78 ($31.38 in chips) 
BookWorm78: posts small blind $0.05
alexpolevaja: posts big blind $0.10
*** HOLE CARDS ***
KA3AXCTAHEU,: folds 
patrick19111: folds 
x3ultimate: raises $0.20 to $0.30
Dcaro31: folds 
BookWorm78: folds 
alexpolevaja: folds 
Uncalled bet ($0.20) returned to x3ultimate
x3ultimate collected $0.25 from pot
*** SUMMARY ***
Total pot $0.25 | Rake $0 
Seat 1: alexpolevaja (big blind) folded before Flop
Seat 2: KA3AXCTAHEU, folded before Flop (didn't bet)
Seat 3: patrick19111 folded before Flop (didn't bet)
Seat 4: x3ultimate collected ($0.25)
Seat 5: Dcaro31 (button) folded before Flop (didn't bet)
Seat 6: BookWorm78 (small blind) folded before Flop



PokerStars Hand #166667847049:  Hold'em No Limit ($0.05/$0.10 USD) - 2017/02/23 16:08:36 ET
Table 'Pirola III' 6-max Seat #2 is the button
Seat 1: bdixon_5 ($9.32 in chips) 
Seat 2: Chodemuncher ($10 in chips) 
Seat 3: kingartur222 ($10.87 in chips) 
Seat 4: McCleans ($10.87 in chips) 
Seat 5: tequila_joop ($9.68 in chips) 
Seat 6: T9MS ($11.01 in chips) 
kingartur222: posts small blind $0.05
McCleans: posts big blind $0.10
*** HOLE CARDS ***
tequila_joop: raises $0.20 to $0.30
T9MS: calls $0.30
bdixon_5: folds 
Chodemuncher: folds 
kingartur222: folds 
McCleans: folds 
*** FLOP *** [4h 2d Ks]
tequila_joop: bets $0.54
T9MS: calls $0.54
*** TURN *** [4h 2d Ks] [Th]
tequila_joop: bets $1.31
T9MS: calls $1.31
*** RIVER *** [4h 2d Ks Th] [Tc]
tequila_joop: checks 
T9MS: checks 
*** SHOW DOWN ***
tequila_joop: shows [Ah 9h] (a pair of Tens)
T9MS: shows [Qc Kc] (two pair, Kings and Tens)
T9MS collected $4.25 from pot
*** SUMMARY ***
Total pot $4.45 | Rake $0.20 
Board [4h 2d Ks Th Tc]
Seat 1: bdixon_5 folded before Flop (didn't bet)
Seat 2: Chodemuncher (button) folded before Flop (didn't bet)
Seat 3: kingartur222 (small blind) folded before Flop
Seat 4: McCleans (big blind) folded before Flop
Seat 5: tequila_joop showed [Ah 9h] and lost with a pair of Tens
Seat 6: T9MS showed [Qc Kc] and won ($4.25) with two pair, Kings and Tens



PokerStars Hand #166667847213:  Hold'em No Limit ($0.05/$0.10 USD) - 2017/02/23 16:08:36 ET
Table 'Sheragul III' 6-max Seat #2 is the button
Seat 1: danky24 ($17.59 in chips) 
Seat 2: Bird et al ($10.41 in chips) 
Seat 3: FRAID358 ($9.90 in chips) 
Seat 4: maxiv608 ($10.43 in chips) 
Seat 5: Bandyaev ($15.97 in chips) 
Seat 6: Andrei ProFF ($11.91 in chips) 
FRAID358: posts small blind $0.05
maxiv608: posts big blind $0.10
*** HOLE CARDS ***
Bandyaev: folds 
Andrei ProFF: folds 
danky24: folds 
danky24 leaves the table
Bird et al: folds 
voledy joins the table at seat #1 
FRAID358: folds 
Uncalled bet ($0.05) returned to maxiv608
maxiv608 collected $0.10 from pot
*** SUMMARY ***
Total pot $0.10 | Rake $0 
Seat 1: danky24 folded before Flop (didn't bet)
Seat 2: Bird et al (button) folded before Flop (didn't bet)
Seat 3: FRAID358 (small blind) folded before Flop
Seat 4: maxiv608 (big blind) collected ($0.10)
Seat 5: Bandyaev folded before Flop (didn't bet)
Seat 6: Andrei ProFF folded before Flop (didn't bet)



PokerStars Hand #166667847214:  Hold'em No Limit ($0.05/$0.10 USD) - 2017/02/23 16:08:36 ET
Table 'Siebohme' 6-max Seat #5 is the button
Seat 1: kusa4ki ($11.53 in chips) 
Seat 2: el toro 1507 ($11.53 in chips) 
Seat 3: ex3Lero86 ($10.41 in chips) 
Seat 4: Innerwuss ($11.53 in chips) 
Seat 5: Kazacha ($10 in chips) 
Seat 6: townerz1991 ($10 in chips) 
townerz1991: posts small blind $0.05
kusa4ki: posts big blind $0.10
*** HOLE CARDS ***
el toro 1507: folds 
ex3Lero86: folds 
Innerwuss: folds 
Innerwuss leaves the table
Kazacha: folds 
townerz1991: folds 
Uncalled bet ($0.05) returned to kusa4ki
kusa4ki collected $0.10 from pot
*** SUMMARY ***
Total pot $0.10 | Rake $0 
Seat 1: kusa4ki (big blind) collected ($0.10)
Seat 2: el toro 1507 folded before Flop (didn't bet)
Seat 3: ex3Lero86 folded before Flop (didn't bet)
Seat 4: Innerwuss folded before Flop (didn't bet)
Seat 5: Kazacha (button) folded before Flop (didn't bet)
Seat 6: townerz1991 (small blind) folded before Flop



PokerStars Hand #166667847249:  Hold'em No Limit ($0.05/$0.10 USD) - 2017/02/23 16:08:36 ET
Table 'Tyndareus III' 6-max Seat #4 is the button
Seat 1: MBen10 ($19.24 in chips) 
Seat 2: MihaGr ($10.42 in chips) 
Seat 3: XaXaTyH4uK ($10 in chips) 
Seat 4: tequila_joop ($10 in chips) 
Seat 5: yodzik ($5 in chips) 
Seat 6: Hb-309 ($10.14 in chips) 
yodzik: posts small blind $0.05
Hb-309: posts big blind $0.10
*** HOLE CARDS ***
MBen10: raises $0.18 to $0.28
MihaGr: folds 
XaXaTyH4uK: folds 
tequila_joop: calls $0.28
yodzik: folds 
Hb-309: calls $0.18
*** FLOP *** [Ks 2d 8c]
Hb-309: bets $0.40
MBen10: folds 
tequila_joop: raises $0.91 to $1.31
Hb-309: folds 
Uncalled bet ($0.91) returned to tequila_joop
tequila_joop collected $1.61 from pot
*** SUMMARY ***
Total pot $1.69 | Rake $0.08 
Board [Ks 2d 8c]
Seat 1: MBen10 folded on the Flop
Seat 2: MihaGr folded before Flop (didn't bet)
Seat 3: XaXaTyH4uK folded before Flop (didn't bet)
Seat 4: tequila_joop (button) collected ($1.61)
Seat 5: yodzik (small blind) folded before Flop
Seat 6: Hb-309 (big blind) folded on the Flop



PokerStars Hand #166667847318:  Hold'em No Limit ($0.05/$0.10 USD) - 2017/02/23 16:08:36 ET
Table 'Repsolda' 6-max Seat #6 is the button
Seat 1: fabadam ($10.55 in chips) 
Seat 2: MBen10 ($24.67 in chips) 
Seat 3: manashov ($14.97 in chips) 
Seat 4: MihaGr ($10 in chips) 
Seat 6: RkaczoR ($11.21 in chips) 
fabadam: posts small blind $0.05
MBen10: posts big blind $0.10
matehouse.: sits out 
*** HOLE CARDS ***
manashov: folds 
manashov leaves the table
MihaGr: folds 
RkaczoR: raises $0.15 to $0.25
fabadam: folds 
Andrei ProFF joins the table at seat #3 
MBen10: calls $0.15
*** FLOP *** [Qc 5h Qd]
Andrei ProFF leaves the table
MBen10: checks 
RkaczoR: bets $0.31
MBen10: folds 
Uncalled bet ($0.31) returned to RkaczoR
RkaczoR collected $0.53 from pot
*** SUMMARY ***
Total pot $0.55 | Rake $0.02 
Board [Qc 5h Qd]
Seat 1: fabadam (small blind) folded before Flop
Seat 2: MBen10 (big blind) folded on the Flop
Seat 3: manashov folded before Flop (didn't bet)
Seat 4: MihaGr folded before Flop (didn't bet)
Seat 6: RkaczoR (button) collected ($0.53)



PokerStars Hand #166667847533:  Hold'em No Limit ($0.05/$0.10 USD) - 2017/02/23 16:08:37 ET
Table 'Crommelin II' 6-max Seat #2 is the button
Seat 1: THIMUCHIN ($11.42 in chips) 
Seat 2: Bird et al ($10 in chips) 
Seat 3: Strelok1974 ($19.83 in chips) 
Seat 4: Pequeño Clau ($12.97 in chips) 
Seat 5: Action_Gibi ($19.30 in chips) 
Strelok1974: posts small blind $0.05
Pequeño Clau: posts big blind $0.10
*** HOLE CARDS ***
Action_Gibi: folds 
THIMUCHIN: folds 
Bird et al: raises $0.21 to $0.31
Strelok1974: folds 
Pequeño Clau: folds 
Uncalled bet ($0.21) returned to Bird et al
Bird et al collected $0.25 from pot
*** SUMMARY ***
Total pot $0.25 | Rake $0 
Seat 1: THIMUCHIN folded before Flop (didn't bet)
Seat 2: Bird et al (button) collected ($0.25)
Seat 3: Strelok1974 (small blind) folded before Flop
Seat 4: Pequeño Clau (big blind) folded before Flop
Seat 5: Action_Gibi folded before Flop (didn't bet)



PokerStars Hand #166667847553:  Hold'em No Limit ($0.05/$0.10 USD) - 2017/02/23 16:08:37 ET
Table 'Anhui II' 6-max Seat #4 is the button
Seat 1: kingartur222 ($17.74 in chips) 
Seat 2: kikus334 ($12.56 in chips) 
Seat 3: lochniak556 ($22.79 in chips) 
Seat 4: dragonste89 ($10 in chips) 
Seat 5: Bandyaev ($10 in chips) 
Seat 6: .BaRReL.1122 ($3.90 in chips) 
Bandyaev: posts small blind $0.05
.BaRReL.1122: posts big blind $0.10
*** HOLE CARDS ***
kingartur222: folds 
kikus334: calls $0.10
kingartur222 said, "8)"
lochniak556: calls $0.10
kikus334 said, ""
dragonste89: folds 
Bandyaev: calls $0.05
.BaRReL.1122: checks 
*** FLOP *** [2c 3d 8s]
Bandyaev: checks 
.BaRReL.1122: checks 
kikus334: checks 
lochniak556: bets $0.30
Bandyaev: calls $0.30
.BaRReL.1122: folds 
kikus334: calls $0.30
*** TURN *** [2c 3d 8s] [4h]
Bandyaev: bets $0.94
kikus334: folds 
lochniak556: calls $0.94
*** RIVER *** [2c 3d 8s 4h] [9h]
.BaRReL.1122 said, "lochniak, bedzie na maszynki co?"
Bandyaev: checks 
lochniak556: bets $1.10
Bandyaev: raises $6.02 to $7.12
lochniak556: folds 
Uncalled bet ($6.02) returned to Bandyaev
Bandyaev collected $5.14 from pot
*** SUMMARY ***
Total pot $5.38 | Rake $0.24 
Board [2c 3d 8s 4h 9h]
Seat 1: kingartur222 folded before Flop (didn't bet)
Seat 2: kikus334 folded on the Turn
Seat 3: lochniak556 folded on the River
Seat 4: dragonste89 (button) folded before Flop (didn't bet)
Seat 5: Bandyaev (small blind) collected ($5.14)
Seat 6: .BaRReL.1122 (big blind) folded on the Flop



PokerStars Hand #166667848000:  Hold'em No Limit ($0.05/$0.10 USD) - 2017/02/23 16:08:37 ET
Table 'Unitas II' 6-max Seat #2 is the button
Seat 1: Peter0087 ($9.99 in chips) 
Seat 2: steepfell ($10.10 in chips) 
Seat 3: BahiaMinhaP ($10 in chips) 
Seat 4: truck1234 ($10.94 in chips) 
Seat 5: chimera252 ($24.48 in chips) 
Seat 6: paxit71 ($9.58 in chips) 
BahiaMinhaP: posts small blind $0.05
truck1234: posts big blind $0.10
*** HOLE CARDS ***
chimera252: raises $0.20 to $0.30
paxit71: folds 
Peter0087 has timed out
Peter0087: folds 
steepfell: folds 
BahiaMinhaP: raises $0.70 to $1
truck1234: folds 
chimera252: folds 
Uncalled bet ($0.70) returned to BahiaMinhaP
BahiaMinhaP collected $0.70 from pot
*** SUMMARY ***
Total pot $0.70 | Rake $0 
Seat 1: Peter0087 folded before Flop (didn't bet)
Seat 2: steepfell (button) folded before Flop (didn't bet)
Seat 3: BahiaMinhaP (small blind) collected ($0.70)
Seat 4: truck1234 (big blind) folded before Flop
Seat 5: chimera252 folded before Flop
Seat 6: paxit71 folded before Flop (didn't bet)



PokerStars Hand #166667848001:  Hold'em No Limit ($0.05/$0.10 USD) - 2017/02/23 16:08:37 ET
Table 'Jokaste II' 6-max Seat #2 is the button
Seat 1: Hyd SK ($13.55 in chips) 
Seat 2: T9MS ($12.18 in chips) 
Seat 3: crazydevill ($11.70 in chips) 
Seat 4: FRAID358 ($15.21 in chips) 
Seat 5: Vrinni ($10.13 in chips) 
Seat 6: Adailton07 ($13.70 in chips) 
crazydevill: posts small blind $0.05
FRAID358: posts big blind $0.10
*** HOLE CARDS ***
Vrinni: folds 
Adailton07: folds 
Hyd SK: folds 
T9MS: folds 
crazydevill: folds 
Uncalled bet ($0.05) returned to FRAID358
FRAID358 collected $0.10 from pot
*** SUMMARY ***
Total pot $0.10 | Rake $0 
Seat 1: Hyd SK folded before Flop (didn't bet)
Seat 2: T9MS (button) folded before Flop (didn't bet)
Seat 3: crazydevill (small blind) folded before Flop
Seat 4: FRAID358 (big blind) collected ($0.10)
Seat 5: Vrinni folded before Flop (didn't bet)
Seat 6: Adailton07 folded before Flop (didn't bet)



PokerStars Hand #166667848151:  Hold'em No Limit ($0.05/$0.10 USD) - 2017/02/23 16:08:37 ET
Table 'Armenia' 6-max Seat #1 is the button
Seat 1: tr41n3r12 ($11.52 in chips) 
Seat 2: Yabidooo ($10.88 in chips) 
Seat 3: Crimsonr ($5.14 in chips) 
Seat 4: mbkongstad ($9.60 in chips) 
Seat 6: mega spasser ($7.44 in chips) 
Yabidooo: posts small blind $0.05
Crimsonr: posts big blind $0.10
DrVzad: sits out 
*** HOLE CARDS ***
mbkongstad: folds 
mega spasser: calls $0.10
tr41n3r12: folds 
Yabidooo: folds 
Crimsonr: checks 
*** FLOP *** [5d 4d 6c]
Crimsonr: checks 
mega spasser: checks 
*** TURN *** [5d 4d 6c] [6s]
Crimsonr: bets $0.50
mega spasser: folds 
Uncalled bet ($0.50) returned to Crimsonr
Crimsonr collected $0.24 from pot
*** SUMMARY ***
Total pot $0.25 | Rake $0.01 
Board [5d 4d 6c 6s]
Seat 1: tr41n3r12 (button) folded before Flop (didn't bet)
Seat 2: Yabidooo (small blind) folded before Flop
Seat 3: Crimsonr (big blind) collected ($0.24)
Seat 4: mbkongstad folded before Flop (didn't bet)
Seat 6: mega spasser folded on the Turn



PokerStars Hand #166667848357:  Hold'em No Limit ($0.05/$0.10 USD) - 2017/02/23 16:08:38 ET
Table 'Nemo III' 6-max Seat #5 is the button
Seat 1: Kow6oy ($10 in chips) 
Seat 2: Bandyaev ($11.11 in chips) 
Seat 3: Dimka4 ($10 in chips) 
Seat 4: vtalian ($11.13 in chips) 
Seat 5: Joker51_wtf! ($11.13 in chips) 
Seat 6: maxiv608 ($10 in chips) 
maxiv608: posts small blind $0.05
Kow6oy: posts big blind $0.10
*** HOLE CARDS ***
Bandyaev: raises $0.20 to $0.30
Dimka4: folds 
vtalian: folds 
Joker51_wtf!: raises $0.70 to $1
maxiv608: folds 
Kow6oy: folds 
Bandyaev: folds 
Uncalled bet ($0.70) returned to Joker51_wtf!
Joker51_wtf! collected $0.75 from pot
*** SUMMARY ***
Total pot $0.75 | Rake $0 
Seat 1: Kow6oy (big blind) folded before Flop
Seat 2: Bandyaev folded before Flop
Seat 3: Dimka4 folded before Flop (didn't bet)
Seat 4: vtalian folded before Flop (didn't bet)
Seat 5: Joker51_wtf! (button) collected ($0.75)
Seat 6: maxiv608 (small blind) folded before Flop



PokerStars Hand #166667848404:  Hold'em No Limit ($0.05/$0.10 USD) - 2017/02/23 16:08:38 ET
Table 'Ruvuma' 6-max Seat #3 is the button
Seat 1: FRAID358 ($23.82 in chips) 
Seat 3: Spud014 ($10 in chips) 
Seat 4: DamDatsAnAce ($10 in chips) 
Seat 5: sexy_seagull ($10 in chips) 
DamDatsAnAce: posts small blind $0.05
sexy_seagull: posts big blind $0.10
*** HOLE CARDS ***
FRAID358: folds 
Spud014: raises $0.10 to $0.20
DamDatsAnAce: folds 
sexy_seagull: calls $0.10
*** FLOP *** [3s 6d 9s]
sexy_seagull: checks 
Yspenyanin joins the table at seat #2 
Spud014: checks 
*** TURN *** [3s 6d 9s] [Kc]
sexy_seagull: checks 
Spud014: bets $0.28
sexy_seagull: folds 
Uncalled bet ($0.28) returned to Spud014
Spud014 collected $0.43 from pot
*** SUMMARY ***
Total pot $0.45 | Rake $0.02 
Board [3s 6d 9s Kc]
Seat 1: FRAID358 folded before Flop (didn't bet)
Seat 3: Spud014 (button) collected ($0.43)
Seat 4: DamDatsAnAce (small blind) folded before Flop
Seat 5: sexy_seagull (big blind) folded on the Turn



PokerStars Hand #166667848407:  Hold'em No Limit ($0.05/$0.10 USD) - 2017/02/23 16:08:38 ET
Table 'Kanda' 6-max Seat #4 is the button
Seat 1: Andy Wolf ($11.57 in chips) 
Seat 2: Pelotín ($5.42 in chips) 
Seat 3: XaXaTyH4uK ($10.27 in chips) 
Seat 4: Orlangoor ($10 in chips) 
Seat 5: Dimka4 ($10 in chips) 
Seat 6: oddshoff ($9.21 in chips) 
Dimka4: posts small blind $0.05
oddshoff: posts big blind $0.10
*** HOLE CARDS ***
Andy Wolf: folds 
Pelotín: folds 
XaXaTyH4uK: raises $0.20 to $0.30
Orlangoor: folds 
Dimka4: folds 
oddshoff: folds 
Uncalled bet ($0.20) returned to XaXaTyH4uK
XaXaTyH4uK collected $0.25 from pot
*** SUMMARY ***
Total pot $0.25 | Rake $0 
Seat 1: Andy Wolf folded before Flop (didn't bet)
Seat 2: Pelotín folded before Flop (didn't bet)
Seat 3: XaXaTyH4uK collected ($0.25)
Seat 4: Orlangoor (button) folded before Flop (didn't bet)
Seat 5: Dimka4 (small blind) folded before Flop
Seat 6: oddshoff (big blind) folded before Flop



PokerStars Hand #166667848636:  Hold'em No Limit ($0.05/$0.10 USD) - 2017/02/23 16:08:38 ET
Table 'Themisto II' 6-max Seat #5 is the button
Seat 1: ChuikaPridi ($10 in chips) 
Seat 2: CA225 ($11.96 in chips) 
Seat 3: eniksenik ($15.69 in chips) 
Seat 5: ex3Lero86 ($10.22 in chips) 
Seat 6: noobigrok ($3.50 in chips) 
noobigrok: posts small blind $0.05
ChuikaPridi: posts big blind $0.10
DrVzad: sits out 
*** HOLE CARDS ***
CA225: folds 
eniksenik: raises $0.20 to $0.30
ex3Lero86: folds 
noobigrok: calls $0.25
ChuikaPridi: folds 
*** FLOP *** [9d Td Ah]
noobigrok: checks 
eniksenik: checks 
*** TURN *** [9d Td Ah] [5d]
noobigrok: checks 
eniksenik: bets $0.37
noobigrok: folds 
Uncalled bet ($0.37) returned to eniksenik
eniksenik collected $0.67 from pot
*** SUMMARY ***
Total pot $0.70 | Rake $0.03 
Board [9d Td Ah 5d]
Seat 1: ChuikaPridi (big blind) folded before Flop
Seat 2: CA225 folded before Flop (didn't bet)
Seat 3: eniksenik collected ($0.67)
Seat 5: ex3Lero86 (button) folded before Flop (didn't bet)
Seat 6: noobigrok (small blind) folded on the Turn



PokerStars Hand #166667848789:  Hold'em No Limit ($0.05/$0.10 USD) - 2017/02/23 16:08:38 ET
Table 'Pandora III' 6-max Seat #4 is the button
Seat 1: Pokeaster ($11.09 in chips) 
Seat 2: garigura ($11.54 in chips) 
Seat 3: Chodemuncher ($10 in chips) 
Seat 4: mhonielsen ($10 in chips) 
Seat 5: MühliJr ($10.62 in chips) 
Seat 6: yodzik ($5 in chips) 
MühliJr: posts small blind $0.05
yodzik: posts big blind $0.10
*** HOLE CARDS ***
Pokeaster: folds 
garigura: folds 
Chodemuncher: folds 
mhonielsen: raises $0.20 to $0.30
MühliJr: folds 
yodzik: folds 
Uncalled bet ($0.20) returned to mhonielsen
mhonielsen collected $0.25 from pot
*** SUMMARY ***
Total pot $0.25 | Rake $0 
Seat 1: Pokeaster folded before Flop (didn't bet)
Seat 2: garigura folded before Flop (didn't bet)
Seat 3: Chodemuncher folded before Flop (didn't bet)
Seat 4: mhonielsen (button) collected ($0.25)
Seat 5: MühliJr (small blind) folded before Flop
Seat 6: yodzik (big blind) folded before Flop



PokerStars Hand #166667848998:  Hold'em No Limit ($0.05/$0.10 USD) - 2017/02/23 16:08:38 ET
Table 'Eurydome II' 6-max Seat #6 is the button
Seat 1: rusu_rapid ($11.73 in chips) 
Seat 3: gaHy_HaXeP ($12.09 in chips) 
Seat 4: Smitty03300 ($10.07 in chips) 
Seat 5: kush-killa87 ($10.74 in chips) 
Seat 6: Jucatorul823 ($4.52 in chips) 
rusu_rapid: posts small blind $0.05
gaHy_HaXeP: posts big blind $0.10
*** HOLE CARDS ***
Smitty03300: folds 
kush-killa87: folds 
Jucatorul823: raises $0.20 to $0.30
rusu_rapid: folds 
gaHy_HaXeP: folds 
Uncalled bet ($0.20) returned to Jucatorul823
Jucatorul823 collected $0.25 from pot
*** SUMMARY ***
Total pot $0.25 | Rake $0 
Seat 1: rusu_rapid (small blind) folded before Flop
Seat 3: gaHy_HaXeP (big blind) folded before Flop
Seat 4: Smitty03300 folded before Flop (didn't bet)
Seat 5: kush-killa87 folded before Flop (didn't bet)
Seat 6: Jucatorul823 (button) collected ($0.25)



PokerStars Hand #166667849163:  Hold'em No Limit ($0.05/$0.10 USD) - 2017/02/23 16:08:38 ET
Table 'Antinous' 6-max Seat #5 is the button
Seat 1: Andrei ProFF ($15.98 in chips) 
Seat 2: Nr847 ($13.60 in chips) 
Seat 3: dittoro ($10 in chips) 
Seat 4: Pekaml ($15.65 in chips) 
Seat 5: Covetsoles ($3.37 in chips) 
Seat 6: coolisses111 ($9.90 in chips) 
coolisses111: posts small blind $0.05
Andrei ProFF: posts big blind $0.10
*** HOLE CARDS ***
Nr847: folds 
dittoro: folds 
Pekaml: folds 
Covetsoles: raises $0.10 to $0.20
coolisses111: folds 
Andrei ProFF: raises $0.40 to $0.60
Covetsoles: raises $2.77 to $3.37 and is all-in
Andrei ProFF: folds 
Uncalled bet ($2.77) returned to Covetsoles
Covetsoles collected $1.25 from pot
*** SUMMARY ***
Total pot $1.25 | Rake $0 
Seat 1: Andrei ProFF (big blind) folded before Flop
Seat 2: Nr847 folded before Flop (didn't bet)
Seat 3: dittoro folded before Flop (didn't bet)
Seat 4: Pekaml folded before Flop (didn't bet)
Seat 5: Covetsoles (button) collected ($1.25)
Seat 6: coolisses111 (small blind) folded before Flop



PokerStars Hand #166667849166:  Hold'em No Limit ($0.05/$0.10 USD) - 2017/02/23 16:08:38 ET
Table 'Kraz II' 6-max Seat #6 is the button
Seat 1: bdixon_5 ($9.15 in chips) 
Seat 2: shellyld ($10 in chips) 
Seat 3: Eddys Edge ($10.15 in chips) 
Seat 5: Joker51_wtf! ($10 in chips) 
Seat 6: tr41n3r12 ($11.11 in chips) 
bdixon_5: posts small blind $0.05
shellyld: posts big blind $0.10
DrVzad: sits out 
*** HOLE CARDS ***
Eddys Edge: folds 
Joker51_wtf!: folds 
tr41n3r12: raises $0.15 to $0.25
bdixon_5: folds 
shellyld: folds 
Uncalled bet ($0.15) returned to tr41n3r12
tr41n3r12 collected $0.25 from pot
*** SUMMARY ***
Total pot $0.25 | Rake $0 
Seat 1: bdixon_5 (small blind) folded before Flop
Seat 2: shellyld (big blind) folded before Flop
Seat 3: Eddys Edge folded before Flop (didn't bet)
Seat 5: Joker51_wtf! folded before Flop (didn't bet)
Seat 6: tr41n3r12 (button) collected ($0.25)



PokerStars Hand #166667849227:  Hold'em No Limit ($0.05/$0.10 USD) - 2017/02/23 16:08:38 ET
Table 'Xanthippe II' 6-max Seat #6 is the button
Seat 2: Bird et al ($10.13 in chips) 
Seat 3: Dcaro31 ($14.76 in chips) 
Seat 6: Orlangoor ($13.03 in chips) 
Bird et al: posts small blind $0.05
Dcaro31: posts big blind $0.10
*** HOLE CARDS ***
Orlangoor: raises $0.12 to $0.22
Bird et al: folds 
Dcaro31: folds 
Uncalled bet ($0.12) returned to Orlangoor
Orlangoor collected $0.25 from pot
*** SUMMARY ***
Total pot $0.25 | Rake $0 
Seat 2: Bird et al (small blind) folded before Flop
Seat 3: Dcaro31 (big blind) folded before Flop
Seat 6: Orlangoor (button) collected ($0.25)



PokerStars Hand #166667849338:  Hold'em No Limit ($0.05/$0.10 USD) - 2017/02/23 16:08:39 ET
Table 'Nephthys II' 6-max Seat #6 is the button
Seat 1: DamDatsAnAce ($11.08 in chips) 
Seat 2: Ju$tD0it ($8.74 in chips) 
Seat 3: Newqbrown ($20.66 in chips) 
Seat 4: MihaGr ($10 in chips) 
Seat 5: kingartur222 ($8.61 in chips) 
Seat 6: CHRO8 ($14.14 in chips) 
DamDatsAnAce: posts small blind $0.05
Ju$tD0it: posts big blind $0.10
*** HOLE CARDS ***
Newqbrown: folds 
MihaGr: folds 
kingartur222: folds 
CHRO8: raises $0.20 to $0.30
DamDatsAnAce: folds 
Ju$tD0it: folds 
Uncalled bet ($0.20) returned to CHRO8
CHRO8 collected $0.25 from pot
*** SUMMARY ***
Total pot $0.25 | Rake $0 
Seat 1: DamDatsAnAce (small blind) folded before Flop
Seat 2: Ju$tD0it (big blind) folded before Flop
Seat 3: Newqbrown folded before Flop (didn't bet)
Seat 4: MihaGr folded before Flop (didn't bet)
Seat 5: kingartur222 folded before Flop (didn't bet)
Seat 6: CHRO8 (button) collected ($0.25)



PokerStars Hand #166667849490:  Hold'em No Limit ($0.05/$0.10 USD) - 2017/02/23 16:08:39 ET
Table 'Landi II' 6-max Seat #2 is the button
Seat 1: dersiemer ($12.89 in chips) 
Seat 2: Aescul@pius ($10 in chips) 
Seat 4: alesi13 ($6.31 in chips) 
Seat 5: Bird et al ($10.25 in chips) 
x3ultimate will be allowed to play after the button
alesi13: posts small blind $0.05
Bird et al: posts big blind $0.10
arti192837: sits out 
*** HOLE CARDS ***
dersiemer: folds 
Aescul@pius: folds 
alesi13: raises $0.10 to $0.20
Bird et al: folds 
Uncalled bet ($0.10) returned to alesi13
alesi13 collected $0.20 from pot
*** SUMMARY ***
Total pot $0.20 | Rake $0 
Seat 1: dersiemer folded before Flop (didn't bet)
Seat 2: Aescul@pius (button) folded before Flop (didn't bet)
Seat 4: alesi13 (small blind) collected ($0.20)
Seat 5: Bird et al (big blind) folded before Flop



PokerStars Hand #166667849571:  Hold'em No Limit ($0.05/$0.10 USD) - 2017/02/23 16:08:39 ET
Table 'Kochera' 6-max Seat #3 is the button
Seat 1: chimera252 ($11.67 in chips) 
Seat 2: bartabs2 ($10.39 in chips) 
Seat 3: KA3AXCTAHEU, ($10.31 in chips) 
Seat 4: dany_de_vit ($10.05 in chips) 
Seat 5: univibe68 ($11.65 in chips) 
Seat 6: oddshoff ($9.63 in chips) 
dany_de_vit: posts small blind $0.05
univibe68: posts big blind $0.10
*** HOLE CARDS ***
oddshoff: folds 
chimera252: folds 
bartabs2: folds 
KA3AXCTAHEU,: folds 
dany_de_vit: calls $0.05
univibe68: raises $0.20 to $0.30
dany_de_vit: calls $0.20
*** FLOP *** [5h Js Ad]
dany_de_vit: checks 
univibe68: bets $0.40
dany_de_vit: folds 
Uncalled bet ($0.40) returned to univibe68
univibe68 collected $0.57 from pot
*** SUMMARY ***
Total pot $0.60 | Rake $0.03 
Board [5h Js Ad]
Seat 1: chimera252 folded before Flop (didn't bet)
Seat 2: bartabs2 folded before Flop (didn't bet)
Seat 3: KA3AXCTAHEU, (button) folded before Flop (didn't bet)
Seat 4: dany_de_vit (small blind) folded on the Flop
Seat 5: univibe68 (big blind) collected ($0.57)
Seat 6: oddshoff folded before Flop (didn't bet)



PokerStars Hand #166667850048:  Hold'em No Limit ($0.05/$0.10 USD) - 2017/02/23 16:08:39 ET
Table 'Hajek III' 6-max Seat #2 is the button
Seat 1: MBen10 ($12.03 in chips) 
Seat 2: fortieth ($10.04 in chips) 
Seat 3: fedorka rus ($10.51 in chips) 
Seat 4: NvR.m1nD ($13.67 in chips) 
fedorka rus: posts small blind $0.05
NvR.m1nD: posts big blind $0.10
fabadam: sits out 
*** HOLE CARDS ***
MBen10: raises $0.15 to $0.25
fortieth: folds 
fedorka rus: folds 
NvR.m1nD: folds 
Uncalled bet ($0.15) returned to MBen10
MBen10 collected $0.25 from pot
*** SUMMARY ***
Total pot $0.25 | Rake $0 
Seat 1: MBen10 collected ($0.25)
Seat 2: fortieth (button) folded before Flop (didn't bet)
Seat 3: fedorka rus (small blind) folded before Flop
Seat 4: NvR.m1nD (big blind) folded before Flop



PokerStars Hand #166667850315:  Hold'em No Limit ($0.05/$0.10 USD) - 2017/02/23 16:08:40 ET
Table 'Emma II' 6-max Seat #5 is the button
Seat 1: LarryTheStar ($10.10 in chips) 
Seat 2: T9MS ($11.64 in chips) 
Seat 3: oddshoff ($9.47 in chips) 
Seat 4: Jucatorul823 ($6.51 in chips) 
Seat 5: Scanner17 ($10.81 in chips) 
Seat 6: CHRO8 ($14.72 in chips) 
CHRO8: posts small blind $0.05
LarryTheStar: posts big blind $0.10
*** HOLE CARDS ***
T9MS: folds 
oddshoff: folds 
Jucatorul823: raises $0.20 to $0.30
Scanner17: folds 
CHRO8: folds 
LarryTheStar: folds 
Uncalled bet ($0.20) returned to Jucatorul823
Jucatorul823 collected $0.25 from pot
*** SUMMARY ***
Total pot $0.25 | Rake $0 
Seat 1: LarryTheStar (big blind) folded before Flop
Seat 2: T9MS folded before Flop (didn't bet)
Seat 3: oddshoff folded before Flop (didn't bet)
Seat 4: Jucatorul823 collected ($0.25)
Seat 5: Scanner17 (button) folded before Flop (didn't bet)
Seat 6: CHRO8 (small blind) folded before Flop



PokerStars Hand #166667850418:  Hold'em No Limit ($0.05/$0.10 USD) - 2017/02/23 16:08:40 ET
Table 'Vesta II' 6-max Seat #5 is the button
Seat 1: Yabidooo ($17.42 in chips) 
Seat 2: Dimka4 ($10 in chips) 
Seat 3: Pokeaster ($12.56 in chips) 
Seat 4: Dcaro31 ($10 in chips) 
Seat 5: ChuikaPridi ($10 in chips) 
Seat 6: XaXaTyH4uK ($10.91 in chips) 
XaXaTyH4uK: posts small blind $0.05
Yabidooo: posts big blind $0.10
*** HOLE CARDS ***
Dimka4: folds 
Pokeaster: raises $0.20 to $0.30
Dcaro31: folds 
ChuikaPridi: folds 
XaXaTyH4uK: folds 
Yabidooo: folds 
Uncalled bet ($0.20) returned to Pokeaster
Pokeaster collected $0.25 from pot
*** SUMMARY ***
Total pot $0.25 | Rake $0 
Seat 1: Yabidooo (big blind) folded before Flop
Seat 2: Dimka4 folded before Flop (didn't bet)
Seat 3: Pokeaster collected ($0.25)
Seat 4: Dcaro31 folded before Flop (didn't bet)
Seat 5: ChuikaPridi (button) folded before Flop (didn't bet)
Seat 6: XaXaTyH4uK (small blind) folded before Flop



PokerStars Hand #166667850459:  Hold'em No Limit ($0.05/$0.10 USD) - 2017/02/23 16:08:40 ET
Table 'Caprera III' 6-max Seat #6 is the button
Seat 1: Vrinni ($19.34 in chips) 
Seat 2: hg123454321 ($10.72 in chips) 
Seat 5: fedorka rus ($50.43 in chips) 
Seat 6: GESPERIA ($15.56 in chips) 
Vrinni: posts small blind $0.05
hg123454321: posts big blind $0.10
*** HOLE CARDS ***
fedorka rus: folds 
GESPERIA: folds 
Vrinni: folds 
Uncalled bet ($0.05) returned to hg123454321
hg123454321 collected $0.10 from pot
*** SUMMARY ***
Total pot $0.10 | Rake $0 
Seat 1: Vrinni (small blind) folded before Flop
Seat 2: hg123454321 (big blind) collected ($0.10)
Seat 5: fedorka rus folded before Flop (didn't bet)
Seat 6: GESPERIA (button) folded before Flop (didn't bet)



PokerStars Hand #166667850501:  Hold'em No Limit ($0.05/$0.10 USD) - 2017/02/23 16:08:40 ET
Table 'Mesarthim' 6-max Seat #2 is the button
Seat 1: Mancuso2010 ($15.85 in chips) 
Seat 2: MühliJr ($12.99 in chips) 
Seat 3: Damage514 ($9.49 in chips) 
Seat 4: Strelok1974 ($10.11 in chips) 
Seat 5: Iarlei ($10.15 in chips) 
Seat 6: bdixon_5 ($8.81 in chips) 
Damage514: posts small blind $0.05
Strelok1974: posts big blind $0.10
*** HOLE CARDS ***
Iarlei: folds 
bdixon_5: raises $0.20 to $0.30
Mancuso2010: calls $0.30
MühliJr: folds 
Damage514: folds 
Strelok1974: folds 
*** FLOP *** [Qh 3c 4s]
bdixon_5: checks 
Mancuso2010: bets $0.40
bdixon_5: folds 
Uncalled bet ($0.40) returned to Mancuso2010
Mancuso2010 collected $0.72 from pot
*** SUMMARY ***
Total pot $0.75 | Rake $0.03 
Board [Qh 3c 4s]
Seat 1: Mancuso2010 collected ($0.72)
Seat 2: MühliJr (button) folded before Flop (didn't bet)
Seat 3: Damage514 (small blind) folded before Flop
Seat 4: Strelok1974 (big blind) folded before Flop
Seat 5: Iarlei folded before Flop (didn't bet)
Seat 6: bdixon_5 folded on the Flop



PokerStars Hand #166667850764:  Hold'em No Limit ($0.05/$0.10 USD) - 2017/02/23 16:08:40 ET
Table 'Eudora' 6-max Seat #2 is the button
Seat 1: archer2511 ($12.40 in chips) 
Seat 2: popypaleta ($10 in chips) 
Seat 3: Ice_Isayev ($10.50 in chips) 
Seat 4: yodzik ($5.30 in chips) 
Seat 5: chimera252 ($10.79 in chips) 
Ice_Isayev: posts small blind $0.05
yodzik: posts big blind $0.10
*** HOLE CARDS ***
chimera252: raises $0.20 to $0.30
archer2511: folds 
popypaleta: folds 
Ice_Isayev: folds 
yodzik: calls $0.20
*** FLOP *** [8c Qc Kh]
yodzik: checks 
chimera252: checks 
*** TURN *** [8c Qc Kh] [5c]
yodzik: checks 
chimera252: checks 
*** RIVER *** [8c Qc Kh 5c] [Kc]
yodzik: checks 
chimera252: checks 
*** SHOW DOWN ***
yodzik: shows [Ad Jd] (a pair of Kings)
chimera252: shows [Js Jh] (two pair, Kings and Jacks)
chimera252 collected $0.62 from pot
*** SUMMARY ***
Total pot $0.65 | Rake $0.03 
Board [8c Qc Kh 5c Kc]
Seat 1: archer2511 folded before Flop (didn't bet)
Seat 2: popypaleta (button) folded before Flop (didn't bet)
Seat 3: Ice_Isayev (small blind) folded before Flop
Seat 4: yodzik (big blind) showed [Ad Jd] and lost with a pair of Kings
Seat 5: chimera252 showed [Js Jh] and won ($0.62) with two pair, Kings and Jacks



PokerStars Hand #166667850791:  Hold'em No Limit ($0.05/$0.10 USD) - 2017/02/23 16:08:40 ET
Table 'Crocus' 6-max Seat #1 is the button
Seat 1: truck1234 ($25.76 in chips) 
Seat 2: garigura ($11.19 in chips) 
Seat 4: patrick19111 ($12.61 in chips) 
Seat 6: Rodik002 ($10 in chips) 
garigura: posts small blind $0.05
patrick19111: posts big blind $0.10
*** HOLE CARDS ***
Rodik002: folds 
truck1234: folds 
garigura: folds 
Uncalled bet ($0.05) returned to patrick19111
patrick19111 collected $0.10 from pot
*** SUMMARY ***
Total pot $0.10 | Rake $0 
Seat 1: truck1234 (button) folded before Flop (didn't bet)
Seat 2: garigura (small blind) folded before Flop
Seat 4: patrick19111 (big blind) collected ($0.10)
Seat 6: Rodik002 folded before Flop (didn't bet)



PokerStars Hand #166667850801:  Hold'em No Limit ($0.05/$0.10 USD) - 2017/02/23 16:08:40 ET
Table 'Selinur' 6-max Seat #1 is the button
Seat 1: KA3AXCTAHEU, ($10 in chips) 
Seat 2: hoedje72 ($7.12 in chips) 
Seat 5: DrVzad ($10 in chips) 
Seat 6: homelessdan ($18.50 in chips) 
hoedje72: posts small blind $0.05
DrVzad: posts big blind $0.10
*** HOLE CARDS ***
homelessdan: folds 
KA3AXCTAHEU,: folds 
hoedje72: raises $0.10 to $0.20
DrVzad: folds 
Uncalled bet ($0.10) returned to hoedje72
hoedje72 collected $0.20 from pot
*** SUMMARY ***
Total pot $0.20 | Rake $0 
Seat 1: KA3AXCTAHEU, (button) folded before Flop (didn't bet)
Seat 2: hoedje72 (small blind) collected ($0.20)
Seat 5: DrVzad (big blind) folded before Flop
Seat 6: homelessdan folded before Flop (didn't bet)



PokerStars Hand #166667851059:  Hold'em No Limit ($0.05/$0.10 USD) - 2017/02/23 16:08:40 ET
Table 'Clavel' 6-max Seat #4 is the button
Seat 1: KRZuff ($14.51 in chips) 
Seat 2: Namhkal ($10.15 in chips) 
Seat 4: Dcaro31 ($11.68 in chips) 
Seat 5: Vrinni ($10 in chips) 
Seat 6: Gra_anD77 ($5.13 in chips) 
Vrinni: posts small blind $0.05
Gra_anD77: posts big blind $0.10
*** HOLE CARDS ***
KRZuff: folds 
Namhkal: folds 
Dcaro31: folds 
Vrinni: raises $0.20 to $0.30
Gra_anD77: raises $0.20 to $0.50
Vrinni: calls $0.20
*** FLOP *** [6h Kd Qh]
Vrinni: checks 
Gra_anD77: bets $0.96
Vrinni: raises $1.24 to $2.20
Gra_anD77: folds 
Uncalled bet ($1.24) returned to Vrinni
Vrinni collected $2.79 from pot
*** SUMMARY ***
Total pot $2.92 | Rake $0.13 
Board [6h Kd Qh]
Seat 1: KRZuff folded before Flop (didn't bet)
Seat 2: Namhkal folded before Flop (didn't bet)
Seat 4: Dcaro31 (button) folded before Flop (didn't bet)
Seat 5: Vrinni (small blind) collected ($2.79)
Seat 6: Gra_anD77 (big blind) folded on the Flop



PokerStars Hand #166667851062:  Hold'em No Limit ($0.05/$0.10 USD) - 2017/02/23 16:08:40 ET
Table 'Azelfafage' 6-max Seat #5 is the button
Seat 1: Sbozzz ($15.61 in chips) 
Seat 2: tr41n3r12 ($10 in chips) 
Seat 3: todor1711 ($19.37 in chips) 
Seat 4: fedorka rus ($12.02 in chips) 
Seat 5: 8th wonders ($12.80 in chips) 
Seat 6: KA3AXCTAHEU, ($10 in chips) 
KA3AXCTAHEU,: posts small blind $0.05
Sbozzz: posts big blind $0.10
*** HOLE CARDS ***
tr41n3r12: raises $0.20 to $0.30
todor1711: calls $0.30
fedorka rus: calls $0.30
8th wonders: folds 
KA3AXCTAHEU,: folds 
Sbozzz: folds 
*** FLOP *** [7s Ks 9d]
tr41n3r12: checks 
todor1711: bets $1.20
fedorka rus: calls $1.20
tr41n3r12: folds 
*** TURN *** [7s Ks 9d] [Qd]
todor1711: checks 
fedorka rus: bets $2.19
todor1711: calls $2.19
*** RIVER *** [7s Ks 9d Qd] [Kc]
todor1711: checks 
fedorka rus: bets $2.90
todor1711: folds 
Uncalled bet ($2.90) returned to fedorka rus
fedorka rus collected $7.48 from pot
*** SUMMARY ***
Total pot $7.83 | Rake $0.35 
Board [7s Ks 9d Qd Kc]
Seat 1: Sbozzz (big blind) folded before Flop
Seat 2: tr41n3r12 folded on the Flop
Seat 3: todor1711 folded on the River
Seat 4: fedorka rus collected ($7.48)
Seat 5: 8th wonders (button) folded before Flop (didn't bet)
Seat 6: KA3AXCTAHEU, (small blind) folded before Flop



PokerStars Hand #166667851137:  Hold'em No Limit ($0.05/$0.10 USD) - 2017/02/23 16:08:41 ET
Table 'Girtab' 6-max Seat #2 is the button
Seat 1: pokekrk ($17.32 in chips) 
Seat 2: MühliJr ($10 in chips) 
Seat 3: kingartur222 ($10.35 in chips) 
Seat 4: Hyd SK ($10.88 in chips) 
Seat 5: sexy_seagull ($11.20 in chips) 
Seat 6: iluzja12 ($10 in chips) 
kingartur222: posts small blind $0.05
Hyd SK: posts big blind $0.10
*** HOLE CARDS ***
sexy_seagull: folds 
iluzja12: folds 
pokekrk: raises $0.15 to $0.25
MühliJr: calls $0.25
kingartur222: folds 
Hyd SK: calls $0.15
*** FLOP *** [Qd Td 7c]
Hyd SK: checks 
pokekrk: checks 
MühliJr: bets $0.65
Hyd SK: folds 
pokekrk: folds 
Uncalled bet ($0.65) returned to MühliJr
MühliJr collected $0.76 from pot
*** SUMMARY ***
Total pot $0.80 | Rake $0.04 
Board [Qd Td 7c]
Seat 1: pokekrk folded on the Flop
Seat 2: MühliJr (button) collected ($0.76)
Seat 3: kingartur222 (small blind) folded before Flop
Seat 4: Hyd SK (big blind) folded on the Flop
Seat 5: sexy_seagull folded before Flop (didn't bet)
Seat 6: iluzja12 folded before Flop (didn't bet)



PokerStars Hand #166667851243:  Hold'em No Limit ($0.05/$0.10 USD) - 2017/02/23 16:08:41 ET
Table 'Rosalia' 6-max Seat #1 is the button
Seat 1: Hyd SK ($10 in chips) 
Seat 2: Bandyaev ($10.89 in chips) 
Seat 3: Andy Wolf ($11.98 in chips) 
Seat 4: THIMUCHIN ($10 in chips) 
Seat 5: miron762 ($19.71 in chips) 
Seat 6: facewald ($17.99 in chips) 
Bandyaev: posts small blind $0.05
Andy Wolf: posts big blind $0.10
*** HOLE CARDS ***
THIMUCHIN: folds 
miron762: raises $0.10 to $0.20
facewald: folds 
Hyd SK: folds 
Bandyaev: raises $0.50 to $0.70
Andy Wolf: folds 
miron762: calls $0.50
*** FLOP *** [6d Kd Qs]
Bandyaev: checks 
miron762: bets $0.10
Bandyaev: calls $0.10
*** TURN *** [6d Kd Qs] [3d]
Bandyaev: checks 
miron762: bets $1.40
Bandyaev: folds 
Uncalled bet ($1.40) returned to miron762
miron762 collected $1.62 from pot
*** SUMMARY ***
Total pot $1.70 | Rake $0.08 
Board [6d Kd Qs 3d]
Seat 1: Hyd SK (button) folded before Flop (didn't bet)
Seat 2: Bandyaev (small blind) folded on the Turn
Seat 3: Andy Wolf (big blind) folded before Flop
Seat 4: THIMUCHIN folded before Flop (didn't bet)
Seat 5: miron762 collected ($1.62)
Seat 6: facewald folded before Flop (didn't bet)



PokerStars Hand #166667851560:  Hold'em No Limit ($0.05/$0.10 USD) - 2017/02/23 16:08:41 ET
Table 'Wingolfia II' 6-max Seat #4 is the button
Seat 1: BahiaMinhaP ($10.17 in chips) 
Seat 2: NvR.m1nD ($10.40 in chips) 
Seat 3: truck1234 ($10.21 in chips) 
Seat 4: zlobslob ($17.87 in chips) 
Seat 5: tr41n3r12 ($11.48 in chips) 
tr41n3r12: posts small blind $0.05
EphemeralBen: is sitting out 
BahiaMinhaP: posts big blind $0.10
*** HOLE CARDS ***
NvR.m1nD: raises $0.15 to $0.25
truck1234: calls $0.25
zlobslob: folds 
tr41n3r12: folds 
BahiaMinhaP: calls $0.15
*** FLOP *** [8s 9s 3h]
BahiaMinhaP: checks 
NvR.m1nD: checks 
truck1234: bets $0.50
EphemeralBen leaves the table
BahiaMinhaP: folds 
NvR.m1nD: folds 
Uncalled bet ($0.50) returned to truck1234
truck1234 collected $0.76 from pot
*** SUMMARY ***
Total pot $0.80 | Rake $0.04 
Board [8s 9s 3h]
Seat 1: BahiaMinhaP (big blind) folded on the Flop
Seat 2: NvR.m1nD folded on the Flop
Seat 3: truck1234 collected ($0.76)
Seat 4: zlobslob (button) folded before Flop (didn't bet)
Seat 5: tr41n3r12 (small blind) folded before Flop



PokerStars Hand #166667851627:  Hold'em No Limit ($0.05/$0.10 USD) - 2017/02/23 16:08:41 ET
Table 'Goto II' 6-max Seat #1 is the button
Seat 1: FRAID358 ($12.01 in chips) 
Seat 2: 6ePeMeHHa9 ($11.72 in chips) 
Seat 3: Goroshkos88 ($10.81 in chips) 
Seat 4: KRZuff ($13.76 in chips) 
Seat 5: RoJ1 ($14.50 in chips) 
Seat 6: ermananb93 ($11.51 in chips) 
6ePeMeHHa9: posts small blind $0.05
Goroshkos88: posts big blind $0.10
*** HOLE CARDS ***
KRZuff: folds 
RoJ1: folds 
ermananb93: folds 
FRAID358: folds 
6ePeMeHHa9: folds 
Uncalled bet ($0.05) returned to Goroshkos88
Goroshkos88 collected $0.10 from pot
*** SUMMARY ***
Total pot $0.10 | Rake $0 
Seat 1: FRAID358 (button) folded before Flop (didn't bet)
Seat 2: 6ePeMeHHa9 (small blind) folded before Flop
Seat 3: Goroshkos88 (big blind) collected ($0.10)
Seat 4: KRZuff folded before Flop (didn't bet)
Seat 5: RoJ1 folded before Flop (didn't bet)
Seat 6: ermananb93 folded before Flop (didn't bet)



PokerStars Hand #166667851632:  Hold'em No Limit ($0.05/$0.10 USD) - 2017/02/23 16:08:41 ET
Table 'Tyche III' 6-max Seat #4 is the button
Seat 1: milt65 ($10.46 in chips) 
Seat 3: ChuikaPridi ($10 in chips) 
Seat 4: Kazacha ($10 in chips) 
Seat 5: chimera252 ($14.41 in chips) 
Seat 6: Ice_Isayev ($10 in chips) 
chimera252: posts small blind $0.05
Ice_Isayev: posts big blind $0.10
arti192837: sits out 
*** HOLE CARDS ***
milt65: raises $0.15 to $0.25
ChuikaPridi: folds 
Kazacha: raises $0.55 to $0.80
chimera252: folds 
Ice_Isayev: folds 
milt65: calls $0.55
*** FLOP *** [8c Ah 8d]
milt65: checks 
Kazacha: bets $1
milt65: folds 
Uncalled bet ($1) returned to Kazacha
Kazacha collected $1.67 from pot
*** SUMMARY ***
Total pot $1.75 | Rake $0.08 
Board [8c Ah 8d]
Seat 1: milt65 folded on the Flop
Seat 3: ChuikaPridi folded before Flop (didn't bet)
Seat 4: Kazacha (button) collected ($1.67)
Seat 5: chimera252 (small blind) folded before Flop
Seat 6: Ice_Isayev (big blind) folded before Flop



PokerStars Hand #166667852123:  Hold'em No Limit ($0.05/$0.10 USD) - 2017/02/23 16:08:42 ET
Table 'Huberta II' 6-max Seat #3 is the button
Seat 1: tr41n3r12 ($10 in chips) 
Seat 2: Ice_Isayev ($11.88 in chips) 
Seat 3: patrick19111 ($10.18 in chips) 
Seat 4: VAD21 ($12.01 in chips) 
Seat 5: Feverhead ($27.80 in chips) 
Seat 6: yodzik ($5.83 in chips) 
VAD21: posts small blind $0.05
Feverhead: posts big blind $0.10
*** HOLE CARDS ***
yodzik: folds 
tr41n3r12: folds 
Ice_Isayev: folds 
patrick19111: raises $0.10 to $0.20
VAD21: folds 
Feverhead: calls $0.10
*** FLOP *** [6d Td 2h]
Feverhead: checks 
patrick19111: bets $0.29
Feverhead: folds 
Uncalled bet ($0.29) returned to patrick19111
patrick19111 collected $0.43 from pot
*** SUMMARY ***
Total pot $0.45 | Rake $0.02 
Board [6d Td 2h]
Seat 1: tr41n3r12 folded before Flop (didn't bet)
Seat 2: Ice_Isayev folded before Flop (didn't bet)
Seat 3: patrick19111 (button) collected ($0.43)
Seat 4: VAD21 (small blind) folded before Flop
Seat 5: Feverhead (big blind) folded on the Flop
Seat 6: yodzik folded before Flop (didn't bet)



PokerStars Hand #166667852371:  Hold'em No Limit ($0.05/$0.10 USD) - 2017/02/23 16:08:42 ET
Table 'Nekkar' 6-max Seat #4 is the button
Seat 2: Bird et al ($10.87 in chips) 
Seat 3: Zemz_Ru ($15.86 in chips) 
Seat 4: kingartur222 ($12.10 in chips) 
Seat 5: Vrinni ($12.24 in chips) 
Seat 6: Eddys Edge ($10.48 in chips) 
Vrinni: posts small blind $0.05
Eddys Edge: posts big blind $0.10
*** HOLE CARDS ***
Bird et al: folds 
Zemz_Ru: raises $0.20 to $0.30
kingartur222: raises $0.60 to $0.90
Vrinni: raises $1.90 to $2.80
Eddys Edge: folds 
Zemz_Ru: folds 
kingartur222: folds 
Uncalled bet ($1.90) returned to Vrinni
Vrinni collected $2.20 from pot
*** SUMMARY ***
Total pot $2.20 | Rake $0 
Seat 2: Bird et al folded before Flop (didn't bet)
Seat 3: Zemz_Ru folded before Flop
Seat 4: kingartur222 (button) folded before Flop
Seat 5: Vrinni (small blind) collected ($2.20)
Seat 6: Eddys Edge (big blind) folded before Flop



PokerStars Hand #166667852411:  Hold'em No Limit ($0.05/$0.10 USD) - 2017/02/23 16:08:42 ET
Table 'Samitchell III' 6-max Seat #2 is the button
Seat 2: scorpionfish ($13.03 in chips) 
Seat 3: Vanne11 ($9.40 in chips) 
scorpionfish: posts small blind $0.05
Vanne11: posts big blind $0.10
*** HOLE CARDS ***
scorpionfish: folds 
Uncalled bet ($0.05) returned to Vanne11
Vanne11 collected $0.10 from pot
*** SUMMARY ***
Total pot $0.10 | Rake $0 
Seat 2: scorpionfish (button) (small blind) folded before Flop
Seat 3: Vanne11 (big blind) collected ($0.10)



PokerStars Hand #166667852504:  Hold'em No Limit ($0.05/$0.10 USD) - 2017/02/23 16:08:42 ET
Table 'Atalante' 6-max Seat #4 is the button
Seat 1: OceanBlue100 ($4.94 in chips) 
Seat 2: CiisCi ($20.05 in chips) 
Seat 3: Kow6oy ($10 in chips) 
Seat 4: Dcaro31 ($23.82 in chips) 
Seat 5: eniksenik ($10.19 in chips) 
Seat 6: FlopsterGB ($31.51 in chips) 
eniksenik: posts small blind $0.05
FlopsterGB: posts big blind $0.10
*** HOLE CARDS ***
OceanBlue100: calls $0.10
CiisCi: raises $0.30 to $0.40
Kow6oy: folds 
Dcaro31: raises $1.10 to $1.50
eniksenik: folds 
FlopsterGB: folds 
OceanBlue100: folds 
CiisCi: folds 
Uncalled bet ($1.10) returned to Dcaro31
Dcaro31 collected $1.05 from pot
*** SUMMARY ***
Total pot $1.05 | Rake $0 
Seat 1: OceanBlue100 folded before Flop
Seat 2: CiisCi folded before Flop
Seat 3: Kow6oy folded before Flop (didn't bet)
Seat 4: Dcaro31 (button) collected ($1.05)
Seat 5: eniksenik (small blind) folded before Flop
Seat 6: FlopsterGB (big blind) folded before Flop



PokerStars Hand #166667852540:  Hold'em No Limit ($0.05/$0.10 USD) - 2017/02/23 16:08:42 ET
Table 'Phereclos II' 6-max Seat #2 is the button
Seat 2: Kazacha ($10.30 in chips) 
Seat 3: BJamesB2014 ($5.75 in chips) 
Seat 5: crazydevill ($12.19 in chips) 
Seat 6: mhonielsen ($16.39 in chips) 
BJamesB2014: posts small blind $0.05
DamDatsAnAce: is sitting out 
DamDatsAnAce leaves the table
crazydevill: posts big blind $0.10
*** HOLE CARDS ***
mhonielsen: folds 
Lucky HoBBiT joins the table at seat #4 
Kazacha: raises $0.14 to $0.24
BJamesB2014: calls $0.19
crazydevill: folds 
*** FLOP *** [Ac Qs Ah]
Croplayer1 leaves the table
Vladu1986 joins the table at seat #1 
BJamesB2014: bets $1
Kazacha: raises $1.60 to $2.60
BJamesB2014: calls $1.60
*** TURN *** [Ac Qs Ah] [5s]
BJamesB2014: bets $1
Kazacha: raises $2.10 to $3.10
BJamesB2014: calls $1.91 and is all-in
Uncalled bet ($0.19) returned to Kazacha
*** RIVER *** [Ac Qs Ah 5s] [8d]
*** SHOW DOWN ***
BJamesB2014: shows [Js 6c] (a pair of Aces)
Kazacha: shows [As Kd] (three of a kind, Aces)
Kazacha collected $11.08 from pot
*** SUMMARY ***
Total pot $11.60 | Rake $0.52 
Board [Ac Qs Ah 5s 8d]
Seat 2: Kazacha (button) showed [As Kd] and won ($11.08) with three of a kind, Aces
Seat 3: BJamesB2014 (small blind) showed [Js 6c] and lost with a pair of Aces
Seat 5: crazydevill (big blind) folded before Flop
Seat 6: mhonielsen folded before Flop (didn't bet)



PokerStars Hand #166667852546:  Hold'em No Limit ($0.05/$0.10 USD) - 2017/02/23 16:08:42 ET
Table 'Tomita II' 6-max Seat #2 is the button
Seat 2: mhonielsen ($10.15 in chips) 
Seat 3: D3NyA ($10 in chips) 
Seat 4: Hyd SK ($11.41 in chips) 
Seat 5: ex3Lero86 ($10.10 in chips) 
Seat 6: saniasmir ($10 in chips) 
D3NyA: posts small blind $0.05
Hyd SK: posts big blind $0.10
*** HOLE CARDS ***
ex3Lero86: folds 
saniasmir: folds 
mhonielsen: raises $0.10 to $0.20
D3NyA: folds 
Hyd SK: raises $0.80 to $1
mhonielsen: folds 
Uncalled bet ($0.80) returned to Hyd SK
Hyd SK collected $0.45 from pot
*** SUMMARY ***
Total pot $0.45 | Rake $0 
Seat 2: mhonielsen (button) folded before Flop
Seat 3: D3NyA (small blind) folded before Flop
Seat 4: Hyd SK (big blind) collected ($0.45)
Seat 5: ex3Lero86 folded before Flop (didn't bet)
Seat 6: saniasmir folded before Flop (didn't bet)



PokerStars Hand #166667852748:  Hold'em No Limit ($0.05/$0.10 USD) - 2017/02/23 16:08:42 ET
Table 'Aconcagua' 6-max Seat #3 is the button
Seat 1: MLPlayer16 ($10.11 in chips) 
Seat 2: Kupi007 ($10 in chips) 
Seat 3: burtila1989 ($7.88 in chips) 
Seat 4: pivanki11 ($9.69 in chips) 
Seat 5: Andrei ProFF ($10 in chips) 
Seat 6: coolisses111 ($11.86 in chips) 
pivanki11: posts small blind $0.05
Andrei ProFF: posts big blind $0.10
MLPlayer16: posts the ante $0.02
Kupi007: posts the ante $0.02
burtila1989: posts the ante $0.02
pivanki11: posts the ante $0.02
Andrei ProFF: posts the ante $0.02
coolisses111: posts the ante $0.02
*** HOLE CARDS ***
coolisses111: folds 
MLPlayer16: folds 
Kupi007: folds 
burtila1989: calls $0.10
pivanki11: folds 
Andrei ProFF: checks 
*** FLOP *** [Ts 6c 5d]
Andrei ProFF: checks 
burtila1989: bets $0.30
Andrei ProFF: folds 
Uncalled bet ($0.30) returned to burtila1989
burtila1989 collected $0.35 from pot
*** SUMMARY ***
Total pot $0.37 | Rake $0.02 
Board [Ts 6c 5d]
Seat 1: MLPlayer16 folded before Flop (didn't bet)
Seat 2: Kupi007 folded before Flop (didn't bet)
Seat 3: burtila1989 (button) collected ($0.35)
Seat 4: pivanki11 (small blind) folded before Flop
Seat 5: Andrei ProFF (big blind) folded on the Flop
Seat 6: coolisses111 folded before Flop (didn't bet)



PokerStars Hand #166667853191:  Hold'em No Limit ($0.05/$0.10 USD) - 2017/02/23 16:08:43 ET
Table 'Sham' 6-max Seat #4 is the button
Seat 1: pancernik21 ($10.15 in chips) 
Seat 2: ex3Lero86 ($10.30 in chips) 
Seat 3: weez3r ($14.48 in chips) 
Seat 4: VAD21 ($14.21 in chips) 
Seat 5: T9MS ($10 in chips) 
Seat 6: bdixon_5 ($19.50 in chips) 
T9MS: posts small blind $0.05
bdixon_5: posts big blind $0.10
*** HOLE CARDS ***
pancernik21: folds 
ex3Lero86: folds 
weez3r: folds 
VAD21: folds 
T9MS: folds 
Uncalled bet ($0.05) returned to bdixon_5
bdixon_5 collected $0.10 from pot
*** SUMMARY ***
Total pot $0.10 | Rake $0 
Seat 1: pancernik21 folded before Flop (didn't bet)
Seat 2: ex3Lero86 folded before Flop (didn't bet)
Seat 3: weez3r folded before Flop (didn't bet)
Seat 4: VAD21 (button) folded before Flop (didn't bet)
Seat 5: T9MS (small blind) folded before Flop
Seat 6: bdixon_5 (big blind) collected ($0.10)



PokerStars Hand #166667853816:  Hold'em No Limit ($0.05/$0.10 USD) - 2017/02/23 16:08:43 ET
Table 'Gaika' 6-max Seat #6 is the button
Seat 1: oddshoff ($15.43 in chips) 
Seat 2: NvR.m1nD ($22.66 in chips) 
Seat 3: david_sara83 ($10 in chips) 
Seat 4: fortieth ($11.35 in chips) 
Seat 5: fedorka rus ($11.10 in chips) 
Seat 6: dr.goofy ($10 in chips) 
oddshoff: posts small blind $0.05
NvR.m1nD: posts big blind $0.10
*** HOLE CARDS ***
david_sara83: folds 
fortieth: raises $0.25 to $0.35
fedorka rus: calls $0.35
dr.goofy: folds 
oddshoff: calls $0.30
NvR.m1nD: folds 
*** FLOP *** [5c 2d Qh]
oddshoff: checks 
fortieth: checks 
fedorka rus: checks 
*** TURN *** [5c 2d Qh] [Ts]
oddshoff: checks 
fortieth: bets $0.58
fedorka rus: folds 
oddshoff: calls $0.58
*** RIVER *** [5c 2d Qh Ts] [6c]
oddshoff: bets $1.48
fortieth: folds 
Uncalled bet ($1.48) returned to oddshoff
oddshoff collected $2.21 from pot
*** SUMMARY ***
Total pot $2.31 | Rake $0.10 
Board [5c 2d Qh Ts 6c]
Seat 1: oddshoff (small blind) collected ($2.21)
Seat 2: NvR.m1nD (big blind) folded before Flop
Seat 3: david_sara83 folded before Flop (didn't bet)
Seat 4: fortieth folded on the River
Seat 5: fedorka rus folded on the Turn
Seat 6: dr.goofy (button) folded before Flop (didn't bet)



PokerStars Hand #166667853817:  Hold'em No Limit ($0.05/$0.10 USD) - 2017/02/23 16:08:43 ET
Table 'Stroobantia' 6-max Seat #4 is the button
Seat 1: mam9zyc ($9.19 in chips) 
Seat 2: XwinX25 ($10 in chips) 
Seat 3: Namhkal ($11.05 in chips) 
Seat 4: Yspenyanin ($10 in chips) 
Seat 5: boxer821 ($10.89 in chips) 
Seat 6: KokoulinV ($15.67 in chips) 
boxer821: posts small blind $0.05
KokoulinV: posts big blind $0.10
*** HOLE CARDS ***
mam9zyc: calls $0.10
XwinX25: folds 
Namhkal: folds 
Yspenyanin: raises $0.35 to $0.45
boxer821: folds 
KokoulinV: folds 
mam9zyc: calls $0.35
*** FLOP *** [Kc Qh 7c]
mam9zyc: bets $0.10
Yspenyanin: calls $0.10
*** TURN *** [Kc Qh 7c] [Js]
mam9zyc: checks 
Yspenyanin: bets $0.60
mam9zyc: calls $0.60
*** RIVER *** [Kc Qh 7c Js] [5d]
mam9zyc: checks 
Yspenyanin: checks 
*** SHOW DOWN ***
mam9zyc: shows [Ad Ts] (a straight, Ten to Ace)
Yspenyanin: mucks hand 
mam9zyc collected $2.34 from pot
*** SUMMARY ***
Total pot $2.45 | Rake $0.11 
Board [Kc Qh 7c Js 5d]
Seat 1: mam9zyc showed [Ad Ts] and won ($2.34) with a straight, Ten to Ace
Seat 2: XwinX25 folded before Flop (didn't bet)
Seat 3: Namhkal folded before Flop (didn't bet)
Seat 4: Yspenyanin (button) mucked
Seat 5: boxer821 (small blind) folded before Flop
Seat 6: KokoulinV (big blind) folded before Flop



PokerStars Hand #166667853951:  Hold'em No Limit ($0.05/$0.10 USD) - 2017/02/23 16:08:44 ET
Table 'Geisha' 6-max Seat #1 is the button
Seat 1: facewald ($34.49 in chips) 
Seat 3: Eddys Edge ($10 in chips) 
Seat 4: marianoboni ($10 in chips) 
Seat 5: KRZuff ($14.36 in chips) 
Seat 6: Namhkal ($20.83 in chips) 
MisterX413 will be allowed to play after the button
Eddys Edge: posts small blind $0.05
marianoboni: posts big blind $0.10
*** HOLE CARDS ***
KRZuff: raises $0.20 to $0.30
Namhkal: folds 
facewald: folds 
Eddys Edge: folds 
marianoboni: folds 
Uncalled bet ($0.20) returned to KRZuff
KRZuff collected $0.25 from pot
*** SUMMARY ***
Total pot $0.25 | Rake $0 
Seat 1: facewald (button) folded before Flop (didn't bet)
Seat 3: Eddys Edge (small blind) folded before Flop
Seat 4: marianoboni (big blind) folded before Flop
Seat 5: KRZuff collected ($0.25)
Seat 6: Namhkal folded before Flop (didn't bet)



PokerStars Hand #166667854456:  Hold'em No Limit ($0.05/$0.10 USD) - 2017/02/23 16:08:44 ET
Table 'Lobelia II' 6-max Seat #5 is the button
Seat 1: facewald ($22.65 in chips) 
Seat 2: Dcaro31 ($17.46 in chips) 
Seat 3: oddshoff ($19.58 in chips) 
Seat 5: Feverhead ($18.46 in chips) 
Seat 6: NvR.m1nD ($10.14 in chips) 
NvR.m1nD: posts small blind $0.05
facewald: posts big blind $0.10
arti192837: sits out 
*** HOLE CARDS ***
Dcaro31: folds 
oddshoff: folds 
Feverhead: raises $0.10 to $0.20
NvR.m1nD: folds 
facewald: calls $0.10
*** FLOP *** [Qs 2d Ad]
facewald: checks 
Feverhead: bets $0.29
facewald: calls $0.29
*** TURN *** [Qs 2d Ad] [2h]
facewald: checks 
Feverhead: checks 
*** RIVER *** [Qs 2d Ad 2h] [6c]
facewald: checks 
Feverhead: checks 
*** SHOW DOWN ***
facewald: shows [3s 5h] (a pair of Deuces)
Feverhead: shows [Ac 7c] (two pair, Aces and Deuces)
Feverhead collected $0.98 from pot
*** SUMMARY ***
Total pot $1.03 | Rake $0.05 
Board [Qs 2d Ad 2h 6c]
Seat 1: facewald (big blind) showed [3s 5h] and lost with a pair of Deuces
Seat 2: Dcaro31 folded before Flop (didn't bet)
Seat 3: oddshoff folded before Flop (didn't bet)
Seat 5: Feverhead (button) showed [Ac 7c] and won ($0.98) with two pair, Aces and Deuces
Seat 6: NvR.m1nD (small blind) folded before Flop



PokerStars Hand #166667854894:  Hold'em No Limit ($0.05/$0.10 USD) - 2017/02/23 16:08:45 ET
Table 'Torrence II' 6-max Seat #3 is the button
Seat 1: Starbooks ($6.91 in chips) 
Seat 2: scorpionfish ($16.22 in chips) 
Seat 3: coolisses111 ($9.89 in chips) 
Seat 4: Zooplack ($10 in chips) 
Seat 5: Kow6oy ($12.18 in chips) 
Seat 6: mhonielsen ($10 in chips) 
Zooplack: posts small blind $0.05
Kow6oy: posts big blind $0.10
*** HOLE CARDS ***
mhonielsen: raises $0.30 to $0.40
Starbooks: folds 
scorpionfish: calls $0.40
coolisses111: folds 
Zooplack: folds 
Kow6oy: folds 
*** FLOP *** [Jc 5h Kh]
mhonielsen: bets $0.53
scorpionfish: folds 
Uncalled bet ($0.53) returned to mhonielsen
mhonielsen collected $0.91 from pot
*** SUMMARY ***
Total pot $0.95 | Rake $0.04 
Board [Jc 5h Kh]
Seat 1: Starbooks folded before Flop (didn't bet)
Seat 2: scorpionfish folded on the Flop
Seat 3: coolisses111 (button) folded before Flop (didn't bet)
Seat 4: Zooplack (small blind) folded before Flop
Seat 5: Kow6oy (big blind) folded before Flop
Seat 6: mhonielsen collected ($0.91)



PokerStars Hand #166667854966:  Hold'em No Limit ($0.05/$0.10 USD) - 2017/02/23 16:08:45 ET
Table 'Tirela' 6-max Seat #6 is the button
Seat 1: Smitty03300 ($10 in chips) 
Seat 2: Andrei ProFF ($17.34 in chips) 
Seat 3: aim444 ($16.43 in chips) 
Seat 4: ArcticBearDK ($10 in chips) 
Seat 5: KRZuff ($13.59 in chips) 
Seat 6: coolisses111 ($9.80 in chips) 
Smitty03300: posts small blind $0.05
Andrei ProFF: posts big blind $0.10
*** HOLE CARDS ***
aim444: folds 
ArcticBearDK: folds 
KRZuff: raises $0.20 to $0.30
coolisses111: folds 
Smitty03300: folds 
Andrei ProFF: calls $0.20
*** FLOP *** [2c 9h 7h]
Andrei ProFF: checks 
KRZuff: bets $0.40
Andrei ProFF: folds 
Uncalled bet ($0.40) returned to KRZuff
KRZuff collected $0.62 from pot
*** SUMMARY ***
Total pot $0.65 | Rake $0.03 
Board [2c 9h 7h]
Seat 1: Smitty03300 (small blind) folded before Flop
Seat 2: Andrei ProFF (big blind) folded on the Flop
Seat 3: aim444 folded before Flop (didn't bet)
Seat 4: ArcticBearDK folded before Flop (didn't bet)
Seat 5: KRZuff collected ($0.62)
Seat 6: coolisses111 (button) folded before Flop (didn't bet)



PokerStars Hand #166667855223:  Hold'em No Limit ($0.05/$0.10 USD) - 2017/02/23 16:08:45 ET
Table 'Kunigunde II' 6-max Seat #3 is the button
Seat 1: facewald ($10.20 in chips) 
Seat 3: pancernik21 ($18.19 in chips) 
Seat 4: david_sara83 ($13.72 in chips) 
Seat 5: mdelfin0 ($11.44 in chips) 
Seat 6: Zooplack ($10 in chips) 
david_sara83: posts small blind $0.05
mdelfin0: posts big blind $0.10
DrVzad: sits out 
*** HOLE CARDS ***
Zooplack: folds 
facewald: folds 
pancernik21: raises $0.20 to $0.30
david_sara83: folds 
mdelfin0: raises $0.90 to $1.20
pancernik21: calls $0.90
*** FLOP *** [3c Td Kh]
mdelfin0: bets $1.10
pancernik21: folds 
Uncalled bet ($1.10) returned to mdelfin0
mdelfin0 collected $2.34 from pot
*** SUMMARY ***
Total pot $2.45 | Rake $0.11 
Board [3c Td Kh]
Seat 1: facewald folded before Flop (didn't bet)
Seat 3: pancernik21 (button) folded on the Flop
Seat 4: david_sara83 (small blind) folded before Flop
Seat 5: mdelfin0 (big blind) collected ($2.34)
Seat 6: Zooplack folded before Flop (didn't bet)



PokerStars Hand #166667855384:  Hold'em No Limit ($0.05/$0.10 USD) - 2017/02/23 16:08:45 ET
Table 'Brambilla II' 6-max Seat #3 is the button
Seat 1: Rodik002 ($12.27 in chips) 
Seat 2: dwonder75 ($15.46 in chips) 
Seat 3: BORIS_ENEV ($13.91 in chips) 
Seat 4: david_sara83 ($11.72 in chips) 
Seat 5: FRAID358 ($10.15 in chips) 
Seat 6: boxer821 ($10 in chips) 
david_sara83: posts small blind $0.05
FRAID358: posts big blind $0.10
*** HOLE CARDS ***
boxer821: folds 
Rodik002: folds 
dwonder75: folds 
BORIS_ENEV: raises $0.10 to $0.20
david_sara83: folds 
FRAID358: folds 
Uncalled bet ($0.10) returned to BORIS_ENEV
BORIS_ENEV collected $0.25 from pot
*** SUMMARY ***
Total pot $0.25 | Rake $0 
Seat 1: Rodik002 folded before Flop (didn't bet)
Seat 2: dwonder75 folded before Flop (didn't bet)
Seat 3: BORIS_ENEV (button) collected ($0.25)
Seat 4: david_sara83 (small blind) folded before Flop
Seat 5: FRAID358 (big blind) folded before Flop
Seat 6: boxer821 folded before Flop (didn't bet)



PokerStars Hand #166667855412:  Hold'em No Limit ($0.05/$0.10 USD) - 2017/02/23 16:08:45 ET
Table 'Pulcova II' 6-max Seat #1 is the button
Seat 1: sexy_seagull ($10.83 in chips) 
Seat 2: Kazacha ($10.45 in chips) 
Seat 3: Lao Tsy ($14.22 in chips) 
Seat 4: VioXion ($12.78 in chips) 
Seat 5: mdelfin0 ($10.09 in chips) 
Seat 6: Ice_Isayev ($10.20 in chips) 
Kazacha: posts small blind $0.05
Lao Tsy: posts big blind $0.10
*** HOLE CARDS ***
VioXion: folds 
VioXion leaves the table
mdelfin0: folds 
Ice_Isayev: raises $0.15 to $0.25
sexy_seagull: raises $0.55 to $0.80
Kazacha: folds 
Lao Tsy: folds 
Ice_Isayev: folds 
Uncalled bet ($0.55) returned to sexy_seagull
sexy_seagull collected $0.65 from pot
*** SUMMARY ***
Total pot $0.65 | Rake $0 
Seat 1: sexy_seagull (button) collected ($0.65)
Seat 2: Kazacha (small blind) folded before Flop
Seat 3: Lao Tsy (big blind) folded before Flop
Seat 4: VioXion folded before Flop (didn't bet)
Seat 5: mdelfin0 folded before Flop (didn't bet)
Seat 6: Ice_Isayev folded before Flop



PokerStars Hand #166667855735:  Hold'em No Limit ($0.05/$0.10 USD) - 2017/02/23 16:08:45 ET
Table 'Izar' 6-max Seat #3 is the button
Seat 2: mvp0013 ($10 in chips) 
Seat 3: Yspenyanin ($11.02 in chips) 
Seat 4: Matee92 ($6.14 in chips) 
Seat 5: fishhook5 ($11.30 in chips) 
Seat 6: yodzik ($7.79 in chips) 
Matee92: posts small blind $0.05
fishhook5: posts big blind $0.10
*** HOLE CARDS ***
yodzik: folds 
mvp0013: folds 
Yspenyanin: raises $0.15 to $0.25
Matee92: folds 
fishhook5: folds 
Uncalled bet ($0.15) returned to Yspenyanin
Yspenyanin collected $0.25 from pot
*** SUMMARY ***
Total pot $0.25 | Rake $0 
Seat 2: mvp0013 folded before Flop (didn't bet)
Seat 3: Yspenyanin (button) collected ($0.25)
Seat 4: Matee92 (small blind) folded before Flop
Seat 5: fishhook5 (big blind) folded before Flop
Seat 6: yodzik folded before Flop (didn't bet)



PokerStars Hand #166667856237:  Hold'em No Limit ($0.05/$0.10 USD) - 2017/02/23 16:08:46 ET
Table 'Ebella II' 6-max Seat #6 is the button
Seat 1: gaHy_HaXeP ($10 in chips) 
Seat 2: Therodorus ($10 in chips) 
Seat 3: Torften2 ($17.51 in chips) 
Seat 4: ValdemorS ($11.35 in chips) 
Seat 5: Bird et al ($10 in chips) 
Seat 6: Joker51_wtf! ($11.24 in chips) 
gaHy_HaXeP: posts small blind $0.05
Therodorus: posts big blind $0.10
*** HOLE CARDS ***
Torften2: folds 
ValdemorS: folds 
Bird et al: folds 
Joker51_wtf!: raises $0.12 to $0.22
gaHy_HaXeP: folds 
Therodorus: folds 
Uncalled bet ($0.12) returned to Joker51_wtf!
Joker51_wtf! collected $0.25 from pot
*** SUMMARY ***
Total pot $0.25 | Rake $0 
Seat 1: gaHy_HaXeP (small blind) folded before Flop
Seat 2: Therodorus (big blind) folded before Flop
Seat 3: Torften2 folded before Flop (didn't bet)
Seat 4: ValdemorS folded before Flop (didn't bet)
Seat 5: Bird et al folded before Flop (didn't bet)
Seat 6: Joker51_wtf! (button) collected ($0.25)



PokerStars Hand #166667857067:  Hold'em No Limit ($0.05/$0.10 USD) - 2017/02/23 16:08:47 ET
Table 'Hercynia III' 6-max Seat #5 is the button
Seat 1: Bird et al ($14.63 in chips) 
Seat 2: Action_Gibi ($7.13 in chips) 
Seat 3: Dcaro31 ($20.02 in chips) 
Seat 5: THIMUCHIN ($15.30 in chips) 
Seat 6: bdixon_5 ($11.64 in chips) 
bdixon_5: posts small blind $0.05
Bird et al: posts big blind $0.10
*** HOLE CARDS ***
Action_Gibi: folds 
Dcaro31: folds 
THIMUCHIN: folds 
bdixon_5: folds 
Uncalled bet ($0.05) returned to Bird et al
Bird et al collected $0.10 from pot
*** SUMMARY ***
Total pot $0.10 | Rake $0 
Seat 1: Bird et al (big blind) collected ($0.10)
Seat 2: Action_Gibi folded before Flop (didn't bet)
Seat 3: Dcaro31 folded before Flop (didn't bet)
Seat 5: THIMUCHIN (button) folded before Flop (didn't bet)
Seat 6: bdixon_5 (small blind) folded before Flop



PokerStars Hand #166667857232:  Hold'em No Limit ($0.05/$0.10 USD) - 2017/02/23 16:08:47 ET
Table 'Samitchell III' 6-max Seat #3 is the button
Seat 2: scorpionfish ($12.98 in chips) 
Seat 3: Vanne11 ($9.45 in chips) 
Vanne11: posts small blind $0.05
scorpionfish: posts big blind $0.10
*** HOLE CARDS ***
Vanne11: raises $0.10 to $0.20
scorpionfish: folds 
Uncalled bet ($0.10) returned to Vanne11
Vanne11 collected $0.20 from pot
*** SUMMARY ***
Total pot $0.20 | Rake $0 
Seat 2: scorpionfish (big blind) folded before Flop
Seat 3: Vanne11 (button) (small blind) collected ($0.20)



PokerStars Hand #166667857557:  Hold'em No Limit ($0.05/$0.10 USD) - 2017/02/23 16:08:48 ET
Table 'Eurykleia' 6-max Seat #1 is the button
Seat 1: Giyorod ($10.15 in chips) 
Seat 2: x3ultimate ($10.64 in chips) 
Seat 3: boxer821 ($20.41 in chips) 
Seat 4: 6ePeMeHHa9 ($16.59 in chips) 
Seat 5: fishhook5 ($10 in chips) 
Seat 6: afca128 ($7.16 in chips) 
x3ultimate: posts small blind $0.05
boxer821: posts big blind $0.10
*** HOLE CARDS ***
6ePeMeHHa9: raises $0.19 to $0.29
fishhook5: folds 
afca128: calls $0.29
Giyorod: folds 
x3ultimate: folds 
boxer821: folds 
*** FLOP *** [2d 6s 3d]
6ePeMeHHa9: bets $0.50
afca128: calls $0.50
*** TURN *** [2d 6s 3d] [5h]
6ePeMeHHa9: checks 
afca128: bets $1.65
6ePeMeHHa9: calls $1.65
*** RIVER *** [2d 6s 3d 5h] [9s]
6ePeMeHHa9: checks 
afca128: checks 
*** SHOW DOWN ***
6ePeMeHHa9: shows [Jh Jc] (a pair of Jacks)
afca128: mucks hand 
6ePeMeHHa9 collected $4.80 from pot
*** SUMMARY ***
Total pot $5.03 | Rake $0.23 
Board [2d 6s 3d 5h 9s]
Seat 1: Giyorod (button) folded before Flop (didn't bet)
Seat 2: x3ultimate (small blind) folded before Flop
Seat 3: boxer821 (big blind) folded before Flop
Seat 4: 6ePeMeHHa9 showed [Jh Jc] and won ($4.80) with a pair of Jacks
Seat 5: fishhook5 folded before Flop (didn't bet)
Seat 6: afca128 mucked



PokerStars Hand #166667857580:  Hold'em No Limit ($0.05/$0.10 USD) - 2017/02/23 16:08:48 ET
Table 'Bootes' 6-max Seat #6 is the button
Seat 1: Namhkal ($11.30 in chips) 
Seat 2: Bird et al ($17.46 in chips) 
Seat 3: KA3AXCTAHEU, ($20.76 in chips) 
Seat 4: totonove ($6.88 in chips) 
Seat 5: Pekaml ($15.42 in chips) 
Seat 6: cherep61987 ($10.07 in chips) 
Namhkal: posts small blind $0.05
Bird et al: posts big blind $0.10
*** HOLE CARDS ***
KA3AXCTAHEU,: folds 
totonove: folds 
Pekaml: folds 
cherep61987: folds 
Namhkal: raises $0.15 to $0.25
Bird et al: folds 
Uncalled bet ($0.15) returned to Namhkal
Namhkal collected $0.20 from pot
*** SUMMARY ***
Total pot $0.20 | Rake $0 
Seat 1: Namhkal (small blind) collected ($0.20)
Seat 2: Bird et al (big blind) folded before Flop
Seat 3: KA3AXCTAHEU, folded before Flop (didn't bet)
Seat 4: totonove folded before Flop (didn't bet)
Seat 5: Pekaml folded before Flop (didn't bet)
Seat 6: cherep61987 (button) folded before Flop (didn't bet)



PokerStars Hand #166667857824:  Hold'em No Limit ($0.05/$0.10 USD) - 2017/02/23 16:08:48 ET
Table 'Nymphe II' 6-max Seat #3 is the button
Seat 1: jacktayra ($1.01 in chips) 
Seat 2: Newqbrown ($10.63 in chips) 
Seat 3: THIMUCHIN ($16.76 in chips) 
Seat 4: coolisses111 ($17.20 in chips) 
Seat 6: Xander188 ($10 in chips) 
coolisses111: posts small blind $0.05
Xander188: posts big blind $0.10
*** HOLE CARDS ***
jacktayra: folds 
RoJ1 joins the table at seat #5 
Newqbrown: raises $0.20 to $0.30
THIMUCHIN: folds 
coolisses111: folds 
Xander188: folds 
Uncalled bet ($0.20) returned to Newqbrown
Newqbrown collected $0.25 from pot
*** SUMMARY ***
Total pot $0.25 | Rake $0 
Seat 1: jacktayra folded before Flop (didn't bet)
Seat 2: Newqbrown collected ($0.25)
Seat 3: THIMUCHIN (button) folded before Flop (didn't bet)
Seat 4: coolisses111 (small blind) folded before Flop
Seat 6: Xander188 (big blind) folded before Flop



PokerStars Hand #166667857920:  Hold'em No Limit ($0.05/$0.10 USD) - 2017/02/23 16:08:48 ET
Table 'Deflotte' 6-max Seat #4 is the button
Seat 1: Zooplack ($16.16 in chips) 
Seat 2: MonteCris92 ($10.15 in chips) 
Seat 4: 8th wonders ($10.37 in chips) 
Seat 5: Pokeaster ($11.37 in chips) 
Seat 6: Iarlei ($11.60 in chips) 
Pokeaster: posts small blind $0.05
Iarlei: posts big blind $0.10
*** HOLE CARDS ***
Zooplack: folds 
MonteCris92: folds 
8th wonders: folds 
Croplayer1 leaves the table
Pokeaster: raises $0.20 to $0.30
Iarlei: folds 
Uncalled bet ($0.20) returned to Pokeaster
Pokeaster collected $0.20 from pot
*** SUMMARY ***
Total pot $0.20 | Rake $0 
Seat 1: Zooplack folded before Flop (didn't bet)
Seat 2: MonteCris92 folded before Flop (didn't bet)
Seat 4: 8th wonders (button) folded before Flop (didn't bet)
Seat 5: Pokeaster (small blind) collected ($0.20)
Seat 6: Iarlei (big blind) folded before Flop



PokerStars Hand #166667858084:  Hold'em No Limit ($0.05/$0.10 USD) - 2017/02/23 16:08:48 ET
Table 'Pirola' 6-max Seat #2 is the button
Seat 1: Rodik002 ($10 in chips) 
Seat 2: lmlmlmlm90 ($17.69 in chips) 
Seat 4: barons89 ($11.96 in chips) 
Seat 5: Iarlei ($13.99 in chips) 
Seat 6: Hyd SK ($13.34 in chips) 
Goroshkos88 will be allowed to play after the button
barons89: posts small blind $0.05
Iarlei: posts big blind $0.10
*** HOLE CARDS ***
Hyd SK: folds 
Rodik002: folds 
lmlmlmlm90: calls $0.10
barons89: folds 
Iarlei: checks 
*** FLOP *** [6d 2d Tc]
Iarlei: bets $0.15
lmlmlmlm90: calls $0.15
*** TURN *** [6d 2d Tc] [Qh]
Iarlei: checks 
lmlmlmlm90: checks 
*** RIVER *** [6d 2d Tc Qh] [9c]
Iarlei: checks 
lmlmlmlm90: bets $0.10
Iarlei: calls $0.10
*** SHOW DOWN ***
lmlmlmlm90: shows [Jc As] (high card Ace)
Iarlei: shows [2h Ts] (two pair, Tens and Deuces)
Iarlei collected $0.72 from pot
*** SUMMARY ***
Total pot $0.75 | Rake $0.03 
Board [6d 2d Tc Qh 9c]
Seat 1: Rodik002 folded before Flop (didn't bet)
Seat 2: lmlmlmlm90 (button) showed [Jc As] and lost with high card Ace
Seat 4: barons89 (small blind) folded before Flop
Seat 5: Iarlei (big blind) showed [2h Ts] and won ($0.72) with two pair, Tens and Deuces
Seat 6: Hyd SK folded before Flop (didn't bet)



PokerStars Hand #166667858687:  Hold'em No Limit ($0.05/$0.10 USD) - 2017/02/23 16:08:49 ET
Table 'Sheragul III' 6-max Seat #3 is the button
Seat 2: Bird et al ($10.41 in chips) 
Seat 3: FRAID358 ($9.85 in chips) 
Seat 4: maxiv608 ($10.48 in chips) 
Seat 5: Bandyaev ($15.97 in chips) 
Seat 6: Andrei ProFF ($11.91 in chips) 
maxiv608: posts small blind $0.05
Bandyaev: posts big blind $0.10
voledy: sits out 
*** HOLE CARDS ***
Andrei ProFF: folds 
Andrei ProFF leaves the table
Bird et al: folds 
FRAID358: raises $0.15 to $0.25
maxiv608: folds 
Bandyaev: folds 
Uncalled bet ($0.15) returned to FRAID358
Bandyaev leaves the table
FRAID358 collected $0.25 from pot
*** SUMMARY ***
Total pot $0.25 | Rake $0 
Seat 2: Bird et al folded before Flop (didn't bet)
Seat 3: FRAID358 (button) collected ($0.25)
Seat 4: maxiv608 (small blind) folded before Flop
Seat 5: Bandyaev (big blind) folded before Flop
Seat 6: Andrei ProFF folded before Flop (didn't bet)



PokerStars Hand #166667858719:  Hold'em No Limit ($0.05/$0.10 USD) - 2017/02/23 16:08:49 ET
Table 'Pompeja III' 6-max Seat #6 is the button
Seat 1: Iarlei ($12.03 in chips) 
Seat 2: steepfell ($10.15 in chips) 
Seat 3: Yspenyanin ($12.31 in chips) 
Seat 4: Cluckh ($13.57 in chips) 
Seat 5: Spud014 ($12.45 in chips) 
Seat 6: mega spasser ($4.50 in chips) 
Iarlei: posts small blind $0.05
steepfell: posts big blind $0.10
*** HOLE CARDS ***
Yspenyanin: folds 
Cluckh: raises $0.20 to $0.30
Spud014: folds 
mega spasser: folds 
Iarlei: folds 
steepfell: calls $0.20
*** FLOP *** [3h 5d 6s]
steepfell: checks 
Cluckh: checks 
*** TURN *** [3h 5d 6s] [2s]
steepfell: bets $0.42
Cluckh: folds 
Uncalled bet ($0.42) returned to steepfell
steepfell collected $0.62 from pot
*** SUMMARY ***
Total pot $0.65 | Rake $0.03 
Board [3h 5d 6s 2s]
Seat 1: Iarlei (small blind) folded before Flop
Seat 2: steepfell (big blind) collected ($0.62)
Seat 3: Yspenyanin folded before Flop (didn't bet)
Seat 4: Cluckh folded on the Turn
Seat 5: Spud014 folded before Flop (didn't bet)
Seat 6: mega spasser (button) folded before Flop (didn't bet)



PokerStars Hand #166667858754:  Hold'em No Limit ($0.05/$0.10 USD) - 2017/02/23 16:08:49 ET
Table 'Marbachia II' 6-max Seat #2 is the button
Seat 2: Yabidooo ($10 in chips) 
Seat 3: MisterX413 ($10.09 in chips) 
Seat 4: marianoboni ($10 in chips) 
Seat 5: MihaGr ($12.64 in chips) 
MisterX413: posts small blind $0.05
marianoboni: posts big blind $0.10
arti192837: sits out 
crooso: sits out 
*** HOLE CARDS ***
MihaGr: folds 
Yabidooo: raises $0.10 to $0.20
MisterX413: raises $0.50 to $0.70
marianoboni: folds 
Yabidooo: folds 
Uncalled bet ($0.50) returned to MisterX413
MisterX413 collected $0.50 from pot
*** SUMMARY ***
Total pot $0.50 | Rake $0 
Seat 2: Yabidooo (button) folded before Flop
Seat 3: MisterX413 (small blind) collected ($0.50)
Seat 4: marianoboni (big blind) folded before Flop
Seat 5: MihaGr folded before Flop (didn't bet)



PokerStars Hand #166667858861:  Hold'em No Limit ($0.05/$0.10 USD) - 2017/02/23 16:08:49 ET
Table 'Pallas II' 6-max Seat #5 is the button
Seat 1: mdelfin0 ($16.37 in chips) 
Seat 4: MisterX413 ($10 in chips) 
Seat 5: gaHy_HaXeP ($10.10 in chips) 
Seat 6: Smitty03300 ($10 in chips) 
Smitty03300: posts small blind $0.05
mdelfin0: posts big blind $0.10
DEraser: sits out 
popypaleta: sits out 
*** HOLE CARDS ***
MisterX413: raises $0.20 to $0.30
gaHy_HaXeP: folds 
Smitty03300: folds 
mdelfin0: calls $0.20
*** FLOP *** [5d 9c Js]
mdelfin0: checks 
MisterX413: checks 
*** TURN *** [5d 9c Js] [Ah]
mdelfin0: checks 
MisterX413: checks 
*** RIVER *** [5d 9c Js Ah] [2s]
mdelfin0: bets $0.20
MisterX413: folds 
Uncalled bet ($0.20) returned to mdelfin0
mdelfin0 collected $0.62 from pot
*** SUMMARY ***
Total pot $0.65 | Rake $0.03 
Board [5d 9c Js Ah 2s]
Seat 1: mdelfin0 (big blind) collected ($0.62)
Seat 4: MisterX413 folded on the River
Seat 5: gaHy_HaXeP (button) folded before Flop (didn't bet)
Seat 6: Smitty03300 (small blind) folded before Flop



PokerStars Hand #166667859314:  Hold'em No Limit ($0.05/$0.10 USD) - 2017/02/23 16:08:49 ET
Table 'Walpurga' 6-max Seat #5 is the button
Seat 1: chimera252 ($12.12 in chips) 
Seat 2: paxit71 ($5.25 in chips) 
Seat 3: marianoboni ($16.21 in chips) 
Seat 4: oddshoff ($12.89 in chips) 
Seat 5: Fremara ($9.75 in chips) 
chimera252: posts small blind $0.05
paxit71: posts big blind $0.10
*** HOLE CARDS ***
AIONCMA1988 leaves the table
marianoboni: folds 
oddshoff: folds 
Fremara: raises $0.20 to $0.30
chimera252: folds 
paxit71: folds 
Uncalled bet ($0.20) returned to Fremara
Fremara collected $0.25 from pot
*** SUMMARY ***
Total pot $0.25 | Rake $0 
Seat 1: chimera252 (small blind) folded before Flop
Seat 2: paxit71 (big blind) folded before Flop
Seat 3: marianoboni folded before Flop (didn't bet)
Seat 4: oddshoff folded before Flop (didn't bet)
Seat 5: Fremara (button) collected ($0.25)



