PokerStars Hand #166667535195:  Hold'em No Limit ($0.05/$0.10 USD) - 2017/02/23 16:02:56 ET
Table 'Lorbach' 6-max Seat #5 is the button
Seat 1: LarryTheStar ($11.12 in chips) 
Seat 2: fabadam ($12.63 in chips) 
Seat 3: ArcticBearDK ($11.05 in chips) 
Seat 4: McCleans ($10.54 in chips) 
Seat 5: Cluckh ($14.62 in chips) 
Seat 6: Worlz ($12.72 in chips) 
Worlz: posts small blind $0.05
LarryTheStar: posts big blind $0.10
*** HOLE CARDS ***
fabadam: folds 
ArcticBearDK: folds 
McCleans: raises $0.20 to $0.30
Cluckh: folds 
Worlz: folds 
LarryTheStar: calls $0.20
*** FLOP *** [6c 7c 9h]
LarryTheStar: checks 
McCleans: bets $0.40
LarryTheStar: calls $0.40
*** TURN *** [6c 7c 9h] [Jh]
LarryTheStar: checks 
McCleans: bets $0.80
LarryTheStar: calls $0.80
*** RIVER *** [6c 7c 9h Jh] [As]
LarryTheStar: checks 
McCleans: bets $2.25
LarryTheStar: calls $2.25
*** SHOW DOWN ***
McCleans: shows [Td Qh] (high card Ace)
LarryTheStar: shows [Qc Jc] (a pair of Jacks)
LarryTheStar collected $7.21 from pot
*** SUMMARY ***
Total pot $7.55 | Rake $0.34 
Board [6c 7c 9h Jh As]
Seat 1: LarryTheStar (big blind) showed [Qc Jc] and won ($7.21) with a pair of Jacks
Seat 2: fabadam folded before Flop (didn't bet)
Seat 3: ArcticBearDK folded before Flop (didn't bet)
Seat 4: McCleans showed [Td Qh] and lost with high card Ace
Seat 5: Cluckh (button) folded before Flop (didn't bet)
Seat 6: Worlz (small blind) folded before Flop



PokerStars Hand #166667535599:  Hold'em No Limit ($0.05/$0.10 USD) - 2017/02/23 16:02:56 ET
Table 'Pompeja III' 6-max Seat #5 is the button
Seat 1: Iarlei ($12.04 in chips) 
Seat 2: steepfell ($10.69 in chips) 
Seat 3: Yspenyanin ($12 in chips) 
Seat 4: Cluckh ($12.06 in chips) 
Seat 5: Spud014 ($12.14 in chips) 
Seat 6: mega spasser ($5 in chips) 
mega spasser: posts small blind $0.05
Iarlei: posts big blind $0.10
*** HOLE CARDS ***
steepfell: folds 
Yspenyanin: folds 
Cluckh: raises $0.15 to $0.25
Spud014: folds 
mega spasser: folds 
Iarlei: folds 
Uncalled bet ($0.15) returned to Cluckh
Cluckh collected $0.25 from pot
*** SUMMARY ***
Total pot $0.25 | Rake $0 
Seat 1: Iarlei (big blind) folded before Flop
Seat 2: steepfell folded before Flop (didn't bet)
Seat 3: Yspenyanin folded before Flop (didn't bet)
Seat 4: Cluckh collected ($0.25)
Seat 5: Spud014 (button) folded before Flop (didn't bet)
Seat 6: mega spasser (small blind) folded before Flop



PokerStars Hand #166667535773:  Hold'em No Limit ($0.05/$0.10 USD) - 2017/02/23 16:02:56 ET
Table 'Oongaq' 6-max Seat #4 is the button
Seat 1: Dmitrij218 ($13.60 in chips) 
Seat 2: homelessdan ($19.05 in chips) 
Seat 3: iDecMate ($10 in chips) 
Seat 4: Bird et al ($10 in chips) 
Seat 5: Dizzler1991 ($4.46 in chips) 
Seat 6: boxer821 ($10 in chips) 
Dizzler1991: posts small blind $0.05
boxer821: posts big blind $0.10
*** HOLE CARDS ***
Dmitrij218: folds 
homelessdan: folds 
iDecMate: folds 
Bird et al: folds 
Dizzler1991: calls $0.05
boxer821: checks 
*** FLOP *** [5s Tc 8s]
Dizzler1991: checks 
boxer821: checks 
*** TURN *** [5s Tc 8s] [6d]
Dizzler1991: checks 
boxer821: checks 
*** RIVER *** [5s Tc 8s 6d] [Jh]
Dizzler1991: checks 
boxer821: checks 
*** SHOW DOWN ***
Dizzler1991: shows [2s Ad] (high card Ace)
boxer821: mucks hand 
Dizzler1991 collected $0.19 from pot
*** SUMMARY ***
Total pot $0.20 | Rake $0.01 
Board [5s Tc 8s 6d Jh]
Seat 1: Dmitrij218 folded before Flop (didn't bet)
Seat 2: homelessdan folded before Flop (didn't bet)
Seat 3: iDecMate folded before Flop (didn't bet)
Seat 4: Bird et al (button) folded before Flop (didn't bet)
Seat 5: Dizzler1991 (small blind) showed [2s Ad] and won ($0.19) with high card Ace
Seat 6: boxer821 (big blind) mucked



PokerStars Hand #166667535872:  Hold'em No Limit ($0.05/$0.10 USD) - 2017/02/23 16:02:56 ET
Table 'Reginhild' 6-max Seat #6 is the button
Seat 1: iamkakaroto ($11.45 in chips) 
Seat 2: Kow6oy ($10.15 in chips) 
Seat 3: ARCHITECT83 ($6.18 in chips) 
Seat 4: Raymondo21 ($23.36 in chips) 
Seat 5: XCarlos610 ($28.74 in chips) 
Seat 6: eniksenik ($10.04 in chips) 
iamkakaroto: posts small blind $0.05
Kow6oy: posts big blind $0.10
*** HOLE CARDS ***
ARCHITECT83: folds 
Raymondo21: folds 
XCarlos610: calls $0.10
eniksenik: raises $0.30 to $0.40
iamkakaroto: folds 
Kow6oy: folds 
XCarlos610: calls $0.30
*** FLOP *** [Ts Js 5h]
XCarlos610: checks 
eniksenik: checks 
*** TURN *** [Ts Js 5h] [7h]
XCarlos610: bets $0.46
eniksenik: folds 
Uncalled bet ($0.46) returned to XCarlos610
XCarlos610 collected $0.91 from pot
*** SUMMARY ***
Total pot $0.95 | Rake $0.04 
Board [Ts Js 5h 7h]
Seat 1: iamkakaroto (small blind) folded before Flop
Seat 2: Kow6oy (big blind) folded before Flop
Seat 3: ARCHITECT83 folded before Flop (didn't bet)
Seat 4: Raymondo21 folded before Flop (didn't bet)
Seat 5: XCarlos610 collected ($0.91)
Seat 6: eniksenik (button) folded on the Turn



PokerStars Hand #166667535906:  Hold'em No Limit ($0.05/$0.10 USD) - 2017/02/23 16:02:56 ET
Table 'Geisha' 6-max Seat #1 is the button
Seat 1: facewald ($34.63 in chips) 
Seat 2: voledy ($10.20 in chips) 
Seat 3: Eddys Edge ($10 in chips) 
Seat 4: jvstsayyes ($11.47 in chips) 
Seat 5: KRZuff ($14.10 in chips) 
Seat 6: Namhkal ($21.48 in chips) 
voledy: posts small blind $0.05
Eddys Edge: posts big blind $0.10
*** HOLE CARDS ***
jvstsayyes: folds 
KRZuff: raises $0.20 to $0.30
Namhkal: folds 
facewald: folds 
voledy: raises $0.70 to $1
Eddys Edge: folds 
KRZuff: folds 
Uncalled bet ($0.70) returned to voledy
voledy collected $0.70 from pot
*** SUMMARY ***
Total pot $0.70 | Rake $0 
Seat 1: facewald (button) folded before Flop (didn't bet)
Seat 2: voledy (small blind) collected ($0.70)
Seat 3: Eddys Edge (big blind) folded before Flop
Seat 4: jvstsayyes folded before Flop (didn't bet)
Seat 5: KRZuff folded before Flop
Seat 6: Namhkal folded before Flop (didn't bet)



PokerStars Hand #166667536280:  Hold'em No Limit ($0.05/$0.10 USD) - 2017/02/23 16:02:57 ET
Table 'Persephone' 6-max Seat #6 is the button
Seat 1: FRAID358 ($9.90 in chips) 
Seat 2: AM-L-SL ($5 in chips) 
Seat 3: Kow6oy ($11.88 in chips) 
Seat 4: 2G28 ($10 in chips) 
Seat 5: D3NyA ($10 in chips) 
Seat 6: popypaleta ($14.79 in chips) 
FRAID358: posts small blind $0.05
AM-L-SL: posts big blind $0.10
*** HOLE CARDS ***
Kow6oy: raises $0.25 to $0.35
2G28: folds 
D3NyA: calls $0.35
popypaleta: folds 
FRAID358: folds 
AM-L-SL: folds 
*** FLOP *** [Jc 8d Tc]
Kow6oy: bets $0.61
D3NyA: calls $0.61
*** TURN *** [Jc 8d Tc] [Qd]
Kow6oy: bets $1.32
D3NyA: folds 
Uncalled bet ($1.32) returned to Kow6oy
Kow6oy collected $1.98 from pot
*** SUMMARY ***
Total pot $2.07 | Rake $0.09 
Board [Jc 8d Tc Qd]
Seat 1: FRAID358 (small blind) folded before Flop
Seat 2: AM-L-SL (big blind) folded before Flop
Seat 3: Kow6oy collected ($1.98)
Seat 4: 2G28 folded before Flop (didn't bet)
Seat 5: D3NyA folded on the Turn
Seat 6: popypaleta (button) folded before Flop (didn't bet)



PokerStars Hand #166667536405:  Hold'em No Limit ($0.05/$0.10 USD) - 2017/02/23 16:02:57 ET
Table 'Peiroos III' 6-max Seat #5 is the button
Seat 1: tequila_joop ($10.05 in chips) 
Seat 3: nabatov.m ($6.01 in chips) 
Seat 4: pivanki11 ($11.12 in chips) 
Seat 5: ChuikaPridi ($9.74 in chips) 
Seat 6: CHRO8 ($9.66 in chips) 
CHRO8: posts small blind $0.05
tequila_joop: posts big blind $0.10
tequila_joop: posts the ante $0.02
nabatov.m: posts the ante $0.02
pivanki11: posts the ante $0.02
ChuikaPridi: posts the ante $0.02
CHRO8: posts the ante $0.02
*** HOLE CARDS ***
nabatov.m: calls $0.10
pivanki11: calls $0.10
ChuikaPridi: folds 
CHRO8: raises $0.40 to $0.50
tequila_joop: calls $0.40
nabatov.m: calls $0.40
pivanki11: calls $0.40
*** FLOP *** [3d 8d 2s]
CHRO8: bets $1.20
tequila_joop: folds 
nabatov.m: folds 
pivanki11: folds 
Uncalled bet ($1.20) returned to CHRO8
CHRO8 collected $2.01 from pot
*** SUMMARY ***
Total pot $2.10 | Rake $0.09 
Board [3d 8d 2s]
Seat 1: tequila_joop (big blind) folded on the Flop
Seat 3: nabatov.m folded on the Flop
Seat 4: pivanki11 folded on the Flop
Seat 5: ChuikaPridi (button) folded before Flop (didn't bet)
Seat 6: CHRO8 (small blind) collected ($2.01)



PokerStars Hand #166667536589:  Hold'em No Limit ($0.05/$0.10 USD) - 2017/02/23 16:02:57 ET
Table 'Themisto II' 6-max Seat #1 is the button
Seat 1: kickereens ($12.16 in chips) 
Seat 2: CA225 ($9.86 in chips) 
Seat 3: eniksenik ($11.21 in chips) 
Seat 4: Innerwuss ($11.19 in chips) 
Seat 5: ex3Lero86 ($10.94 in chips) 
Seat 6: noobigrok ($4 in chips) 
CA225: posts small blind $0.05
eniksenik: posts big blind $0.10
*** HOLE CARDS ***
Innerwuss: raises $0.20 to $0.30
ex3Lero86: folds 
noobigrok: raises $0.75 to $1.05
kickereens: folds 
CA225: folds 
eniksenik: folds 
Innerwuss: folds 
Uncalled bet ($0.75) returned to noobigrok
noobigrok collected $0.75 from pot
*** SUMMARY ***
Total pot $0.75 | Rake $0 
Seat 1: kickereens (button) folded before Flop (didn't bet)
Seat 2: CA225 (small blind) folded before Flop
Seat 3: eniksenik (big blind) folded before Flop
Seat 4: Innerwuss folded before Flop
Seat 5: ex3Lero86 folded before Flop (didn't bet)
Seat 6: noobigrok collected ($0.75)



PokerStars Hand #166667536669:  Hold'em No Limit ($0.05/$0.10 USD) - 2017/02/23 16:02:57 ET
Table 'Veniakaverin' 6-max Seat #6 is the button
Seat 1: pivanki11 ($11.99 in chips) 
Seat 2: david_sara83 ($10 in chips) 
Seat 3: Hyd SK ($18.50 in chips) 
Seat 4: Ampped87 ($8.53 in chips) 
Seat 5: Innerwuss ($24.69 in chips) 
Seat 6: bdixon_5 ($9.70 in chips) 
pivanki11: posts small blind $0.05
david_sara83: posts big blind $0.10
*** HOLE CARDS ***
Hyd SK: raises $0.25 to $0.35
Ampped87: folds 
Innerwuss: folds 
bdixon_5: calls $0.35
pivanki11: calls $0.30
david_sara83: folds 
*** FLOP *** [7s 6s 3c]
pivanki11: checks 
Hyd SK: bets $0.55
bdixon_5: folds 
pivanki11: calls $0.55
*** TURN *** [7s 6s 3c] [6h]
pivanki11: checks 
Hyd SK: bets $1.08
pivanki11: folds 
Uncalled bet ($1.08) returned to Hyd SK
Hyd SK collected $2.15 from pot
*** SUMMARY ***
Total pot $2.25 | Rake $0.10 
Board [7s 6s 3c 6h]
Seat 1: pivanki11 (small blind) folded on the Turn
Seat 2: david_sara83 (big blind) folded before Flop
Seat 3: Hyd SK collected ($2.15)
Seat 4: Ampped87 folded before Flop (didn't bet)
Seat 5: Innerwuss folded before Flop (didn't bet)
Seat 6: bdixon_5 (button) folded on the Flop



PokerStars Hand #166667536717:  Hold'em No Limit ($0.05/$0.10 USD) - 2017/02/23 16:02:57 ET
Table 'Vesta II' 6-max Seat #4 is the button
Seat 1: Yabidooo ($13.16 in chips) 
Seat 2: joewatson90 ($9.95 in chips) 
Seat 3: Pokeaster ($12.23 in chips) 
Seat 4: Dcaro31 ($10 in chips) 
Seat 5: Andy Wolf ($12.65 in chips) 
Andy Wolf: posts small blind $0.05
Yabidooo: posts big blind $0.10
*** HOLE CARDS ***
XaXaTyH4uK joins the table at seat #6 
joewatson90: folds 
joewatson90 leaves the table
Pokeaster: folds 
Dimka4 joins the table at seat #2 
Dcaro31: folds 
Andy Wolf: folds 
Uncalled bet ($0.05) returned to Yabidooo
Yabidooo collected $0.10 from pot
*** SUMMARY ***
Total pot $0.10 | Rake $0 
Seat 1: Yabidooo (big blind) collected ($0.10)
Seat 2: joewatson90 folded before Flop (didn't bet)
Seat 3: Pokeaster folded before Flop (didn't bet)
Seat 4: Dcaro31 (button) folded before Flop (didn't bet)
Seat 5: Andy Wolf (small blind) folded before Flop



PokerStars Hand #166667536793:  Hold'em No Limit ($0.05/$0.10 USD) - 2017/02/23 16:02:57 ET
Table 'Apollonia' 6-max Seat #2 is the button
Seat 1: ex3Lero86 ($10.11 in chips) 
Seat 2: ibara000 ($18.84 in chips) 
Seat 3: derbesteojr ($9.25 in chips) 
Seat 4: Goroshkos88 ($17.46 in chips) 
Seat 5: EphemeralBen ($13.49 in chips) 
Seat 6: Namhkal ($10.40 in chips) 
derbesteojr: posts small blind $0.05
Goroshkos88: posts big blind $0.10
*** HOLE CARDS ***
EphemeralBen: folds 
Namhkal: folds 
ex3Lero86: folds 
ibara000: folds 
derbesteojr: raises $0.20 to $0.30
Goroshkos88: folds 
Uncalled bet ($0.20) returned to derbesteojr
derbesteojr collected $0.20 from pot
*** SUMMARY ***
Total pot $0.20 | Rake $0 
Seat 1: ex3Lero86 folded before Flop (didn't bet)
Seat 2: ibara000 (button) folded before Flop (didn't bet)
Seat 3: derbesteojr (small blind) collected ($0.20)
Seat 4: Goroshkos88 (big blind) folded before Flop
Seat 5: EphemeralBen folded before Flop (didn't bet)
Seat 6: Namhkal folded before Flop (didn't bet)



PokerStars Hand #166667537082:  Hold'em No Limit ($0.05/$0.10 USD) - 2017/02/23 16:02:58 ET
Table 'Camilla II' 6-max Seat #6 is the button
Seat 1: paxit71 ($8.05 in chips) 
Seat 2: Giyorod ($15.81 in chips) 
Seat 4: chimera252 ($12.41 in chips) 
Seat 5: LarryTheStar ($11.49 in chips) 
Seat 6: david_sara83 ($10 in chips) 
paxit71: posts small blind $0.05
Giyorod: posts big blind $0.10
Andy Wolf: sits out 
*** HOLE CARDS ***
chimera252: folds 
LarryTheStar: folds 
david_sara83: raises $0.15 to $0.25
paxit71: folds 
Giyorod: folds 
Uncalled bet ($0.15) returned to david_sara83
david_sara83 collected $0.25 from pot
*** SUMMARY ***
Total pot $0.25 | Rake $0 
Seat 1: paxit71 (small blind) folded before Flop
Seat 2: Giyorod (big blind) folded before Flop
Seat 4: chimera252 folded before Flop (didn't bet)
Seat 5: LarryTheStar folded before Flop (didn't bet)
Seat 6: david_sara83 (button) collected ($0.25)



PokerStars Hand #166667537751:  Hold'em No Limit ($0.05/$0.10 USD) - 2017/02/23 16:02:58 ET
Table 'Tomyris II' 6-max Seat #1 is the button
Seat 1: ArcticBearDK ($21.98 in chips) 
Seat 2: Yspenyanin ($12.44 in chips) 
Seat 3: robertsabb ($11.66 in chips) 
Seat 4: Dcaro31 ($10 in chips) 
Seat 5: joewatson90 ($12.20 in chips) 
Seat 6: StackSmakka ($12.22 in chips) 
Yspenyanin: posts small blind $0.05
robertsabb: posts big blind $0.10
*** HOLE CARDS ***
Dcaro31: folds 
joewatson90 has timed out
joewatson90: folds 
StackSmakka: raises $0.15 to $0.25
joewatson90 leaves the table
ArcticBearDK: folds 
Yspenyanin: folds 
6ePeMeHHa9 joins the table at seat #5 
robertsabb: calls $0.15
*** FLOP *** [4s Ah 2h]
robertsabb: checks 
StackSmakka: bets $0.38
robertsabb: calls $0.38
*** TURN *** [4s Ah 2h] [Td]
robertsabb: checks 
StackSmakka: checks 
*** RIVER *** [4s Ah 2h Td] [Jd]
robertsabb: bets $0.60
StackSmakka: folds 
Uncalled bet ($0.60) returned to robertsabb
robertsabb collected $1.25 from pot
*** SUMMARY ***
Total pot $1.31 | Rake $0.06 
Board [4s Ah 2h Td Jd]
Seat 1: ArcticBearDK (button) folded before Flop (didn't bet)
Seat 2: Yspenyanin (small blind) folded before Flop
Seat 3: robertsabb (big blind) collected ($1.25)
Seat 4: Dcaro31 folded before Flop (didn't bet)
Seat 5: joewatson90 folded before Flop (didn't bet)
Seat 6: StackSmakka folded on the River



PokerStars Hand #166667538368:  Hold'em No Limit ($0.05/$0.10 USD) - 2017/02/23 16:02:59 ET
Table 'Iapetus III' 6-max Seat #5 is the button
Seat 2: Crafty23@PS ($10.05 in chips) 
Seat 3: takis nik ($10 in chips) 
Seat 4: XaXaTyH4uK ($10.45 in chips) 
Seat 5: homelessdan ($13.76 in chips) 
Crafty23@PS: posts small blind $0.05
takis nik: posts big blind $0.10
*** HOLE CARDS ***
yodzik leaves the table
XaXaTyH4uK: raises $0.20 to $0.30
tauronex joins the table at seat #6 
homelessdan: folds 
Crafty23@PS: folds 
takis nik: folds 
Uncalled bet ($0.20) returned to XaXaTyH4uK
XaXaTyH4uK collected $0.25 from pot
*** SUMMARY ***
Total pot $0.25 | Rake $0 
Seat 2: Crafty23@PS (small blind) folded before Flop
Seat 3: takis nik (big blind) folded before Flop
Seat 4: XaXaTyH4uK collected ($0.25)
Seat 5: homelessdan (button) folded before Flop (didn't bet)



PokerStars Hand #166667538396:  Hold'em No Limit ($0.05/$0.10 USD) - 2017/02/23 16:02:59 ET
Table 'Siebohme' 6-max Seat #2 is the button
Seat 1: kusa4ki ($11.38 in chips) 
Seat 2: el toro 1507 ($11.53 in chips) 
Seat 3: ex3Lero86 ($10.35 in chips) 
Seat 4: Innerwuss ($10.09 in chips) 
Seat 5: Kazacha ($10.10 in chips) 
Seat 6: townerz1991 ($10.53 in chips) 
ex3Lero86: posts small blind $0.05
Innerwuss: posts big blind $0.10
*** HOLE CARDS ***
Kazacha: folds 
townerz1991: raises $0.15 to $0.25
kusa4ki: folds 
el toro 1507: folds 
ex3Lero86: folds 
Innerwuss: folds 
Uncalled bet ($0.15) returned to townerz1991
townerz1991 collected $0.25 from pot
*** SUMMARY ***
Total pot $0.25 | Rake $0 
Seat 1: kusa4ki folded before Flop (didn't bet)
Seat 2: el toro 1507 (button) folded before Flop (didn't bet)
Seat 3: ex3Lero86 (small blind) folded before Flop
Seat 4: Innerwuss (big blind) folded before Flop
Seat 5: Kazacha folded before Flop (didn't bet)
Seat 6: townerz1991 collected ($0.25)



PokerStars Hand #166667538418:  Hold'em No Limit ($0.05/$0.10 USD) - 2017/02/23 16:02:59 ET
Table 'Ruvuma' 6-max Seat #6 is the button
Seat 1: FRAID358 ($10.30 in chips) 
Seat 2: Fab_1512 ($14.81 in chips) 
Seat 3: Spud014 ($11.26 in chips) 
Seat 4: DamDatsAnAce ($10 in chips) 
Seat 5: sexy_seagull ($10 in chips) 
Seat 6: Elinaattor ($9.45 in chips) 
FRAID358: posts small blind $0.05
Fab_1512: posts big blind $0.10
*** HOLE CARDS ***
Spud014: folds 
DamDatsAnAce: folds 
sexy_seagull: folds 
Elinaattor: raises $0.25 to $0.35
FRAID358: folds 
Fab_1512: folds 
Uncalled bet ($0.25) returned to Elinaattor
Elinaattor collected $0.25 from pot
*** SUMMARY ***
Total pot $0.25 | Rake $0 
Seat 1: FRAID358 (small blind) folded before Flop
Seat 2: Fab_1512 (big blind) folded before Flop
Seat 3: Spud014 folded before Flop (didn't bet)
Seat 4: DamDatsAnAce folded before Flop (didn't bet)
Seat 5: sexy_seagull folded before Flop (didn't bet)
Seat 6: Elinaattor (button) collected ($0.25)



PokerStars Hand #166667538787:  Hold'em No Limit ($0.05/$0.10 USD) - 2017/02/23 16:02:59 ET
Table 'Brendelia II' 6-max Seat #3 is the button
Seat 2: Crimsonr ($5.94 in chips) 
Seat 3: ValdemorS ($17.79 in chips) 
Seat 6: luckyPositiv ($10.54 in chips) 
luckyPositiv: posts small blind $0.05
Crimsonr: posts big blind $0.10
Crimsonr: posts the ante $0.02
ValdemorS: posts the ante $0.02
luckyPositiv: posts the ante $0.02
*** HOLE CARDS ***
ValdemorS: raises $0.20 to $0.30
luckyPositiv: folds 
Crimsonr: folds 
Uncalled bet ($0.20) returned to ValdemorS
ValdemorS collected $0.31 from pot
*** SUMMARY ***
Total pot $0.31 | Rake $0 
Seat 2: Crimsonr (big blind) folded before Flop
Seat 3: ValdemorS (button) collected ($0.31)
Seat 6: luckyPositiv (small blind) folded before Flop



PokerStars Hand #166667538862:  Hold'em No Limit ($0.05/$0.10 USD) - 2017/02/23 16:03:00 ET
Table 'Bootes' 6-max Seat #4 is the button
Seat 1: Namhkal ($13.20 in chips) 
Seat 2: Bird et al ($19.45 in chips) 
Seat 3: KA3AXCTAHEU, ($19.63 in chips) 
Seat 4: totonove ($4.56 in chips) 
Seat 5: Pekaml ($15.09 in chips) 
Pekaml: posts small blind $0.05
cherep61987: is sitting out 
Namhkal: posts big blind $0.10
*** HOLE CARDS ***
Bird et al: folds 
KA3AXCTAHEU,: folds 
totonove: folds 
Pekaml: raises $0.10 to $0.20
Namhkal: calls $0.10
*** FLOP *** [Jd Jc 7s]
Pekaml: bets $0.25
Namhkal: folds 
Uncalled bet ($0.25) returned to Pekaml
Pekaml collected $0.38 from pot
*** SUMMARY ***
Total pot $0.40 | Rake $0.02 
Board [Jd Jc 7s]
Seat 1: Namhkal (big blind) folded on the Flop
Seat 2: Bird et al folded before Flop (didn't bet)
Seat 3: KA3AXCTAHEU, folded before Flop (didn't bet)
Seat 4: totonove (button) folded before Flop (didn't bet)
Seat 5: Pekaml (small blind) collected ($0.38)



PokerStars Hand #166667538890:  Hold'em No Limit ($0.05/$0.10 USD) - 2017/02/23 16:03:00 ET
Table 'Juliet II' 6-max Seat #1 is the button
Seat 1: alexpolevaja ($11.08 in chips) 
Seat 2: KA3AXCTAHEU, ($15.33 in chips) 
Seat 3: patrick19111 ($11.72 in chips) 
Seat 4: x3ultimate ($10 in chips) 
Seat 5: Dcaro31 ($19.02 in chips) 
Seat 6: BookWorm78 ($33.10 in chips) 
KA3AXCTAHEU,: posts small blind $0.05
patrick19111: posts big blind $0.10
*** HOLE CARDS ***
x3ultimate: folds 
Dcaro31: folds 
BookWorm78: folds 
alexpolevaja: folds 
KA3AXCTAHEU,: raises $0.15 to $0.25
patrick19111: folds 
Uncalled bet ($0.15) returned to KA3AXCTAHEU,
KA3AXCTAHEU, collected $0.20 from pot
*** SUMMARY ***
Total pot $0.20 | Rake $0 
Seat 1: alexpolevaja (button) folded before Flop (didn't bet)
Seat 2: KA3AXCTAHEU, (small blind) collected ($0.20)
Seat 3: patrick19111 (big blind) folded before Flop
Seat 4: x3ultimate folded before Flop (didn't bet)
Seat 5: Dcaro31 folded before Flop (didn't bet)
Seat 6: BookWorm78 folded before Flop (didn't bet)



PokerStars Hand #166667539031:  Hold'em No Limit ($0.05/$0.10 USD) - 2017/02/23 16:03:00 ET
Table 'Rotraut' 6-max Seat #2 is the button
Seat 1: Hypermetal ($13.14 in chips) 
Seat 2: Newqbrown ($11.59 in chips) 
Seat 3: FlackoD ($11.57 in chips) 
Seat 5: Bird et al ($11.75 in chips) 
Seat 6: KokoulinV ($12.99 in chips) 
FlackoD: posts small blind $0.05
Darkfrai: is sitting out 
Bird et al: posts big blind $0.10
*** HOLE CARDS ***
KokoulinV: folds 
Hypermetal: folds 
Newqbrown: folds 
FlackoD: raises $0.10 to $0.20
Bird et al: folds 
Uncalled bet ($0.10) returned to FlackoD
FlackoD collected $0.20 from pot
*** SUMMARY ***
Total pot $0.20 | Rake $0 
Seat 1: Hypermetal folded before Flop (didn't bet)
Seat 2: Newqbrown (button) folded before Flop (didn't bet)
Seat 3: FlackoD (small blind) collected ($0.20)
Seat 5: Bird et al (big blind) folded before Flop
Seat 6: KokoulinV folded before Flop (didn't bet)



PokerStars Hand #166667539180:  Hold'em No Limit ($0.05/$0.10 USD) - 2017/02/23 16:03:00 ET
Table 'Tomita II' 6-max Seat #2 is the button
Seat 2: mhonielsen ($10 in chips) 
Seat 3: Lucky HoBBiT ($12.06 in chips) 
Seat 4: Hyd SK ($10.15 in chips) 
Seat 6: Punzzzer ($12.36 in chips) 
Lucky HoBBiT: posts small blind $0.05
Hyd SK: posts big blind $0.10
*** HOLE CARDS ***
Punzzzer: folds 
mhonielsen: raises $0.20 to $0.30
Lucky HoBBiT: folds 
Hyd SK: folds 
Uncalled bet ($0.20) returned to mhonielsen
mhonielsen collected $0.25 from pot
*** SUMMARY ***
Total pot $0.25 | Rake $0 
Seat 2: mhonielsen (button) collected ($0.25)
Seat 3: Lucky HoBBiT (small blind) folded before Flop
Seat 4: Hyd SK (big blind) folded before Flop
Seat 6: Punzzzer folded before Flop (didn't bet)



PokerStars Hand #166667539288:  Hold'em No Limit ($0.05/$0.10 USD) - 2017/02/23 16:03:00 ET
Table 'Torrence II' 6-max Seat #1 is the button
Seat 1: Starbooks ($4.22 in chips) 
Seat 2: scorpionfish ($16.15 in chips) 
Seat 3: coolisses111 ($9.70 in chips) 
Seat 4: Zooplack ($10.23 in chips) 
Seat 5: Kow6oy ($12.33 in chips) 
scorpionfish: posts small blind $0.05
coolisses111: posts big blind $0.10
mhonielsen: sits out 
*** HOLE CARDS ***
Zooplack: folds 
Kow6oy: folds 
Starbooks: folds 
scorpionfish: folds 
Uncalled bet ($0.05) returned to coolisses111
coolisses111 collected $0.10 from pot
*** SUMMARY ***
Total pot $0.10 | Rake $0 
Seat 1: Starbooks (button) folded before Flop (didn't bet)
Seat 2: scorpionfish (small blind) folded before Flop
Seat 3: coolisses111 (big blind) collected ($0.10)
Seat 4: Zooplack folded before Flop (didn't bet)
Seat 5: Kow6oy folded before Flop (didn't bet)



PokerStars Hand #166667539536:  Hold'em No Limit ($0.05/$0.10 USD) - 2017/02/23 16:03:00 ET
Table 'Wil' 6-max Seat #5 is the button
Seat 1: jwhelan94 ($24.47 in chips) 
Seat 2: Vrinni ($22.36 in chips) 
Seat 3: Namhkal ($10 in chips) 
Seat 4: x3ultimate ($10.70 in chips) 
Seat 5: Feverhead ($11.58 in chips) 
Seat 6: Comeback3392 ($14.08 in chips) 
Comeback3392: posts small blind $0.05
jwhelan94: posts big blind $0.10
*** HOLE CARDS ***
Vrinni: raises $0.20 to $0.30
Namhkal: folds 
x3ultimate: folds 
Feverhead: calls $0.30
Comeback3392: folds 
jwhelan94: calls $0.20
*** FLOP *** [9c 7d As]
jwhelan94: checks 
Vrinni: checks 
Feverhead: bets $0.46
jwhelan94: calls $0.46
Vrinni: calls $0.46
*** TURN *** [9c 7d As] [Jh]
jwhelan94: checks 
Vrinni: checks 
Feverhead: bets $1.12
jwhelan94: calls $1.12
Vrinni: folds 
*** RIVER *** [9c 7d As Jh] [Qs]
jwhelan94: checks 
Feverhead: checks 
*** SHOW DOWN ***
jwhelan94: shows [Kd Ks] (a pair of Kings)
Feverhead: shows [9h 7h] (two pair, Nines and Sevens)
Feverhead collected $4.36 from pot
*** SUMMARY ***
Total pot $4.57 | Rake $0.21 
Board [9c 7d As Jh Qs]
Seat 1: jwhelan94 (big blind) showed [Kd Ks] and lost with a pair of Kings
Seat 2: Vrinni folded on the Turn
Seat 3: Namhkal folded before Flop (didn't bet)
Seat 4: x3ultimate folded before Flop (didn't bet)
Seat 5: Feverhead (button) showed [9h 7h] and won ($4.36) with two pair, Nines and Sevens
Seat 6: Comeback3392 (small blind) folded before Flop



PokerStars Hand #166667539571:  Hold'em No Limit ($0.05/$0.10 USD) - 2017/02/23 16:03:00 ET
Table 'Union' 6-max Seat #1 is the button
Seat 1: Krumi1703 ($5.87 in chips) 
Seat 2: Zooplack ($10 in chips) 
Seat 3: Rodik002 ($12.16 in chips) 
Seat 4: Croplayer1 ($14.95 in chips) 
Seat 5: Chodemuncher ($10 in chips) 
Seat 6: bonyo71 ($3.85 in chips) 
Zooplack: posts small blind $0.05
Rodik002: posts big blind $0.10
*** HOLE CARDS ***
Croplayer1: folds 
Chodemuncher: raises $0.20 to $0.30
bonyo71: folds 
Krumi1703: calls $0.30
Zooplack: folds 
Rodik002: folds 
*** FLOP *** [Ac 5d 7c]
Chodemuncher: bets $0.40
Krumi1703: raises $1.50 to $1.90
Chodemuncher: raises $4.52 to $6.42
Krumi1703: calls $3.67 and is all-in
Uncalled bet ($0.85) returned to Chodemuncher
*** TURN *** [Ac 5d 7c] [6s]
*** RIVER *** [Ac 5d 7c 6s] [Js]
*** SHOW DOWN ***
Chodemuncher: shows [Qh As] (a pair of Aces)
Krumi1703: shows [Ah 8c] (a pair of Aces - lower kicker)
Chodemuncher collected $11.35 from pot
*** SUMMARY ***
Total pot $11.89 | Rake $0.54 
Board [Ac 5d 7c 6s Js]
Seat 1: Krumi1703 (button) showed [Ah 8c] and lost with a pair of Aces
Seat 2: Zooplack (small blind) folded before Flop
Seat 3: Rodik002 (big blind) folded before Flop
Seat 4: Croplayer1 folded before Flop (didn't bet)
Seat 5: Chodemuncher showed [Qh As] and won ($11.35) with a pair of Aces
Seat 6: bonyo71 folded before Flop (didn't bet)



PokerStars Hand #166667539599:  Hold'em No Limit ($0.05/$0.10 USD) - 2017/02/23 16:03:00 ET
Table 'Pirola' 6-max Seat #2 is the button
Seat 1: Rodik002 ($12.78 in chips) 
Seat 2: lmlmlmlm90 ($18.54 in chips) 
Seat 3: XaXaTyH4uK ($11.67 in chips) 
Seat 4: barons89 ($8.50 in chips) 
Seat 5: Iarlei ($14.39 in chips) 
Seat 6: Hyd SK ($10 in chips) 
XaXaTyH4uK: posts small blind $0.05
barons89: posts big blind $0.10
*** HOLE CARDS ***
Iarlei: folds 
Hyd SK: raises $0.25 to $0.35
Rodik002: folds 
lmlmlmlm90: folds 
XaXaTyH4uK: folds 
barons89: calls $0.25
*** FLOP *** [4s 9c 8s]
barons89: checks 
Hyd SK: checks 
*** TURN *** [4s 9c 8s] [8h]
barons89: bets $0.40
Hyd SK: folds 
Uncalled bet ($0.40) returned to barons89
barons89 collected $0.72 from pot
*** SUMMARY ***
Total pot $0.75 | Rake $0.03 
Board [4s 9c 8s 8h]
Seat 1: Rodik002 folded before Flop (didn't bet)
Seat 2: lmlmlmlm90 (button) folded before Flop (didn't bet)
Seat 3: XaXaTyH4uK (small blind) folded before Flop
Seat 4: barons89 (big blind) collected ($0.72)
Seat 5: Iarlei folded before Flop (didn't bet)
Seat 6: Hyd SK folded on the Turn



PokerStars Hand #166667539980:  Hold'em No Limit ($0.05/$0.10 USD) - 2017/02/23 16:03:01 ET
Table 'Xanthippe II' 6-max Seat #4 is the button
Seat 1: ade22345 ($4.48 in chips) 
Seat 2: Bird et al ($13.51 in chips) 
Seat 3: Dcaro31 ($10 in chips) 
Seat 4: Barcardi14 ($10.29 in chips) 
Seat 5: yodzik ($5 in chips) 
Seat 6: Orlangoor ($11.04 in chips) 
yodzik: posts small blind $0.05
Orlangoor: posts big blind $0.10
*** HOLE CARDS ***
ade22345: raises $0.90 to $1
Bird et al: folds 
Dcaro31: folds 
Barcardi14: raises $9.29 to $10.29 and is all-in
yodzik: folds 
Orlangoor: folds 
ade22345: calls $3.48 and is all-in
Uncalled bet ($5.81) returned to Barcardi14
*** FLOP *** [7s Qs 2s]
*** TURN *** [7s Qs 2s] [4s]
*** RIVER *** [7s Qs 2s 4s] [2h]
*** SHOW DOWN ***
ade22345: shows [Ac Ts] (a flush, Queen high)
Barcardi14: shows [8s 8d] (a flush, Queen high - lower cards)
ade22345 collected $8.70 from pot
*** SUMMARY ***
Total pot $9.11 | Rake $0.41 
Board [7s Qs 2s 4s 2h]
Seat 1: ade22345 showed [Ac Ts] and won ($8.70) with a flush, Queen high
Seat 2: Bird et al folded before Flop (didn't bet)
Seat 3: Dcaro31 folded before Flop (didn't bet)
Seat 4: Barcardi14 (button) showed [8s 8d] and lost with a flush, Queen high
Seat 5: yodzik (small blind) folded before Flop
Seat 6: Orlangoor (big blind) folded before Flop



PokerStars Hand #166667540113:  Hold'em No Limit ($0.05/$0.10 USD) - 2017/02/23 16:03:01 ET
Table 'Martha' 6-max Seat #4 is the button
Seat 1: Peter0087 ($10.26 in chips) 
Seat 2: pauli95 ($8.25 in chips) 
Seat 3: Hyd SK ($12.16 in chips) 
Seat 4: dittoro ($10.49 in chips) 
Seat 5: MihaGr ($10 in chips) 
Seat 6: 8th wonders ($10 in chips) 
MihaGr: posts small blind $0.05
8th wonders: posts big blind $0.10
*** HOLE CARDS ***
Peter0087: raises $0.10 to $0.20
pauli95: calls $0.20
Hyd SK: folds 
dittoro: folds 
MihaGr: folds 
8th wonders: folds 
*** FLOP *** [9d 9c Jd]
Peter0087: bets $0.30
pauli95: folds 
Uncalled bet ($0.30) returned to Peter0087
Peter0087 collected $0.53 from pot
*** SUMMARY ***
Total pot $0.55 | Rake $0.02 
Board [9d 9c Jd]
Seat 1: Peter0087 collected ($0.53)
Seat 2: pauli95 folded on the Flop
Seat 3: Hyd SK folded before Flop (didn't bet)
Seat 4: dittoro (button) folded before Flop (didn't bet)
Seat 5: MihaGr (small blind) folded before Flop
Seat 6: 8th wonders (big blind) folded before Flop



PokerStars Hand #166667540164:  Hold'em No Limit ($0.05/$0.10 USD) - 2017/02/23 16:03:01 ET
Table 'Lampetia III' 6-max Seat #6 is the button
Seat 1: gaHy_HaXeP ($10.20 in chips) 
Seat 2: DamDatsAnAce ($10.10 in chips) 
Seat 3: Therodorus ($10 in chips) 
Seat 4: IAntikI ($11.36 in chips) 
Seat 5: robson1235 ($19.55 in chips) 
Seat 6: bdixon_5 ($9.35 in chips) 
gaHy_HaXeP: posts small blind $0.05
DamDatsAnAce: posts big blind $0.10
*** HOLE CARDS ***
Therodorus: folds 
IAntikI: folds 
robson1235: folds 
bdixon_5: folds 
gaHy_HaXeP: raises $0.20 to $0.30
DamDatsAnAce: folds 
Uncalled bet ($0.20) returned to gaHy_HaXeP
gaHy_HaXeP collected $0.20 from pot
*** SUMMARY ***
Total pot $0.20 | Rake $0 
Seat 1: gaHy_HaXeP (small blind) collected ($0.20)
Seat 2: DamDatsAnAce (big blind) folded before Flop
Seat 3: Therodorus folded before Flop (didn't bet)
Seat 4: IAntikI folded before Flop (didn't bet)
Seat 5: robson1235 folded before Flop (didn't bet)
Seat 6: bdixon_5 (button) folded before Flop (didn't bet)



PokerStars Hand #166667540557:  Hold'em No Limit ($0.05/$0.10 USD) - 2017/02/23 16:03:01 ET
Table 'Antinous' 6-max Seat #5 is the button
Seat 1: Andrei ProFF ($15.94 in chips) 
Seat 2: Nr847 ($10.61 in chips) 
Seat 3: dittoro ($10 in chips) 
Seat 4: Pekaml ($15.42 in chips) 
Seat 5: Covetsoles ($6.60 in chips) 
Seat 6: coolisses111 ($10.25 in chips) 
coolisses111: posts small blind $0.05
Andrei ProFF: posts big blind $0.10
*** HOLE CARDS ***
Nr847: folds 
dittoro: folds 
Pekaml: folds 
Covetsoles: calls $0.10
coolisses111: folds 
Andrei ProFF: checks 
*** FLOP *** [Qs Qh 9h]
Andrei ProFF: checks 
Covetsoles: checks 
*** TURN *** [Qs Qh 9h] [Tc]
Andrei ProFF: bets $0.30
Covetsoles: folds 
Uncalled bet ($0.30) returned to Andrei ProFF
Andrei ProFF collected $0.24 from pot
*** SUMMARY ***
Total pot $0.25 | Rake $0.01 
Board [Qs Qh 9h Tc]
Seat 1: Andrei ProFF (big blind) collected ($0.24)
Seat 2: Nr847 folded before Flop (didn't bet)
Seat 3: dittoro folded before Flop (didn't bet)
Seat 4: Pekaml folded before Flop (didn't bet)
Seat 5: Covetsoles (button) folded on the Turn
Seat 6: coolisses111 (small blind) folded before Flop



PokerStars Hand #166667540663:  Hold'em No Limit ($0.05/$0.10 USD) - 2017/02/23 16:03:02 ET
Table 'Alzirr II' 6-max Seat #1 is the button
Seat 1: KA3AXCTAHEU, ($10.86 in chips) 
Seat 2: popypaleta ($10 in chips) 
Seat 3: Lucky HoBBiT ($14.41 in chips) 
Seat 4: Scanner17 ($17.69 in chips) 
popypaleta: posts small blind $0.05
Lucky HoBBiT: posts big blind $0.10
yodzik: sits out 
AM-L-SL: sits out 
*** HOLE CARDS ***
Scanner17: folds 
KA3AXCTAHEU,: raises $0.15 to $0.25
popypaleta: calls $0.20
Lucky HoBBiT: folds 
*** FLOP *** [8h Jc 8c]
Lucky HoBBiT leaves the table
popypaleta: bets $0.40
KA3AXCTAHEU,: folds 
Uncalled bet ($0.40) returned to popypaleta
popypaleta collected $0.57 from pot
*** SUMMARY ***
Total pot $0.60 | Rake $0.03 
Board [8h Jc 8c]
Seat 1: KA3AXCTAHEU, (button) folded on the Flop
Seat 2: popypaleta (small blind) collected ($0.57)
Seat 3: Lucky HoBBiT (big blind) folded before Flop
Seat 4: Scanner17 folded before Flop (didn't bet)



PokerStars Hand #166667540724:  Hold'em No Limit ($0.05/$0.10 USD) - 2017/02/23 16:03:02 ET
Table 'Pallas II' 6-max Seat #5 is the button
Seat 1: mdelfin0 ($15.78 in chips) 
Seat 2: FRAID358 ($9.95 in chips) 
Seat 4: Mr. Bluff 34 ($11.12 in chips) 
Seat 5: Yspenyanin ($19.71 in chips) 
mdelfin0: posts small blind $0.05
FRAID358: posts big blind $0.10
KRZuff: sits out 
*** HOLE CARDS ***
Mr. Bluff 34: calls $0.10
Yspenyanin: folds 
xdjango07x leaves the table
mdelfin0: folds 
FRAID358: checks 
*** FLOP *** [3d 7d 4s]
Mr. Bluff 34 said, "last round"
Sbozzz joins the table at seat #6 
FRAID358: checks 
Mr. Bluff 34: bets $0.20
FRAID358: calls $0.20
*** TURN *** [3d 7d 4s] [8h]
Sbozzz leaves the table
FRAID358: checks 
Orlangoor joins the table at seat #6 
Mr. Bluff 34: bets $0.30
FRAID358: calls $0.30
*** RIVER *** [3d 7d 4s 8h] [Td]
FRAID358: checks 
Mr. Bluff 34: bets $0.70
FRAID358: folds 
Uncalled bet ($0.70) returned to Mr. Bluff 34
Mr. Bluff 34 collected $1.19 from pot
*** SUMMARY ***
Total pot $1.25 | Rake $0.06 
Board [3d 7d 4s 8h Td]
Seat 1: mdelfin0 (small blind) folded before Flop
Seat 2: FRAID358 (big blind) folded on the River
Seat 4: Mr. Bluff 34 collected ($1.19)
Seat 5: Yspenyanin (button) folded before Flop (didn't bet)



PokerStars Hand #166667541435:  Hold'em No Limit ($0.05/$0.10 USD) - 2017/02/23 16:03:02 ET
Table 'Krethon' 6-max Seat #2 is the button
Seat 1: boxer821 ($10.25 in chips) 
Seat 2: manashov ($10.80 in chips) 
Seat 4: chimera252 ($15.58 in chips) 
Seat 5: popypaleta ($10.15 in chips) 
6ePeMeHHa9 will be allowed to play after the button
chimera252: posts small blind $0.05
popypaleta: posts big blind $0.10
*** HOLE CARDS ***
6ePeMeHHa9 leaves the table
boxer821: folds 
manashov: raises $0.10 to $0.20
chimera252: folds 
popypaleta: raises $0.45 to $0.65
D3NyA joins the table at seat #3 
manashov: raises $0.85 to $1.50
popypaleta: calls $0.85
*** FLOP *** [7s 7c Ts]
popypaleta: checks 
manashov: bets $1.16
popypaleta: folds 
Uncalled bet ($1.16) returned to manashov
manashov collected $2.91 from pot
*** SUMMARY ***
Total pot $3.05 | Rake $0.14 
Board [7s 7c Ts]
Seat 1: boxer821 folded before Flop (didn't bet)
Seat 2: manashov (button) collected ($2.91)
Seat 4: chimera252 (small blind) folded before Flop
Seat 5: popypaleta (big blind) folded on the Flop



PokerStars Hand #166667541594:  Hold'em No Limit ($0.05/$0.10 USD) - 2017/02/23 16:03:03 ET
Table 'Tyche III' 6-max Seat #1 is the button
Seat 1: milt65 ($10.16 in chips) 
Seat 3: ChuikaPridi ($9.84 in chips) 
Seat 4: Kazacha ($10 in chips) 
Seat 5: chimera252 ($11.75 in chips) 
Seat 6: Ice_Isayev ($10.15 in chips) 
ChuikaPridi: posts small blind $0.05
Kazacha: posts big blind $0.10
*** HOLE CARDS ***
chimera252: folds 
Ice_Isayev: folds 
milt65: folds 
ChuikaPridi: raises $0.20 to $0.30
Kazacha: calls $0.20
*** FLOP *** [2c Jh 9c]
ChuikaPridi: bets $0.35
Kazacha: folds 
Uncalled bet ($0.35) returned to ChuikaPridi
ChuikaPridi collected $0.57 from pot
*** SUMMARY ***
Total pot $0.60 | Rake $0.03 
Board [2c Jh 9c]
Seat 1: milt65 (button) folded before Flop (didn't bet)
Seat 3: ChuikaPridi (small blind) collected ($0.57)
Seat 4: Kazacha (big blind) folded on the Flop
Seat 5: chimera252 folded before Flop (didn't bet)
Seat 6: Ice_Isayev folded before Flop (didn't bet)



PokerStars Hand #166667541766:  Hold'em No Limit ($0.05/$0.10 USD) - 2017/02/23 16:03:03 ET
Table 'Lesath III' 6-max Seat #5 is the button
Seat 1: Gogeta26 ($6.57 in chips) 
Seat 2: WinninBikini ($10.18 in chips) 
Seat 3: Giyorod ($10 in chips) 
Seat 4: Eddys Edge ($10 in chips) 
Seat 5: eniksenik ($16 in chips) 
Seat 6: patrick19111 ($10.61 in chips) 
patrick19111: posts small blind $0.05
Gogeta26: posts big blind $0.10
*** HOLE CARDS ***
WinninBikini: folds 
Giyorod: folds 
Eddys Edge: folds 
eniksenik: raises $0.20 to $0.30
patrick19111: folds 
Gogeta26: folds 
Uncalled bet ($0.20) returned to eniksenik
eniksenik collected $0.25 from pot
*** SUMMARY ***
Total pot $0.25 | Rake $0 
Seat 1: Gogeta26 (big blind) folded before Flop
Seat 2: WinninBikini folded before Flop (didn't bet)
Seat 3: Giyorod folded before Flop (didn't bet)
Seat 4: Eddys Edge folded before Flop (didn't bet)
Seat 5: eniksenik (button) collected ($0.25)
Seat 6: patrick19111 (small blind) folded before Flop



PokerStars Hand #166667541878:  Hold'em No Limit ($0.05/$0.10 USD) - 2017/02/23 16:03:03 ET
Table 'Nemo III' 6-max Seat #5 is the button
Seat 2: Bandyaev ($11.89 in chips) 
Seat 3: Therodorus ($10 in chips) 
Seat 4: vtalian ($9.70 in chips) 
Seat 5: Joker51_wtf! ($11.43 in chips) 
Bandyaev: posts small blind $0.05
Therodorus: posts big blind $0.10
*** HOLE CARDS ***
vtalian: folds 
Joker51_wtf!: raises $0.12 to $0.22
Bandyaev: folds 
Therodorus: folds 
Uncalled bet ($0.12) returned to Joker51_wtf!
SALAMIS85 leaves the table
Joker51_wtf! collected $0.25 from pot
*** SUMMARY ***
Total pot $0.25 | Rake $0 
Seat 2: Bandyaev (small blind) folded before Flop
Seat 3: Therodorus (big blind) folded before Flop
Seat 4: vtalian folded before Flop (didn't bet)
Seat 5: Joker51_wtf! (button) collected ($0.25)



PokerStars Hand #166667541904:  Hold'em No Limit ($0.05/$0.10 USD) - 2017/02/23 16:03:03 ET
Table 'Thia' 6-max Seat #4 is the button
Seat 1: Eddys Edge ($10 in chips) 
Seat 2: sugrob86 ($20.10 in chips) 
Seat 3: northug18 ($9.17 in chips) 
Seat 4: Bandyaev ($10 in chips) 
Seat 5: ab260414 ($10.62 in chips) 
Seat 6: ex3Lero86 ($15.60 in chips) 
ab260414: posts small blind $0.05
ex3Lero86: posts big blind $0.10
*** HOLE CARDS ***
Eddys Edge: folds 
sugrob86: calls $0.10
northug18: calls $0.10
Bandyaev: raises $0.40 to $0.50
ab260414: folds 
ex3Lero86: folds 
sugrob86: folds 
northug18: folds 
Uncalled bet ($0.40) returned to Bandyaev
Bandyaev collected $0.45 from pot
*** SUMMARY ***
Total pot $0.45 | Rake $0 
Seat 1: Eddys Edge folded before Flop (didn't bet)
Seat 2: sugrob86 folded before Flop
Seat 3: northug18 folded before Flop
Seat 4: Bandyaev (button) collected ($0.45)
Seat 5: ab260414 (small blind) folded before Flop
Seat 6: ex3Lero86 (big blind) folded before Flop



PokerStars Hand #166667542041:  Hold'em No Limit ($0.05/$0.10 USD) - 2017/02/23 16:03:03 ET
Table 'Carina' 6-max Seat #4 is the button
Seat 2: kickereens ($24.24 in chips) 
Seat 3: LarryTheStar ($10.10 in chips) 
Seat 4: crazydevill ($10 in chips) 
Seat 5: IAntikI ($10.05 in chips) 
Seat 6: alexweezer ($9.95 in chips) 
IAntikI: posts small blind $0.05
alexweezer: posts big blind $0.10
Kupi007: sits out 
*** HOLE CARDS ***
kickereens: raises $0.20 to $0.30
LarryTheStar: folds 
crazydevill: folds 
IAntikI: folds 
alexweezer: folds 
Uncalled bet ($0.20) returned to kickereens
kickereens collected $0.25 from pot
*** SUMMARY ***
Total pot $0.25 | Rake $0 
Seat 2: kickereens collected ($0.25)
Seat 3: LarryTheStar folded before Flop (didn't bet)
Seat 4: crazydevill (button) folded before Flop (didn't bet)
Seat 5: IAntikI (small blind) folded before Flop
Seat 6: alexweezer (big blind) folded before Flop



PokerStars Hand #166667542110:  Hold'em No Limit ($0.05/$0.10 USD) - 2017/02/23 16:03:03 ET
Table 'Scabiosa III' 6-max Seat #5 is the button
Seat 1: Feverhead ($13.41 in chips) 
Seat 3: Goroshkos88 ($11.40 in chips) 
Seat 4: voledy ($10.10 in chips) 
Seat 5: patrick19111 ($24.60 in chips) 
Seat 6: Smitty03300 ($10.81 in chips) 
Smitty03300: posts small blind $0.05
Feverhead: posts big blind $0.10
*** HOLE CARDS ***
Goroshkos88: folds 
yodzik joins the table at seat #2 
voledy: folds 
patrick19111: raises $0.15 to $0.25
Smitty03300: raises $0.65 to $0.90
Feverhead: folds 
patrick19111: raises $1.70 to $2.60
Smitty03300: folds 
Uncalled bet ($1.70) returned to patrick19111
patrick19111 collected $1.90 from pot
*** SUMMARY ***
Total pot $1.90 | Rake $0 
Seat 1: Feverhead (big blind) folded before Flop
Seat 3: Goroshkos88 folded before Flop (didn't bet)
Seat 4: voledy folded before Flop (didn't bet)
Seat 5: patrick19111 (button) collected ($1.90)
Seat 6: Smitty03300 (small blind) folded before Flop



PokerStars Hand #166667542160:  Hold'em No Limit ($0.05/$0.10 USD) - 2017/02/23 16:03:03 ET
Table 'Hirons' 6-max Seat #2 is the button
Seat 1: RoJ1 ($11.68 in chips) 
Seat 2: coolisses111 ($7.79 in chips) 
Seat 3: czeczen7 ($13.98 in chips) 
Seat 4: Smitty03300 ($10 in chips) 
Seat 5: Pekaml ($10 in chips) 
Seat 6: garigura ($14.61 in chips) 
czeczen7: posts small blind $0.05
Smitty03300: posts big blind $0.10
*** HOLE CARDS ***
Pekaml: folds 
garigura: raises $0.20 to $0.30
RoJ1: folds 
coolisses111: folds 
czeczen7: calls $0.25
Smitty03300: folds 
*** FLOP *** [5s Jh 7c]
czeczen7: checks 
garigura: bets $0.34
czeczen7: folds 
Uncalled bet ($0.34) returned to garigura
garigura collected $0.67 from pot
*** SUMMARY ***
Total pot $0.70 | Rake $0.03 
Board [5s Jh 7c]
Seat 1: RoJ1 folded before Flop (didn't bet)
Seat 2: coolisses111 (button) folded before Flop (didn't bet)
Seat 3: czeczen7 (small blind) folded on the Flop
Seat 4: Smitty03300 (big blind) folded before Flop
Seat 5: Pekaml folded before Flop (didn't bet)
Seat 6: garigura collected ($0.67)



PokerStars Hand #166667542238:  Hold'em No Limit ($0.05/$0.10 USD) - 2017/02/23 16:03:03 ET
Table 'Luanda' 6-max Seat #5 is the button
Seat 1: AM-L-SL ($5 in chips) 
Seat 2: Xander188 ($10 in chips) 
Seat 3: DamDatsAnAce ($10 in chips) 
Seat 5: st4tion ($12.63 in chips) 
Seat 6: KA3AXCTAHEU, ($11.31 in chips) 
KA3AXCTAHEU,: posts small blind $0.05
AM-L-SL: posts big blind $0.10
*** HOLE CARDS ***
Xander188: folds 
DamDatsAnAce: raises $0.20 to $0.30
st4tion: folds 
KA3AXCTAHEU,: folds 
AM-L-SL: folds 
Uncalled bet ($0.20) returned to DamDatsAnAce
DamDatsAnAce collected $0.25 from pot
*** SUMMARY ***
Total pot $0.25 | Rake $0 
Seat 1: AM-L-SL (big blind) folded before Flop
Seat 2: Xander188 folded before Flop (didn't bet)
Seat 3: DamDatsAnAce collected ($0.25)
Seat 5: st4tion (button) folded before Flop (didn't bet)
Seat 6: KA3AXCTAHEU, (small blind) folded before Flop



PokerStars Hand #166667542748:  Hold'em No Limit ($0.05/$0.10 USD) - 2017/02/23 16:03:04 ET
Table 'Kochera' 6-max Seat #4 is the button
Seat 1: chimera252 ($11.65 in chips) 
Seat 2: bartabs2 ($10.61 in chips) 
Seat 3: KA3AXCTAHEU, ($10.10 in chips) 
Seat 4: johkom ($5.46 in chips) 
Seat 5: univibe68 ($11.90 in chips) 
Seat 6: oddshoff ($9.48 in chips) 
univibe68: posts small blind $0.05
oddshoff: posts big blind $0.10
*** HOLE CARDS ***
chimera252: folds 
bartabs2: folds 
KA3AXCTAHEU,: raises $0.15 to $0.25
johkom: folds 
univibe68: folds 
oddshoff: folds 
Uncalled bet ($0.15) returned to KA3AXCTAHEU,
KA3AXCTAHEU, collected $0.25 from pot
*** SUMMARY ***
Total pot $0.25 | Rake $0 
Seat 1: chimera252 folded before Flop (didn't bet)
Seat 2: bartabs2 folded before Flop (didn't bet)
Seat 3: KA3AXCTAHEU, collected ($0.25)
Seat 4: johkom (button) folded before Flop (didn't bet)
Seat 5: univibe68 (small blind) folded before Flop
Seat 6: oddshoff (big blind) folded before Flop



PokerStars Hand #166667542911:  Hold'em No Limit ($0.05/$0.10 USD) - 2017/02/23 16:03:04 ET
Table 'Armenia' 6-max Seat #6 is the button
Seat 1: tr41n3r12 ($12.07 in chips) 
Seat 2: Yabidooo ($11.87 in chips) 
Seat 4: x3ultimate ($10.15 in chips) 
Seat 5: boxer821 ($12.10 in chips) 
Seat 6: mega spasser ($5.07 in chips) 
tr41n3r12: posts small blind $0.05
Yabidooo: posts big blind $0.10
XwinX25: sits out 
*** HOLE CARDS ***
x3ultimate: raises $0.20 to $0.30
boxer821: folds 
mega spasser: calls $0.30
tr41n3r12: folds 
Yabidooo: folds 
*** FLOP *** [Th 7c Kh]
x3ultimate: bets $0.50
mega spasser: raises $1.20 to $1.70
x3ultimate: folds 
Uncalled bet ($1.20) returned to mega spasser
mega spasser collected $1.67 from pot
*** SUMMARY ***
Total pot $1.75 | Rake $0.08 
Board [Th 7c Kh]
Seat 1: tr41n3r12 (small blind) folded before Flop
Seat 2: Yabidooo (big blind) folded before Flop
Seat 4: x3ultimate folded on the Flop
Seat 5: boxer821 folded before Flop (didn't bet)
Seat 6: mega spasser (button) collected ($1.67)



PokerStars Hand #166667542998:  Hold'em No Limit ($0.05/$0.10 USD) - 2017/02/23 16:03:04 ET
Table 'Markab II' 6-max Seat #6 is the button
Seat 1: david_sara83 ($10.07 in chips) 
Seat 2: truck1234 ($11.05 in chips) 
Seat 3: sexy_seagull ($10.15 in chips) 
Seat 4: Crafty23@PS ($11.69 in chips) 
Seat 5: Rodik002 ($19.17 in chips) 
Seat 6: Comeback3392 ($10.49 in chips) 
david_sara83: posts small blind $0.05
truck1234: posts big blind $0.10
*** HOLE CARDS ***
sexy_seagull: folds 
Crafty23@PS: folds 
Rodik002: folds 
Comeback3392: raises $0.15 to $0.25
david_sara83: calls $0.20
truck1234: folds 
*** FLOP *** [4c Qh 7s]
david_sara83: checks 
Comeback3392: bets $0.30
david_sara83: calls $0.30
*** TURN *** [4c Qh 7s] [2h]
david_sara83: checks 
Comeback3392: checks 
*** RIVER *** [4c Qh 7s 2h] [2s]
david_sara83: bets $0.81
Comeback3392: folds 
Uncalled bet ($0.81) returned to david_sara83
david_sara83 collected $1.15 from pot
*** SUMMARY ***
Total pot $1.20 | Rake $0.05 
Board [4c Qh 7s 2h 2s]
Seat 1: david_sara83 (small blind) collected ($1.15)
Seat 2: truck1234 (big blind) folded before Flop
Seat 3: sexy_seagull folded before Flop (didn't bet)
Seat 4: Crafty23@PS folded before Flop (didn't bet)
Seat 5: Rodik002 folded before Flop (didn't bet)
Seat 6: Comeback3392 (button) folded on the River



PokerStars Hand #166667543230:  Hold'em No Limit ($0.05/$0.10 USD) - 2017/02/23 16:03:04 ET
Table 'Unitas II' 6-max Seat #4 is the button
Seat 1: Peter0087 ($10 in chips) 
Seat 2: dragonste89 ($11.06 in chips) 
Seat 3: CallByValue ($9.85 in chips) 
Seat 4: truck1234 ($10.99 in chips) 
Seat 5: chimera252 ($25.66 in chips) 
Seat 6: paxit71 ($8 in chips) 
chimera252: posts small blind $0.05
paxit71: posts big blind $0.10
*** HOLE CARDS ***
Peter0087: folds 
dragonste89: raises $0.20 to $0.30
CallByValue: folds 
truck1234: folds 
chimera252: folds 
paxit71: calls $0.20
*** FLOP *** [2h 6s 2d]
paxit71: bets $0.40
dragonste89: folds 
Uncalled bet ($0.40) returned to paxit71
paxit71 collected $0.62 from pot
*** SUMMARY ***
Total pot $0.65 | Rake $0.03 
Board [2h 6s 2d]
Seat 1: Peter0087 folded before Flop (didn't bet)
Seat 2: dragonste89 folded on the Flop
Seat 3: CallByValue folded before Flop (didn't bet)
Seat 4: truck1234 (button) folded before Flop (didn't bet)
Seat 5: chimera252 (small blind) folded before Flop
Seat 6: paxit71 (big blind) collected ($0.62)



PokerStars Hand #166667543385:  Hold'em No Limit ($0.05/$0.10 USD) - 2017/02/23 16:03:05 ET
Table 'Kobresia II' 6-max Seat #4 is the button
Seat 1: RoJ1 ($13.96 in chips) 
Seat 2: Dcaro31 ($13.44 in chips) 
Seat 3: FRAID358 ($10.84 in chips) 
Seat 4: armstv ($10.87 in chips) 
Seat 5: Goroshkos88 ($11.94 in chips) 
Seat 6: WinninBikini ($10 in chips) 
Goroshkos88: posts small blind $0.05
WinninBikini: posts big blind $0.10
*** HOLE CARDS ***
RoJ1: folds 
Dcaro31: folds 
FRAID358: folds 
armstv has timed out
armstv: folds 
Goroshkos88: raises $0.15 to $0.25
WinninBikini: folds 
Uncalled bet ($0.15) returned to Goroshkos88
Goroshkos88 collected $0.20 from pot
*** SUMMARY ***
Total pot $0.20 | Rake $0 
Seat 1: RoJ1 folded before Flop (didn't bet)
Seat 2: Dcaro31 folded before Flop (didn't bet)
Seat 3: FRAID358 folded before Flop (didn't bet)
Seat 4: armstv (button) folded before Flop (didn't bet)
Seat 5: Goroshkos88 (small blind) collected ($0.20)
Seat 6: WinninBikini (big blind) folded before Flop



PokerStars Hand #166667543406:  Hold'em No Limit ($0.05/$0.10 USD) - 2017/02/23 16:03:05 ET
Table 'Syringa' 6-max Seat #2 is the button
Seat 1: bdixon_5 ($7.95 in chips) 
Seat 2: Goroshkos88 ($10.41 in chips) 
Seat 3: Yspenyanin ($13.42 in chips) 
Seat 4: tangler19 ($14.58 in chips) 
Seat 5: Andrei ProFF ($13.31 in chips) 
Seat 6: ibara000 ($16.43 in chips) 
Yspenyanin: posts small blind $0.05
tangler19: posts big blind $0.10
*** HOLE CARDS ***
Andrei ProFF: folds 
ibara000: folds 
bdixon_5: folds 
Goroshkos88: raises $0.15 to $0.25
Yspenyanin: folds 
tangler19: folds 
Uncalled bet ($0.15) returned to Goroshkos88
Goroshkos88 collected $0.25 from pot
*** SUMMARY ***
Total pot $0.25 | Rake $0 
Seat 1: bdixon_5 folded before Flop (didn't bet)
Seat 2: Goroshkos88 (button) collected ($0.25)
Seat 3: Yspenyanin (small blind) folded before Flop
Seat 4: tangler19 (big blind) folded before Flop
Seat 5: Andrei ProFF folded before Flop (didn't bet)
Seat 6: ibara000 folded before Flop (didn't bet)



PokerStars Hand #166667543422:  Hold'em No Limit ($0.05/$0.10 USD) - 2017/02/23 16:03:05 ET
Table 'Aconcagua' 6-max Seat #5 is the button
Seat 3: burtila1989 ($10 in chips) 
Seat 4: pivanki11 ($9.44 in chips) 
Seat 5: frazaunch ($7.20 in chips) 
Seat 6: coolisses111 ($8.87 in chips) 
coolisses111: posts small blind $0.05
burtila1989: posts big blind $0.10
burtila1989: posts the ante $0.02
pivanki11: posts the ante $0.02
frazaunch: posts the ante $0.02
coolisses111: posts the ante $0.02
*** HOLE CARDS ***
pivanki11: folds 
frazaunch: calls $0.10
coolisses111: folds 
burtila1989: raises $0.10 to $0.20
frazaunch: calls $0.10
*** FLOP *** [Th Ac 5s]
burtila1989: checks 
frazaunch: checks 
*** TURN *** [Th Ac 5s] [Qs]
burtila1989: checks 
frazaunch: checks 
*** RIVER *** [Th Ac 5s Qs] [2h]
burtila1989: bets $0.20
frazaunch: folds 
Uncalled bet ($0.20) returned to burtila1989
burtila1989 collected $0.51 from pot
*** SUMMARY ***
Total pot $0.53 | Rake $0.02 
Board [Th Ac 5s Qs 2h]
Seat 3: burtila1989 (big blind) collected ($0.51)
Seat 4: pivanki11 folded before Flop (didn't bet)
Seat 5: frazaunch (button) folded on the River
Seat 6: coolisses111 (small blind) folded before Flop



PokerStars Hand #166667543470:  Hold'em No Limit ($0.05/$0.10 USD) - 2017/02/23 16:03:05 ET
Table 'Samitchell III' 6-max Seat #4 is the button
Seat 1: dr.goofy ($10.27 in chips) 
Seat 2: Orlangoor ($10 in chips) 
Seat 3: Kow6oy ($10 in chips) 
Seat 4: eniksenik ($10.62 in chips) 
Seat 6: fedorka rus ($13.01 in chips) 
JahSoldier69 will be allowed to play after the button
fedorka rus: posts small blind $0.05
dr.goofy: posts big blind $0.10
*** HOLE CARDS ***
Orlangoor: folds 
JahSoldier69 leaves the table
Kow6oy: raises $0.20 to $0.30
eniksenik: folds 
fedorka rus: folds 
dr.goofy: folds 
Uncalled bet ($0.20) returned to Kow6oy
Kow6oy collected $0.25 from pot
*** SUMMARY ***
Total pot $0.25 | Rake $0 
Seat 1: dr.goofy (big blind) folded before Flop
Seat 2: Orlangoor folded before Flop (didn't bet)
Seat 3: Kow6oy collected ($0.25)
Seat 4: eniksenik (button) folded before Flop (didn't bet)
Seat 6: fedorka rus (small blind) folded before Flop



PokerStars Hand #166667543558:  Hold'em No Limit ($0.05/$0.10 USD) - 2017/02/23 16:03:05 ET
Table 'Wilkens II' 6-max Seat #1 is the button
Seat 1: Islamiq-GuRL ($12.15 in chips) 
Seat 2: manashov ($10.35 in chips) 
Seat 3: Namhkal ($10.80 in chips) 
Seat 5: patrick19111 ($10 in chips) 
Seat 6: XaXaTyH4uK ($14.76 in chips) 
manashov: posts small blind $0.05
Namhkal: posts big blind $0.10
*** HOLE CARDS ***
patrick19111: folds 
XaXaTyH4uK: raises $0.20 to $0.30
Islamiq-GuRL: folds 
manashov: raises $0.90 to $1.20
Namhkal: folds 
XaXaTyH4uK: folds 
Uncalled bet ($0.90) returned to manashov
manashov collected $0.70 from pot
*** SUMMARY ***
Total pot $0.70 | Rake $0 
Seat 1: Islamiq-GuRL (button) folded before Flop (didn't bet)
Seat 2: manashov (small blind) collected ($0.70)
Seat 3: Namhkal (big blind) folded before Flop
Seat 5: patrick19111 folded before Flop (didn't bet)
Seat 6: XaXaTyH4uK folded before Flop



PokerStars Hand #166667543583:  Hold'em No Limit ($0.05/$0.10 USD) - 2017/02/23 16:03:05 ET
Table 'Walpurga' 6-max Seat #3 is the button
Seat 1: chimera252 ($12.22 in chips) 
Seat 2: paxit71 ($6.84 in chips) 
Seat 3: Innerwuss ($19.28 in chips) 
Seat 4: oddshoff ($12.84 in chips) 
Seat 6: AIONCMA1988 ($4.36 in chips) 
oddshoff: posts small blind $0.05
AIONCMA1988: posts big blind $0.10
*** HOLE CARDS ***
chimera252: folds 
paxit71: folds 
Innerwuss: raises $0.10 to $0.20
oddshoff: folds 
AIONCMA1988: folds 
Uncalled bet ($0.10) returned to Innerwuss
Innerwuss collected $0.25 from pot
*** SUMMARY ***
Total pot $0.25 | Rake $0 
Seat 1: chimera252 folded before Flop (didn't bet)
Seat 2: paxit71 folded before Flop (didn't bet)
Seat 3: Innerwuss (button) collected ($0.25)
Seat 4: oddshoff (small blind) folded before Flop
Seat 6: AIONCMA1988 (big blind) folded before Flop



PokerStars Hand #166667543640:  Hold'em No Limit ($0.05/$0.10 USD) - 2017/02/23 16:03:05 ET
Table 'Tyndareus III' 6-max Seat #2 is the button
Seat 1: MBen10 ($10 in chips) 
Seat 2: MihaGr ($10 in chips) 
Seat 4: Therodorus ($11.51 in chips) 
Seat 6: Elinaattor ($9.80 in chips) 
steepfell will be allowed to play after the button
Therodorus: posts small blind $0.05
Chodemuncher: is sitting out 
Elinaattor: posts big blind $0.10
*** HOLE CARDS ***
Chodemuncher leaves the table
MBen10: folds 
yodzik joins the table at seat #5 
MihaGr: raises $0.20 to $0.30
Therodorus: folds 
Elinaattor: calls $0.20
*** FLOP *** [Kd Ac Ah]
Elinaattor: checks 
MihaGr: bets $0.25
Elinaattor: calls $0.25
*** TURN *** [Kd Ac Ah] [Ks]
Elinaattor: checks 
MihaGr: checks 
*** RIVER *** [Kd Ac Ah Ks] [3h]
Elinaattor: bets $0.44
MihaGr: folds 
Uncalled bet ($0.44) returned to Elinaattor
Elinaattor collected $1.10 from pot
*** SUMMARY ***
Total pot $1.15 | Rake $0.05 
Board [Kd Ac Ah Ks 3h]
Seat 1: MBen10 folded before Flop (didn't bet)
Seat 2: MihaGr (button) folded on the River
Seat 4: Therodorus (small blind) folded before Flop
Seat 6: Elinaattor (big blind) collected ($1.10)



PokerStars Hand #166667543771:  Hold'em No Limit ($0.05/$0.10 USD) - 2017/02/23 16:03:05 ET
Table 'Clavel' 6-max Seat #5 is the button
Seat 1: KRZuff ($14.12 in chips) 
Seat 2: RoJ1 ($12.37 in chips) 
Seat 4: Dcaro31 ($11.81 in chips) 
Seat 5: Vrinni ($10.39 in chips) 
Seat 6: Gra_anD77 ($4.61 in chips) 
Gra_anD77: posts small blind $0.05
KRZuff: posts big blind $0.10
*** HOLE CARDS ***
RoJ1: raises $0.12 to $0.22
Dcaro31: folds 
Vrinni: folds 
Gra_anD77: calls $0.17
KRZuff: raises $1.13 to $1.35
RoJ1: folds 
Gra_anD77: folds 
Uncalled bet ($1.13) returned to KRZuff
KRZuff collected $0.66 from pot
*** SUMMARY ***
Total pot $0.66 | Rake $0 
Seat 1: KRZuff (big blind) collected ($0.66)
Seat 2: RoJ1 folded before Flop
Seat 4: Dcaro31 folded before Flop (didn't bet)
Seat 5: Vrinni (button) folded before Flop (didn't bet)
Seat 6: Gra_anD77 (small blind) folded before Flop



PokerStars Hand #166667543819:  Hold'em No Limit ($0.05/$0.10 USD) - 2017/02/23 16:03:05 ET
Table 'Kanda' 6-max Seat #1 is the button
Seat 1: Andy Wolf ($10.41 in chips) 
Seat 2: Pelotín ($5.35 in chips) 
Seat 3: joewatson90 ($12.59 in chips) 
Seat 4: Orlangoor ($10.71 in chips) 
Seat 5: Temniy Elf ($10.15 in chips) 
Seat 6: oddshoff ($8.81 in chips) 
Pelotín: posts small blind $0.05
joewatson90: posts big blind $0.10
*** HOLE CARDS ***
Orlangoor: raises $0.15 to $0.25
Temniy Elf: folds 
oddshoff: folds 
Andy Wolf: calls $0.25
Pelotín: folds 
joewatson90: folds 
*** FLOP *** [Qd 9h 5c]
joewatson90 leaves the table
XaXaTyH4uK joins the table at seat #3 
Temniy Elf leaves the table
Dimka4 joins the table at seat #5 
Orlangoor: bets $0.37
Andy Wolf: calls $0.37
*** TURN *** [Qd 9h 5c] [Qs]
Orlangoor: checks 
Andy Wolf: bets $0.80
Orlangoor: folds 
Uncalled bet ($0.80) returned to Andy Wolf
Andy Wolf collected $1.33 from pot
*** SUMMARY ***
Total pot $1.39 | Rake $0.06 
Board [Qd 9h 5c Qs]
Seat 1: Andy Wolf (button) collected ($1.33)
Seat 2: Pelotín (small blind) folded before Flop
Seat 3: joewatson90 (big blind) folded before Flop
Seat 4: Orlangoor folded on the Turn
Seat 5: Temniy Elf folded before Flop (didn't bet)
Seat 6: oddshoff folded before Flop (didn't bet)



PokerStars Hand #166667543931:  Hold'em No Limit ($0.05/$0.10 USD) - 2017/02/23 16:03:05 ET
Table 'Cassini' 6-max Seat #6 is the button
Seat 1: Pokeaster ($10.20 in chips) 
Seat 2: mhonielsen ($13.09 in chips) 
Seat 4: fortieth ($13.72 in chips) 
Seat 5: johkom ($7.75 in chips) 
Seat 6: JahSoldier69 ($10 in chips) 
Pokeaster: posts small blind $0.05
mhonielsen: posts big blind $0.10
*** HOLE CARDS ***
fortieth: folds 
johkom: folds 
JahSoldier69: folds 
Pokeaster: folds 
Uncalled bet ($0.05) returned to mhonielsen
mhonielsen collected $0.10 from pot
*** SUMMARY ***
Total pot $0.10 | Rake $0 
Seat 1: Pokeaster (small blind) folded before Flop
Seat 2: mhonielsen (big blind) collected ($0.10)
Seat 4: fortieth folded before Flop (didn't bet)
Seat 5: johkom folded before Flop (didn't bet)
Seat 6: JahSoldier69 (button) folded before Flop (didn't bet)



PokerStars Hand #166667543976:  Hold'em No Limit ($0.05/$0.10 USD) - 2017/02/23 16:03:05 ET
Table 'Risha II' 6-max Seat #4 is the button
Seat 1: R. Lemonte ($10.63 in chips) 
Seat 2: KA3AXCTAHEU, ($12.65 in chips) 
Seat 3: steepfell ($10 in chips) 
Seat 4: Comeback3392 ($23.42 in chips) 
Seat 5: m.c-alkatraz ($10.25 in chips) 
Seat 6: univibe68 ($10.76 in chips) 
m.c-alkatraz: posts small blind $0.05
univibe68: posts big blind $0.10
*** HOLE CARDS ***
R. Lemonte: calls $0.10
KA3AXCTAHEU,: folds 
steepfell: folds 
Comeback3392: raises $0.30 to $0.40
m.c-alkatraz: folds 
univibe68: calls $0.30
R. Lemonte: calls $0.30
*** FLOP *** [9d Qc 7h]
univibe68: checks 
R. Lemonte: checks 
Comeback3392: checks 
*** TURN *** [9d Qc 7h] [Tc]
univibe68: checks 
R. Lemonte: bets $0.40
Comeback3392: calls $0.40
univibe68: folds 
*** RIVER *** [9d Qc 7h Tc] [As]
R. Lemonte: bets $1.96
Comeback3392: calls $1.96
*** SHOW DOWN ***
R. Lemonte: shows [Jc Kc] (a straight, Ten to Ace)
Comeback3392: mucks hand 
R. Lemonte collected $5.70 from pot
*** SUMMARY ***
Total pot $5.97 | Rake $0.27 
Board [9d Qc 7h Tc As]
Seat 1: R. Lemonte showed [Jc Kc] and won ($5.70) with a straight, Ten to Ace
Seat 2: KA3AXCTAHEU, folded before Flop (didn't bet)
Seat 3: steepfell folded before Flop (didn't bet)
Seat 4: Comeback3392 (button) mucked
Seat 5: m.c-alkatraz (small blind) folded before Flop
Seat 6: univibe68 (big blind) folded on the Turn



PokerStars Hand #166667544005:  Hold'em No Limit ($0.05/$0.10 USD) - 2017/02/23 16:03:05 ET
Table 'Gaika' 6-max Seat #1 is the button
Seat 1: oddshoff ($12.41 in chips) 
Seat 2: NvR.m1nD ($18.27 in chips) 
Seat 3: david_sara83 ($10.32 in chips) 
Seat 4: fortieth ($11.50 in chips) 
Seat 5: fedorka rus ($10.65 in chips) 
Seat 6: dr.goofy ($11 in chips) 
NvR.m1nD: posts small blind $0.05
david_sara83: posts big blind $0.10
*** HOLE CARDS ***
fortieth: folds 
fedorka rus has timed out
fedorka rus: folds 
dr.goofy: folds 
oddshoff: raises $0.10 to $0.20
NvR.m1nD: raises $0.50 to $0.70
david_sara83: folds 
oddshoff: calls $0.50
*** FLOP *** [7h 8d Qd]
NvR.m1nD: bets $0.94
oddshoff: calls $0.94
*** TURN *** [7h 8d Qd] [3c]
NvR.m1nD: bets $1.68
oddshoff: calls $1.68
*** RIVER *** [7h 8d Qd 3c] [8h]
NvR.m1nD: checks 
oddshoff: checks 
*** SHOW DOWN ***
NvR.m1nD: shows [Td Th] (two pair, Tens and Eights)
oddshoff: shows [Ks Qs] (two pair, Queens and Eights)
oddshoff collected $6.44 from pot
*** SUMMARY ***
Total pot $6.74 | Rake $0.30 
Board [7h 8d Qd 3c 8h]
Seat 1: oddshoff (button) showed [Ks Qs] and won ($6.44) with two pair, Queens and Eights
Seat 2: NvR.m1nD (small blind) showed [Td Th] and lost with two pair, Tens and Eights
Seat 3: david_sara83 (big blind) folded before Flop
Seat 4: fortieth folded before Flop (didn't bet)
Seat 5: fedorka rus folded before Flop (didn't bet)
Seat 6: dr.goofy folded before Flop (didn't bet)



PokerStars Hand #166667544484:  Hold'em No Limit ($0.05/$0.10 USD) - 2017/02/23 16:03:06 ET
Table 'Arpola' 6-max Seat #3 is the button
Seat 1: dincimus ($10 in chips) 
Seat 2: patrick19111 ($10.13 in chips) 
Seat 3: simaryk ($2.64 in chips) 
Seat 4: Orlangoor ($19.10 in chips) 
Seat 5: truck1234 ($11.39 in chips) 
Seat 6: Andrei ProFF ($10.47 in chips) 
Orlangoor: posts small blind $0.05
truck1234: posts big blind $0.10
*** HOLE CARDS ***
Andrei ProFF: folds 
dincimus: folds 
patrick19111: folds 
simaryk: calls $0.10
Orlangoor: folds 
truck1234: checks 
*** FLOP *** [4h 3s 5h]
truck1234: checks 
simaryk: checks 
*** TURN *** [4h 3s 5h] [Ac]
truck1234: checks 
simaryk: checks 
*** RIVER *** [4h 3s 5h Ac] [9s]
truck1234: checks 
simaryk: bets $0.20
truck1234: calls $0.20
*** SHOW DOWN ***
simaryk: shows [7c 9c] (a pair of Nines)
truck1234: shows [Ad Ts] (a pair of Aces)
truck1234 collected $0.62 from pot
*** SUMMARY ***
Total pot $0.65 | Rake $0.03 
Board [4h 3s 5h Ac 9s]
Seat 1: dincimus folded before Flop (didn't bet)
Seat 2: patrick19111 folded before Flop (didn't bet)
Seat 3: simaryk (button) showed [7c 9c] and lost with a pair of Nines
Seat 4: Orlangoor (small blind) folded before Flop
Seat 5: truck1234 (big blind) showed [Ad Ts] and won ($0.62) with a pair of Aces
Seat 6: Andrei ProFF folded before Flop (didn't bet)



PokerStars Hand #166667544808:  Hold'em No Limit ($0.05/$0.10 USD) - 2017/02/23 16:03:06 ET
Table 'Virginia II' 6-max Seat #2 is the button
Seat 1: Iarlei ($11.56 in chips) 
Seat 2: Yspenyanin ($10 in chips) 
Seat 3: garigura ($14.61 in chips) 
Seat 4: onkelottoHH ($11.18 in chips) 
Seat 5: dr.goofy ($20.68 in chips) 
Seat 6: ab260414 ($10.45 in chips) 
garigura: posts small blind $0.05
onkelottoHH: posts big blind $0.10
*** HOLE CARDS ***
dr.goofy: folds 
ab260414: folds 
Iarlei: raises $0.20 to $0.30
Yspenyanin: folds 
garigura: folds 
onkelottoHH: folds 
Uncalled bet ($0.20) returned to Iarlei
Iarlei collected $0.25 from pot
*** SUMMARY ***
Total pot $0.25 | Rake $0 
Seat 1: Iarlei collected ($0.25)
Seat 2: Yspenyanin (button) folded before Flop (didn't bet)
Seat 3: garigura (small blind) folded before Flop
Seat 4: onkelottoHH (big blind) folded before Flop
Seat 5: dr.goofy folded before Flop (didn't bet)
Seat 6: ab260414 folded before Flop (didn't bet)



PokerStars Hand #166667545129:  Hold'em No Limit ($0.05/$0.10 USD) - 2017/02/23 16:03:06 ET
Table 'Halawe II' 6-max Seat #5 is the button
Seat 1: DIGOR100 ($7.02 in chips) 
Seat 2: Darkfrai ($10 in chips) 
Seat 3: cherep61987 ($10.72 in chips) 
Seat 4: voledy ($12.55 in chips) 
Seat 5: takis nik ($12.43 in chips) 
Seat 6: Rodik002 ($20.42 in chips) 
Rodik002: posts small blind $0.05
DIGOR100: posts big blind $0.10
*** HOLE CARDS ***
Darkfrai: raises $0.20 to $0.30
cherep61987: folds 
voledy: folds 
takis nik: folds 
Rodik002: folds 
DIGOR100: folds 
Uncalled bet ($0.20) returned to Darkfrai
Darkfrai collected $0.25 from pot
*** SUMMARY ***
Total pot $0.25 | Rake $0 
Seat 1: DIGOR100 (big blind) folded before Flop
Seat 2: Darkfrai collected ($0.25)
Seat 3: cherep61987 folded before Flop (didn't bet)
Seat 4: voledy folded before Flop (didn't bet)
Seat 5: takis nik (button) folded before Flop (didn't bet)
Seat 6: Rodik002 (small blind) folded before Flop



PokerStars Hand #166667545134:  Hold'em No Limit ($0.05/$0.10 USD) - 2017/02/23 16:03:06 ET
Table 'Nephthys II' 6-max Seat #3 is the button
Seat 1: DamDatsAnAce ($10.05 in chips) 
Seat 2: AC Evergreen ($10.33 in chips) 
Seat 3: Newqbrown ($20.08 in chips) 
Seat 5: kingartur222 ($9.06 in chips) 
Seat 6: CHRO8 ($14.49 in chips) 
MihaGr will be allowed to play after the button
kingartur222: posts small blind $0.05
CHRO8: posts big blind $0.10
*** HOLE CARDS ***
DamDatsAnAce: folds 
AC Evergreen: raises $0.16 to $0.26
Newqbrown: calls $0.26
kingartur222: folds 
CHRO8: folds 
*** FLOP *** [6s 3c 8d]
AC Evergreen: checks 
Newqbrown: bets $0.40
AC Evergreen: calls $0.40
*** TURN *** [6s 3c 8d] [Qc]
AC Evergreen: checks 
Newqbrown: bets $1
AC Evergreen: calls $1
*** RIVER *** [6s 3c 8d Qc] [7s]
AC Evergreen: checks 
Newqbrown: checks 
*** SHOW DOWN ***
AC Evergreen: shows [Ac Kh] (high card Ace)
Newqbrown: shows [Qd Js] (a pair of Queens)
Newqbrown collected $3.31 from pot
*** SUMMARY ***
Total pot $3.47 | Rake $0.16 
Board [6s 3c 8d Qc 7s]
Seat 1: DamDatsAnAce folded before Flop (didn't bet)
Seat 2: AC Evergreen showed [Ac Kh] and lost with high card Ace
Seat 3: Newqbrown (button) showed [Qd Js] and won ($3.31) with a pair of Queens
Seat 5: kingartur222 (small blind) folded before Flop
Seat 6: CHRO8 (big blind) folded before Flop



PokerStars Hand #166667545347:  Hold'em No Limit ($0.05/$0.10 USD) - 2017/02/23 16:03:07 ET
Table 'Girtab II' 6-max Seat #1 is the button
Seat 1: Kow6oy ($10 in chips) 
Seat 2: Pokeaster ($13.67 in chips) 
Seat 3: chimera252 ($10 in chips) 
Seat 4: Hyd SK ($27.03 in chips) 
Seat 5: dzesio18 ($12.34 in chips) 
Seat 6: DamDatsAnAce ($10 in chips) 
Pokeaster: posts small blind $0.05
chimera252: posts big blind $0.10
*** HOLE CARDS ***
Hyd SK: folds 
dzesio18: folds 
DamDatsAnAce: folds 
Kow6oy: raises $0.15 to $0.25
Pokeaster: raises $0.65 to $0.90
chimera252: folds 
Kow6oy: folds 
Uncalled bet ($0.65) returned to Pokeaster
Pokeaster collected $0.60 from pot
*** SUMMARY ***
Total pot $0.60 | Rake $0 
Seat 1: Kow6oy (button) folded before Flop
Seat 2: Pokeaster (small blind) collected ($0.60)
Seat 3: chimera252 (big blind) folded before Flop
Seat 4: Hyd SK folded before Flop (didn't bet)
Seat 5: dzesio18 folded before Flop (didn't bet)
Seat 6: DamDatsAnAce folded before Flop (didn't bet)



PokerStars Hand #166667545453:  Hold'em No Limit ($0.05/$0.10 USD) - 2017/02/23 16:03:07 ET
Table 'Brendelia II' 6-max Seat #6 is the button
Seat 2: Crimsonr ($5.82 in chips) 
Seat 3: ValdemorS ($17.98 in chips) 
Seat 6: luckyPositiv ($10.47 in chips) 
Crimsonr: posts small blind $0.05
ValdemorS: posts big blind $0.10
Crimsonr: posts the ante $0.02
ValdemorS: posts the ante $0.02
luckyPositiv: posts the ante $0.02
*** HOLE CARDS ***
luckyPositiv: raises $0.20 to $0.30
Crimsonr: folds 
ValdemorS: raises $0.80 to $1.10
luckyPositiv: folds 
Uncalled bet ($0.80) returned to ValdemorS
ValdemorS collected $0.71 from pot
*** SUMMARY ***
Total pot $0.71 | Rake $0 
Seat 2: Crimsonr (small blind) folded before Flop
Seat 3: ValdemorS (big blind) collected ($0.71)
Seat 6: luckyPositiv (button) folded before Flop



PokerStars Hand #166667545592:  Hold'em No Limit ($0.05/$0.10 USD) - 2017/02/23 16:03:07 ET
Table 'Ostara III' 6-max Seat #2 is the button
Seat 1: MühliJr ($10 in chips) 
Seat 2: Action_Gibi ($10.04 in chips) 
Seat 3: vtalian ($10.01 in chips) 
Seat 5: dzesio18 ($12.45 in chips) 
Seat 6: FlopsterGB ($11.90 in chips) 
vtalian: posts small blind $0.05
dzesio18: posts big blind $0.10
*** HOLE CARDS ***
FlopsterGB: raises $0.15 to $0.25
MühliJr: folds 
Action_Gibi: folds 
vtalian: raises $0.45 to $0.70
dzesio18: folds 
FlopsterGB: calls $0.45
*** FLOP *** [8c Kc 4c]
vtalian: checks 
FlopsterGB: checks 
*** TURN *** [8c Kc 4c] [3h]
vtalian: bets $1.10
FlopsterGB: calls $1.10
*** RIVER *** [8c Kc 4c 3h] [6c]
vtalian: bets $3
FlopsterGB: folds 
Uncalled bet ($3) returned to vtalian
vtalian collected $3.53 from pot
*** SUMMARY ***
Total pot $3.70 | Rake $0.17 
Board [8c Kc 4c 3h 6c]
Seat 1: MühliJr folded before Flop (didn't bet)
Seat 2: Action_Gibi (button) folded before Flop (didn't bet)
Seat 3: vtalian (small blind) collected ($3.53)
Seat 5: dzesio18 (big blind) folded before Flop
Seat 6: FlopsterGB folded on the River



PokerStars Hand #166667545825:  Hold'em No Limit ($0.05/$0.10 USD) - 2017/02/23 16:03:07 ET
Table 'Fechtig III' 6-max Seat #6 is the button
Seat 1: Scanner17 ($10 in chips) 
Seat 2: GV82 ($16.88 in chips) 
Seat 3: eniksenik ($10 in chips) 
Seat 4: kickereens ($11.23 in chips) 
Seat 5: ksandr_hom ($10.10 in chips) 
Seat 6: Glatzemandse ($19.19 in chips) 
Scanner17: posts small blind $0.05
GV82: posts big blind $0.10
*** HOLE CARDS ***
eniksenik: raises $0.20 to $0.30
kickereens: folds 
ksandr_hom: folds 
Glatzemandse: folds 
Scanner17: folds 
GV82: raises $0.50 to $0.80
eniksenik: folds 
Uncalled bet ($0.50) returned to GV82
GV82 collected $0.65 from pot
*** SUMMARY ***
Total pot $0.65 | Rake $0 
Seat 1: Scanner17 (small blind) folded before Flop
Seat 2: GV82 (big blind) collected ($0.65)
Seat 3: eniksenik folded before Flop
Seat 4: kickereens folded before Flop (didn't bet)
Seat 5: ksandr_hom folded before Flop (didn't bet)
Seat 6: Glatzemandse (button) folded before Flop (didn't bet)



PokerStars Hand #166667546024:  Hold'em No Limit ($0.05/$0.10 USD) - 2017/02/23 16:03:07 ET
Table 'Crocus' 6-max Seat #4 is the button
Seat 1: truck1234 ($24.91 in chips) 
Seat 2: garigura ($11.19 in chips) 
Seat 3: Limpa Meza ($0.86 in chips) 
Seat 4: patrick19111 ($12.26 in chips) 
Seat 5: Golsuorsi ($10 in chips) 
Seat 6: Rodik002 ($10 in chips) 
Golsuorsi: posts small blind $0.05
Rodik002: posts big blind $0.10
*** HOLE CARDS ***
truck1234: folds 
garigura: folds 
Limpa Meza: calls $0.10
patrick19111: folds 
Golsuorsi: folds 
Rodik002: checks 
*** FLOP *** [9c Ks Qs]
Rodik002: checks 
Limpa Meza: checks 
*** TURN *** [9c Ks Qs] [3d]
Rodik002: checks 
Limpa Meza: checks 
*** RIVER *** [9c Ks Qs 3d] [3s]
Rodik002: checks 
Limpa Meza: checks 
*** SHOW DOWN ***
Rodik002: shows [7s 8c] (a pair of Threes)
Limpa Meza: shows [6c 7h] (a pair of Threes)
Rodik002 collected $0.12 from pot
Limpa Meza collected $0.12 from pot
*** SUMMARY ***
Total pot $0.25 | Rake $0.01 
Board [9c Ks Qs 3d 3s]
Seat 1: truck1234 folded before Flop (didn't bet)
Seat 2: garigura folded before Flop (didn't bet)
Seat 3: Limpa Meza showed [6c 7h] and won ($0.12) with a pair of Threes
Seat 4: patrick19111 (button) folded before Flop (didn't bet)
Seat 5: Golsuorsi (small blind) folded before Flop
Seat 6: Rodik002 (big blind) showed [7s 8c] and won ($0.12) with a pair of Threes



PokerStars Hand #166667546101:  Hold'em No Limit ($0.05/$0.10 USD) - 2017/02/23 16:03:08 ET
Table 'Tyndareus II' 6-max Seat #6 is the button
Seat 1: Makc1705 ($3.70 in chips) 
Seat 2: Therodorus ($11.77 in chips) 
Seat 3: McCleans ($11.21 in chips) 
Seat 4: gaHy_HaXeP ($11.21 in chips) 
Seat 5: vtalian ($10 in chips) 
Seat 6: sexy_seagull ($10 in chips) 
Makc1705: posts small blind $0.05
Therodorus: posts big blind $0.10
*** HOLE CARDS ***
McCleans: folds 
gaHy_HaXeP: folds 
vtalian: folds 
sexy_seagull: raises $0.15 to $0.25
Makc1705: folds 
Therodorus: folds 
Uncalled bet ($0.15) returned to sexy_seagull
sexy_seagull collected $0.25 from pot
*** SUMMARY ***
Total pot $0.25 | Rake $0 
Seat 1: Makc1705 (small blind) folded before Flop
Seat 2: Therodorus (big blind) folded before Flop
Seat 3: McCleans folded before Flop (didn't bet)
Seat 4: gaHy_HaXeP folded before Flop (didn't bet)
Seat 5: vtalian folded before Flop (didn't bet)
Seat 6: sexy_seagull (button) collected ($0.25)



PokerStars Hand #166667546165:  Hold'em No Limit ($0.05/$0.10 USD) - 2017/02/23 16:03:08 ET
Table 'Stroobantia II' 6-max Seat #5 is the button
Seat 1: XBrosh ($7.88 in chips) 
Seat 2: IAntikI ($10 in chips) 
Seat 3: 8th wonders ($11.03 in chips) 
Seat 4: Xander188 ($10 in chips) 
Seat 5: Zooplack ($12.33 in chips) 
Seat 6: CHRO8 ($13.02 in chips) 
CHRO8: posts small blind $0.05
XBrosh: posts big blind $0.10
*** HOLE CARDS ***
IAntikI: folds 
8th wonders: folds 
Xander188: folds 
Zooplack: raises $0.15 to $0.25
CHRO8: folds 
XBrosh: folds 
Uncalled bet ($0.15) returned to Zooplack
Zooplack collected $0.25 from pot
*** SUMMARY ***
Total pot $0.25 | Rake $0 
Seat 1: XBrosh (big blind) folded before Flop
Seat 2: IAntikI folded before Flop (didn't bet)
Seat 3: 8th wonders folded before Flop (didn't bet)
Seat 4: Xander188 folded before Flop (didn't bet)
Seat 5: Zooplack (button) collected ($0.25)
Seat 6: CHRO8 (small blind) folded before Flop



PokerStars Hand #166667546262:  Hold'em No Limit ($0.05/$0.10 USD) - 2017/02/23 16:03:08 ET
Table 'Eurydome II' 6-max Seat #6 is the button
Seat 2: Elinaattor ($10.39 in chips) 
Seat 3: gaHy_HaXeP ($10 in chips) 
Seat 4: Smitty03300 ($10.03 in chips) 
Seat 5: kush-killa87 ($13.99 in chips) 
Seat 6: Jucatorul823 ($6.20 in chips) 
Elinaattor: posts small blind $0.05
gaHy_HaXeP: posts big blind $0.10
*** HOLE CARDS ***
Smitty03300: folds 
kush-killa87: folds 
Jucatorul823: folds 
Elinaattor: folds 
Uncalled bet ($0.05) returned to gaHy_HaXeP
gaHy_HaXeP collected $0.10 from pot
*** SUMMARY ***
Total pot $0.10 | Rake $0 
Seat 2: Elinaattor (small blind) folded before Flop
Seat 3: gaHy_HaXeP (big blind) collected ($0.10)
Seat 4: Smitty03300 folded before Flop (didn't bet)
Seat 5: kush-killa87 folded before Flop (didn't bet)
Seat 6: Jucatorul823 (button) folded before Flop (didn't bet)



PokerStars Hand #166667546371:  Hold'em No Limit ($0.05/$0.10 USD) - 2017/02/23 16:03:08 ET
Table 'Pompeja III' 6-max Seat #6 is the button
Seat 1: Iarlei ($11.94 in chips) 
Seat 2: steepfell ($10.69 in chips) 
Seat 3: Yspenyanin ($12 in chips) 
Seat 4: Cluckh ($12.21 in chips) 
Seat 5: Spud014 ($12.14 in chips) 
Seat 6: mega spasser ($4.95 in chips) 
Iarlei: posts small blind $0.05
steepfell: posts big blind $0.10
*** HOLE CARDS ***
Yspenyanin: folds 
Cluckh: raises $0.20 to $0.30
Spud014: folds 
mega spasser: folds 
Iarlei: folds 
steepfell: folds 
Uncalled bet ($0.20) returned to Cluckh
Cluckh collected $0.25 from pot
*** SUMMARY ***
Total pot $0.25 | Rake $0 
Seat 1: Iarlei (small blind) folded before Flop
Seat 2: steepfell (big blind) folded before Flop
Seat 3: Yspenyanin folded before Flop (didn't bet)
Seat 4: Cluckh collected ($0.25)
Seat 5: Spud014 folded before Flop (didn't bet)
Seat 6: mega spasser (button) folded before Flop (didn't bet)



PokerStars Hand #166667546443:  Hold'em No Limit ($0.05/$0.10 USD) - 2017/02/23 16:03:08 ET
Table 'Phereclos II' 6-max Seat #3 is the button
Seat 1: Croplayer1 ($10 in chips) 
Seat 2: Kazacha ($10.13 in chips) 
Seat 3: kickereens ($21.16 in chips) 
Seat 4: DamDatsAnAce ($10.43 in chips) 
Seat 5: Smitty03300 ($10.30 in chips) 
Seat 6: mhonielsen ($16.07 in chips) 
DamDatsAnAce: posts small blind $0.05
Smitty03300: posts big blind $0.10
*** HOLE CARDS ***
mhonielsen: folds 
Croplayer1: folds 
Kazacha: raises $0.14 to $0.24
kickereens: folds 
DamDatsAnAce: folds 
Smitty03300: folds 
Uncalled bet ($0.14) returned to Kazacha
Smitty03300 leaves the table
Kazacha collected $0.25 from pot
*** SUMMARY ***
Total pot $0.25 | Rake $0 
Seat 1: Croplayer1 folded before Flop (didn't bet)
Seat 2: Kazacha collected ($0.25)
Seat 3: kickereens (button) folded before Flop (didn't bet)
Seat 4: DamDatsAnAce (small blind) folded before Flop
Seat 5: Smitty03300 (big blind) folded before Flop
Seat 6: mhonielsen folded before Flop (didn't bet)



PokerStars Hand #166667546681:  Hold'em No Limit ($0.05/$0.10 USD) - 2017/02/23 16:03:08 ET
Table 'Atalante' 6-max Seat #4 is the button
Seat 1: OceanBlue100 ($5.24 in chips) 
Seat 2: CiisCi ($19.77 in chips) 
Seat 3: Kow6oy ($10 in chips) 
Seat 4: Dcaro31 ($25.07 in chips) 
Seat 5: eniksenik ($10.34 in chips) 
Seat 6: FlopsterGB ($30.23 in chips) 
eniksenik: posts small blind $0.05
FlopsterGB: posts big blind $0.10
*** HOLE CARDS ***
OceanBlue100: folds 
CiisCi: folds 
Kow6oy: folds 
Dcaro31: folds 
eniksenik: folds 
Uncalled bet ($0.05) returned to FlopsterGB
FlopsterGB collected $0.10 from pot
*** SUMMARY ***
Total pot $0.10 | Rake $0 
Seat 1: OceanBlue100 folded before Flop (didn't bet)
Seat 2: CiisCi folded before Flop (didn't bet)
Seat 3: Kow6oy folded before Flop (didn't bet)
Seat 4: Dcaro31 (button) folded before Flop (didn't bet)
Seat 5: eniksenik (small blind) folded before Flop
Seat 6: FlopsterGB (big blind) collected ($0.10)



PokerStars Hand #166667546755:  Hold'em No Limit ($0.05/$0.10 USD) - 2017/02/23 16:03:08 ET
Table 'Rostia' 6-max Seat #3 is the button
Seat 1: paxit71 ($7.70 in chips) 
Seat 2: david_sara83 ($19.26 in chips) 
Seat 3: ImpAV ($10.57 in chips) 
Seat 4: Hyd SK ($11.58 in chips) 
Seat 5: silsilviu ($7.20 in chips) 
Seat 6: Giyorod ($10.85 in chips) 
Hyd SK: posts small blind $0.05
silsilviu: posts big blind $0.10
*** HOLE CARDS ***
Giyorod: folds 
paxit71: folds 
david_sara83: raises $0.15 to $0.25
ImpAV: folds 
Hyd SK: folds 
ImpAV leaves the table
iThreeBarrel joins the table at seat #3 
silsilviu: folds 
Uncalled bet ($0.15) returned to david_sara83
david_sara83 collected $0.25 from pot
*** SUMMARY ***
Total pot $0.25 | Rake $0 
Seat 1: paxit71 folded before Flop (didn't bet)
Seat 2: david_sara83 collected ($0.25)
Seat 3: ImpAV (button) folded before Flop (didn't bet)
Seat 4: Hyd SK (small blind) folded before Flop
Seat 5: silsilviu (big blind) folded before Flop
Seat 6: Giyorod folded before Flop (didn't bet)



PokerStars Hand #166667546826:  Hold'em No Limit ($0.05/$0.10 USD) - 2017/02/23 16:03:08 ET
Table 'Lacroute' 6-max Seat #4 is the button
Seat 1: johnnyPieper ($5.86 in chips) 
Seat 2: Andy Wolf ($10 in chips) 
Seat 3: Croplayer1 ($14.90 in chips) 
Seat 4: st4tion ($15.91 in chips) 
Seat 5: steepfell ($11.02 in chips) 
Seat 6: IAntikI ($10 in chips) 
steepfell: posts small blind $0.05
IAntikI: posts big blind $0.10
*** HOLE CARDS ***
johnnyPieper: calls $0.10
Andy Wolf: folds 
Croplayer1: folds 
st4tion: folds 
steepfell: folds 
IAntikI: checks 
*** FLOP *** [Td Qs 5s]
IAntikI: checks 
johnnyPieper: checks 
*** TURN *** [Td Qs 5s] [2d]
IAntikI: checks 
johnnyPieper: bets $0.10
IAntikI: calls $0.10
*** RIVER *** [Td Qs 5s 2d] [2c]
IAntikI: checks 
johnnyPieper: bets $1.40
IAntikI: folds 
Uncalled bet ($1.40) returned to johnnyPieper
johnnyPieper collected $0.43 from pot
*** SUMMARY ***
Total pot $0.45 | Rake $0.02 
Board [Td Qs 5s 2d 2c]
Seat 1: johnnyPieper collected ($0.43)
Seat 2: Andy Wolf folded before Flop (didn't bet)
Seat 3: Croplayer1 folded before Flop (didn't bet)
Seat 4: st4tion (button) folded before Flop (didn't bet)
Seat 5: steepfell (small blind) folded before Flop
Seat 6: IAntikI (big blind) folded on the River



PokerStars Hand #166667547467:  Hold'em No Limit ($0.05/$0.10 USD) - 2017/02/23 16:03:09 ET
Table 'Hunnia' 6-max Seat #2 is the button
Seat 1: univibe68 ($22.65 in chips) 
Seat 2: mhonielsen ($10 in chips) 
Seat 3: 6ePeMeHHa9 ($10 in chips) 
Seat 4: Jalida3 ($9.41 in chips) 
Seat 5: Smarkon ($14.93 in chips) 
Seat 6: ChuikaPridi ($9.07 in chips) 
6ePeMeHHa9: posts small blind $0.05
Jalida3: posts big blind $0.10
*** HOLE CARDS ***
Smarkon: folds 
ChuikaPridi: folds 
univibe68: folds 
mhonielsen: raises $0.10 to $0.20
6ePeMeHHa9: folds 
Jalida3: calls $0.10
*** FLOP *** [3h 4c 6h]
Jalida3: bets $0.43
mhonielsen: calls $0.43
*** TURN *** [3h 4c 6h] [Ks]
Jalida3: bets $0.63
mhonielsen: calls $0.63
*** RIVER *** [3h 4c 6h Ks] [Qc]
Jalida3: checks 
mhonielsen: checks 
*** SHOW DOWN ***
Jalida3: shows [5d 5c] (a pair of Fives)
mhonielsen: mucks hand 
Jalida3 collected $2.45 from pot
*** SUMMARY ***
Total pot $2.57 | Rake $0.12 
Board [3h 4c 6h Ks Qc]
Seat 1: univibe68 folded before Flop (didn't bet)
Seat 2: mhonielsen (button) mucked
Seat 3: 6ePeMeHHa9 (small blind) folded before Flop
Seat 4: Jalida3 (big blind) showed [5d 5c] and won ($2.45) with a pair of Fives
Seat 5: Smarkon folded before Flop (didn't bet)
Seat 6: ChuikaPridi folded before Flop (didn't bet)



PokerStars Hand #166667547528:  Hold'em No Limit ($0.05/$0.10 USD) - 2017/02/23 16:03:09 ET
Table 'Iduberga II' 6-max Seat #3 is the button
Seat 1: mhonielsen ($10.76 in chips) 
Seat 2: popypaleta ($12.12 in chips) 
Seat 3: scorpionfish ($11.58 in chips) 
Seat 4: Peter0087 ($9.93 in chips) 
Seat 5: Pokeaster ($10.62 in chips) 
Seat 6: tblocos ($12.97 in chips) 
Peter0087: posts small blind $0.05
Pokeaster: posts big blind $0.10
*** HOLE CARDS ***
tblocos: calls $0.10
mhonielsen: folds 
popypaleta: folds 
scorpionfish has timed out
scorpionfish: folds 
Peter0087: folds 
Pokeaster: checks 
*** FLOP *** [5h 7d 8d]
Pokeaster: checks 
tblocos: checks 
*** TURN *** [5h 7d 8d] [4s]
Pokeaster: checks 
tblocos: checks 
*** RIVER *** [5h 7d 8d 4s] [3d]
Pokeaster: checks 
tblocos: checks 
*** SHOW DOWN ***
Pokeaster: shows [Qd 7h] (a pair of Sevens)
tblocos: shows [Ac 2c] (a straight, Ace to Five)
tblocos collected $0.24 from pot
*** SUMMARY ***
Total pot $0.25 | Rake $0.01 
Board [5h 7d 8d 4s 3d]
Seat 1: mhonielsen folded before Flop (didn't bet)
Seat 2: popypaleta folded before Flop (didn't bet)
Seat 3: scorpionfish (button) folded before Flop (didn't bet)
Seat 4: Peter0087 (small blind) folded before Flop
Seat 5: Pokeaster (big blind) showed [Qd 7h] and lost with a pair of Sevens
Seat 6: tblocos showed [Ac 2c] and won ($0.24) with a straight, Ace to Five



PokerStars Hand #166667547913:  Hold'em No Limit ($0.05/$0.10 USD) - 2017/02/23 16:03:10 ET
Table 'Sirius II' 6-max Seat #5 is the button
Seat 1: Ampped87 ($13.76 in chips) 
Seat 3: Spud014 ($10.40 in chips) 
Seat 5: pokekrk ($11.48 in chips) 
Seat 6: MihaGr ($10 in chips) 
MihaGr: posts small blind $0.05
Ampped87: posts big blind $0.10
Buddy8711: sits out 
*** HOLE CARDS ***
Spud014: folds 
pokekrk: raises $0.10 to $0.20
MihaGr: folds 
Ampped87: calls $0.10
*** FLOP *** [2d 8h 4h]
Ampped87: checks 
pokekrk: bets $0.24
Ampped87: raises $0.54 to $0.78
pokekrk: folds 
Uncalled bet ($0.54) returned to Ampped87
Ampped87 collected $0.89 from pot
*** SUMMARY ***
Total pot $0.93 | Rake $0.04 
Board [2d 8h 4h]
Seat 1: Ampped87 (big blind) collected ($0.89)
Seat 3: Spud014 folded before Flop (didn't bet)
Seat 5: pokekrk (button) folded on the Flop
Seat 6: MihaGr (small blind) folded before Flop



PokerStars Hand #166667547985:  Hold'em No Limit ($0.05/$0.10 USD) - 2017/02/23 16:03:10 ET
Table 'Arduina' 6-max Seat #6 is the button
Seat 2: Andy Wolf ($14.50 in chips) 
Seat 3: Dcaro31 ($13.11 in chips) 
Seat 4: ChuikaPridi ($30.73 in chips) 
Seat 5: ettedallas ($5.16 in chips) 
Seat 6: dierri ($9.99 in chips) 
tauronex will be allowed to play after the button
Andy Wolf: posts small blind $0.05
Dcaro31: posts big blind $0.10
*** HOLE CARDS ***
ChuikaPridi: folds 
ettedallas: folds 
dierri: folds 
Andy Wolf: folds 
Uncalled bet ($0.05) returned to Dcaro31
Dcaro31 collected $0.10 from pot
*** SUMMARY ***
Total pot $0.10 | Rake $0 
Seat 2: Andy Wolf (small blind) folded before Flop
Seat 3: Dcaro31 (big blind) collected ($0.10)
Seat 4: ChuikaPridi folded before Flop (didn't bet)
Seat 5: ettedallas folded before Flop (didn't bet)
Seat 6: dierri (button) folded before Flop (didn't bet)



PokerStars Hand #166667548250:  Hold'em No Limit ($0.05/$0.10 USD) - 2017/02/23 16:03:10 ET
Table 'Jacchia' 6-max Seat #2 is the button
Seat 1: viklundm ($35.22 in chips) 
Seat 2: VAD21 ($18.29 in chips) 
Seat 4: paterthomas ($9.18 in chips) 
Seat 6: RoJ1 ($11.81 in chips) 
maxiv608 will be allowed to play after the button
paterthomas: posts small blind $0.05
RoJ1: posts big blind $0.10
*** HOLE CARDS ***
viklundm: folds 
VAD21: folds 
paterthomas: raises $0.15 to $0.25
RoJ1: raises $0.50 to $0.75
paterthomas: raises $1.35 to $2.10
RoJ1: raises $9.71 to $11.81 and is all-in
paterthomas: folds 
Uncalled bet ($9.71) returned to RoJ1
RoJ1 collected $4.20 from pot
*** SUMMARY ***
Total pot $4.20 | Rake $0 
Seat 1: viklundm folded before Flop (didn't bet)
Seat 2: VAD21 (button) folded before Flop (didn't bet)
Seat 4: paterthomas (small blind) folded before Flop
Seat 6: RoJ1 (big blind) collected ($4.20)



PokerStars Hand #166667548259:  Hold'em No Limit ($0.05/$0.10 USD) - 2017/02/23 16:03:10 ET
Table 'Lederle' 6-max Seat #4 is the button
Seat 2: truck1234 ($15.85 in chips) 
Seat 3: Kazacha ($10.50 in chips) 
Seat 4: Pokeaster ($13.61 in chips) 
Seat 5: 8th wonders ($14.06 in chips) 
Seat 6: pokekrk ($10.15 in chips) 
8th wonders: posts small blind $0.05
pokekrk: posts big blind $0.10
*** HOLE CARDS ***
truck1234: folds 
Kazacha: folds 
Pokeaster: raises $0.15 to $0.25
8th wonders: folds 
pokekrk: folds 
Uncalled bet ($0.15) returned to Pokeaster
Pokeaster collected $0.25 from pot
*** SUMMARY ***
Total pot $0.25 | Rake $0 
Seat 2: truck1234 folded before Flop (didn't bet)
Seat 3: Kazacha folded before Flop (didn't bet)
Seat 4: Pokeaster (button) collected ($0.25)
Seat 5: 8th wonders (small blind) folded before Flop
Seat 6: pokekrk (big blind) folded before Flop



PokerStars Hand #166667548597:  Hold'em No Limit ($0.05/$0.10 USD) - 2017/02/23 16:03:10 ET
Table 'Jokaste II' 6-max Seat #4 is the button
Seat 1: Hyd SK ($13.48 in chips) 
Seat 2: T9MS ($12.48 in chips) 
Seat 3: crazydevill ($10 in chips) 
Seat 4: FRAID358 ($15.16 in chips) 
Seat 5: Vrinni ($10.05 in chips) 
Seat 6: Adailton07 ($15.20 in chips) 
Vrinni: posts small blind $0.05
Adailton07: posts big blind $0.10
*** HOLE CARDS ***
Hyd SK: folds 
T9MS: folds 
crazydevill: raises $0.20 to $0.30
FRAID358: folds 
Vrinni: folds 
Adailton07: folds 
Uncalled bet ($0.20) returned to crazydevill
crazydevill collected $0.25 from pot
*** SUMMARY ***
Total pot $0.25 | Rake $0 
Seat 1: Hyd SK folded before Flop (didn't bet)
Seat 2: T9MS folded before Flop (didn't bet)
Seat 3: crazydevill collected ($0.25)
Seat 4: FRAID358 (button) folded before Flop (didn't bet)
Seat 5: Vrinni (small blind) folded before Flop
Seat 6: Adailton07 (big blind) folded before Flop



PokerStars Hand #166667548603:  Hold'em No Limit ($0.05/$0.10 USD) - 2017/02/23 16:03:10 ET
Table 'Euryalos II' 6-max Seat #6 is the button
Seat 1: acekid403 ($9.95 in chips) 
Seat 2: silsilviu ($7.20 in chips) 
Seat 3: Hyd SK ($10.50 in chips) 
Seat 4: popypaleta ($15.72 in chips) 
Seat 5: horang2 ($8 in chips) 
Seat 6: MihaGr ($10 in chips) 
acekid403: posts small blind $0.05
silsilviu: posts big blind $0.10
horang2: posts big blind $0.10
*** HOLE CARDS ***
Hyd SK: folds 
popypaleta: calls $0.10
horang2: raises $0.20 to $0.30
MihaGr: folds 
acekid403: folds 
silsilviu: folds 
popypaleta: folds 
Uncalled bet ($0.20) returned to horang2
horang2 collected $0.35 from pot
*** SUMMARY ***
Total pot $0.35 | Rake $0 
Seat 1: acekid403 (small blind) folded before Flop
Seat 2: silsilviu (big blind) folded before Flop
Seat 3: Hyd SK folded before Flop (didn't bet)
Seat 4: popypaleta folded before Flop
Seat 5: horang2 collected ($0.35)
Seat 6: MihaGr (button) folded before Flop (didn't bet)



PokerStars Hand #166667549187:  Hold'em No Limit ($0.05/$0.10 USD) - 2017/02/23 16:03:11 ET
Table 'Sham' 6-max Seat #2 is the button
Seat 1: pancernik21 ($10 in chips) 
Seat 2: ex3Lero86 ($10.15 in chips) 
Seat 3: weez3r ($22.73 in chips) 
Seat 4: VAD21 ($12.95 in chips) 
Seat 5: T9MS ($10.43 in chips) 
Seat 6: bdixon_5 ($9.55 in chips) 
weez3r: posts small blind $0.05
VAD21: posts big blind $0.10
*** HOLE CARDS ***
T9MS: folds 
bdixon_5: folds 
pancernik21: folds 
ex3Lero86: folds 
weez3r: folds 
Uncalled bet ($0.05) returned to VAD21
VAD21 collected $0.10 from pot
*** SUMMARY ***
Total pot $0.10 | Rake $0 
Seat 1: pancernik21 folded before Flop (didn't bet)
Seat 2: ex3Lero86 (button) folded before Flop (didn't bet)
Seat 3: weez3r (small blind) folded before Flop
Seat 4: VAD21 (big blind) collected ($0.10)
Seat 5: T9MS folded before Flop (didn't bet)
Seat 6: bdixon_5 folded before Flop (didn't bet)



PokerStars Hand #166667549216:  Hold'em No Limit ($0.05/$0.10 USD) - 2017/02/23 16:03:11 ET
Table 'Ophelia' 6-max Seat #1 is the button
Seat 1: ralfi37 ($10.61 in chips) 
Seat 2: popypaleta ($16.68 in chips) 
Seat 3: mvp0013 ($11.60 in chips) 
Seat 4: Cluckh ($11.35 in chips) 
Seat 5: truck1234 ($14.01 in chips) 
Seat 6: Yabidooo ($10.86 in chips) 
popypaleta: posts small blind $0.05
mvp0013: posts big blind $0.10
*** HOLE CARDS ***
Cluckh: folds 
truck1234: folds 
Yabidooo: folds 
ralfi37: raises $0.20 to $0.30
popypaleta: folds 
mvp0013: folds 
Uncalled bet ($0.20) returned to ralfi37
ralfi37 collected $0.25 from pot
*** SUMMARY ***
Total pot $0.25 | Rake $0 
Seat 1: ralfi37 (button) collected ($0.25)
Seat 2: popypaleta (small blind) folded before Flop
Seat 3: mvp0013 (big blind) folded before Flop
Seat 4: Cluckh folded before Flop (didn't bet)
Seat 5: truck1234 folded before Flop (didn't bet)
Seat 6: Yabidooo folded before Flop (didn't bet)



PokerStars Hand #166667549421:  Hold'em No Limit ($0.05/$0.10 USD) - 2017/02/23 16:03:11 ET
Table 'Bengt' 6-max Seat #3 is the button
Seat 1: Lucky HoBBiT ($12.50 in chips) 
Seat 2: ChefRocco ($20.45 in chips) 
Seat 3: nantes15 ($12.88 in chips) 
Seat 4: 8th wonders ($10 in chips) 
Seat 5: RoJ1 ($10.46 in chips) 
Seat 6: Goroshkos88 ($10 in chips) 
8th wonders: posts small blind $0.05
RoJ1: posts big blind $0.10
*** HOLE CARDS ***
Goroshkos88: folds 
Lucky HoBBiT: folds 
ChefRocco: calls $0.10
nantes15: folds 
8th wonders: raises $0.40 to $0.50
RoJ1: folds 
ChefRocco: calls $0.40
*** FLOP *** [3s Kh 2d]
8th wonders: bets $0.50
ChefRocco: calls $0.50
*** TURN *** [3s Kh 2d] [6s]
8th wonders: checks 
ChefRocco: bets $0.40
8th wonders: folds 
Uncalled bet ($0.40) returned to ChefRocco
ChefRocco collected $2.01 from pot
*** SUMMARY ***
Total pot $2.10 | Rake $0.09 
Board [3s Kh 2d 6s]
Seat 1: Lucky HoBBiT folded before Flop (didn't bet)
Seat 2: ChefRocco collected ($2.01)
Seat 3: nantes15 (button) folded before Flop (didn't bet)
Seat 4: 8th wonders (small blind) folded on the Turn
Seat 5: RoJ1 (big blind) folded before Flop
Seat 6: Goroshkos88 folded before Flop (didn't bet)



PokerStars Hand #166667550139:  Hold'em No Limit ($0.05/$0.10 USD) - 2017/02/23 16:03:12 ET
Table 'Nemo III' 6-max Seat #2 is the button
Seat 2: Bandyaev ($11.84 in chips) 
Seat 3: Therodorus ($10 in chips) 
Seat 4: vtalian ($9.70 in chips) 
Seat 5: Joker51_wtf! ($11.58 in chips) 
Therodorus: posts small blind $0.05
vtalian: posts big blind $0.10
*** HOLE CARDS ***
Joker51_wtf!: raises $0.12 to $0.22
Bandyaev: folds 
Therodorus: folds 
vtalian: folds 
Uncalled bet ($0.12) returned to Joker51_wtf!
Joker51_wtf! collected $0.25 from pot
*** SUMMARY ***
Total pot $0.25 | Rake $0 
Seat 2: Bandyaev (button) folded before Flop (didn't bet)
Seat 3: Therodorus (small blind) folded before Flop
Seat 4: vtalian (big blind) folded before Flop
Seat 5: Joker51_wtf! collected ($0.25)



PokerStars Hand #166667550932:  Hold'em No Limit ($0.05/$0.10 USD) - 2017/02/23 16:03:13 ET
Table 'Grietje' 6-max Seat #6 is the button
Seat 1: WinninBikini ($14.68 in chips) 
Seat 2: Feverhead ($13.17 in chips) 
Seat 4: 6ePeMeHHa9 ($10 in chips) 
Seat 6: Prometheu$8 ($21.20 in chips) 
WinninBikini: posts small blind $0.05
Feverhead: posts big blind $0.10
voledy: sits out 
*** HOLE CARDS ***
6ePeMeHHa9: folds 
Prometheu$8: folds 
WinninBikini: folds 
Uncalled bet ($0.05) returned to Feverhead
sbalass leaves the table
Feverhead collected $0.10 from pot
*** SUMMARY ***
Total pot $0.10 | Rake $0 
Seat 1: WinninBikini (small blind) folded before Flop
Seat 2: Feverhead (big blind) collected ($0.10)
Seat 4: 6ePeMeHHa9 folded before Flop (didn't bet)
Seat 6: Prometheu$8 (button) folded before Flop (didn't bet)



PokerStars Hand #166667551031:  Hold'em No Limit ($0.05/$0.10 USD) - 2017/02/23 16:03:13 ET
Table 'Selinur' 6-max Seat #1 is the button
Seat 1: KA3AXCTAHEU, ($10 in chips) 
Seat 3: bambolejro ($10.42 in chips) 
Seat 4: freezing666 ($11.63 in chips) 
Seat 5: IAntikI ($10.37 in chips) 
Seat 6: homelessdan ($17.92 in chips) 
hoedje72 will be allowed to play after the button
bambolejro: posts small blind $0.05
freezing666: posts big blind $0.10
*** HOLE CARDS ***
IAntikI: folds 
homelessdan: raises $0.20 to $0.30
KA3AXCTAHEU,: folds 
bambolejro: raises $0.64 to $0.94
freezing666: folds 
homelessdan: folds 
Uncalled bet ($0.64) returned to bambolejro
bambolejro collected $0.70 from pot
*** SUMMARY ***
Total pot $0.70 | Rake $0 
Seat 1: KA3AXCTAHEU, (button) folded before Flop (didn't bet)
Seat 3: bambolejro (small blind) collected ($0.70)
Seat 4: freezing666 (big blind) folded before Flop
Seat 5: IAntikI folded before Flop (didn't bet)
Seat 6: homelessdan folded before Flop



PokerStars Hand #166667551417:  Hold'em No Limit ($0.05/$0.10 USD) - 2017/02/23 16:03:13 ET
Table 'Lobelia II' 6-max Seat #2 is the button
Seat 1: facewald ($20.64 in chips) 
Seat 2: Dcaro31 ($18.14 in chips) 
Seat 3: oddshoff ($19.30 in chips) 
Seat 5: Feverhead ($20.43 in chips) 
Seat 6: NvR.m1nD ($10 in chips) 
oddshoff: posts small blind $0.05
Feverhead: posts big blind $0.10
*** HOLE CARDS ***
NvR.m1nD: folds 
facewald: folds 
Dcaro31: folds 
oddshoff: raises $0.10 to $0.20
Feverhead: folds 
Uncalled bet ($0.10) returned to oddshoff
oddshoff collected $0.20 from pot
*** SUMMARY ***
Total pot $0.20 | Rake $0 
Seat 1: facewald folded before Flop (didn't bet)
Seat 2: Dcaro31 (button) folded before Flop (didn't bet)
Seat 3: oddshoff (small blind) collected ($0.20)
Seat 5: Feverhead (big blind) folded before Flop
Seat 6: NvR.m1nD folded before Flop (didn't bet)



PokerStars Hand #166667552176:  Hold'em No Limit ($0.05/$0.10 USD) - 2017/02/23 16:03:14 ET
Table 'Nymphe II' 6-max Seat #5 is the button
Seat 1: jacktayra ($4.61 in chips) 
Seat 2: Newqbrown ($10.15 in chips) 
Seat 3: THIMUCHIN ($14.05 in chips) 
Seat 4: coolisses111 ($18.45 in chips) 
Seat 5: Yspenyanin ($10.94 in chips) 
Seat 6: Xander188 ($18.13 in chips) 
Xander188: posts small blind $0.05
jacktayra: posts big blind $0.10
*** HOLE CARDS ***
Newqbrown: raises $0.20 to $0.30
THIMUCHIN: folds 
coolisses111: folds 
Yspenyanin: folds 
Xander188: folds 
jacktayra: folds 
Uncalled bet ($0.20) returned to Newqbrown
Newqbrown collected $0.25 from pot
*** SUMMARY ***
Total pot $0.25 | Rake $0 
Seat 1: jacktayra (big blind) folded before Flop
Seat 2: Newqbrown collected ($0.25)
Seat 3: THIMUCHIN folded before Flop (didn't bet)
Seat 4: coolisses111 folded before Flop (didn't bet)
Seat 5: Yspenyanin (button) folded before Flop (didn't bet)
Seat 6: Xander188 (small blind) folded before Flop



PokerStars Hand #166667552240:  Hold'em No Limit ($0.05/$0.10 USD) - 2017/02/23 16:03:14 ET
Table 'Landi II' 6-max Seat #5 is the button
Seat 1: dersiemer ($11.87 in chips) 
Seat 2: Aescul@pius ($11.10 in chips) 
Seat 3: dr.goofy ($21.59 in chips) 
Seat 4: alesi13 ($6.20 in chips) 
Seat 5: Bird et al ($10 in chips) 
dersiemer: posts small blind $0.05
Aescul@pius: posts big blind $0.10
*** HOLE CARDS ***
dr.goofy: folds 
alesi13: folds 
Bird et al: folds 
dersiemer: raises $0.10 to $0.20
Aescul@pius: folds 
Uncalled bet ($0.10) returned to dersiemer
dersiemer collected $0.20 from pot
*** SUMMARY ***
Total pot $0.20 | Rake $0 
Seat 1: dersiemer (small blind) collected ($0.20)
Seat 2: Aescul@pius (big blind) folded before Flop
Seat 3: dr.goofy folded before Flop (didn't bet)
Seat 4: alesi13 folded before Flop (didn't bet)
Seat 5: Bird et al (button) folded before Flop (didn't bet)



PokerStars Hand #166667552331:  Hold'em No Limit ($0.05/$0.10 USD) - 2017/02/23 16:03:14 ET
Table 'Nauheima II' 6-max Seat #6 is the button
Seat 2: Peter0087 ($9.64 in chips) 
Seat 3: KokoulinV ($13.74 in chips) 
Seat 4: Innerwuss ($10.12 in chips) 
Seat 5: Kow6oy ($10.45 in chips) 
Seat 6: bonyo71 ($5.04 in chips) 
Peter0087: posts small blind $0.05
KokoulinV: posts big blind $0.10
*** HOLE CARDS ***
Innerwuss: folds 
Kow6oy: folds 
bonyo71: folds 
Peter0087: raises $0.10 to $0.20
KokoulinV: calls $0.10
*** FLOP *** [Jc 5s Kh]
Peter0087: bets $0.20
KokoulinV: folds 
Uncalled bet ($0.20) returned to Peter0087
Peter0087 collected $0.38 from pot
*** SUMMARY ***
Total pot $0.40 | Rake $0.02 
Board [Jc 5s Kh]
Seat 2: Peter0087 (small blind) collected ($0.38)
Seat 3: KokoulinV (big blind) folded on the Flop
Seat 4: Innerwuss folded before Flop (didn't bet)
Seat 5: Kow6oy folded before Flop (didn't bet)
Seat 6: bonyo71 (button) folded before Flop (didn't bet)



PokerStars Hand #166667552374:  Hold'em No Limit ($0.05/$0.10 USD) - 2017/02/23 16:03:14 ET
Table 'Orthos III' 6-max Seat #3 is the button
Seat 1: sexy_seagull ($10 in chips) 
Seat 2: Xander188 ($16.03 in chips) 
Seat 3: koka4cs ($6.05 in chips) 
Seat 4: FlopsterGB ($15.72 in chips) 
Seat 5: Bird et al ($20.62 in chips) 
Seat 6: RoJ1 ($10.79 in chips) 
FlopsterGB: posts small blind $0.05
Bird et al: posts big blind $0.10
*** HOLE CARDS ***
RoJ1: folds 
sexy_seagull: folds 
Xander188: raises $0.20 to $0.30
koka4cs: calls $0.30
FlopsterGB: calls $0.25
Bird et al: folds 
*** FLOP *** [4c 3h 9c]
FlopsterGB: checks 
Xander188: bets $0.60
koka4cs: folds 
FlopsterGB: folds 
Uncalled bet ($0.60) returned to Xander188
Xander188 collected $0.96 from pot
*** SUMMARY ***
Total pot $1 | Rake $0.04 
Board [4c 3h 9c]
Seat 1: sexy_seagull folded before Flop (didn't bet)
Seat 2: Xander188 collected ($0.96)
Seat 3: koka4cs (button) folded on the Flop
Seat 4: FlopsterGB (small blind) folded on the Flop
Seat 5: Bird et al (big blind) folded before Flop
Seat 6: RoJ1 folded before Flop (didn't bet)



PokerStars Hand #166667552384:  Hold'em No Limit ($0.05/$0.10 USD) - 2017/02/23 16:03:14 ET
Table 'Hyakutake' 6-max Seat #2 is the button
Seat 1: Asilvagoat ($11.58 in chips) 
Seat 2: boxer821 ($10.79 in chips) 
Seat 3: lenboysprite ($6.65 in chips) 
Seat 4: eniksenik ($13.80 in chips) 
Seat 5: RoJ1 ($11.59 in chips) 
Seat 6: maxiv608 ($13.27 in chips) 
lenboysprite: posts small blind $0.05
eniksenik: posts big blind $0.10
*** HOLE CARDS ***
RoJ1: folds 
maxiv608: raises $0.20 to $0.30
Asilvagoat: folds 
boxer821: folds 
lenboysprite: folds 
eniksenik: folds 
Uncalled bet ($0.20) returned to maxiv608
maxiv608 collected $0.25 from pot
*** SUMMARY ***
Total pot $0.25 | Rake $0 
Seat 1: Asilvagoat folded before Flop (didn't bet)
Seat 2: boxer821 (button) folded before Flop (didn't bet)
Seat 3: lenboysprite (small blind) folded before Flop
Seat 4: eniksenik (big blind) folded before Flop
Seat 5: RoJ1 folded before Flop (didn't bet)
Seat 6: maxiv608 collected ($0.25)



PokerStars Hand #166667552451:  Hold'em No Limit ($0.05/$0.10 USD) - 2017/02/23 16:03:15 ET
Table 'Repsolda' 6-max Seat #5 is the button
Seat 2: MBen10 ($25.36 in chips) 
Seat 3: manashov ($13.10 in chips) 
Seat 5: danky24 ($7.35 in chips) 
Seat 6: RkaczoR ($10 in chips) 
RkaczoR: posts small blind $0.05
fabadam: is sitting out 
MBen10: posts big blind $0.10
MihaGr: sits out 
*** HOLE CARDS ***
manashov: folds 
danky24: folds 
RkaczoR: raises $0.20 to $0.30
MBen10: calls $0.20
*** FLOP *** [7c 6d 3d]
RkaczoR: checks 
MBen10: bets $0.27
RkaczoR: raises $0.81 to $1.08
MBen10: calls $0.81
*** TURN *** [7c 6d 3d] [4c]
RkaczoR: bets $1.66
MBen10: folds 
Uncalled bet ($1.66) returned to RkaczoR
RkaczoR collected $2.64 from pot
*** SUMMARY ***
Total pot $2.76 | Rake $0.12 
Board [7c 6d 3d 4c]
Seat 2: MBen10 (big blind) folded on the Turn
Seat 3: manashov folded before Flop (didn't bet)
Seat 5: danky24 (button) folded before Flop (didn't bet)
Seat 6: RkaczoR (small blind) collected ($2.64)



PokerStars Hand #166667552473:  Hold'em No Limit ($0.05/$0.10 USD) - 2017/02/23 16:03:15 ET
Table 'Wabash' 6-max Seat #2 is the button
Seat 2: ex3Lero86 ($32.55 in chips) 
Seat 3: sszabi28 ($5.47 in chips) 
Seat 4: Nr847 ($10 in chips) 
Seat 5: popypaleta ($10.10 in chips) 
Seat 6: weez3r ($10.44 in chips) 
sszabi28: posts small blind $0.05
Nr847: posts big blind $0.10
*** HOLE CARDS ***
popypaleta: folds 
weez3r: folds 
ex3Lero86: folds 
sszabi28: calls $0.05
Nr847: checks 
*** FLOP *** [8s Js 9d]
sszabi28: bets $0.10
Nr847: folds 
Uncalled bet ($0.10) returned to sszabi28
sszabi28 collected $0.19 from pot
*** SUMMARY ***
Total pot $0.20 | Rake $0.01 
Board [8s Js 9d]
Seat 2: ex3Lero86 (button) folded before Flop (didn't bet)
Seat 3: sszabi28 (small blind) collected ($0.19)
Seat 4: Nr847 (big blind) folded on the Flop
Seat 5: popypaleta folded before Flop (didn't bet)
Seat 6: weez3r folded before Flop (didn't bet)



PokerStars Hand #166667552537:  Hold'em No Limit ($0.05/$0.10 USD) - 2017/02/23 16:03:15 ET
Table 'Crommelin II' 6-max Seat #3 is the button
Seat 1: THIMUCHIN ($11.07 in chips) 
Seat 2: Bird et al ($10 in chips) 
Seat 3: Strelok1974 ($21.95 in chips) 
Seat 4: Pequeño Clau ($10 in chips) 
Seat 5: Action_Gibi ($20.19 in chips) 
Seat 6: Darkfrai ($10.95 in chips) 
Pequeño Clau: posts small blind $0.05
Action_Gibi: posts big blind $0.10
*** HOLE CARDS ***
Darkfrai: folds 
THIMUCHIN: folds 
Bird et al: folds 
Strelok1974: folds 
Pequeño Clau: folds 
Uncalled bet ($0.05) returned to Action_Gibi
Action_Gibi collected $0.10 from pot
*** SUMMARY ***
Total pot $0.10 | Rake $0 
Seat 1: THIMUCHIN folded before Flop (didn't bet)
Seat 2: Bird et al folded before Flop (didn't bet)
Seat 3: Strelok1974 (button) folded before Flop (didn't bet)
Seat 4: Pequeño Clau (small blind) folded before Flop
Seat 5: Action_Gibi (big blind) collected ($0.10)
Seat 6: Darkfrai folded before Flop (didn't bet)



PokerStars Hand #166667552711:  Hold'em No Limit ($0.05/$0.10 USD) - 2017/02/23 16:03:15 ET
Table 'Cyane' 6-max Seat #5 is the button
Seat 1: KA3AXCTAHEU, ($10.32 in chips) 
Seat 2: Temniy Elf ($10.15 in chips) 
Seat 3: Mamm0nism ($13.94 in chips) 
Seat 4: truck1234 ($20.96 in chips) 
Seat 5: ChuikaPridi ($9.92 in chips) 
Seat 6: 8th wonders ($10.60 in chips) 
8th wonders: posts small blind $0.05
KA3AXCTAHEU,: posts big blind $0.10
*** HOLE CARDS ***
Temniy Elf: folds 
Mamm0nism: folds 
truck1234: folds 
Temniy Elf leaves the table
ChuikaPridi: raises $0.20 to $0.30
8th wonders: folds 
KA3AXCTAHEU,: folds 
Uncalled bet ($0.20) returned to ChuikaPridi
ChuikaPridi collected $0.25 from pot
*** SUMMARY ***
Total pot $0.25 | Rake $0 
Seat 1: KA3AXCTAHEU, (big blind) folded before Flop
Seat 2: Temniy Elf folded before Flop (didn't bet)
Seat 3: Mamm0nism folded before Flop (didn't bet)
Seat 4: truck1234 folded before Flop (didn't bet)
Seat 5: ChuikaPridi (button) collected ($0.25)
Seat 6: 8th wonders (small blind) folded before Flop



PokerStars Hand #166667552712:  Hold'em No Limit ($0.05/$0.10 USD) - 2017/02/23 16:03:15 ET
Table 'Esperanto II' 6-max Seat #2 is the button
Seat 1: kurasd ($11.01 in chips) 
Seat 2: MihaGr ($10.04 in chips) 
Seat 3: Namhkal ($12.15 in chips) 
Seat 4: Andrei ProFF ($10.41 in chips) 
Seat 5: FRAID358 ($10 in chips) 
Seat 6: ArcticBearDK ($12.73 in chips) 
Namhkal: posts small blind $0.05
Andrei ProFF: posts big blind $0.10
*** HOLE CARDS ***
FRAID358: folds 
ArcticBearDK: folds 
kurasd: calls $0.10
MihaGr: folds 
Namhkal: folds 
Andrei ProFF: checks 
*** FLOP *** [8c Kd 8d]
Andrei ProFF: checks 
kurasd: checks 
*** TURN *** [8c Kd 8d] [Kc]
Andrei ProFF: checks 
kurasd: checks 
*** RIVER *** [8c Kd 8d Kc] [9h]
Andrei ProFF: bets $0.30
kurasd: folds 
Uncalled bet ($0.30) returned to Andrei ProFF
Andrei ProFF collected $0.24 from pot
*** SUMMARY ***
Total pot $0.25 | Rake $0.01 
Board [8c Kd 8d Kc 9h]
Seat 1: kurasd folded on the River
Seat 2: MihaGr (button) folded before Flop (didn't bet)
Seat 3: Namhkal (small blind) folded before Flop
Seat 4: Andrei ProFF (big blind) collected ($0.24)
Seat 5: FRAID358 folded before Flop (didn't bet)
Seat 6: ArcticBearDK folded before Flop (didn't bet)



PokerStars Hand #166667552855:  Hold'em No Limit ($0.05/$0.10 USD) - 2017/02/23 16:03:15 ET
Table 'Ruvuma' 6-max Seat #1 is the button
Seat 1: FRAID358 ($10.25 in chips) 
Seat 2: Fab_1512 ($14.71 in chips) 
Seat 3: Spud014 ($11.26 in chips) 
Seat 4: DamDatsAnAce ($10 in chips) 
Seat 5: sexy_seagull ($10 in chips) 
Seat 6: Elinaattor ($9.60 in chips) 
Fab_1512: posts small blind $0.05
Spud014: posts big blind $0.10
*** HOLE CARDS ***
DamDatsAnAce: folds 
sexy_seagull: folds 
Elinaattor: folds 
FRAID358: raises $0.15 to $0.25
Fab_1512: calls $0.20
Spud014: calls $0.15
*** FLOP *** [7c Js 3d]
Fab_1512: checks 
Spud014: checks 
FRAID358: checks 
*** TURN *** [7c Js 3d] [7d]
Fab_1512: checks 
Spud014: bets $0.47
FRAID358: calls $0.47
Fab_1512: calls $0.47
*** RIVER *** [7c Js 3d 7d] [9s]
Fab_1512: checks 
Spud014: bets $1.37
FRAID358: calls $1.37
Fab_1512: calls $1.37
*** SHOW DOWN ***
Spud014: shows [Qh Th] (a pair of Sevens)
FRAID358: shows [7s 5s] (three of a kind, Sevens)
Fab_1512: mucks hand 
FRAID358 collected $5.99 from pot
*** SUMMARY ***
Total pot $6.27 | Rake $0.28 
Board [7c Js 3d 7d 9s]
Seat 1: FRAID358 (button) showed [7s 5s] and won ($5.99) with three of a kind, Sevens
Seat 2: Fab_1512 (small blind) mucked
Seat 3: Spud014 (big blind) showed [Qh Th] and lost with a pair of Sevens
Seat 4: DamDatsAnAce folded before Flop (didn't bet)
Seat 5: sexy_seagull folded before Flop (didn't bet)
Seat 6: Elinaattor folded before Flop (didn't bet)



PokerStars Hand #166667552943:  Hold'em No Limit ($0.05/$0.10 USD) - 2017/02/23 16:03:15 ET
Table 'Luanda' 6-max Seat #6 is the button
Seat 1: AM-L-SL ($4.90 in chips) 
Seat 2: Xander188 ($10 in chips) 
Seat 3: DamDatsAnAce ($10.15 in chips) 
Seat 5: st4tion ($12.63 in chips) 
Seat 6: KA3AXCTAHEU, ($11.26 in chips) 
AM-L-SL: posts small blind $0.05
Xander188: posts big blind $0.10
*** HOLE CARDS ***
DamDatsAnAce: folds 
st4tion: raises $0.15 to $0.25
KA3AXCTAHEU,: folds 
AM-L-SL: folds 
Xander188: folds 
Uncalled bet ($0.15) returned to st4tion
st4tion collected $0.25 from pot
*** SUMMARY ***
Total pot $0.25 | Rake $0 
Seat 1: AM-L-SL (small blind) folded before Flop
Seat 2: Xander188 (big blind) folded before Flop
Seat 3: DamDatsAnAce folded before Flop (didn't bet)
Seat 5: st4tion collected ($0.25)
Seat 6: KA3AXCTAHEU, (button) folded before Flop (didn't bet)



PokerStars Hand #166667553461:  Hold'em No Limit ($0.05/$0.10 USD) - 2017/02/23 16:03:16 ET
Table 'Deflotte' 6-max Seat #6 is the button
Seat 1: Zooplack ($15.84 in chips) 
Seat 2: MonteCris92 ($10 in chips) 
Seat 3: Croplayer1 ($10.15 in chips) 
Seat 4: 8th wonders ($10 in chips) 
Seat 5: Pokeaster ($11.12 in chips) 
Seat 6: Iarlei ($12.30 in chips) 
Zooplack: posts small blind $0.05
MonteCris92: posts big blind $0.10
*** HOLE CARDS ***
Croplayer1: folds 
8th wonders: raises $0.20 to $0.30
Pokeaster: folds 
Iarlei: calls $0.30
Zooplack: folds 
MonteCris92: folds 
*** FLOP *** [Js Kh 9c]
8th wonders: checks 
Iarlei: checks 
*** TURN *** [Js Kh 9c] [5s]
8th wonders: checks 
Iarlei: checks 
*** RIVER *** [Js Kh 9c 5s] [5h]
8th wonders: checks 
Iarlei: checks 
*** SHOW DOWN ***
8th wonders: shows [7s 7d] (two pair, Sevens and Fives)
Iarlei: mucks hand 
8th wonders collected $0.72 from pot
*** SUMMARY ***
Total pot $0.75 | Rake $0.03 
Board [Js Kh 9c 5s 5h]
Seat 1: Zooplack (small blind) folded before Flop
Seat 2: MonteCris92 (big blind) folded before Flop
Seat 3: Croplayer1 folded before Flop (didn't bet)
Seat 4: 8th wonders showed [7s 7d] and won ($0.72) with two pair, Sevens and Fives
Seat 5: Pokeaster folded before Flop (didn't bet)
Seat 6: Iarlei (button) mucked



PokerStars Hand #166667553966:  Hold'em No Limit ($0.05/$0.10 USD) - 2017/02/23 16:03:16 ET
Table 'Gelria' 6-max Seat #5 is the button
Seat 1: ab260414 ($10 in chips) 
Seat 2: fishhook5 ($10 in chips) 
Seat 3: Orlangoor ($11.27 in chips) 
Seat 5: apenvel ($8.18 in chips) 
Seat 6: Andrei ProFF ($10.47 in chips) 
Andrei ProFF: posts small blind $0.05
ab260414: posts big blind $0.10
*** HOLE CARDS ***
fishhook5: folds 
Orlangoor: raises $0.15 to $0.25
apenvel: folds 
Andrei ProFF: folds 
ab260414: folds 
Uncalled bet ($0.15) returned to Orlangoor
Orlangoor collected $0.25 from pot
*** SUMMARY ***
Total pot $0.25 | Rake $0 
Seat 1: ab260414 (big blind) folded before Flop
Seat 2: fishhook5 folded before Flop (didn't bet)
Seat 3: Orlangoor collected ($0.25)
Seat 5: apenvel (button) folded before Flop (didn't bet)
Seat 6: Andrei ProFF (small blind) folded before Flop



PokerStars Hand #166667554070:  Hold'em No Limit ($0.05/$0.10 USD) - 2017/02/23 16:03:16 ET
Table 'Ushakaron II' 6-max Seat #6 is the button
Seat 1: Kow6oy ($10.20 in chips) 
Seat 2: Iarlei ($10.23 in chips) 
Seat 3: Rodik002 ($10 in chips) 
Seat 4: avintage176 ($27.86 in chips) 
Seat 5: 1limewax1 ($17.23 in chips) 
Seat 6: eniksenik ($11.16 in chips) 
Kow6oy: posts small blind $0.05
Iarlei: posts big blind $0.10
*** HOLE CARDS ***
Rodik002: raises $0.20 to $0.30
avintage176: folds 
1limewax1: folds 
eniksenik: folds 
Kow6oy: folds 
Iarlei: folds 
Uncalled bet ($0.20) returned to Rodik002
Rodik002 collected $0.25 from pot
*** SUMMARY ***
Total pot $0.25 | Rake $0 
Seat 1: Kow6oy (small blind) folded before Flop
Seat 2: Iarlei (big blind) folded before Flop
Seat 3: Rodik002 collected ($0.25)
Seat 4: avintage176 folded before Flop (didn't bet)
Seat 5: 1limewax1 folded before Flop (didn't bet)
Seat 6: eniksenik (button) folded before Flop (didn't bet)



PokerStars Hand #166667554150:  Hold'em No Limit ($0.05/$0.10 USD) - 2017/02/23 16:03:16 ET
Table 'Glarona' 6-max Seat #5 is the button
Seat 1: LarryTheStar ($10.80 in chips) 
Seat 2: BookWorm78 ($10.02 in chips) 
Seat 3: hoedje72 ($3.86 in chips) 
Seat 4: CrippledGod ($6.72 in chips) 
Seat 5: david_sara83 ($10.35 in chips) 
Seat 6: Namhkal ($10.98 in chips) 
Namhkal: posts small blind $0.05
LarryTheStar: posts big blind $0.10
*** HOLE CARDS ***
BookWorm78: folds 
hoedje72: folds 
CrippledGod: folds 
david_sara83: raises $0.15 to $0.25
Namhkal: folds 
LarryTheStar: folds 
Uncalled bet ($0.15) returned to david_sara83
david_sara83 collected $0.25 from pot
*** SUMMARY ***
Total pot $0.25 | Rake $0 
Seat 1: LarryTheStar (big blind) folded before Flop
Seat 2: BookWorm78 folded before Flop (didn't bet)
Seat 3: hoedje72 folded before Flop (didn't bet)
Seat 4: CrippledGod folded before Flop (didn't bet)
Seat 5: david_sara83 (button) collected ($0.25)
Seat 6: Namhkal (small blind) folded before Flop



PokerStars Hand #166667554259:  Hold'em No Limit ($0.05/$0.10 USD) - 2017/02/23 16:03:17 ET
Table 'Giclas' 6-max Seat #1 is the button
Seat 1: david_sara83 ($10 in chips) 
Seat 2: Crafty23@PS ($10 in chips) 
Seat 3: fidas1972 ($10.76 in chips) 
Seat 4: Eddys Edge ($10 in chips) 
Seat 5: dedea1989 ($24.86 in chips) 
Seat 6: eniksenik ($14.63 in chips) 
Crafty23@PS: posts small blind $0.05
fidas1972: posts big blind $0.10
*** HOLE CARDS ***
Eddys Edge: folds 
dedea1989: calls $0.10
eniksenik: folds 
david_sara83: folds 
Crafty23@PS: folds 
fidas1972: checks 
*** FLOP *** [6c 5c Kh]
fidas1972: bets $0.10
dedea1989: calls $0.10
*** TURN *** [6c 5c Kh] [2c]
fidas1972: bets $0.40
dedea1989: calls $0.40
*** RIVER *** [6c 5c Kh 2c] [Ts]
fidas1972: checks 
dedea1989: checks 
*** SHOW DOWN ***
fidas1972: shows [4c 6d] (a pair of Sixes)
dedea1989: shows [Ah Tc] (a pair of Tens)
dedea1989 collected $1.19 from pot
*** SUMMARY ***
Total pot $1.25 | Rake $0.06 
Board [6c 5c Kh 2c Ts]
Seat 1: david_sara83 (button) folded before Flop (didn't bet)
Seat 2: Crafty23@PS (small blind) folded before Flop
Seat 3: fidas1972 (big blind) showed [4c 6d] and lost with a pair of Sixes
Seat 4: Eddys Edge folded before Flop (didn't bet)
Seat 5: dedea1989 showed [Ah Tc] and won ($1.19) with a pair of Tens
Seat 6: eniksenik folded before Flop (didn't bet)



PokerStars Hand #166667554260:  Hold'em No Limit ($0.05/$0.10 USD) - 2017/02/23 16:03:17 ET
Table 'Peiroos' 6-max Seat #6 is the button
Seat 1: ksandr_hom ($10 in chips) 
Seat 2: Nr847 ($10 in chips) 
Seat 3: atlx0711 ($26.87 in chips) 
Seat 4: Peter0087 ($10 in chips) 
Seat 5: sergio-cb164 ($9.40 in chips) 
Seat 6: DevonMiles88 ($4.07 in chips) 
ksandr_hom: posts small blind $0.05
Nr847: posts big blind $0.10
*** HOLE CARDS ***
atlx0711: folds 
Peter0087: folds 
sergio-cb164: raises $0.10 to $0.20
DevonMiles88: raises $0.10 to $0.30
ksandr_hom: folds 
Nr847: folds 
sergio-cb164: calls $0.10
*** FLOP *** [2s 6c Th]
sergio-cb164: checks 
DevonMiles88: bets $0.70
sergio-cb164: folds 
Uncalled bet ($0.70) returned to DevonMiles88
DevonMiles88 collected $0.72 from pot
*** SUMMARY ***
Total pot $0.75 | Rake $0.03 
Board [2s 6c Th]
Seat 1: ksandr_hom (small blind) folded before Flop
Seat 2: Nr847 (big blind) folded before Flop
Seat 3: atlx0711 folded before Flop (didn't bet)
Seat 4: Peter0087 folded before Flop (didn't bet)
Seat 5: sergio-cb164 folded on the Flop
Seat 6: DevonMiles88 (button) collected ($0.72)



PokerStars Hand #166667554663:  Hold'em No Limit ($0.05/$0.10 USD) - 2017/02/23 16:03:17 ET
Table 'Tristan III' 6-max Seat #4 is the button
Seat 1: CHRO8 ($19 in chips) 
Seat 2: Hyd SK ($14.03 in chips) 
Seat 3: fedorka rus ($24.87 in chips) 
Seat 4: Feverhead ($11.53 in chips) 
Seat 5: david_sara83 ($10.66 in chips) 
david_sara83: posts small blind $0.05
joewatson90: is sitting out 
joewatson90 leaves the table
CHRO8: posts big blind $0.10
*** HOLE CARDS ***
Chodemuncher joins the table at seat #6 
Chodemuncher leaves the table
Hyd SK: folds 
fedorka rus: raises $0.20 to $0.30
fredrik10528 joins the table at seat #6 
Feverhead: folds 
david_sara83: folds 
CHRO8: calls $0.20
*** FLOP *** [Js Kd Qc]
CHRO8: checks 
fedorka rus: bets $0.47
CHRO8: calls $0.47
*** TURN *** [Js Kd Qc] [4h]
CHRO8: checks 
fedorka rus: checks 
*** RIVER *** [Js Kd Qc 4h] [Ks]
CHRO8: checks 
fedorka rus: bets $1.14
CHRO8: folds 
Uncalled bet ($1.14) returned to fedorka rus
fedorka rus collected $1.52 from pot
*** SUMMARY ***
Total pot $1.59 | Rake $0.07 
Board [Js Kd Qc 4h Ks]
Seat 1: CHRO8 (big blind) folded on the River
Seat 2: Hyd SK folded before Flop (didn't bet)
Seat 3: fedorka rus collected ($1.52)
Seat 4: Feverhead (button) folded before Flop (didn't bet)
Seat 5: david_sara83 (small blind) folded before Flop



PokerStars Hand #166667554802:  Hold'em No Limit ($0.05/$0.10 USD) - 2017/02/23 16:03:17 ET
Table 'Hestia' 6-max Seat #1 is the button
Seat 1: Pekaml ($10 in chips) 
Seat 3: MBen10 ($13.82 in chips) 
Seat 4: Lucky HoBBiT ($10 in chips) 
Seat 5: CiisCi ($16.05 in chips) 
MBen10: posts small blind $0.05
Lucky HoBBiT: posts big blind $0.10
Smitty03300: sits out 
*** HOLE CARDS ***
CiisCi: folds 
Pekaml: raises $0.10 to $0.20
Kow6oy joins the table at seat #2 
MBen10: folds 
Lucky HoBBiT: calls $0.10
*** FLOP *** [Qd 4h 3d]
Lucky HoBBiT: checks 
Pekaml: bets $0.22
Lucky HoBBiT: folds 
Uncalled bet ($0.22) returned to Pekaml
Pekaml collected $0.43 from pot
*** SUMMARY ***
Total pot $0.45 | Rake $0.02 
Board [Qd 4h 3d]
Seat 1: Pekaml (button) collected ($0.43)
Seat 3: MBen10 (small blind) folded before Flop
Seat 4: Lucky HoBBiT (big blind) folded on the Flop
Seat 5: CiisCi folded before Flop (didn't bet)



PokerStars Hand #166667555111:  Hold'em No Limit ($0.05/$0.10 USD) - 2017/02/23 16:03:17 ET
Table 'Iapetus III' 6-max Seat #2 is the button
Seat 2: Crafty23@PS ($10 in chips) 
Seat 3: takis nik ($10 in chips) 
Seat 5: homelessdan ($13.76 in chips) 
takis nik: posts small blind $0.05
XaXaTyH4uK: is sitting out 
homelessdan: posts big blind $0.10
XaXaTyH4uK leaves the table
tauronex: sits out 
*** HOLE CARDS ***
Raggibest joins the table at seat #4 
Crafty23@PS: folds 
takis nik: raises $0.10 to $0.20
homelessdan: folds 
Uncalled bet ($0.10) returned to takis nik
takis nik collected $0.20 from pot
*** SUMMARY ***
Total pot $0.20 | Rake $0 
Seat 2: Crafty23@PS (button) folded before Flop (didn't bet)
Seat 3: takis nik (small blind) collected ($0.20)
Seat 5: homelessdan (big blind) folded before Flop



PokerStars Hand #166667555122:  Hold'em No Limit ($0.05/$0.10 USD) - 2017/02/23 16:03:17 ET
Table 'Duhr II' 6-max Seat #1 is the button
Seat 1: Lucky HoBBiT ($10 in chips) 
Seat 2: Feverhead ($37.66 in chips) 
Seat 3: Innerwuss ($23.18 in chips) 
Seat 4: CHRO8 ($2.55 in chips) 
Seat 5: Punzzzer ($12.11 in chips) 
Seat 6: townerz1991 ($10 in chips) 
Feverhead: posts small blind $0.05
Innerwuss: posts big blind $0.10
*** HOLE CARDS ***
CHRO8: folds 
Punzzzer: folds 
townerz1991: folds 
Lucky HoBBiT: folds 
Feverhead: raises $0.15 to $0.25
Innerwuss: calls $0.15
*** FLOP *** [6d Jc 2s]
Feverhead: checks 
Innerwuss: checks 
*** TURN *** [6d Jc 2s] [3h]
Feverhead: bets $0.40
Innerwuss: folds 
Uncalled bet ($0.40) returned to Feverhead
Feverhead collected $0.48 from pot
*** SUMMARY ***
Total pot $0.50 | Rake $0.02 
Board [6d Jc 2s 3h]
Seat 1: Lucky HoBBiT (button) folded before Flop (didn't bet)
Seat 2: Feverhead (small blind) collected ($0.48)
Seat 3: Innerwuss (big blind) folded on the Turn
Seat 4: CHRO8 folded before Flop (didn't bet)
Seat 5: Punzzzer folded before Flop (didn't bet)
Seat 6: townerz1991 folded before Flop (didn't bet)



PokerStars Hand #166667555383:  Hold'em No Limit ($0.05/$0.10 USD) - 2017/02/23 16:03:18 ET
Table 'Walpurga' 6-max Seat #4 is the button
Seat 1: chimera252 ($12.22 in chips) 
Seat 2: paxit71 ($6.84 in chips) 
Seat 3: Innerwuss ($19.43 in chips) 
Seat 4: oddshoff ($12.79 in chips) 
Seat 6: AIONCMA1988 ($4.26 in chips) 
AIONCMA1988: posts small blind $0.05
chimera252: posts big blind $0.10
*** HOLE CARDS ***
paxit71: raises $0.10 to $0.20
Innerwuss: folds 
oddshoff: folds 
AIONCMA1988: folds 
chimera252: folds 
Uncalled bet ($0.10) returned to paxit71
paxit71 collected $0.25 from pot
*** SUMMARY ***
Total pot $0.25 | Rake $0 
Seat 1: chimera252 (big blind) folded before Flop
Seat 2: paxit71 collected ($0.25)
Seat 3: Innerwuss folded before Flop (didn't bet)
Seat 4: oddshoff (button) folded before Flop (didn't bet)
Seat 6: AIONCMA1988 (small blind) folded before Flop



PokerStars Hand #166667555661:  Hold'em No Limit ($0.05/$0.10 USD) - 2017/02/23 16:03:18 ET
Table 'Eurydome II' 6-max Seat #2 is the button
Seat 2: Elinaattor ($10.34 in chips) 
Seat 3: gaHy_HaXeP ($10.05 in chips) 
Seat 4: Smitty03300 ($10.03 in chips) 
Seat 5: kush-killa87 ($13.99 in chips) 
Seat 6: Jucatorul823 ($6.20 in chips) 
gaHy_HaXeP: posts small blind $0.05
Smitty03300: posts big blind $0.10
*** HOLE CARDS ***
kush-killa87: folds 
Jucatorul823: folds 
Elinaattor: folds 
gaHy_HaXeP: raises $0.20 to $0.30
Smitty03300: folds 
Uncalled bet ($0.20) returned to gaHy_HaXeP
gaHy_HaXeP collected $0.20 from pot
*** SUMMARY ***
Total pot $0.20 | Rake $0 
Seat 2: Elinaattor (button) folded before Flop (didn't bet)
Seat 3: gaHy_HaXeP (small blind) collected ($0.20)
Seat 4: Smitty03300 (big blind) folded before Flop
Seat 5: kush-killa87 folded before Flop (didn't bet)
Seat 6: Jucatorul823 folded before Flop (didn't bet)



PokerStars Hand #166667555901:  Hold'em No Limit ($0.05/$0.10 USD) - 2017/02/23 16:03:18 ET
Table 'Klotho II' 6-max Seat #1 is the button
Seat 1: Alexey74516 ($8.12 in chips) 
Seat 2: kickereens ($10.10 in chips) 
Seat 3: Zooplack ($10.73 in chips) 
Seat 4: Lucky HoBBiT ($10.11 in chips) 
Seat 5: david_sara83 ($15.64 in chips) 
Seat 6: D3NyA ($11.57 in chips) 
kickereens: posts small blind $0.05
Zooplack: posts big blind $0.10
*** HOLE CARDS ***
Lucky HoBBiT: folds 
david_sara83: folds 
D3NyA: folds 
Alexey74516: calls $0.10
kickereens: folds 
Zooplack: checks 
*** FLOP *** [Td 9c 4c]
Zooplack: checks 
Alexey74516: checks 
*** TURN *** [Td 9c 4c] [8c]
Zooplack: checks 
Alexey74516: checks 
*** RIVER *** [Td 9c 4c 8c] [9s]
Zooplack: checks 
Alexey74516: checks 
*** SHOW DOWN ***
Zooplack: shows [6d 3c] (a pair of Nines)
Alexey74516: shows [Jc Ks] (a pair of Nines - King kicker)
Alexey74516 collected $0.24 from pot
*** SUMMARY ***
Total pot $0.25 | Rake $0.01 
Board [Td 9c 4c 8c 9s]
Seat 1: Alexey74516 (button) showed [Jc Ks] and won ($0.24) with a pair of Nines
Seat 2: kickereens (small blind) folded before Flop
Seat 3: Zooplack (big blind) showed [6d 3c] and lost with a pair of Nines
Seat 4: Lucky HoBBiT folded before Flop (didn't bet)
Seat 5: david_sara83 folded before Flop (didn't bet)
Seat 6: D3NyA folded before Flop (didn't bet)



PokerStars Hand #166667556128:  Hold'em No Limit ($0.05/$0.10 USD) - 2017/02/23 16:03:19 ET
Table 'Virginia II' 6-max Seat #3 is the button
Seat 1: Iarlei ($11.71 in chips) 
Seat 2: Yspenyanin ($10 in chips) 
Seat 3: garigura ($14.56 in chips) 
Seat 4: onkelottoHH ($11.08 in chips) 
Seat 5: dr.goofy ($20.68 in chips) 
Seat 6: ab260414 ($10.45 in chips) 
onkelottoHH: posts small blind $0.05
dr.goofy: posts big blind $0.10
*** HOLE CARDS ***
ab260414: folds 
Iarlei: folds 
Yspenyanin: folds 
garigura: folds 
onkelottoHH: folds 
Uncalled bet ($0.05) returned to dr.goofy
dr.goofy collected $0.10 from pot
*** SUMMARY ***
Total pot $0.10 | Rake $0 
Seat 1: Iarlei folded before Flop (didn't bet)
Seat 2: Yspenyanin folded before Flop (didn't bet)
Seat 3: garigura (button) folded before Flop (didn't bet)
Seat 4: onkelottoHH (small blind) folded before Flop
Seat 5: dr.goofy (big blind) collected ($0.10)
Seat 6: ab260414 folded before Flop (didn't bet)



PokerStars Hand #166667556130:  Hold'em No Limit ($0.05/$0.10 USD) - 2017/02/23 16:03:19 ET
Table 'Joella' 6-max Seat #3 is the button
Seat 1: Dcaro31 ($13.25 in chips) 
Seat 2: Kaelyns_Bark ($8.71 in chips) 
Seat 3: Joker51_wtf! ($10 in chips) 
Seat 5: Anestakis777 ($4.88 in chips) 
Seat 6: dr.goofy ($11.76 in chips) 
Anestakis777: posts small blind $0.05
dr.goofy: posts big blind $0.10
*** HOLE CARDS ***
Dcaro31: folds 
Kaelyns_Bark: calls $0.10
Joker51_wtf!: folds 
Anestakis777: calls $0.05
dr.goofy: checks 
*** FLOP *** [Ts Js Qc]
Anestakis777: checks 
dr.goofy: checks 
Kaelyns_Bark: bets $0.10
Anestakis777: raises $0.10 to $0.20
dr.goofy: folds 
Kaelyns_Bark: calls $0.10
*** TURN *** [Ts Js Qc] [4d]
Anestakis777: bets $0.20
Kaelyns_Bark: calls $0.20
*** RIVER *** [Ts Js Qc 4d] [3h]
Anestakis777: bets $0.40
Kaelyns_Bark: calls $0.40
*** SHOW DOWN ***
Anestakis777: shows [Td Qs] (two pair, Queens and Tens)
Kaelyns_Bark: mucks hand 
Anestakis777 collected $1.81 from pot
*** SUMMARY ***
Total pot $1.90 | Rake $0.09 
Board [Ts Js Qc 4d 3h]
Seat 1: Dcaro31 folded before Flop (didn't bet)
Seat 2: Kaelyns_Bark mucked
Seat 3: Joker51_wtf! (button) folded before Flop (didn't bet)
Seat 5: Anestakis777 (small blind) showed [Td Qs] and won ($1.81) with two pair, Queens and Tens
Seat 6: dr.goofy (big blind) folded on the Flop



PokerStars Hand #166667556305:  Hold'em No Limit ($0.05/$0.10 USD) - 2017/02/23 16:03:19 ET
Table 'Siebohme' 6-max Seat #3 is the button
Seat 1: kusa4ki ($11.38 in chips) 
Seat 2: el toro 1507 ($11.53 in chips) 
Seat 3: ex3Lero86 ($10.30 in chips) 
Seat 4: Innerwuss ($10 in chips) 
Seat 5: Kazacha ($10.10 in chips) 
Seat 6: townerz1991 ($10.68 in chips) 
Innerwuss: posts small blind $0.05
Kazacha: posts big blind $0.10
*** HOLE CARDS ***
townerz1991: folds 
kusa4ki: folds 
el toro 1507: folds 
ex3Lero86: raises $0.13 to $0.23
Innerwuss: folds 
Kazacha: calls $0.13
*** FLOP *** [4c Tc 9d]
Kazacha: checks 
ex3Lero86: bets $0.30
Kazacha: folds 
Uncalled bet ($0.30) returned to ex3Lero86
ex3Lero86 collected $0.49 from pot
*** SUMMARY ***
Total pot $0.51 | Rake $0.02 
Board [4c Tc 9d]
Seat 1: kusa4ki folded before Flop (didn't bet)
Seat 2: el toro 1507 folded before Flop (didn't bet)
Seat 3: ex3Lero86 (button) collected ($0.49)
Seat 4: Innerwuss (small blind) folded before Flop
Seat 5: Kazacha (big blind) folded on the Flop
Seat 6: townerz1991 folded before Flop (didn't bet)



PokerStars Hand #166667556456:  Hold'em No Limit ($0.05/$0.10 USD) - 2017/02/23 16:03:19 ET
Table 'Izar' 6-max Seat #5 is the button
Seat 1: bambolejro ($10.54 in chips) 
Seat 2: mvp0013 ($10.89 in chips) 
Seat 3: Yspenyanin ($10.90 in chips) 
Seat 4: Matee92 ($6.51 in chips) 
Seat 5: fishhook5 ($11.30 in chips) 
Seat 6: yodzik ($5 in chips) 
yodzik: posts small blind $0.05
bambolejro: posts big blind $0.10
*** HOLE CARDS ***
mvp0013: folds 
Yspenyanin: raises $0.15 to $0.25
Matee92: calls $0.25
fishhook5: folds 
yodzik: folds 
bambolejro: folds 
*** FLOP *** [Qd 8h 8s]
Yspenyanin: checks 
Matee92: checks 
*** TURN *** [Qd 8h 8s] [Qc]
Yspenyanin: bets $0.31
Matee92: folds 
Uncalled bet ($0.31) returned to Yspenyanin
Yspenyanin collected $0.62 from pot
*** SUMMARY ***
Total pot $0.65 | Rake $0.03 
Board [Qd 8h 8s Qc]
Seat 1: bambolejro (big blind) folded before Flop
Seat 2: mvp0013 folded before Flop (didn't bet)
Seat 3: Yspenyanin collected ($0.62)
Seat 4: Matee92 folded on the Turn
Seat 5: fishhook5 (button) folded before Flop (didn't bet)
Seat 6: yodzik (small blind) folded before Flop



PokerStars Hand #166667556823:  Hold'em No Limit ($0.05/$0.10 USD) - 2017/02/23 16:03:19 ET
Table 'Wingolfia II' 6-max Seat #2 is the button
Seat 1: BahiaMinhaP ($10 in chips) 
Seat 2: NvR.m1nD ($10.60 in chips) 
Seat 3: truck1234 ($10 in chips) 
Seat 4: zlobslob ($18.77 in chips) 
Seat 5: tr41n3r12 ($11.43 in chips) 
Seat 6: EphemeralBen ($11.52 in chips) 
truck1234: posts small blind $0.05
zlobslob: posts big blind $0.10
*** HOLE CARDS ***
tr41n3r12: folds 
EphemeralBen: raises $0.20 to $0.30
BahiaMinhaP: folds 
NvR.m1nD: folds 
truck1234: folds 
zlobslob: calls $0.20
*** FLOP *** [3d 6h Jc]
zlobslob: checks 
EphemeralBen: bets $0.31
zlobslob: folds 
Uncalled bet ($0.31) returned to EphemeralBen
EphemeralBen collected $0.62 from pot
*** SUMMARY ***
Total pot $0.65 | Rake $0.03 
Board [3d 6h Jc]
Seat 1: BahiaMinhaP folded before Flop (didn't bet)
Seat 2: NvR.m1nD (button) folded before Flop (didn't bet)
Seat 3: truck1234 (small blind) folded before Flop
Seat 4: zlobslob (big blind) folded on the Flop
Seat 5: tr41n3r12 folded before Flop (didn't bet)
Seat 6: EphemeralBen collected ($0.62)



PokerStars Hand #166667556887:  Hold'em No Limit ($0.05/$0.10 USD) - 2017/02/23 16:03:19 ET
Table 'Anhui II' 6-max Seat #4 is the button
Seat 1: kingartur222 ($11.99 in chips) 
Seat 2: kikus334 ($10.80 in chips) 
Seat 3: lochniak556 ($27.60 in chips) 
Seat 4: dragonste89 ($10 in chips) 
Seat 5: Bandyaev ($10 in chips) 
Seat 6: .BaRReL.1122 ($6.45 in chips) 
Bandyaev: posts small blind $0.05
.BaRReL.1122: posts big blind $0.10
*** HOLE CARDS ***
kingartur222: folds 
kikus334: calls $0.10
.BaRReL.1122 said, "as 6"
lochniak556: raises $0.20 to $0.30
dragonste89: folds 
Bandyaev: folds 
.BaRReL.1122: calls $0.20
kikus334: calls $0.20
*** FLOP *** [5h Qc 9h]
.BaRReL.1122: checks 
kikus334: checks 
lochniak556: bets $0.60
.BaRReL.1122: calls $0.60
kikus334: calls $0.60
*** TURN *** [5h Qc 9h] [8h]
.BaRReL.1122: checks 
kikus334: bets $0.70
lochniak556: calls $0.70
.BaRReL.1122: folds 
*** RIVER *** [5h Qc 9h 8h] [Ks]
kikus334: bets $3.20
lochniak556: folds 
Uncalled bet ($3.20) returned to kikus334
kikus334 collected $3.96 from pot
*** SUMMARY ***
Total pot $4.15 | Rake $0.19 
Board [5h Qc 9h 8h Ks]
Seat 1: kingartur222 folded before Flop (didn't bet)
Seat 2: kikus334 collected ($3.96)
Seat 3: lochniak556 folded on the River
Seat 4: dragonste89 (button) folded before Flop (didn't bet)
Seat 5: Bandyaev (small blind) folded before Flop
Seat 6: .BaRReL.1122 (big blind) folded on the Turn



PokerStars Hand #166667557157:  Hold'em No Limit ($0.05/$0.10 USD) - 2017/02/23 16:03:20 ET
Table 'Carina' 6-max Seat #5 is the button
Seat 1: Kupi007 ($10 in chips) 
Seat 2: kickereens ($24.39 in chips) 
Seat 3: LarryTheStar ($10.10 in chips) 
Seat 4: crazydevill ($10 in chips) 
Seat 5: IAntikI ($10 in chips) 
Seat 6: alexweezer ($9.85 in chips) 
alexweezer: posts small blind $0.05
Kupi007: posts big blind $0.10
*** HOLE CARDS ***
kickereens: folds 
LarryTheStar: folds 
crazydevill: folds 
IAntikI: raises $0.15 to $0.25
alexweezer: folds 
Kupi007: folds 
Uncalled bet ($0.15) returned to IAntikI
IAntikI collected $0.25 from pot
*** SUMMARY ***
Total pot $0.25 | Rake $0 
Seat 1: Kupi007 (big blind) folded before Flop
Seat 2: kickereens folded before Flop (didn't bet)
Seat 3: LarryTheStar folded before Flop (didn't bet)
Seat 4: crazydevill folded before Flop (didn't bet)
Seat 5: IAntikI (button) collected ($0.25)
Seat 6: alexweezer (small blind) folded before Flop



PokerStars Hand #166667557268:  Hold'em No Limit ($0.05/$0.10 USD) - 2017/02/23 16:03:20 ET
Table 'Isberga' 6-max Seat #4 is the button
Seat 1: Feverhead ($17.27 in chips) 
Seat 2: GESPERIA ($10 in chips) 
Seat 4: THIMUCHIN ($11.04 in chips) 
Seat 5: YoungGriff86 ($19.80 in chips) 
Seat 6: Goroshkos88 ($21.35 in chips) 
YoungGriff86: posts small blind $0.05
Goroshkos88: posts big blind $0.10
*** HOLE CARDS ***
Feverhead: folds 
GESPERIA: raises $0.20 to $0.30
THIMUCHIN: folds 
YoungGriff86: folds 
Goroshkos88: folds 
Uncalled bet ($0.20) returned to GESPERIA
GESPERIA collected $0.25 from pot
*** SUMMARY ***
Total pot $0.25 | Rake $0 
Seat 1: Feverhead folded before Flop (didn't bet)
Seat 2: GESPERIA collected ($0.25)
Seat 4: THIMUCHIN (button) folded before Flop (didn't bet)
Seat 5: YoungGriff86 (small blind) folded before Flop
Seat 6: Goroshkos88 (big blind) folded before Flop



PokerStars Hand #166667557318:  Hold'em No Limit ($0.05/$0.10 USD) - 2017/02/23 16:03:20 ET
Table 'Alnasl' 6-max Seat #5 is the button
Seat 1: KA3AXCTAHEU, ($11.22 in chips) 
Seat 2: XaXaTyH4uK ($10.75 in chips) 
Seat 3: david_sara83 ($22.69 in chips) 
Seat 4: oddshoff ($9.83 in chips) 
Seat 5: steepfell ($10.43 in chips) 
Seat 6: Zooplack ($13.33 in chips) 
Zooplack: posts small blind $0.05
KA3AXCTAHEU,: posts big blind $0.10
*** HOLE CARDS ***
XaXaTyH4uK: folds 
david_sara83: raises $0.20 to $0.30
oddshoff: folds 
steepfell: folds 
Zooplack: folds 
KA3AXCTAHEU,: folds 
Uncalled bet ($0.20) returned to david_sara83
david_sara83 collected $0.25 from pot
*** SUMMARY ***
Total pot $0.25 | Rake $0 
Seat 1: KA3AXCTAHEU, (big blind) folded before Flop
Seat 2: XaXaTyH4uK folded before Flop (didn't bet)
Seat 3: david_sara83 collected ($0.25)
Seat 4: oddshoff folded before Flop (didn't bet)
Seat 5: steepfell (button) folded before Flop (didn't bet)
Seat 6: Zooplack (small blind) folded before Flop



PokerStars Hand #166667557501:  Hold'em No Limit ($0.05/$0.10 USD) - 2017/02/23 16:03:20 ET
Table 'Hamal II' 6-max Seat #5 is the button
Seat 1: saxoalto2011 ($8.64 in chips) 
Seat 2: pancernik21 ($10 in chips) 
Seat 3: Cluckh ($11.24 in chips) 
Seat 4: ArcticBearDK ($10.81 in chips) 
Seat 5: eniksenik ($10.41 in chips) 
Seat 6: LarryTheStar ($11.14 in chips) 
LarryTheStar: posts small blind $0.05
saxoalto2011: posts big blind $0.10
*** HOLE CARDS ***
pancernik21: folds 
Cluckh: folds 
ArcticBearDK: folds 
eniksenik: raises $0.20 to $0.30
LarryTheStar: folds 
saxoalto2011: calls $0.20
*** FLOP *** [Kh 9s 7s]
saxoalto2011: checks 
eniksenik: bets $0.20
saxoalto2011: calls $0.20
*** TURN *** [Kh 9s 7s] [5d]
saxoalto2011: checks 
eniksenik: bets $0.30
saxoalto2011: calls $0.30
*** RIVER *** [Kh 9s 7s 5d] [4d]
saxoalto2011: checks 
eniksenik: checks 
*** SHOW DOWN ***
saxoalto2011: shows [Qc Tc] (high card King)
eniksenik: shows [As 9d] (a pair of Nines)
eniksenik collected $1.58 from pot
*** SUMMARY ***
Total pot $1.65 | Rake $0.07 
Board [Kh 9s 7s 5d 4d]
Seat 1: saxoalto2011 (big blind) showed [Qc Tc] and lost with high card King
Seat 2: pancernik21 folded before Flop (didn't bet)
Seat 3: Cluckh folded before Flop (didn't bet)
Seat 4: ArcticBearDK folded before Flop (didn't bet)
Seat 5: eniksenik (button) showed [As 9d] and won ($1.58) with a pair of Nines
Seat 6: LarryTheStar (small blind) folded before Flop



PokerStars Hand #166667558003:  Hold'em No Limit ($0.05/$0.10 USD) - 2017/02/23 16:03:21 ET
Table 'Marghanna II' 6-max Seat #6 is the button
Seat 2: Namhkal ($11.81 in chips) 
Seat 3: Innerwuss ($11.32 in chips) 
Seat 4: D3NyA ($12.37 in chips) 
Seat 5: ofl21189 ($7.47 in chips) 
Seat 6: VAD21 ($13.11 in chips) 
Goroshkos88 will be allowed to play after the button
Namhkal: posts small blind $0.05
Innerwuss: posts big blind $0.10
*** HOLE CARDS ***
D3NyA: folds 
ofl21189: calls $0.10
VAD21: folds 
Namhkal: raises $0.30 to $0.40
Innerwuss: raises $1 to $1.40
ofl21189: folds 
Namhkal: folds 
Uncalled bet ($1) returned to Innerwuss
Innerwuss collected $0.90 from pot
*** SUMMARY ***
Total pot $0.90 | Rake $0 
Seat 2: Namhkal (small blind) folded before Flop
Seat 3: Innerwuss (big blind) collected ($0.90)
Seat 4: D3NyA folded before Flop (didn't bet)
Seat 5: ofl21189 folded before Flop
Seat 6: VAD21 (button) folded before Flop (didn't bet)



PokerStars Hand #166667558114:  Hold'em No Limit ($0.05/$0.10 USD) - 2017/02/23 16:03:21 ET
Table 'Samitchell III' 6-max Seat #6 is the button
Seat 1: dr.goofy ($10.17 in chips) 
Seat 3: Kow6oy ($10.15 in chips) 
Seat 4: eniksenik ($10.62 in chips) 
Seat 6: fedorka rus ($12.96 in chips) 
dr.goofy: posts small blind $0.05
Orlangoor: is sitting out 
Kow6oy: posts big blind $0.10
*** HOLE CARDS ***
yodzik joins the table at seat #5 
yodzik leaves the table
Orlangoor leaves the table
eniksenik: folds 
fedorka rus: raises $0.20 to $0.30
dr.goofy: folds 
eniksenik leaves the table
Kow6oy: folds 
Uncalled bet ($0.20) returned to fedorka rus
fedorka rus collected $0.25 from pot
*** SUMMARY ***
Total pot $0.25 | Rake $0 
Seat 1: dr.goofy (small blind) folded before Flop
Seat 3: Kow6oy (big blind) folded before Flop
Seat 4: eniksenik folded before Flop (didn't bet)
Seat 6: fedorka rus (button) collected ($0.25)



PokerStars Hand #166667558182:  Hold'em No Limit ($0.05/$0.10 USD) - 2017/02/23 16:03:21 ET
Table 'Lampetia' 6-max Seat #6 is the button
Seat 1: WinninBikini ($10.34 in chips) 
Seat 2: ex3Lero86 ($10 in chips) 
Seat 3: Ice_Isayev ($10.73 in chips) 
Seat 4: Rodik002 ($15.33 in chips) 
Seat 5: luisantrs ($9.33 in chips) 
Seat 6: Scanner17 ($11.76 in chips) 
WinninBikini: posts small blind $0.05
ex3Lero86: posts big blind $0.10
*** HOLE CARDS ***
Ice_Isayev: raises $0.20 to $0.30
Rodik002: raises $0.70 to $1
luisantrs: folds 
Scanner17: folds 
WinninBikini: folds 
ex3Lero86: folds 
Ice_Isayev: raises $1.50 to $2.50
Rodik002: raises $12.83 to $15.33 and is all-in
Ice_Isayev: calls $8.23 and is all-in
Uncalled bet ($4.60) returned to Rodik002
*** FLOP *** [6d 7d 9d]
*** TURN *** [6d 7d 9d] [Qs]
*** RIVER *** [6d 7d 9d Qs] [5s]
*** SHOW DOWN ***
Ice_Isayev: shows [Ah As] (a pair of Aces)
Rodik002: shows [Kh Ks] (a pair of Kings)
Ice_Isayev collected $20.64 from pot
*** SUMMARY ***
Total pot $21.61 | Rake $0.97 
Board [6d 7d 9d Qs 5s]
Seat 1: WinninBikini (small blind) folded before Flop
Seat 2: ex3Lero86 (big blind) folded before Flop
Seat 3: Ice_Isayev showed [Ah As] and won ($20.64) with a pair of Aces
Seat 4: Rodik002 showed [Kh Ks] and lost with a pair of Kings
Seat 5: luisantrs folded before Flop (didn't bet)
Seat 6: Scanner17 (button) folded before Flop (didn't bet)



PokerStars Hand #166667558291:  Hold'em No Limit ($0.05/$0.10 USD) - 2017/02/23 16:03:21 ET
Table 'Cassini' 6-max Seat #1 is the button
Seat 1: Pokeaster ($10.15 in chips) 
Seat 2: mhonielsen ($13.14 in chips) 
Seat 4: fortieth ($13.72 in chips) 
Seat 5: johkom ($7.75 in chips) 
Seat 6: JahSoldier69 ($10 in chips) 
mhonielsen: posts small blind $0.05
fortieth: posts big blind $0.10
*** HOLE CARDS ***
johkom: folds 
JahSoldier69: folds 
Pokeaster: raises $0.15 to $0.25
mhonielsen: calls $0.20
fortieth: folds 
*** FLOP *** [8s 4c 6h]
mhonielsen: bets $0.33
Pokeaster: calls $0.33
*** TURN *** [8s 4c 6h] [4d]
mhonielsen: checks 
Pokeaster: checks 
*** RIVER *** [8s 4c 6h 4d] [Td]
mhonielsen: checks 
Pokeaster: checks 
*** SHOW DOWN ***
mhonielsen: shows [Qc As] (a pair of Fours)
Pokeaster: shows [5s 5c] (two pair, Fives and Fours)
Pokeaster collected $1.20 from pot
*** SUMMARY ***
Total pot $1.26 | Rake $0.06 
Board [8s 4c 6h 4d Td]
Seat 1: Pokeaster (button) showed [5s 5c] and won ($1.20) with two pair, Fives and Fours
Seat 2: mhonielsen (small blind) showed [Qc As] and lost with a pair of Fours
Seat 4: fortieth (big blind) folded before Flop
Seat 5: johkom folded before Flop (didn't bet)
Seat 6: JahSoldier69 folded before Flop (didn't bet)



PokerStars Hand #166667558303:  Hold'em No Limit ($0.05/$0.10 USD) - 2017/02/23 16:03:21 ET
Table 'Arkab' 6-max Seat #4 is the button
Seat 1: iamkakaroto ($10 in chips) 
Seat 2: aktion4ik ($12.39 in chips) 
Seat 3: sexy_seagull ($10 in chips) 
Seat 4: donkucallme ($17.15 in chips) 
Seat 5: OrionYusupov ($10.24 in chips) 
Seat 6: MihaGr ($10 in chips) 
OrionYusupov: posts small blind $0.05
MihaGr: posts big blind $0.10
*** HOLE CARDS ***
iamkakaroto: folds 
aktion4ik: folds 
sexy_seagull: folds 
donkucallme: folds 
OrionYusupov: calls $0.05
MihaGr: raises $0.20 to $0.30
OrionYusupov: calls $0.20
*** FLOP *** [Jc Th Js]
OrionYusupov: bets $0.50
MihaGr: calls $0.50
*** TURN *** [Jc Th Js] [Qc]
OrionYusupov: checks 
MihaGr: bets $0.85
OrionYusupov: folds 
Uncalled bet ($0.85) returned to MihaGr
MihaGr collected $1.53 from pot
*** SUMMARY ***
Total pot $1.60 | Rake $0.07 
Board [Jc Th Js Qc]
Seat 1: iamkakaroto folded before Flop (didn't bet)
Seat 2: aktion4ik folded before Flop (didn't bet)
Seat 3: sexy_seagull folded before Flop (didn't bet)
Seat 4: donkucallme (button) folded before Flop (didn't bet)
Seat 5: OrionYusupov (small blind) folded on the Turn
Seat 6: MihaGr (big blind) collected ($1.53)



PokerStars Hand #166667558343:  Hold'em No Limit ($0.05/$0.10 USD) - 2017/02/23 16:03:21 ET
Table 'Juliet II' 6-max Seat #2 is the button
Seat 1: alexpolevaja ($11.08 in chips) 
Seat 2: KA3AXCTAHEU, ($15.43 in chips) 
Seat 3: patrick19111 ($11.62 in chips) 
Seat 4: x3ultimate ($10 in chips) 
Seat 5: Dcaro31 ($19.02 in chips) 
Seat 6: BookWorm78 ($33.10 in chips) 
patrick19111: posts small blind $0.05
x3ultimate: posts big blind $0.10
*** HOLE CARDS ***
Dcaro31: folds 
BookWorm78: folds 
alexpolevaja: raises $0.10 to $0.20
KA3AXCTAHEU,: folds 
patrick19111: folds 
x3ultimate: folds 
Uncalled bet ($0.10) returned to alexpolevaja
alexpolevaja collected $0.25 from pot
*** SUMMARY ***
Total pot $0.25 | Rake $0 
Seat 1: alexpolevaja collected ($0.25)
Seat 2: KA3AXCTAHEU, (button) folded before Flop (didn't bet)
Seat 3: patrick19111 (small blind) folded before Flop
Seat 4: x3ultimate (big blind) folded before Flop
Seat 5: Dcaro31 folded before Flop (didn't bet)
Seat 6: BookWorm78 folded before Flop (didn't bet)



PokerStars Hand #166667558607:  Hold'em No Limit ($0.05/$0.10 USD) - 2017/02/23 16:03:21 ET
Table 'Atropos' 6-max Seat #3 is the button
Seat 1: ScorpionF39 ($0.88 in chips) 
Seat 3: NvR.m1nD ($10.14 in chips) 
Seat 4: iDecMate ($12.30 in chips) 
Seat 5: KokoulinV ($12.09 in chips) 
Seat 6: Iarlei ($12.20 in chips) 
iDecMate: posts small blind $0.05
KokoulinV: posts big blind $0.10
yodzik: sits out 
*** HOLE CARDS ***
Iarlei: folds 
ScorpionF39: folds 
NvR.m1nD: folds 
iDecMate: folds 
Uncalled bet ($0.05) returned to KokoulinV
KokoulinV collected $0.10 from pot
*** SUMMARY ***
Total pot $0.10 | Rake $0 
Seat 1: ScorpionF39 folded before Flop (didn't bet)
Seat 3: NvR.m1nD (button) folded before Flop (didn't bet)
Seat 4: iDecMate (small blind) folded before Flop
Seat 5: KokoulinV (big blind) collected ($0.10)
Seat 6: Iarlei folded before Flop (didn't bet)



PokerStars Hand #166667558718:  Hold'em No Limit ($0.05/$0.10 USD) - 2017/02/23 16:03:21 ET
Table 'Themisto II' 6-max Seat #2 is the button
Seat 1: kickereens ($12.16 in chips) 
Seat 2: CA225 ($9.81 in chips) 
Seat 3: eniksenik ($11.11 in chips) 
Seat 4: Innerwuss ($10.89 in chips) 
Seat 5: ex3Lero86 ($10.94 in chips) 
Seat 6: noobigrok ($4.45 in chips) 
eniksenik: posts small blind $0.05
Innerwuss: posts big blind $0.10
*** HOLE CARDS ***
ex3Lero86: folds 
noobigrok: calls $0.10
kickereens: calls $0.10
CA225: raises $0.45 to $0.55
eniksenik: folds 
Innerwuss: folds 
noobigrok: folds 
kickereens: calls $0.45
*** FLOP *** [Qd Kh Qh]
kickereens: checks 
CA225: bets $0.60
kickereens: folds 
Uncalled bet ($0.60) returned to CA225
CA225 collected $1.29 from pot
*** SUMMARY ***
Total pot $1.35 | Rake $0.06 
Board [Qd Kh Qh]
Seat 1: kickereens folded on the Flop
Seat 2: CA225 (button) collected ($1.29)
Seat 3: eniksenik (small blind) folded before Flop
Seat 4: Innerwuss (big blind) folded before Flop
Seat 5: ex3Lero86 folded before Flop (didn't bet)
Seat 6: noobigrok folded before Flop



PokerStars Hand #166667558758:  Hold'em No Limit ($0.05/$0.10 USD) - 2017/02/23 16:03:21 ET
Table 'Epimetheus' 6-max Seat #5 is the button
Seat 1: 6ePeMeHHa9 ($10.64 in chips) 
Seat 2: patrick19111 ($15.05 in chips) 
Seat 3: dineldidi ($9.84 in chips) 
Seat 5: afca128 ($24.43 in chips) 
Seat 6: voledy ($10 in chips) 
voledy: posts small blind $0.05
6ePeMeHHa9: posts big blind $0.10
*** HOLE CARDS ***
patrick19111: raises $0.20 to $0.30
dineldidi: folds 
afca128: calls $0.30
voledy: folds 
6ePeMeHHa9: calls $0.20
*** FLOP *** [9d Jc 4h]
6ePeMeHHa9: checks 
patrick19111: bets $0.61
afca128: folds 
6ePeMeHHa9: folds 
Uncalled bet ($0.61) returned to patrick19111
patrick19111 collected $0.91 from pot
*** SUMMARY ***
Total pot $0.95 | Rake $0.04 
Board [9d Jc 4h]
Seat 1: 6ePeMeHHa9 (big blind) folded on the Flop
Seat 2: patrick19111 collected ($0.91)
Seat 3: dineldidi folded before Flop (didn't bet)
Seat 5: afca128 (button) folded on the Flop
Seat 6: voledy (small blind) folded before Flop



PokerStars Hand #166667558985:  Hold'em No Limit ($0.05/$0.10 USD) - 2017/02/23 16:03:22 ET
Table 'Kunigunde II' 6-max Seat #6 is the button
Seat 1: facewald ($10.01 in chips) 
Seat 3: pancernik21 ($14.76 in chips) 
Seat 4: david_sara83 ($12.83 in chips) 
Seat 5: mdelfin0 ($11.59 in chips) 
Seat 6: Zooplack ($10 in chips) 
facewald: posts small blind $0.05
dragonste89: is sitting out 
pancernik21: posts big blind $0.10
*** HOLE CARDS ***
dragonste89 leaves the table
eniksenik joins the table at seat #2 
david_sara83: folds 
mdelfin0: folds 
Zooplack has timed out
Zooplack: folds 
facewald: raises $0.12 to $0.22
pancernik21: raises $0.53 to $0.75
facewald: folds 
Uncalled bet ($0.53) returned to pancernik21
pancernik21 collected $0.44 from pot
*** SUMMARY ***
Total pot $0.44 | Rake $0 
Seat 1: facewald (small blind) folded before Flop
Seat 3: pancernik21 (big blind) collected ($0.44)
Seat 4: david_sara83 folded before Flop (didn't bet)
Seat 5: mdelfin0 folded before Flop (didn't bet)
Seat 6: Zooplack (button) folded before Flop (didn't bet)



PokerStars Hand #166667559242:  Hold'em No Limit ($0.05/$0.10 USD) - 2017/02/23 16:03:22 ET
Table 'Thoas' 6-max Seat #5 is the button
Seat 1: Pekaml ($11.58 in chips) 
Seat 2: themacer24 ($8.52 in chips) 
Seat 3: by.y.y.y86 ($10 in chips) 
Seat 4: Morris_Chair ($17.81 in chips) 
Seat 5: Kow6oy ($10.02 in chips) 
Seat 6: takis nik ($10 in chips) 
takis nik: posts small blind $0.05
Pekaml: posts big blind $0.10
*** HOLE CARDS ***
themacer24: folds 
by.y.y.y86: folds 
Morris_Chair: folds 
Kow6oy: raises $0.20 to $0.30
takis nik: folds 
Pekaml: folds 
Uncalled bet ($0.20) returned to Kow6oy
Kow6oy collected $0.25 from pot
*** SUMMARY ***
Total pot $0.25 | Rake $0 
Seat 1: Pekaml (big blind) folded before Flop
Seat 2: themacer24 folded before Flop (didn't bet)
Seat 3: by.y.y.y86 folded before Flop (didn't bet)
Seat 4: Morris_Chair folded before Flop (didn't bet)
Seat 5: Kow6oy (button) collected ($0.25)
Seat 6: takis nik (small blind) folded before Flop



PokerStars Hand #166667559261:  Hold'em No Limit ($0.05/$0.10 USD) - 2017/02/23 16:03:22 ET
Table 'Caupolican' 6-max Seat #6 is the button
Seat 1: kingartur222 ($11.18 in chips) 
Seat 2: garigura ($19.55 in chips) 
Seat 3: arturgalant ($3.82 in chips) 
Seat 4: mhonielsen ($11.69 in chips) 
Seat 5: Kazacha ($10.80 in chips) 
Seat 6: crazydevill ($10.77 in chips) 
kingartur222: posts small blind $0.05
garigura: posts big blind $0.10
*** HOLE CARDS ***
arturgalant: calls $0.10
mhonielsen: raises $0.50 to $0.60
Kazacha: folds 
crazydevill: folds 
kingartur222: folds 
garigura: calls $0.50
arturgalant: calls $0.50
*** FLOP *** [9c Ac Kd]
garigura: checks 
arturgalant: bets $3.22 and is all-in
mhonielsen: calls $3.22
garigura: folds 
*** TURN *** [9c Ac Kd] [9h]
*** RIVER *** [9c Ac Kd 9h] [6d]
*** SHOW DOWN ***
arturgalant: shows [Td 5d] (a pair of Nines)
mhonielsen: shows [Jh Ah] (two pair, Aces and Nines)
mhonielsen collected $7.92 from pot
*** SUMMARY ***
Total pot $8.29 | Rake $0.37 
Board [9c Ac Kd 9h 6d]
Seat 1: kingartur222 (small blind) folded before Flop
Seat 2: garigura (big blind) folded on the Flop
Seat 3: arturgalant showed [Td 5d] and lost with a pair of Nines
Seat 4: mhonielsen showed [Jh Ah] and won ($7.92) with two pair, Aces and Nines
Seat 5: Kazacha folded before Flop (didn't bet)
Seat 6: crazydevill (button) folded before Flop (didn't bet)



PokerStars Hand #166667559320:  Hold'em No Limit ($0.05/$0.10 USD) - 2017/02/23 16:03:22 ET
Table 'Brendelia II' 6-max Seat #2 is the button
Seat 2: Crimsonr ($5.75 in chips) 
Seat 3: ValdemorS ($18.37 in chips) 
Seat 6: luckyPositiv ($10.15 in chips) 
ValdemorS: posts small blind $0.05
luckyPositiv: posts big blind $0.10
Crimsonr: posts the ante $0.02
ValdemorS: posts the ante $0.02
luckyPositiv: posts the ante $0.02
*** HOLE CARDS ***
Crimsonr: folds 
ValdemorS: folds 
Uncalled bet ($0.05) returned to luckyPositiv
luckyPositiv collected $0.16 from pot
*** SUMMARY ***
Total pot $0.16 | Rake $0 
Seat 2: Crimsonr (button) folded before Flop (didn't bet)
Seat 3: ValdemorS (small blind) folded before Flop
Seat 6: luckyPositiv (big blind) collected ($0.16)



PokerStars Hand #166667559369:  Hold'em No Limit ($0.05/$0.10 USD) - 2017/02/23 16:03:22 ET
Table 'Sham' 6-max Seat #3 is the button
Seat 1: pancernik21 ($10 in chips) 
Seat 2: ex3Lero86 ($10.15 in chips) 
Seat 3: weez3r ($22.68 in chips) 
Seat 4: VAD21 ($13 in chips) 
Seat 5: T9MS ($10.43 in chips) 
Seat 6: bdixon_5 ($9.55 in chips) 
VAD21: posts small blind $0.05
T9MS: posts big blind $0.10
*** HOLE CARDS ***
bdixon_5: folds 
pancernik21: folds 
ex3Lero86: raises $0.15 to $0.25
weez3r: folds 
VAD21: folds 
T9MS: folds 
Uncalled bet ($0.15) returned to ex3Lero86
ex3Lero86 collected $0.25 from pot
*** SUMMARY ***
Total pot $0.25 | Rake $0 
Seat 1: pancernik21 folded before Flop (didn't bet)
Seat 2: ex3Lero86 collected ($0.25)
Seat 3: weez3r (button) folded before Flop (didn't bet)
Seat 4: VAD21 (small blind) folded before Flop
Seat 5: T9MS (big blind) folded before Flop
Seat 6: bdixon_5 folded before Flop (didn't bet)



PokerStars Hand #166667559481:  Hold'em No Limit ($0.05/$0.10 USD) - 2017/02/23 16:03:22 ET
Table 'Tomita II' 6-max Seat #3 is the button
Seat 2: mhonielsen ($10.15 in chips) 
Seat 3: Lucky HoBBiT ($12.01 in chips) 
Seat 4: Hyd SK ($10.05 in chips) 
Hyd SK: posts small blind $0.05
Punzzzer: is sitting out 
mhonielsen: posts big blind $0.10
*** HOLE CARDS ***
Punzzzer leaves the table
Lucky HoBBiT: raises $0.15 to $0.25
Kow6oy joins the table at seat #6 
Hyd SK: folds 
mhonielsen: folds 
Uncalled bet ($0.15) returned to Lucky HoBBiT
Kow6oy leaves the table
Lucky HoBBiT collected $0.25 from pot
*** SUMMARY ***
Total pot $0.25 | Rake $0 
Seat 2: mhonielsen (big blind) folded before Flop
Seat 3: Lucky HoBBiT (button) collected ($0.25)
Seat 4: Hyd SK (small blind) folded before Flop



PokerStars Hand #166667559517:  Hold'em No Limit ($0.05/$0.10 USD) - 2017/02/23 16:03:22 ET
Table 'Syringa' 6-max Seat #3 is the button
Seat 1: bdixon_5 ($7.95 in chips) 
Seat 2: Goroshkos88 ($10.56 in chips) 
Seat 3: Yspenyanin ($13.37 in chips) 
Seat 4: tangler19 ($14.48 in chips) 
Seat 5: Andrei ProFF ($13.31 in chips) 
Seat 6: ibara000 ($16.43 in chips) 
tangler19: posts small blind $0.05
Andrei ProFF: posts big blind $0.10
*** HOLE CARDS ***
ibara000: folds 
bdixon_5: folds 
Goroshkos88: folds 
Yspenyanin: folds 
tangler19: folds 
Uncalled bet ($0.05) returned to Andrei ProFF
Andrei ProFF collected $0.10 from pot
*** SUMMARY ***
Total pot $0.10 | Rake $0 
Seat 1: bdixon_5 folded before Flop (didn't bet)
Seat 2: Goroshkos88 folded before Flop (didn't bet)
Seat 3: Yspenyanin (button) folded before Flop (didn't bet)
Seat 4: tangler19 (small blind) folded before Flop
Seat 5: Andrei ProFF (big blind) collected ($0.10)
Seat 6: ibara000 folded before Flop (didn't bet)



PokerStars Hand #166667559554:  Hold'em No Limit ($0.05/$0.10 USD) - 2017/02/23 16:03:22 ET
Table 'Grietje' 6-max Seat #1 is the button
Seat 1: WinninBikini ($14.63 in chips) 
Seat 2: Feverhead ($13.22 in chips) 
Seat 3: voledy ($10 in chips) 
Seat 4: 6ePeMeHHa9 ($10 in chips) 
Seat 6: Prometheu$8 ($21.20 in chips) 
Feverhead: posts small blind $0.05
voledy: posts big blind $0.10
*** HOLE CARDS ***
Namhkal joins the table at seat #5 
6ePeMeHHa9: folds 
Namhkal leaves the table
Prometheu$8: folds 
WinninBikini: folds 
Feverhead: raises $0.15 to $0.25
voledy: folds 
Uncalled bet ($0.15) returned to Feverhead
Feverhead collected $0.20 from pot
*** SUMMARY ***
Total pot $0.20 | Rake $0 
Seat 1: WinninBikini (button) folded before Flop (didn't bet)
Seat 2: Feverhead (small blind) collected ($0.20)
Seat 3: voledy (big blind) folded before Flop
Seat 4: 6ePeMeHHa9 folded before Flop (didn't bet)
Seat 6: Prometheu$8 folded before Flop (didn't bet)



PokerStars Hand #166667559836:  Hold'em No Limit ($0.05/$0.10 USD) - 2017/02/23 16:03:23 ET
Table 'Pirola III' 6-max Seat #2 is the button
Seat 1: bdixon_5 ($9.47 in chips) 
Seat 2: gaHy_HaXeP ($10 in chips) 
Seat 3: kingartur222 ($10.97 in chips) 
Seat 4: McCleans ($10.45 in chips) 
Seat 6: T9MS ($10 in chips) 
kingartur222: posts small blind $0.05
McCleans: posts big blind $0.10
tequila_joop: sits out 
*** HOLE CARDS ***
T9MS: folds 
bdixon_5: folds 
gaHy_HaXeP: folds 
kingartur222: raises $0.19 to $0.29
McCleans: folds 
Uncalled bet ($0.19) returned to kingartur222
kingartur222 collected $0.20 from pot
*** SUMMARY ***
Total pot $0.20 | Rake $0 
Seat 1: bdixon_5 folded before Flop (didn't bet)
Seat 2: gaHy_HaXeP (button) folded before Flop (didn't bet)
Seat 3: kingartur222 (small blind) collected ($0.20)
Seat 4: McCleans (big blind) folded before Flop
Seat 6: T9MS folded before Flop (didn't bet)



PokerStars Hand #166667559892:  Hold'em No Limit ($0.05/$0.10 USD) - 2017/02/23 16:03:23 ET
Table 'Bootes' 6-max Seat #5 is the button
Seat 1: Namhkal ($13 in chips) 
Seat 2: Bird et al ($19.45 in chips) 
Seat 3: KA3AXCTAHEU, ($19.63 in chips) 
Seat 4: totonove ($4.56 in chips) 
Seat 5: Pekaml ($15.27 in chips) 
cherep61987 will be allowed to play after the button
Namhkal: posts small blind $0.05
Bird et al: posts big blind $0.10
*** HOLE CARDS ***
KA3AXCTAHEU,: folds 
totonove: folds 
Pekaml: raises $0.10 to $0.20
Namhkal: folds 
Bird et al: folds 
Uncalled bet ($0.10) returned to Pekaml
Pekaml collected $0.25 from pot
*** SUMMARY ***
Total pot $0.25 | Rake $0 
Seat 1: Namhkal (small blind) folded before Flop
Seat 2: Bird et al (big blind) folded before Flop
Seat 3: KA3AXCTAHEU, folded before Flop (didn't bet)
Seat 4: totonove folded before Flop (didn't bet)
Seat 5: Pekaml (button) collected ($0.25)



PokerStars Hand #166667560129:  Hold'em No Limit ($0.05/$0.10 USD) - 2017/02/23 16:03:23 ET
Table 'Phereclos II' 6-max Seat #4 is the button
Seat 1: Croplayer1 ($10 in chips) 
Seat 2: Kazacha ($10.28 in chips) 
Seat 3: kickereens ($21.16 in chips) 
Seat 4: DamDatsAnAce ($10.38 in chips) 
Seat 6: mhonielsen ($16.07 in chips) 
mhonielsen: posts small blind $0.05
Croplayer1: posts big blind $0.10
*** HOLE CARDS ***
Kazacha: folds 
kickereens: folds 
DamDatsAnAce: raises $0.15 to $0.25
crazydevill joins the table at seat #5 
mhonielsen: folds 
Croplayer1: folds 
Uncalled bet ($0.15) returned to DamDatsAnAce
DamDatsAnAce collected $0.25 from pot
*** SUMMARY ***
Total pot $0.25 | Rake $0 
Seat 1: Croplayer1 (big blind) folded before Flop
Seat 2: Kazacha folded before Flop (didn't bet)
Seat 3: kickereens folded before Flop (didn't bet)
Seat 4: DamDatsAnAce (button) collected ($0.25)
Seat 6: mhonielsen (small blind) folded before Flop



PokerStars Hand #166667560447:  Hold'em No Limit ($0.05/$0.10 USD) - 2017/02/23 16:03:23 ET
Table 'Senta II' 6-max Seat #4 is the button
Seat 2: NvR.m1nD ($11.30 in chips) 
Seat 3: Aescul@pius ($21.25 in chips) 
Seat 4: fedorka rus ($21.24 in chips) 
Seat 5: Algarah ($5.94 in chips) 
Seat 6: T9MS ($11.92 in chips) 
Algarah: posts small blind $0.05
T9MS: posts big blind $0.10
*** HOLE CARDS ***
NvR.m1nD: folds 
Aescul@pius: raises $0.15 to $0.25
fedorka rus: folds 
Algarah: calls $0.20
T9MS: calls $0.15
*** FLOP *** [5s Kc 4s]
Algarah: checks 
T9MS: checks 
Aescul@pius: bets $0.45
Algarah: calls $0.45
T9MS: folds 
*** TURN *** [5s Kc 4s] [3s]
Algarah: checks 
Aescul@pius: checks 
*** RIVER *** [5s Kc 4s 3s] [3h]
Algarah: bets $0.80
Aescul@pius: folds 
Uncalled bet ($0.80) returned to Algarah
Algarah collected $1.58 from pot
*** SUMMARY ***
Total pot $1.65 | Rake $0.07 
Board [5s Kc 4s 3s 3h]
Seat 2: NvR.m1nD folded before Flop (didn't bet)
Seat 3: Aescul@pius folded on the River
Seat 4: fedorka rus (button) folded before Flop (didn't bet)
Seat 5: Algarah (small blind) collected ($1.58)
Seat 6: T9MS (big blind) folded on the Flop



PokerStars Hand #166667560571:  Hold'em No Limit ($0.05/$0.10 USD) - 2017/02/23 16:03:23 ET
Table 'Aisakos II' 6-max Seat #6 is the button
Seat 1: Crafty23@PS ($10 in chips) 
Seat 2: svaika24 ($16.93 in chips) 
Seat 3: iamkakaroto ($10.69 in chips) 
Seat 4: T9MS ($10 in chips) 
Seat 5: KokoulinV ($12.40 in chips) 
Seat 6: LarryTheStar ($10 in chips) 
Crafty23@PS: posts small blind $0.05
svaika24: posts big blind $0.10
*** HOLE CARDS ***
iamkakaroto: folds 
T9MS: folds 
KokoulinV: folds 
LarryTheStar: folds 
Crafty23@PS: folds 
Uncalled bet ($0.05) returned to svaika24
svaika24 collected $0.10 from pot
*** SUMMARY ***
Total pot $0.10 | Rake $0 
Seat 1: Crafty23@PS (small blind) folded before Flop
Seat 2: svaika24 (big blind) collected ($0.10)
Seat 3: iamkakaroto folded before Flop (didn't bet)
Seat 4: T9MS folded before Flop (didn't bet)
Seat 5: KokoulinV folded before Flop (didn't bet)
Seat 6: LarryTheStar (button) folded before Flop (didn't bet)



PokerStars Hand #166667560650:  Hold'em No Limit ($0.05/$0.10 USD) - 2017/02/23 16:03:23 ET
Table 'Vaisala' 6-max Seat #5 is the button
Seat 1: Pekaml ($10.15 in chips) 
Seat 2: XaXaTyH4uK ($10 in chips) 
Seat 3: x3ultimate ($10 in chips) 
Seat 4: sexy_seagull ($11.53 in chips) 
Seat 5: AIONCMA1988 ($6.10 in chips) 
Seat 6: Aleksey K228 ($15.33 in chips) 
Aleksey K228: posts small blind $0.05
Pekaml: posts big blind $0.10
*** HOLE CARDS ***
XaXaTyH4uK: folds 
x3ultimate: raises $0.20 to $0.30
sexy_seagull: folds 
AIONCMA1988: folds 
Aleksey K228: folds 
Pekaml: folds 
Uncalled bet ($0.20) returned to x3ultimate
x3ultimate collected $0.25 from pot
*** SUMMARY ***
Total pot $0.25 | Rake $0 
Seat 1: Pekaml (big blind) folded before Flop
Seat 2: XaXaTyH4uK folded before Flop (didn't bet)
Seat 3: x3ultimate collected ($0.25)
Seat 4: sexy_seagull folded before Flop (didn't bet)
Seat 5: AIONCMA1988 (button) folded before Flop (didn't bet)
Seat 6: Aleksey K228 (small blind) folded before Flop



PokerStars Hand #166667560737:  Hold'em No Limit ($0.05/$0.10 USD) - 2017/02/23 16:03:24 ET
Table 'Gyldenia II' 6-max Seat #1 is the button
Seat 1: KokoulinV ($10.40 in chips) 
Seat 2: Bandyaev ($11.14 in chips) 
Seat 3: ex3Lero86 ($23.37 in chips) 
Seat 5: CHRO8 ($17.41 in chips) 
Seat 6: 8th wonders ($10 in chips) 
Bandyaev: posts small blind $0.05
ex3Lero86: posts big blind $0.10
*** HOLE CARDS ***
CHRO8: folds 
8th wonders: folds 
KokoulinV: folds 
Bandyaev: folds 
Uncalled bet ($0.05) returned to ex3Lero86
ex3Lero86 collected $0.10 from pot
*** SUMMARY ***
Total pot $0.10 | Rake $0 
Seat 1: KokoulinV (button) folded before Flop (didn't bet)
Seat 2: Bandyaev (small blind) folded before Flop
Seat 3: ex3Lero86 (big blind) collected ($0.10)
Seat 5: CHRO8 folded before Flop (didn't bet)
Seat 6: 8th wonders folded before Flop (didn't bet)



PokerStars Hand #166667561361:  Hold'em No Limit ($0.05/$0.10 USD) - 2017/02/23 16:03:24 ET
Table 'Nymphe II' 6-max Seat #6 is the button
Seat 1: jacktayra ($4.51 in chips) 
Seat 2: Newqbrown ($10.30 in chips) 
Seat 3: THIMUCHIN ($14.05 in chips) 
Seat 4: coolisses111 ($18.45 in chips) 
Seat 5: Yspenyanin ($10.94 in chips) 
Seat 6: Xander188 ($18.08 in chips) 
jacktayra: posts small blind $0.05
Newqbrown: posts big blind $0.10
*** HOLE CARDS ***
THIMUCHIN: raises $0.20 to $0.30
coolisses111: calls $0.30
Yspenyanin: folds 
Xander188: folds 
jacktayra: calls $0.25
Newqbrown: folds 
*** FLOP *** [4s Kh Ad]
jacktayra: checks 
THIMUCHIN: bets $0.60
coolisses111: folds 
jacktayra: folds 
Uncalled bet ($0.60) returned to THIMUCHIN
THIMUCHIN collected $0.96 from pot
*** SUMMARY ***
Total pot $1 | Rake $0.04 
Board [4s Kh Ad]
Seat 1: jacktayra (small blind) folded on the Flop
Seat 2: Newqbrown (big blind) folded before Flop
Seat 3: THIMUCHIN collected ($0.96)
Seat 4: coolisses111 folded on the Flop
Seat 5: Yspenyanin folded before Flop (didn't bet)
Seat 6: Xander188 (button) folded before Flop (didn't bet)



PokerStars Hand #166667561403:  Hold'em No Limit ($0.05/$0.10 USD) - 2017/02/23 16:03:24 ET
Table 'Lagrula' 6-max Seat #1 is the button
Seat 1: Ice_Isayev ($10 in chips) 
Seat 3: micke667 ($15.73 in chips) 
Seat 4: Calimero2408 ($5.74 in chips) 
Seat 5: Iarlei ($10 in chips) 
Seat 6: Spud014 ($10.95 in chips) 
KRZuff will be allowed to play after the button
micke667: posts small blind $0.05
Calimero2408: posts big blind $0.10
*** HOLE CARDS ***
Iarlei: folds 
Spud014: raises $0.40 to $0.50
Ice_Isayev: folds 
micke667: folds 
Calimero2408: calls $0.40
*** FLOP *** [6c Ac Kc]
Calimero2408: checks 
Spud014: bets $0.50
Calimero2408: folds 
Uncalled bet ($0.50) returned to Spud014
Spud014 collected $1 from pot
*** SUMMARY ***
Total pot $1.05 | Rake $0.05 
Board [6c Ac Kc]
Seat 1: Ice_Isayev (button) folded before Flop (didn't bet)
Seat 3: micke667 (small blind) folded before Flop
Seat 4: Calimero2408 (big blind) folded on the Flop
Seat 5: Iarlei folded before Flop (didn't bet)
Seat 6: Spud014 collected ($1)



PokerStars Hand #166667561415:  Hold'em No Limit ($0.05/$0.10 USD) - 2017/02/23 16:03:24 ET
Table 'Kochera' 6-max Seat #5 is the button
Seat 1: chimera252 ($11.65 in chips) 
Seat 2: bartabs2 ($10.61 in chips) 
Seat 3: KA3AXCTAHEU, ($10.25 in chips) 
Seat 4: johkom ($5.46 in chips) 
Seat 5: univibe68 ($11.85 in chips) 
Seat 6: oddshoff ($9.38 in chips) 
oddshoff: posts small blind $0.05
chimera252: posts big blind $0.10
*** HOLE CARDS ***
bartabs2: folds 
KA3AXCTAHEU,: folds 
johkom: folds 
univibe68: folds 
oddshoff: raises $0.10 to $0.20
chimera252: folds 
Uncalled bet ($0.10) returned to oddshoff
oddshoff collected $0.20 from pot
*** SUMMARY ***
Total pot $0.20 | Rake $0 
Seat 1: chimera252 (big blind) folded before Flop
Seat 2: bartabs2 folded before Flop (didn't bet)
Seat 3: KA3AXCTAHEU, folded before Flop (didn't bet)
Seat 4: johkom folded before Flop (didn't bet)
Seat 5: univibe68 (button) folded before Flop (didn't bet)
Seat 6: oddshoff (small blind) collected ($0.20)



PokerStars Hand #166667562032:  Hold'em No Limit ($0.05/$0.10 USD) - 2017/02/23 16:03:25 ET
Table 'Pulcova II' 6-max Seat #6 is the button
Seat 1: sexy_seagull ($10 in chips) 
Seat 2: Kazacha ($10 in chips) 
Seat 3: Lao Tsy ($14.28 in chips) 
Seat 4: VioXion ($10.25 in chips) 
Seat 5: mdelfin0 ($12.74 in chips) 
Seat 6: Ice_Isayev ($10.65 in chips) 
sexy_seagull: posts small blind $0.05
Kazacha: posts big blind $0.10
*** HOLE CARDS ***
Lao Tsy: folds 
VioXion: folds 
mdelfin0: raises $0.15 to $0.25
Ice_Isayev: folds 
sexy_seagull: folds 
Kazacha: folds 
Uncalled bet ($0.15) returned to mdelfin0
mdelfin0 collected $0.25 from pot
*** SUMMARY ***
Total pot $0.25 | Rake $0 
Seat 1: sexy_seagull (small blind) folded before Flop
Seat 2: Kazacha (big blind) folded before Flop
Seat 3: Lao Tsy folded before Flop (didn't bet)
Seat 4: VioXion folded before Flop (didn't bet)
Seat 5: mdelfin0 collected ($0.25)
Seat 6: Ice_Isayev (button) folded before Flop (didn't bet)



PokerStars Hand #166667562281:  Hold'em No Limit ($0.05/$0.10 USD) - 2017/02/23 16:03:25 ET
Table 'Mesarthim' 6-max Seat #2 is the button
Seat 1: Mancuso2010 ($16.30 in chips) 
Seat 2: MühliJr ($10.78 in chips) 
Seat 3: Damage514 ($9.12 in chips) 
Seat 4: Strelok1974 ($10.51 in chips) 
Seat 5: Iarlei ($11.05 in chips) 
Seat 6: bdixon_5 ($8.96 in chips) 
Damage514: posts small blind $0.05
Strelok1974: posts big blind $0.10
*** HOLE CARDS ***
Iarlei: folds 
bdixon_5: folds 
Mancuso2010: folds 
MühliJr: raises $0.15 to $0.25
Damage514: calls $0.20
Strelok1974: folds 
*** FLOP *** [9h 6s Ts]
Damage514: bets $0.50
MühliJr: calls $0.50
*** TURN *** [9h 6s Ts] [4c]
Damage514: bets $0.50
MühliJr: calls $0.50
*** RIVER *** [9h 6s Ts 4c] [Tc]
Damage514: bets $7.87 and is all-in
MühliJr: folds [Th]
Uncalled bet ($7.87) returned to Damage514
Damage514 collected $2.48 from pot
*** SUMMARY ***
Total pot $2.60 | Rake $0.12 
Board [9h 6s Ts 4c Tc]
Seat 1: Mancuso2010 folded before Flop (didn't bet)
Seat 2: MühliJr (button) folded on the River
Seat 3: Damage514 (small blind) collected ($2.48)
Seat 4: Strelok1974 (big blind) folded before Flop
Seat 5: Iarlei folded before Flop (didn't bet)
Seat 6: bdixon_5 folded before Flop (didn't bet)



PokerStars Hand #166667562608:  Hold'em No Limit ($0.05/$0.10 USD) - 2017/02/23 16:03:25 ET
Table 'Pyrrhus III' 6-max Seat #1 is the button
Seat 1: skatejeff ($10 in chips) 
Seat 2: univibe68 ($20.43 in chips) 
Seat 3: coolisses111 ($9.73 in chips) 
Seat 4: ex3Lero86 ($22.32 in chips) 
Seat 5: mAEgar ($4.99 in chips) 
Seat 6: MLPlayer16 ($19.84 in chips) 
univibe68: posts small blind $0.05
coolisses111: posts big blind $0.10
skatejeff: posts the ante $0.02
univibe68: posts the ante $0.02
coolisses111: posts the ante $0.02
ex3Lero86: posts the ante $0.02
mAEgar: posts the ante $0.02
MLPlayer16: posts the ante $0.02
*** HOLE CARDS ***
ex3Lero86: folds 
mAEgar: calls $0.10
MLPlayer16: folds 
skatejeff: folds 
univibe68: folds 
coolisses111: raises $0.50 to $0.60
mAEgar: folds 
Uncalled bet ($0.50) returned to coolisses111
coolisses111 collected $0.37 from pot
*** SUMMARY ***
Total pot $0.37 | Rake $0 
Seat 1: skatejeff (button) folded before Flop (didn't bet)
Seat 2: univibe68 (small blind) folded before Flop
Seat 3: coolisses111 (big blind) collected ($0.37)
Seat 4: ex3Lero86 folded before Flop (didn't bet)
Seat 5: mAEgar folded before Flop
Seat 6: MLPlayer16 folded before Flop (didn't bet)



PokerStars Hand #166667562770:  Hold'em No Limit ($0.05/$0.10 USD) - 2017/02/23 16:03:26 ET
Table 'Lampetia III' 6-max Seat #1 is the button
Seat 1: gaHy_HaXeP ($10.30 in chips) 
Seat 2: DamDatsAnAce ($10 in chips) 
Seat 3: Therodorus ($10 in chips) 
Seat 4: IAntikI ($11.36 in chips) 
Seat 5: robson1235 ($19.55 in chips) 
Seat 6: bdixon_5 ($9.35 in chips) 
DamDatsAnAce: posts small blind $0.05
Therodorus: posts big blind $0.10
*** HOLE CARDS ***
IAntikI: folds 
robson1235: folds 
bdixon_5: folds 
gaHy_HaXeP: raises $0.12 to $0.22
DamDatsAnAce: folds 
Therodorus: calls $0.12
*** FLOP *** [9c 2c 4d]
Therodorus: checks 
gaHy_HaXeP: bets $0.31
Therodorus: folds 
Uncalled bet ($0.31) returned to gaHy_HaXeP
gaHy_HaXeP collected $0.47 from pot
*** SUMMARY ***
Total pot $0.49 | Rake $0.02 
Board [9c 2c 4d]
Seat 1: gaHy_HaXeP (button) collected ($0.47)
Seat 2: DamDatsAnAce (small blind) folded before Flop
Seat 3: Therodorus (big blind) folded on the Flop
Seat 4: IAntikI folded before Flop (didn't bet)
Seat 5: robson1235 folded before Flop (didn't bet)
Seat 6: bdixon_5 folded before Flop (didn't bet)



PokerStars Hand #166667562814:  Hold'em No Limit ($0.05/$0.10 USD) - 2017/02/23 16:03:26 ET
Table 'Lehigh' 6-max Seat #1 is the button
Seat 1: kowe4ka565 ($11.03 in chips) 
Seat 3: Therodorus ($10 in chips) 
Seat 4: Chodemuncher ($10.20 in chips) 
Seat 5: Xander188 ($10 in chips) 
Seat 6: CallByValue ($9.45 in chips) 
Sbozzz will be allowed to play after the button
Therodorus: posts small blind $0.05
Chodemuncher: posts big blind $0.10
*** HOLE CARDS ***
Xander188: raises $0.20 to $0.30
CallByValue: folds 
kowe4ka565: folds 
Therodorus: folds 
Chodemuncher: folds 
Uncalled bet ($0.20) returned to Xander188
Xander188 collected $0.25 from pot
*** SUMMARY ***
Total pot $0.25 | Rake $0 
Seat 1: kowe4ka565 (button) folded before Flop (didn't bet)
Seat 3: Therodorus (small blind) folded before Flop
Seat 4: Chodemuncher (big blind) folded before Flop
Seat 5: Xander188 collected ($0.25)
Seat 6: CallByValue folded before Flop (didn't bet)



PokerStars Hand #166667563775:  Hold'em No Limit ($0.05/$0.10 USD) - 2017/02/23 16:03:27 ET
Table 'Girtab' 6-max Seat #4 is the button
Seat 1: pokekrk ($13.56 in chips) 
Seat 2: MühliJr ($10.06 in chips) 
Seat 3: kingartur222 ($10.35 in chips) 
Seat 4: Hyd SK ($11.50 in chips) 
Seat 5: sexy_seagull ($10.77 in chips) 
sexy_seagull: posts small blind $0.05
BahiaMinhaP: is sitting out 
pokekrk: posts big blind $0.10
*** HOLE CARDS ***
MühliJr: folds 
kingartur222: raises $0.15 to $0.25
Hyd SK: folds 
sexy_seagull: folds 
pokekrk: folds 
Uncalled bet ($0.15) returned to kingartur222
kingartur222 collected $0.25 from pot
*** SUMMARY ***
Total pot $0.25 | Rake $0 
Seat 1: pokekrk (big blind) folded before Flop
Seat 2: MühliJr folded before Flop (didn't bet)
Seat 3: kingartur222 collected ($0.25)
Seat 4: Hyd SK (button) folded before Flop (didn't bet)
Seat 5: sexy_seagull (small blind) folded before Flop



PokerStars Hand #166667563825:  Hold'em No Limit ($0.05/$0.10 USD) - 2017/02/23 16:03:27 ET
Table 'Lobelia II' 6-max Seat #3 is the button
Seat 1: facewald ($20.64 in chips) 
Seat 2: Dcaro31 ($18.14 in chips) 
Seat 3: oddshoff ($19.40 in chips) 
Seat 5: Feverhead ($20.33 in chips) 
Seat 6: NvR.m1nD ($10 in chips) 
Feverhead: posts small blind $0.05
NvR.m1nD: posts big blind $0.10
*** HOLE CARDS ***
facewald: folds 
Dcaro31: raises $0.20 to $0.30
oddshoff: folds 
Feverhead: folds 
NvR.m1nD: calls $0.20
*** FLOP *** [3h Kc Tc]
NvR.m1nD: bets $0.41
Dcaro31: folds 
Uncalled bet ($0.41) returned to NvR.m1nD
NvR.m1nD collected $0.62 from pot
*** SUMMARY ***
Total pot $0.65 | Rake $0.03 
Board [3h Kc Tc]
Seat 1: facewald folded before Flop (didn't bet)
Seat 2: Dcaro31 folded on the Flop
Seat 3: oddshoff (button) folded before Flop (didn't bet)
Seat 5: Feverhead (small blind) folded before Flop
Seat 6: NvR.m1nD (big blind) collected ($0.62)



PokerStars Hand #166667563963:  Hold'em No Limit ($0.05/$0.10 USD) - 2017/02/23 16:03:27 ET
Table 'Ebella II' 6-max Seat #2 is the button
Seat 1: gaHy_HaXeP ($10 in chips) 
Seat 2: Therodorus ($10 in chips) 
Seat 3: Torften2 ($15.63 in chips) 
Seat 4: ValdemorS ($11.20 in chips) 
Seat 5: Bird et al ($10 in chips) 
Seat 6: Joker51_wtf! ($10 in chips) 
Torften2: posts small blind $0.05
ValdemorS: posts big blind $0.10
*** HOLE CARDS ***
Bird et al: folds 
Joker51_wtf!: raises $0.16 to $0.26
gaHy_HaXeP: folds 
Therodorus: calls $0.26
Torften2: folds 
ValdemorS: folds 
*** FLOP *** [5s Ts 9h]
Joker51_wtf!: checks 
Therodorus: checks 
*** TURN *** [5s Ts 9h] [3d]
Joker51_wtf!: bets $0.40
Therodorus: calls $0.40
*** RIVER *** [5s Ts 9h 3d] [Th]
Joker51_wtf!: bets $0.71
Therodorus: calls $0.71
*** SHOW DOWN ***
Joker51_wtf!: shows [Qs 9s] (two pair, Tens and Nines)
Therodorus: mucks hand 
Joker51_wtf! collected $2.76 from pot
*** SUMMARY ***
Total pot $2.89 | Rake $0.13 
Board [5s Ts 9h 3d Th]
Seat 1: gaHy_HaXeP folded before Flop (didn't bet)
Seat 2: Therodorus (button) mucked
Seat 3: Torften2 (small blind) folded before Flop
Seat 4: ValdemorS (big blind) folded before Flop
Seat 5: Bird et al folded before Flop (didn't bet)
Seat 6: Joker51_wtf! showed [Qs 9s] and won ($2.76) with two pair, Tens and Nines



PokerStars Hand #166667564093:  Hold'em No Limit ($0.05/$0.10 USD) - 2017/02/23 16:03:27 ET
Table 'Stroobantia' 6-max Seat #5 is the button
Seat 1: mam9zyc ($8.74 in chips) 
Seat 2: XwinX25 ($10.34 in chips) 
Seat 3: Namhkal ($10 in chips) 
Seat 4: Yspenyanin ($10.13 in chips) 
Seat 5: boxer821 ($10.49 in chips) 
Seat 6: KokoulinV ($15.57 in chips) 
KokoulinV: posts small blind $0.05
mam9zyc: posts big blind $0.10
*** HOLE CARDS ***
XwinX25: raises $0.20 to $0.30
Namhkal: calls $0.30
Yspenyanin: folds 
boxer821: raises $0.90 to $1.20
KokoulinV: folds 
mam9zyc: folds 
XwinX25: folds 
Namhkal: folds 
Uncalled bet ($0.90) returned to boxer821
boxer821 collected $1.05 from pot
*** SUMMARY ***
Total pot $1.05 | Rake $0 
Seat 1: mam9zyc (big blind) folded before Flop
Seat 2: XwinX25 folded before Flop
Seat 3: Namhkal folded before Flop
Seat 4: Yspenyanin folded before Flop (didn't bet)
Seat 5: boxer821 (button) collected ($1.05)
Seat 6: KokoulinV (small blind) folded before Flop



PokerStars Hand #166667564198:  Hold'em No Limit ($0.05/$0.10 USD) - 2017/02/23 16:03:27 ET
Table 'Apollonia' 6-max Seat #3 is the button
Seat 1: ex3Lero86 ($10.11 in chips) 
Seat 2: ibara000 ($18.84 in chips) 
Seat 3: derbesteojr ($9.35 in chips) 
Seat 4: Goroshkos88 ($17.36 in chips) 
Seat 5: EphemeralBen ($13.49 in chips) 
Seat 6: Namhkal ($10.40 in chips) 
Goroshkos88: posts small blind $0.05
EphemeralBen: posts big blind $0.10
*** HOLE CARDS ***
Namhkal: folds 
ex3Lero86: folds 
ibara000: folds 
derbesteojr: raises $0.20 to $0.30
Goroshkos88: folds 
EphemeralBen: raises $0.70 to $1
derbesteojr: calls $0.70
*** FLOP *** [3h 2d Ad]
EphemeralBen: bets $1.10
derbesteojr: calls $1.10
*** TURN *** [3h 2d Ad] [7d]
EphemeralBen: bets $2.20
derbesteojr: calls $2.20
*** RIVER *** [3h 2d Ad 7d] [8s]
EphemeralBen: bets $9.19 and is all-in
derbesteojr: calls $5.05 and is all-in
Uncalled bet ($4.14) returned to EphemeralBen
*** SHOW DOWN ***
EphemeralBen: shows [Ks As] (a pair of Aces)
derbesteojr: shows [9c Ac] (a pair of Aces - lower kicker)
EphemeralBen collected $17.91 from pot
*** SUMMARY ***
Total pot $18.75 | Rake $0.84 
Board [3h 2d Ad 7d 8s]
Seat 1: ex3Lero86 folded before Flop (didn't bet)
Seat 2: ibara000 folded before Flop (didn't bet)
Seat 3: derbesteojr (button) showed [9c Ac] and lost with a pair of Aces
Seat 4: Goroshkos88 (small blind) folded before Flop
Seat 5: EphemeralBen (big blind) showed [Ks As] and won ($17.91) with a pair of Aces
Seat 6: Namhkal folded before Flop (didn't bet)



PokerStars Hand #166667564300:  Hold'em No Limit ($0.05/$0.10 USD) - 2017/02/23 16:03:27 ET
Table 'Sinon II' 6-max Seat #1 is the button
Seat 1: Aescul@pius ($10 in chips) 
Seat 2: ÄissesHai ($15.39 in chips) 
Seat 3: crazydevill ($10.78 in chips) 
Seat 4: Bandyaev ($15.48 in chips) 
Seat 5: ab260414 ($11.06 in chips) 
Seat 6: hartmut2012 ($5.98 in chips) 
ÄissesHai: posts small blind $0.05
crazydevill: posts big blind $0.10
*** HOLE CARDS ***
Bandyaev: folds 
ab260414: folds 
hartmut2012: calls $0.10
Aescul@pius: raises $0.30 to $0.40
ÄissesHai: calls $0.35
crazydevill: folds 
hartmut2012: calls $0.30
*** FLOP *** [Tc 4h 6d]
ÄissesHai: bets $0.30
hartmut2012: calls $0.30
Aescul@pius: calls $0.30
*** TURN *** [Tc 4h 6d] [6c]
ÄissesHai: bets $0.30
hartmut2012: folds 
Aescul@pius: calls $0.30
*** RIVER *** [Tc 4h 6d 6c] [5d]
ÄissesHai: bets $0.10
Aescul@pius: calls $0.10
*** SHOW DOWN ***
ÄissesHai: shows [Qh Th] (two pair, Tens and Sixes)
Aescul@pius: mucks hand 
ÄissesHai collected $2.86 from pot
*** SUMMARY ***
Total pot $3 | Rake $0.14 
Board [Tc 4h 6d 6c 5d]
Seat 1: Aescul@pius (button) mucked
Seat 2: ÄissesHai (small blind) showed [Qh Th] and won ($2.86) with two pair, Tens and Sixes
Seat 3: crazydevill (big blind) folded before Flop
Seat 4: Bandyaev folded before Flop (didn't bet)
Seat 5: ab260414 folded before Flop (didn't bet)
Seat 6: hartmut2012 folded on the Turn



PokerStars Hand #166667564419:  Hold'em No Limit ($0.05/$0.10 USD) - 2017/02/23 16:03:28 ET
Table 'Atalante' 6-max Seat #5 is the button
Seat 1: OceanBlue100 ($5.24 in chips) 
Seat 2: CiisCi ($19.77 in chips) 
Seat 3: Kow6oy ($10 in chips) 
Seat 4: Dcaro31 ($25.07 in chips) 
Seat 5: eniksenik ($10.29 in chips) 
Seat 6: FlopsterGB ($30.28 in chips) 
FlopsterGB: posts small blind $0.05
OceanBlue100: posts big blind $0.10
*** HOLE CARDS ***
CiisCi: raises $0.25 to $0.35
Kow6oy: folds 
Dcaro31: folds 
eniksenik: folds 
FlopsterGB: folds 
OceanBlue100: folds 
Uncalled bet ($0.25) returned to CiisCi
CiisCi collected $0.25 from pot
*** SUMMARY ***
Total pot $0.25 | Rake $0 
Seat 1: OceanBlue100 (big blind) folded before Flop
Seat 2: CiisCi collected ($0.25)
Seat 3: Kow6oy folded before Flop (didn't bet)
Seat 4: Dcaro31 folded before Flop (didn't bet)
Seat 5: eniksenik (button) folded before Flop (didn't bet)
Seat 6: FlopsterGB (small blind) folded before Flop



PokerStars Hand #166667565226:  Hold'em No Limit ($0.05/$0.10 USD) - 2017/02/23 16:03:28 ET
Table 'Aegle' 6-max Seat #4 is the button
Seat 1: phatts76 ($3.90 in chips) 
Seat 2: yodzik ($5 in chips) 
Seat 3: DrejAtom ($11.72 in chips) 
Seat 4: ab260414 ($11.17 in chips) 
Seat 5: KokoulinV ($11.03 in chips) 
Seat 6: CHRO8 ($20.59 in chips) 
KokoulinV: posts small blind $0.05
CHRO8: posts big blind $0.10
*** HOLE CARDS ***
phatts76: folds 
yodzik: folds 
DrejAtom: raises $0.10 to $0.20
ab260414: raises $0.60 to $0.80
KokoulinV: folds 
CHRO8: folds 
DrejAtom: calls $0.60
*** FLOP *** [2d 3s 5s]
DrejAtom: checks 
ab260414: checks 
*** TURN *** [2d 3s 5s] [Qd]
DrejAtom: bets $0.80
ab260414: folds 
Uncalled bet ($0.80) returned to DrejAtom
DrejAtom collected $1.67 from pot
*** SUMMARY ***
Total pot $1.75 | Rake $0.08 
Board [2d 3s 5s Qd]
Seat 1: phatts76 folded before Flop (didn't bet)
Seat 2: yodzik folded before Flop (didn't bet)
Seat 3: DrejAtom collected ($1.67)
Seat 4: ab260414 (button) folded on the Turn
Seat 5: KokoulinV (small blind) folded before Flop
Seat 6: CHRO8 (big blind) folded before Flop



PokerStars Hand #166667565383:  Hold'em No Limit ($0.05/$0.10 USD) - 2017/02/23 16:03:29 ET
Table 'Lederle' 6-max Seat #5 is the button
Seat 2: truck1234 ($15.85 in chips) 
Seat 3: Kazacha ($10.50 in chips) 
Seat 4: Pokeaster ($13.76 in chips) 
Seat 5: 8th wonders ($14.01 in chips) 
Seat 6: pokekrk ($10.05 in chips) 
pokekrk: posts small blind $0.05
truck1234: posts big blind $0.10
*** HOLE CARDS ***
Kazacha: folds 
Pokeaster: folds 
8th wonders: raises $0.20 to $0.30
pokekrk: folds 
truck1234: folds 
Uncalled bet ($0.20) returned to 8th wonders
8th wonders collected $0.25 from pot
*** SUMMARY ***
Total pot $0.25 | Rake $0 
Seat 2: truck1234 (big blind) folded before Flop
Seat 3: Kazacha folded before Flop (didn't bet)
Seat 4: Pokeaster folded before Flop (didn't bet)
Seat 5: 8th wonders (button) collected ($0.25)
Seat 6: pokekrk (small blind) folded before Flop



PokerStars Hand #166667565521:  Hold'em No Limit ($0.05/$0.10 USD) - 2017/02/23 16:03:29 ET
Table 'Crommelin II' 6-max Seat #4 is the button
Seat 1: THIMUCHIN ($11.07 in chips) 
Seat 2: Bird et al ($10 in chips) 
Seat 3: Strelok1974 ($21.95 in chips) 
Seat 4: Pequeño Clau ($10 in chips) 
Seat 5: Action_Gibi ($20.24 in chips) 
Action_Gibi: posts small blind $0.05
Darkfrai: is sitting out 
THIMUCHIN: posts big blind $0.10
*** HOLE CARDS ***
Bird et al: folds 
Strelok1974: folds 
Pequeño Clau: raises $0.20 to $0.30
Action_Gibi: calls $0.25
THIMUCHIN: raises $1 to $1.30
Pequeño Clau: folds 
Action_Gibi: folds 
Uncalled bet ($1) returned to THIMUCHIN
THIMUCHIN collected $0.90 from pot
*** SUMMARY ***
Total pot $0.90 | Rake $0 
Seat 1: THIMUCHIN (big blind) collected ($0.90)
Seat 2: Bird et al folded before Flop (didn't bet)
Seat 3: Strelok1974 folded before Flop (didn't bet)
Seat 4: Pequeño Clau (button) folded before Flop
Seat 5: Action_Gibi (small blind) folded before Flop



PokerStars Hand #166667565579:  Hold'em No Limit ($0.05/$0.10 USD) - 2017/02/23 16:03:29 ET
Table 'Brambilla II' 6-max Seat #2 is the button
Seat 1: Rodik002 ($12.87 in chips) 
Seat 2: dwonder75 ($13.79 in chips) 
Seat 3: BORIS_ENEV ($14.29 in chips) 
Seat 4: david_sara83 ($12.07 in chips) 
Seat 5: FRAID358 ($10 in chips) 
Seat 6: boxer821 ($10.48 in chips) 
BORIS_ENEV: posts small blind $0.05
david_sara83: posts big blind $0.10
*** HOLE CARDS ***
FRAID358: folds 
boxer821: folds 
Rodik002: folds 
dwonder75: folds 
BORIS_ENEV: calls $0.05
david_sara83: checks 
*** FLOP *** [5h 6c Qs]
BORIS_ENEV: bets $0.10
david_sara83: calls $0.10
*** TURN *** [5h 6c Qs] [Qh]
BORIS_ENEV: bets $0.30
david_sara83: folds 
Uncalled bet ($0.30) returned to BORIS_ENEV
BORIS_ENEV collected $0.38 from pot
*** SUMMARY ***
Total pot $0.40 | Rake $0.02 
Board [5h 6c Qs Qh]
Seat 1: Rodik002 folded before Flop (didn't bet)
Seat 2: dwonder75 (button) folded before Flop (didn't bet)
Seat 3: BORIS_ENEV (small blind) collected ($0.38)
Seat 4: david_sara83 (big blind) folded on the Turn
Seat 5: FRAID358 folded before Flop (didn't bet)
Seat 6: boxer821 folded before Flop (didn't bet)



PokerStars Hand #166667565873:  Hold'em No Limit ($0.05/$0.10 USD) - 2017/02/23 16:03:29 ET
Table 'Jokaste II' 6-max Seat #5 is the button
Seat 1: Hyd SK ($13.48 in chips) 
Seat 2: T9MS ($12.48 in chips) 
Seat 3: crazydevill ($10.15 in chips) 
Seat 4: FRAID358 ($15.16 in chips) 
Seat 5: Vrinni ($10 in chips) 
Seat 6: Adailton07 ($15.10 in chips) 
Adailton07: posts small blind $0.05
Hyd SK: posts big blind $0.10
*** HOLE CARDS ***
T9MS: folds 
crazydevill: folds 
FRAID358: folds 
Vrinni: raises $0.15 to $0.25
Adailton07: folds 
Hyd SK: calls $0.15
*** FLOP *** [Qh 4h Tc]
Hyd SK: checks 
Vrinni: bets $0.36
Hyd SK: folds 
Uncalled bet ($0.36) returned to Vrinni
Vrinni collected $0.53 from pot
*** SUMMARY ***
Total pot $0.55 | Rake $0.02 
Board [Qh 4h Tc]
Seat 1: Hyd SK (big blind) folded on the Flop
Seat 2: T9MS folded before Flop (didn't bet)
Seat 3: crazydevill folded before Flop (didn't bet)
Seat 4: FRAID358 folded before Flop (didn't bet)
Seat 5: Vrinni (button) collected ($0.53)
Seat 6: Adailton07 (small blind) folded before Flop



PokerStars Hand #166667566025:  Hold'em No Limit ($0.05/$0.10 USD) - 2017/02/23 16:03:29 ET
Table 'Brendelia II' 6-max Seat #3 is the button
Seat 2: Crimsonr ($5.73 in chips) 
Seat 3: ValdemorS ($18.30 in chips) 
Seat 6: luckyPositiv ($10.24 in chips) 
luckyPositiv: posts small blind $0.05
Crimsonr: posts big blind $0.10
Crimsonr: posts the ante $0.02
ValdemorS: posts the ante $0.02
luckyPositiv: posts the ante $0.02
*** HOLE CARDS ***
ValdemorS: raises $0.20 to $0.30
luckyPositiv: folds 
Crimsonr: folds 
Uncalled bet ($0.20) returned to ValdemorS
ValdemorS collected $0.31 from pot
*** SUMMARY ***
Total pot $0.31 | Rake $0 
Seat 2: Crimsonr (big blind) folded before Flop
Seat 3: ValdemorS (button) collected ($0.31)
Seat 6: luckyPositiv (small blind) folded before Flop



PokerStars Hand #166667566378:  Hold'em No Limit ($0.05/$0.10 USD) - 2017/02/23 16:03:30 ET
Table 'Alzirr II' 6-max Seat #2 is the button
Seat 1: KA3AXCTAHEU, ($10.61 in chips) 
Seat 2: popypaleta ($10.32 in chips) 
Seat 4: Scanner17 ($17.69 in chips) 
Seat 5: yodzik ($5 in chips) 
Scanner17: posts small blind $0.05
yodzik: posts big blind $0.10
AM-L-SL: sits out 
*** HOLE CARDS ***
KA3AXCTAHEU,: folds 
devon_red joins the table at seat #3 
popypaleta: folds 
Scanner17: folds 
Uncalled bet ($0.05) returned to yodzik
yodzik collected $0.10 from pot
*** SUMMARY ***
Total pot $0.10 | Rake $0 
Seat 1: KA3AXCTAHEU, folded before Flop (didn't bet)
Seat 2: popypaleta (button) folded before Flop (didn't bet)
Seat 4: Scanner17 (small blind) folded before Flop
Seat 5: yodzik (big blind) collected ($0.10)



PokerStars Hand #166667566594:  Hold'em No Limit ($0.05/$0.10 USD) - 2017/02/23 16:03:30 ET
Table 'Goto II' 6-max Seat #1 is the button
Seat 1: FRAID358 ($12.76 in chips) 
Seat 2: 6ePeMeHHa9 ($11.87 in chips) 
Seat 3: Goroshkos88 ($10.59 in chips) 
Seat 4: KRZuff ($13.04 in chips) 
Seat 5: RoJ1 ($13.72 in chips) 
Seat 6: ermananb93 ($12.49 in chips) 
6ePeMeHHa9: posts small blind $0.05
Goroshkos88: posts big blind $0.10
*** HOLE CARDS ***
KRZuff: folds 
RoJ1: raises $0.12 to $0.22
ermananb93: calls $0.22
FRAID358: folds 
6ePeMeHHa9: folds 
Goroshkos88: folds 
*** FLOP *** [7s 2c 4h]
RoJ1: bets $0.18
ermananb93: calls $0.18
*** TURN *** [7s 2c 4h] [8c]
RoJ1: checks 
ermananb93: checks 
*** RIVER *** [7s 2c 4h 8c] [As]
RoJ1: checks 
ermananb93: bets $0.30
RoJ1: calls $0.30
*** SHOW DOWN ***
ermananb93: shows [Qc Td] (high card Ace)
RoJ1: shows [Th 8h] (a pair of Eights)
RoJ1 collected $1.48 from pot
*** SUMMARY ***
Total pot $1.55 | Rake $0.07 
Board [7s 2c 4h 8c As]
Seat 1: FRAID358 (button) folded before Flop (didn't bet)
Seat 2: 6ePeMeHHa9 (small blind) folded before Flop
Seat 3: Goroshkos88 (big blind) folded before Flop
Seat 4: KRZuff folded before Flop (didn't bet)
Seat 5: RoJ1 showed [Th 8h] and won ($1.48) with a pair of Eights
Seat 6: ermananb93 showed [Qc Td] and lost with high card Ace



PokerStars Hand #166667566687:  Hold'em No Limit ($0.05/$0.10 USD) - 2017/02/23 16:03:30 ET
Table 'Laetitia II' 6-max Seat #1 is the button
Seat 1: Cluckh ($11.42 in chips) 
Seat 2: manashov ($10.27 in chips) 
Seat 3: 6ePeMeHHa9 ($10.29 in chips) 
Seat 4: Feverhead ($16.81 in chips) 
Seat 5: D3NyA ($16.93 in chips) 
Seat 6: Dima91360 ($4.01 in chips) 
manashov: posts small blind $0.05
6ePeMeHHa9: posts big blind $0.10
*** HOLE CARDS ***
Feverhead: folds 
D3NyA: raises $0.20 to $0.30
Dima91360: calls $0.30
Cluckh: raises $0.90 to $1.20
manashov: folds 
6ePeMeHHa9: folds 
D3NyA: folds 
Dima91360: calls $0.90
*** FLOP *** [Kh 6d 3d]
Dima91360: bets $0.30
Cluckh: calls $0.30
*** TURN *** [Kh 6d 3d] [Ac]
Dima91360: bets $0.50
Cluckh: folds 
Uncalled bet ($0.50) returned to Dima91360
Dima91360 collected $3.29 from pot
*** SUMMARY ***
Total pot $3.45 | Rake $0.16 
Board [Kh 6d 3d Ac]
Seat 1: Cluckh (button) folded on the Turn
Seat 2: manashov (small blind) folded before Flop
Seat 3: 6ePeMeHHa9 (big blind) folded before Flop
Seat 4: Feverhead folded before Flop (didn't bet)
Seat 5: D3NyA folded before Flop
Seat 6: Dima91360 collected ($3.29)



PokerStars Hand #166667566747:  Hold'em No Limit ($0.05/$0.10 USD) - 2017/02/23 16:03:30 ET
Table 'Luanda' 6-max Seat #1 is the button
Seat 1: AM-L-SL ($4.85 in chips) 
Seat 2: Xander188 ($10 in chips) 
Seat 3: DamDatsAnAce ($10.15 in chips) 
Seat 5: st4tion ($12.78 in chips) 
Seat 6: KA3AXCTAHEU, ($11.26 in chips) 
Xander188: posts small blind $0.05
DamDatsAnAce: posts big blind $0.10
*** HOLE CARDS ***
st4tion: raises $0.15 to $0.25
KA3AXCTAHEU,: folds 
AM-L-SL: folds 
Xander188: calls $0.20
DamDatsAnAce: folds 
*** FLOP *** [Th 8h 7d]
Xander188: checks 
st4tion: checks 
*** TURN *** [Th 8h 7d] [7s]
Xander188: checks 
st4tion: checks 
*** RIVER *** [Th 8h 7d 7s] [3s]
Xander188: bets $0.30
st4tion: calls $0.30
*** SHOW DOWN ***
Xander188: shows [2s 2d] (two pair, Sevens and Deuces)
st4tion: shows [3c Ac] (two pair, Sevens and Threes)
st4tion collected $1.15 from pot
*** SUMMARY ***
Total pot $1.20 | Rake $0.05 
Board [Th 8h 7d 7s 3s]
Seat 1: AM-L-SL (button) folded before Flop (didn't bet)
Seat 2: Xander188 (small blind) showed [2s 2d] and lost with two pair, Sevens and Deuces
Seat 3: DamDatsAnAce (big blind) folded before Flop
Seat 5: st4tion showed [3c Ac] and won ($1.15) with two pair, Sevens and Threes
Seat 6: KA3AXCTAHEU, folded before Flop (didn't bet)



PokerStars Hand #166667567014:  Hold'em No Limit ($0.05/$0.10 USD) - 2017/02/23 16:03:30 ET
Table 'Isberga' 6-max Seat #5 is the button
Seat 1: Feverhead ($17.27 in chips) 
Seat 2: GESPERIA ($10.15 in chips) 
Seat 4: THIMUCHIN ($11.04 in chips) 
Seat 5: YoungGriff86 ($19.75 in chips) 
Seat 6: Goroshkos88 ($21.25 in chips) 
Goroshkos88: posts small blind $0.05
Feverhead: posts big blind $0.10
*** HOLE CARDS ***
GESPERIA: folds 
THIMUCHIN: folds 
YoungGriff86: raises $0.20 to $0.30
Goroshkos88: calls $0.25
Feverhead: calls $0.20
*** FLOP *** [Kc 6h 5s]
Goroshkos88: checks 
Feverhead: checks 
YoungGriff86: bets $0.43
Goroshkos88: folds 
Feverhead: calls $0.43
*** TURN *** [Kc 6h 5s] [2s]
Feverhead: checks 
YoungGriff86: checks 
*** RIVER *** [Kc 6h 5s 2s] [5h]
Feverhead: checks 
YoungGriff86: checks 
*** SHOW DOWN ***
Feverhead: shows [9h Kd] (two pair, Kings and Fives)
YoungGriff86: mucks hand 
Feverhead collected $1.68 from pot
*** SUMMARY ***
Total pot $1.76 | Rake $0.08 
Board [Kc 6h 5s 2s 5h]
Seat 1: Feverhead (big blind) showed [9h Kd] and won ($1.68) with two pair, Kings and Fives
Seat 2: GESPERIA folded before Flop (didn't bet)
Seat 4: THIMUCHIN folded before Flop (didn't bet)
Seat 5: YoungGriff86 (button) mucked
Seat 6: Goroshkos88 (small blind) folded on the Flop



PokerStars Hand #166667567264:  Hold'em No Limit ($0.05/$0.10 USD) - 2017/02/23 16:03:31 ET
Table 'Rosalia' 6-max Seat #4 is the button
Seat 1: Hyd SK ($10 in chips) 
Seat 2: Bandyaev ($11.84 in chips) 
Seat 3: Andy Wolf ($12.18 in chips) 
Seat 4: THIMUCHIN ($10 in chips) 
Seat 5: miron762 ($16.65 in chips) 
Seat 6: facewald ($16.93 in chips) 
miron762: posts small blind $0.05
facewald: posts big blind $0.10
*** HOLE CARDS ***
Hyd SK: raises $0.25 to $0.35
Bandyaev: folds 
Andy Wolf: folds 
THIMUCHIN: folds 
miron762: raises $0.65 to $1
facewald: folds 
Hyd SK: folds 
Uncalled bet ($0.65) returned to miron762
miron762 collected $0.80 from pot
*** SUMMARY ***
Total pot $0.80 | Rake $0 
Seat 1: Hyd SK folded before Flop
Seat 2: Bandyaev folded before Flop (didn't bet)
Seat 3: Andy Wolf folded before Flop (didn't bet)
Seat 4: THIMUCHIN (button) folded before Flop (didn't bet)
Seat 5: miron762 (small blind) collected ($0.80)
Seat 6: facewald (big blind) folded before Flop



PokerStars Hand #166667567397:  Hold'em No Limit ($0.05/$0.10 USD) - 2017/02/23 16:03:31 ET
Table 'Nekkar' 6-max Seat #3 is the button
Seat 2: Bird et al ($11.17 in chips) 
Seat 3: Zemz_Ru ($15.92 in chips) 
Seat 4: kingartur222 ($12.15 in chips) 
Seat 5: Vrinni ($11.80 in chips) 
Seat 6: Eddys Edge ($10.73 in chips) 
kingartur222: posts small blind $0.05
Vrinni: posts big blind $0.10
*** HOLE CARDS ***
Eddys Edge: folds 
Bird et al: folds 
Zemz_Ru: raises $0.10 to $0.20
kingartur222: folds 
Vrinni: calls $0.10
*** FLOP *** [9d 9h 7s]
Vrinni: checks 
Zemz_Ru: bets $0.50
Vrinni: folds 
Uncalled bet ($0.50) returned to Zemz_Ru
Zemz_Ru collected $0.43 from pot
*** SUMMARY ***
Total pot $0.45 | Rake $0.02 
Board [9d 9h 7s]
Seat 2: Bird et al folded before Flop (didn't bet)
Seat 3: Zemz_Ru (button) collected ($0.43)
Seat 4: kingartur222 (small blind) folded before Flop
Seat 5: Vrinni (big blind) folded on the Flop
Seat 6: Eddys Edge folded before Flop (didn't bet)



PokerStars Hand #166667567752:  Hold'em No Limit ($0.05/$0.10 USD) - 2017/02/23 16:03:31 ET
Table 'Stroobantia II' 6-max Seat #6 is the button
Seat 1: XBrosh ($7.78 in chips) 
Seat 2: IAntikI ($10 in chips) 
Seat 3: 8th wonders ($11.03 in chips) 
Seat 4: Xander188 ($10 in chips) 
Seat 5: Zooplack ($12.48 in chips) 
Seat 6: CHRO8 ($12.97 in chips) 
XBrosh: posts small blind $0.05
IAntikI: posts big blind $0.10
*** HOLE CARDS ***
8th wonders: folds 
Xander188: raises $0.20 to $0.30
Zooplack: folds 
CHRO8: folds 
XBrosh: calls $0.25
IAntikI: folds 
*** FLOP *** [Ah 9h Qs]
XBrosh: checks 
Xander188: bets $0.40
XBrosh: folds 
Uncalled bet ($0.40) returned to Xander188
Xander188 collected $0.67 from pot
*** SUMMARY ***
Total pot $0.70 | Rake $0.03 
Board [Ah 9h Qs]
Seat 1: XBrosh (small blind) folded on the Flop
Seat 2: IAntikI (big blind) folded before Flop
Seat 3: 8th wonders folded before Flop (didn't bet)
Seat 4: Xander188 collected ($0.67)
Seat 5: Zooplack folded before Flop (didn't bet)
Seat 6: CHRO8 (button) folded before Flop (didn't bet)



PokerStars Hand #166667567891:  Hold'em No Limit ($0.05/$0.10 USD) - 2017/02/23 16:03:31 ET
Table 'Antielus II' 6-max Seat #2 is the button
Seat 1: Dcaro31 ($17.30 in chips) 
Seat 2: Orlangoor ($10.15 in chips) 
Seat 3: mcyi3at2 ($12.54 in chips) 
Seat 4: XwinX25 ($10 in chips) 
Seat 5: Hyd SK ($10.65 in chips) 
Seat 6: GiveTwoMe ($12.40 in chips) 
mcyi3at2: posts small blind $0.05
XwinX25: posts big blind $0.10
*** HOLE CARDS ***
Hyd SK: folds 
GiveTwoMe: folds 
Dcaro31: folds 
Orlangoor: folds 
mcyi3at2: calls $0.05
XwinX25: raises $0.30 to $0.40
mcyi3at2: calls $0.30
*** FLOP *** [Th 3h 2c]
mcyi3at2: checks 
XwinX25: bets $0.50
mcyi3at2: calls $0.50
*** TURN *** [Th 3h 2c] [3c]
mcyi3at2: checks 
XwinX25: checks 
*** RIVER *** [Th 3h 2c 3c] [8c]
mcyi3at2: checks 
XwinX25: checks 
*** SHOW DOWN ***
mcyi3at2: shows [9d Ad] (a pair of Threes)
XwinX25: mucks hand 
mcyi3at2 collected $1.72 from pot
*** SUMMARY ***
Total pot $1.80 | Rake $0.08 
Board [Th 3h 2c 3c 8c]
Seat 1: Dcaro31 folded before Flop (didn't bet)
Seat 2: Orlangoor (button) folded before Flop (didn't bet)
Seat 3: mcyi3at2 (small blind) showed [9d Ad] and won ($1.72) with a pair of Threes
Seat 4: XwinX25 (big blind) mucked
Seat 5: Hyd SK folded before Flop (didn't bet)
Seat 6: GiveTwoMe folded before Flop (didn't bet)



PokerStars Hand #166667568114:  Hold'em No Limit ($0.05/$0.10 USD) - 2017/02/23 16:03:32 ET
Table 'Amalia' 6-max Seat #1 is the button
Seat 1: voledy ($12.84 in chips) 
Seat 2: DamDatsAnAce ($10.60 in chips) 
Seat 3: kickereens ($10 in chips) 
Seat 4: Rodik002 ($16.38 in chips) 
Seat 5: coolisses111 ($11.10 in chips) 
Seat 6: oktomber778 ($23.39 in chips) 
DamDatsAnAce: posts small blind $0.05
kickereens: posts big blind $0.10
*** HOLE CARDS ***
Rodik002: folds 
coolisses111: folds 
oktomber778: folds 
voledy: raises $0.15 to $0.25
DamDatsAnAce: folds 
kickereens: calls $0.15
*** FLOP *** [Jd Ad 3c]
kickereens: checks 
voledy: checks 
*** TURN *** [Jd Ad 3c] [8h]
kickereens: checks 
voledy: checks 
*** RIVER *** [Jd Ad 3c 8h] [Ac]
kickereens: bets $0.28
voledy: folds 
Uncalled bet ($0.28) returned to kickereens
kickereens collected $0.53 from pot
*** SUMMARY ***
Total pot $0.55 | Rake $0.02 
Board [Jd Ad 3c 8h Ac]
Seat 1: voledy (button) folded on the River
Seat 2: DamDatsAnAce (small blind) folded before Flop
Seat 3: kickereens (big blind) collected ($0.53)
Seat 4: Rodik002 folded before Flop (didn't bet)
Seat 5: coolisses111 folded before Flop (didn't bet)
Seat 6: oktomber778 folded before Flop (didn't bet)



PokerStars Hand #166667568223:  Hold'em No Limit ($0.05/$0.10 USD) - 2017/02/23 16:03:32 ET
Table 'Virginia II' 6-max Seat #4 is the button
Seat 1: Iarlei ($11.71 in chips) 
Seat 2: Yspenyanin ($10 in chips) 
Seat 3: garigura ($14.56 in chips) 
Seat 4: onkelottoHH ($11.03 in chips) 
Seat 5: dr.goofy ($20.73 in chips) 
dr.goofy: posts small blind $0.05
ab260414: is sitting out 
ab260414 leaves the table
Iarlei: posts big blind $0.10
*** HOLE CARDS ***
Yspenyanin: folds 
garigura: folds 
onkelottoHH: folds 
NvR.m1nD joins the table at seat #6 
dr.goofy: folds 
Uncalled bet ($0.05) returned to Iarlei
Iarlei collected $0.10 from pot
*** SUMMARY ***
Total pot $0.10 | Rake $0 
Seat 1: Iarlei (big blind) collected ($0.10)
Seat 2: Yspenyanin folded before Flop (didn't bet)
Seat 3: garigura folded before Flop (didn't bet)
Seat 4: onkelottoHH (button) folded before Flop (didn't bet)
Seat 5: dr.goofy (small blind) folded before Flop



PokerStars Hand #166667568253:  Hold'em No Limit ($0.05/$0.10 USD) - 2017/02/23 16:03:32 ET
Table 'Ophelia' 6-max Seat #2 is the button
Seat 1: ralfi37 ($10.76 in chips) 
Seat 2: popypaleta ($16.63 in chips) 
Seat 3: mvp0013 ($11.50 in chips) 
Seat 4: Cluckh ($11.35 in chips) 
Seat 5: truck1234 ($14.01 in chips) 
Seat 6: Yabidooo ($10.86 in chips) 
mvp0013: posts small blind $0.05
Cluckh: posts big blind $0.10
*** HOLE CARDS ***
truck1234: folds 
Yabidooo: folds 
ralfi37: raises $0.20 to $0.30
popypaleta: folds 
mvp0013: folds 
Cluckh: calls $0.20
*** FLOP *** [Qc 8d 5s]
Cluckh: checks 
ralfi37: bets $0.30
Cluckh: calls $0.30
*** TURN *** [Qc 8d 5s] [6c]
Cluckh: checks 
ralfi37: bets $0.60
Cluckh: calls $0.60
*** RIVER *** [Qc 8d 5s 6c] [7c]
Cluckh: checks 
ralfi37: checks 
*** SHOW DOWN ***
Cluckh: shows [Qs Jc] (a pair of Queens)
ralfi37: mucks hand 
Cluckh collected $2.34 from pot
*** SUMMARY ***
Total pot $2.45 | Rake $0.11 
Board [Qc 8d 5s 6c 7c]
Seat 1: ralfi37 mucked
Seat 2: popypaleta (button) folded before Flop (didn't bet)
Seat 3: mvp0013 (small blind) folded before Flop
Seat 4: Cluckh (big blind) showed [Qs Jc] and won ($2.34) with a pair of Queens
Seat 5: truck1234 folded before Flop (didn't bet)
Seat 6: Yabidooo folded before Flop (didn't bet)



PokerStars Hand #166667568376:  Hold'em No Limit ($0.05/$0.10 USD) - 2017/02/23 16:03:32 ET
Table 'Eurydome II' 6-max Seat #3 is the button
Seat 2: Elinaattor ($10.34 in chips) 
Seat 3: gaHy_HaXeP ($10.15 in chips) 
Seat 4: Smitty03300 ($10 in chips) 
Seat 5: kush-killa87 ($13.99 in chips) 
Seat 6: Jucatorul823 ($6.20 in chips) 
Smitty03300: posts small blind $0.05
kush-killa87: posts big blind $0.10
rusu_rapid: sits out 
*** HOLE CARDS ***
Jucatorul823: folds 
Elinaattor: folds 
gaHy_HaXeP: raises $0.12 to $0.22
Smitty03300: raises $0.58 to $0.80
kush-killa87: folds 
gaHy_HaXeP: folds 
Uncalled bet ($0.58) returned to Smitty03300
Smitty03300 collected $0.54 from pot
*** SUMMARY ***
Total pot $0.54 | Rake $0 
Seat 2: Elinaattor folded before Flop (didn't bet)
Seat 3: gaHy_HaXeP (button) folded before Flop
Seat 4: Smitty03300 (small blind) collected ($0.54)
Seat 5: kush-killa87 (big blind) folded before Flop
Seat 6: Jucatorul823 folded before Flop (didn't bet)



PokerStars Hand #166667568435:  Hold'em No Limit ($0.05/$0.10 USD) - 2017/02/23 16:03:32 ET
Table 'Rotraut' 6-max Seat #3 is the button
Seat 1: Hypermetal ($13.14 in chips) 
Seat 2: Newqbrown ($11.59 in chips) 
Seat 3: FlackoD ($11.67 in chips) 
Seat 5: Bird et al ($11.65 in chips) 
Seat 6: KokoulinV ($12.99 in chips) 
Bird et al: posts small blind $0.05
KokoulinV: posts big blind $0.10
*** HOLE CARDS ***
Hypermetal: raises $0.30 to $0.40
Newqbrown: folds 
FlackoD: folds 
Bird et al: folds 
KokoulinV: folds 
Uncalled bet ($0.30) returned to Hypermetal
Hypermetal collected $0.25 from pot
*** SUMMARY ***
Total pot $0.25 | Rake $0 
Seat 1: Hypermetal collected ($0.25)
Seat 2: Newqbrown folded before Flop (didn't bet)
Seat 3: FlackoD (button) folded before Flop (didn't bet)
Seat 5: Bird et al (small blind) folded before Flop
Seat 6: KokoulinV (big blind) folded before Flop



PokerStars Hand #166667568543:  Hold'em No Limit ($0.05/$0.10 USD) - 2017/02/23 16:03:32 ET
Table 'Girtab II' 6-max Seat #2 is the button
Seat 1: Kow6oy ($10 in chips) 
Seat 2: Pokeaster ($14.02 in chips) 
Seat 3: chimera252 ($10 in chips) 
Seat 4: Hyd SK ($27.03 in chips) 
Seat 5: dzesio18 ($12.34 in chips) 
Seat 6: DamDatsAnAce ($10 in chips) 
chimera252: posts small blind $0.05
Hyd SK: posts big blind $0.10
*** HOLE CARDS ***
dzesio18: folds 
DamDatsAnAce: folds 
Kow6oy: folds 
Pokeaster: folds 
chimera252: folds 
Uncalled bet ($0.05) returned to Hyd SK
Hyd SK collected $0.10 from pot
*** SUMMARY ***
Total pot $0.10 | Rake $0 
Seat 1: Kow6oy folded before Flop (didn't bet)
Seat 2: Pokeaster (button) folded before Flop (didn't bet)
Seat 3: chimera252 (small blind) folded before Flop
Seat 4: Hyd SK (big blind) collected ($0.10)
Seat 5: dzesio18 folded before Flop (didn't bet)
Seat 6: DamDatsAnAce folded before Flop (didn't bet)



PokerStars Hand #166667568756:  Hold'em No Limit ($0.05/$0.10 USD) - 2017/02/23 16:03:32 ET
Table 'Gelria' 6-max Seat #6 is the button
Seat 1: ab260414 ($10 in chips) 
Seat 2: fishhook5 ($10 in chips) 
Seat 3: Orlangoor ($11.42 in chips) 
Seat 5: apenvel ($8.18 in chips) 
Seat 6: Andrei ProFF ($10.42 in chips) 
ab260414: posts small blind $0.05
fishhook5: posts big blind $0.10
*** HOLE CARDS ***
Orlangoor: raises $0.15 to $0.25
apenvel: folds 
Andrei ProFF: folds 
ab260414: folds 
fishhook5: folds 
Uncalled bet ($0.15) returned to Orlangoor
Orlangoor collected $0.25 from pot
*** SUMMARY ***
Total pot $0.25 | Rake $0 
Seat 1: ab260414 (small blind) folded before Flop
Seat 2: fishhook5 (big blind) folded before Flop
Seat 3: Orlangoor collected ($0.25)
Seat 5: apenvel folded before Flop (didn't bet)
Seat 6: Andrei ProFF (button) folded before Flop (didn't bet)



PokerStars Hand #166667568869:  Hold'em No Limit ($0.05/$0.10 USD) - 2017/02/23 16:03:32 ET
Table 'Nuki' 6-max Seat #2 is the button
Seat 1: bdixon_5 ($7.65 in chips) 
Seat 2: ArcticBearDK ($19.23 in chips) 
Seat 3: david_sara83 ($13.67 in chips) 
Seat 4: GESPERIA ($28.61 in chips) 
Seat 5: fabadam ($11.13 in chips) 
Seat 6: Zooplack ($25.27 in chips) 
david_sara83: posts small blind $0.05
GESPERIA: posts big blind $0.10
*** HOLE CARDS ***
fabadam: folds 
Zooplack: folds 
bdixon_5: raises $0.20 to $0.30
ArcticBearDK: folds 
david_sara83: folds 
GESPERIA: folds 
Uncalled bet ($0.20) returned to bdixon_5
bdixon_5 collected $0.25 from pot
*** SUMMARY ***
Total pot $0.25 | Rake $0 
Seat 1: bdixon_5 collected ($0.25)
Seat 2: ArcticBearDK (button) folded before Flop (didn't bet)
Seat 3: david_sara83 (small blind) folded before Flop
Seat 4: GESPERIA (big blind) folded before Flop
Seat 5: fabadam folded before Flop (didn't bet)
Seat 6: Zooplack folded before Flop (didn't bet)



PokerStars Hand #166667569185:  Hold'em No Limit ($0.05/$0.10 USD) - 2017/02/23 16:03:33 ET
Table 'Arduina' 6-max Seat #2 is the button
Seat 2: Andy Wolf ($14.45 in chips) 
Seat 3: Dcaro31 ($13.16 in chips) 
Seat 4: ChuikaPridi ($30.73 in chips) 
Seat 5: ettedallas ($5.16 in chips) 
Seat 6: dierri ($9.99 in chips) 
Dcaro31: posts small blind $0.05
ChuikaPridi: posts big blind $0.10
tauronex: sits out 
*** HOLE CARDS ***
ettedallas: raises $5.06 to $5.16 and is all-in
dierri: folds 
Andy Wolf: folds 
Dcaro31: folds 
ChuikaPridi: folds 
Uncalled bet ($5.06) returned to ettedallas
ettedallas collected $0.25 from pot
*** SUMMARY ***
Total pot $0.25 | Rake $0 
Seat 2: Andy Wolf (button) folded before Flop (didn't bet)
Seat 3: Dcaro31 (small blind) folded before Flop
Seat 4: ChuikaPridi (big blind) folded before Flop
Seat 5: ettedallas collected ($0.25)
Seat 6: dierri folded before Flop (didn't bet)



PokerStars Hand #166667569244:  Hold'em No Limit ($0.05/$0.10 USD) - 2017/02/23 16:03:33 ET
Table 'Wesselink II' 6-max Seat #1 is the button
Seat 1: vladcol ($5.49 in chips) 
Seat 3: Wargolandros ($8.97 in chips) 
Seat 4: BahiaMinhaP ($10.78 in chips) 
Seat 5: xdjango07x ($18.75 in chips) 
Seat 6: bambolejro ($10 in chips) 
KRZuff will be allowed to play after the button
Wargolandros: posts small blind $0.05
BahiaMinhaP: posts big blind $0.10
*** HOLE CARDS ***
xdjango07x: folds 
bambolejro: folds 
vladcol: calls $0.10
Wargolandros: folds 
BahiaMinhaP: checks 
*** FLOP *** [8s 9d 3s]
BahiaMinhaP: checks 
vladcol: checks 
*** TURN *** [8s 9d 3s] [8c]
BahiaMinhaP: bets $0.12
vladcol: calls $0.12
*** RIVER *** [8s 9d 3s 8c] [Ac]
BahiaMinhaP: checks 
vladcol: checks 
*** SHOW DOWN ***
BahiaMinhaP: shows [Kd 9c] (two pair, Nines and Eights)
vladcol: mucks hand 
BahiaMinhaP collected $0.47 from pot
*** SUMMARY ***
Total pot $0.49 | Rake $0.02 
Board [8s 9d 3s 8c Ac]
Seat 1: vladcol (button) mucked
Seat 3: Wargolandros (small blind) folded before Flop
Seat 4: BahiaMinhaP (big blind) showed [Kd 9c] and won ($0.47) with two pair, Nines and Eights
Seat 5: xdjango07x folded before Flop (didn't bet)
Seat 6: bambolejro folded before Flop (didn't bet)



PokerStars Hand #166667569263:  Hold'em No Limit ($0.05/$0.10 USD) - 2017/02/23 16:03:33 ET
Table 'Iapetus III' 6-max Seat #3 is the button
Seat 2: Crafty23@PS ($10 in chips) 
Seat 3: takis nik ($10.10 in chips) 
Seat 5: homelessdan ($13.66 in chips) 
Seat 6: tauronex ($10 in chips) 
Raggibest will be allowed to play after the button
homelessdan: posts small blind $0.05
tauronex: posts big blind $0.10
Czezar Life: sits out 
*** HOLE CARDS ***
Crafty23@PS: folds 
takis nik: folds 
homelessdan: folds 
Uncalled bet ($0.05) returned to tauronex
tauronex collected $0.10 from pot
*** SUMMARY ***
Total pot $0.10 | Rake $0 
Seat 2: Crafty23@PS folded before Flop (didn't bet)
Seat 3: takis nik (button) folded before Flop (didn't bet)
Seat 5: homelessdan (small blind) folded before Flop
Seat 6: tauronex (big blind) collected ($0.10)



PokerStars Hand #166667569420:  Hold'em No Limit ($0.05/$0.10 USD) - 2017/02/23 16:03:33 ET
Table 'Cyane' 6-max Seat #6 is the button
Seat 1: KA3AXCTAHEU, ($10.22 in chips) 
Seat 3: Mamm0nism ($13.94 in chips) 
Seat 4: truck1234 ($20.96 in chips) 
Seat 5: ChuikaPridi ($10.07 in chips) 
Seat 6: 8th wonders ($10.55 in chips) 
KA3AXCTAHEU,: posts small blind $0.05
Mamm0nism: posts big blind $0.10
*** HOLE CARDS ***
truck1234: folds 
ChuikaPridi: raises $0.20 to $0.30
8th wonders: folds 
KA3AXCTAHEU,: folds 
Mamm0nism: folds 
Uncalled bet ($0.20) returned to ChuikaPridi
ChuikaPridi collected $0.25 from pot
*** SUMMARY ***
Total pot $0.25 | Rake $0 
Seat 1: KA3AXCTAHEU, (small blind) folded before Flop
Seat 3: Mamm0nism (big blind) folded before Flop
Seat 4: truck1234 folded before Flop (didn't bet)
Seat 5: ChuikaPridi collected ($0.25)
Seat 6: 8th wonders (button) folded before Flop (didn't bet)



PokerStars Hand #166667569485:  Hold'em No Limit ($0.05/$0.10 USD) - 2017/02/23 16:03:33 ET
Table 'Aconcagua' 6-max Seat #6 is the button
Seat 3: burtila1989 ($10.29 in chips) 
Seat 4: pivanki11 ($9.42 in chips) 
Seat 5: frazaunch ($6.98 in chips) 
Seat 6: coolisses111 ($8.80 in chips) 
burtila1989: posts small blind $0.05
pivanki11: posts big blind $0.10
burtila1989: posts the ante $0.02
pivanki11: posts the ante $0.02
frazaunch: posts the ante $0.02
coolisses111: posts the ante $0.02
*** HOLE CARDS ***
frazaunch: raises $0.10 to $0.20
coolisses111: folds 
burtila1989: calls $0.15
pivanki11: folds 
*** FLOP *** [3h 4h 2h]
burtila1989: checks 
frazaunch: bets $0.20
burtila1989: calls $0.20
*** TURN *** [3h 4h 2h] [7s]
burtila1989: checks 
frazaunch: checks 
*** RIVER *** [3h 4h 2h 7s] [3s]
burtila1989: bets $0.40
frazaunch: folds 
Uncalled bet ($0.40) returned to burtila1989
burtila1989 collected $0.94 from pot
*** SUMMARY ***
Total pot $0.98 | Rake $0.04 
Board [3h 4h 2h 7s 3s]
Seat 3: burtila1989 (small blind) collected ($0.94)
Seat 4: pivanki11 (big blind) folded before Flop
Seat 5: frazaunch folded on the River
Seat 6: coolisses111 (button) folded before Flop (didn't bet)



PokerStars Hand #166667569616:  Hold'em No Limit ($0.05/$0.10 USD) - 2017/02/23 16:03:33 ET
Table 'Nemo III' 6-max Seat #3 is the button
Seat 2: Bandyaev ($11.84 in chips) 
Seat 3: Therodorus ($10 in chips) 
Seat 4: vtalian ($9.60 in chips) 
Seat 5: Joker51_wtf! ($11.73 in chips) 
vtalian: posts small blind $0.05
Joker51_wtf!: posts big blind $0.10
*** HOLE CARDS ***
rusu_rapid leaves the table
Bandyaev: raises $0.15 to $0.25
RoJ1 joins the table at seat #6 
Therodorus: raises $0.60 to $0.85
vtalian: folds 
Joker51_wtf!: folds 
Bandyaev: folds 
Uncalled bet ($0.60) returned to Therodorus
Therodorus collected $0.65 from pot
*** SUMMARY ***
Total pot $0.65 | Rake $0 
Seat 2: Bandyaev folded before Flop
Seat 3: Therodorus (button) collected ($0.65)
Seat 4: vtalian (small blind) folded before Flop
Seat 5: Joker51_wtf! (big blind) folded before Flop



PokerStars Hand #166667569821:  Hold'em No Limit ($0.05/$0.10 USD) - 2017/02/23 16:03:34 ET
Table 'Hirons' 6-max Seat #3 is the button
Seat 1: RoJ1 ($11.68 in chips) 
Seat 2: coolisses111 ($7.79 in chips) 
Seat 3: czeczen7 ($13.68 in chips) 
Seat 4: Smitty03300 ($10 in chips) 
Seat 5: Pekaml ($10 in chips) 
Seat 6: garigura ($14.98 in chips) 
Smitty03300: posts small blind $0.05
Pekaml: posts big blind $0.10
*** HOLE CARDS ***
garigura: folds 
RoJ1: folds 
coolisses111: folds 
czeczen7: calls $0.10
Smitty03300: folds 
Pekaml: checks 
*** FLOP *** [9d 4c 3h]
Pekaml: checks 
czeczen7: checks 
*** TURN *** [9d 4c 3h] [Ks]
Pekaml: bets $0.16
czeczen7: folds 
Uncalled bet ($0.16) returned to Pekaml
Pekaml collected $0.24 from pot
*** SUMMARY ***
Total pot $0.25 | Rake $0.01 
Board [9d 4c 3h Ks]
Seat 1: RoJ1 folded before Flop (didn't bet)
Seat 2: coolisses111 folded before Flop (didn't bet)
Seat 3: czeczen7 (button) folded on the Turn
Seat 4: Smitty03300 (small blind) folded before Flop
Seat 5: Pekaml (big blind) collected ($0.24)
Seat 6: garigura folded before Flop (didn't bet)



PokerStars Hand #166667569861:  Hold'em No Limit ($0.05/$0.10 USD) - 2017/02/23 16:03:34 ET
Table 'Unitas II' 6-max Seat #5 is the button
Seat 1: Peter0087 ($10 in chips) 
Seat 2: dragonste89 ($10.76 in chips) 
Seat 3: CallByValue ($10 in chips) 
Seat 4: truck1234 ($10.99 in chips) 
Seat 5: chimera252 ($25.61 in chips) 
Seat 6: paxit71 ($8.32 in chips) 
paxit71: posts small blind $0.05
Peter0087: posts big blind $0.10
*** HOLE CARDS ***
dragonste89: folds 
CallByValue: folds 
truck1234: folds 
chimera252: raises $0.15 to $0.25
paxit71: folds 
Peter0087: folds 
Uncalled bet ($0.15) returned to chimera252
chimera252 collected $0.25 from pot
*** SUMMARY ***
Total pot $0.25 | Rake $0 
Seat 1: Peter0087 (big blind) folded before Flop
Seat 2: dragonste89 folded before Flop (didn't bet)
Seat 3: CallByValue folded before Flop (didn't bet)
Seat 4: truck1234 folded before Flop (didn't bet)
Seat 5: chimera252 (button) collected ($0.25)
Seat 6: paxit71 (small blind) folded before Flop



PokerStars Hand #166667569897:  Hold'em No Limit ($0.05/$0.10 USD) - 2017/02/23 16:03:34 ET
Table 'Nikko II' 6-max Seat #5 is the button
Seat 1: bdixon_5 ($10.52 in chips) 
Seat 2: popypaleta ($10.15 in chips) 
Seat 3: Hyd SK ($11.36 in chips) 
Seat 4: Peter0087 ($9.54 in chips) 
Seat 5: Aescul@pius ($10.66 in chips) 
Seat 6: JahSoldier69 ($10 in chips) 
JahSoldier69: posts small blind $0.05
bdixon_5: posts big blind $0.10
*** HOLE CARDS ***
popypaleta: raises $0.20 to $0.30
Hyd SK: folds 
Peter0087: folds 
Aescul@pius: calls $0.30
JahSoldier69: folds 
bdixon_5: folds 
*** FLOP *** [Kh 5s 5h]
popypaleta: bets $0.50
Aescul@pius: calls $0.50
*** TURN *** [Kh 5s 5h] [Js]
popypaleta: bets $1.10
Aescul@pius: calls $1.10
*** RIVER *** [Kh 5s 5h Js] [5d]
popypaleta: checks 
Aescul@pius: checks 
*** SHOW DOWN ***
popypaleta: shows [Ah Jh] (a full house, Fives full of Jacks)
Aescul@pius: shows [Qd Kd] (a full house, Fives full of Kings)
Aescul@pius collected $3.77 from pot
*** SUMMARY ***
Total pot $3.95 | Rake $0.18 
Board [Kh 5s 5h Js 5d]
Seat 1: bdixon_5 (big blind) folded before Flop
Seat 2: popypaleta showed [Ah Jh] and lost with a full house, Fives full of Jacks
Seat 3: Hyd SK folded before Flop (didn't bet)
Seat 4: Peter0087 folded before Flop (didn't bet)
Seat 5: Aescul@pius (button) showed [Qd Kd] and won ($3.77) with a full house, Fives full of Kings
Seat 6: JahSoldier69 (small blind) folded before Flop



PokerStars Hand #166667570172:  Hold'em No Limit ($0.05/$0.10 USD) - 2017/02/23 16:03:34 ET
Table 'Serpens' 6-max Seat #6 is the button
Seat 1: Namhkal ($10.35 in chips) 
Seat 2: KA3AXCTAHEU, ($10.15 in chips) 
Seat 3: homelessdan ($29.59 in chips) 
Seat 4: Ragazzi3 ($16.29 in chips) 
Seat 5: XwinX25 ($11.81 in chips) 
Seat 6: Croplayer1 ($10 in chips) 
Namhkal: posts small blind $0.05
KA3AXCTAHEU,: posts big blind $0.10
*** HOLE CARDS ***
homelessdan: folds 
Ragazzi3: folds 
XwinX25: folds 
Croplayer1: raises $0.10 to $0.20
Namhkal: folds 
KA3AXCTAHEU,: folds 
Uncalled bet ($0.10) returned to Croplayer1
Croplayer1 collected $0.25 from pot
*** SUMMARY ***
Total pot $0.25 | Rake $0 
Seat 1: Namhkal (small blind) folded before Flop
Seat 2: KA3AXCTAHEU, (big blind) folded before Flop
Seat 3: homelessdan folded before Flop (didn't bet)
Seat 4: Ragazzi3 folded before Flop (didn't bet)
Seat 5: XwinX25 folded before Flop (didn't bet)
Seat 6: Croplayer1 (button) collected ($0.25)



PokerStars Hand #166667570353:  Hold'em No Limit ($0.05/$0.10 USD) - 2017/02/23 16:03:34 ET
Table 'Nehalennia III' 6-max Seat #5 is the button
Seat 1: boxer821 ($13.18 in chips) 
Seat 2: fortieth ($10.33 in chips) 
Seat 3: ValdemorS ($17.56 in chips) 
Seat 4: eniksenik ($10 in chips) 
Seat 5: wulffboy ($35.53 in chips) 
Seat 6: valzeny ($20.45 in chips) 
valzeny: posts small blind $0.05
boxer821: posts big blind $0.10
boxer821: posts the ante $0.02
fortieth: posts the ante $0.02
ValdemorS: posts the ante $0.02
eniksenik: posts the ante $0.02
wulffboy: posts the ante $0.02
valzeny: posts the ante $0.02
*** HOLE CARDS ***
fortieth: folds 
ValdemorS: raises $0.20 to $0.30
eniksenik: calls $0.30
wulffboy: folds 
valzeny: folds 
boxer821: folds 
*** FLOP *** [9h Kh 5h]
ValdemorS: bets $0.62
eniksenik: folds 
Uncalled bet ($0.62) returned to ValdemorS
ValdemorS collected $0.83 from pot
*** SUMMARY ***
Total pot $0.87 | Rake $0.04 
Board [9h Kh 5h]
Seat 1: boxer821 (big blind) folded before Flop
Seat 2: fortieth folded before Flop (didn't bet)
Seat 3: ValdemorS collected ($0.83)
Seat 4: eniksenik folded on the Flop
Seat 5: wulffboy (button) folded before Flop (didn't bet)
Seat 6: valzeny (small blind) folded before Flop



PokerStars Hand #166667570818:  Hold'em No Limit ($0.05/$0.10 USD) - 2017/02/23 16:03:35 ET
Table 'Alnasl II' 6-max Seat #5 is the button
Seat 1: dragonste89 ($13.15 in chips) 
Seat 2: Therodorus ($11.91 in chips) 
Seat 3: ICBM-RS26 ($9.88 in chips) 
Seat 4: Eddys Edge ($10 in chips) 
Seat 5: mdelfin0 ($12.31 in chips) 
Seat 6: Bommer78 ($3.07 in chips) 
Bommer78: posts small blind $0.05
dragonste89: posts big blind $0.10
*** HOLE CARDS ***
Therodorus: folds 
ICBM-RS26: folds 
Eddys Edge: folds 
mdelfin0: folds 
Bommer78: calls $0.05
dragonste89: checks 
*** FLOP *** [Ah Tc 3d]
Bommer78: checks 
dragonste89: checks 
*** TURN *** [Ah Tc 3d] [Ks]
Bommer78: bets $0.10
dragonste89: folds 
Uncalled bet ($0.10) returned to Bommer78
Bommer78 collected $0.19 from pot
*** SUMMARY ***
Total pot $0.20 | Rake $0.01 
Board [Ah Tc 3d Ks]
Seat 1: dragonste89 (big blind) folded on the Turn
Seat 2: Therodorus folded before Flop (didn't bet)
Seat 3: ICBM-RS26 folded before Flop (didn't bet)
Seat 4: Eddys Edge folded before Flop (didn't bet)
Seat 5: mdelfin0 (button) folded before Flop (didn't bet)
Seat 6: Bommer78 (small blind) collected ($0.19)



PokerStars Hand #166667570923:  Hold'em No Limit ($0.05/$0.10 USD) - 2017/02/23 16:03:35 ET
Table 'Aludra II' 6-max Seat #3 is the button
Seat 1: voledy ($10.15 in chips) 
Seat 2: JahSoldier69 ($14.05 in chips) 
Seat 3: 2G28 ($12.65 in chips) 
Seat 4: MihaGr ($10 in chips) 
Seat 5: kingartur222 ($15.85 in chips) 
Seat 6: call me haaa ($14.05 in chips) 
MihaGr: posts small blind $0.05
kingartur222: posts big blind $0.10
*** HOLE CARDS ***
call me haaa: raises $0.20 to $0.30
voledy: calls $0.30
JahSoldier69: folds 
2G28: folds 
MihaGr: folds 
kingartur222: folds 
*** FLOP *** [8d 8s 3d]
call me haaa: bets $0.36
voledy: calls $0.36
*** TURN *** [8d 8s 3d] [Qs]
call me haaa: bets $0.70
voledy: folds 
Uncalled bet ($0.70) returned to call me haaa
call me haaa collected $1.40 from pot
*** SUMMARY ***
Total pot $1.47 | Rake $0.07 
Board [8d 8s 3d Qs]
Seat 1: voledy folded on the Turn
Seat 2: JahSoldier69 folded before Flop (didn't bet)
Seat 3: 2G28 (button) folded before Flop (didn't bet)
Seat 4: MihaGr (small blind) folded before Flop
Seat 5: kingartur222 (big blind) folded before Flop
Seat 6: call me haaa collected ($1.40)



PokerStars Hand #166667570981:  Hold'em No Limit ($0.05/$0.10 USD) - 2017/02/23 16:03:35 ET
Table 'Pandora III' 6-max Seat #6 is the button
Seat 1: Pokeaster ($10.89 in chips) 
Seat 2: garigura ($11.77 in chips) 
Seat 3: ChuikaPridi ($16.93 in chips) 
Seat 4: mhonielsen ($10 in chips) 
Seat 5: MühliJr ($10.55 in chips) 
Seat 6: yodzik ($5 in chips) 
Pokeaster: posts small blind $0.05
garigura: posts big blind $0.10
*** HOLE CARDS ***
ChuikaPridi: raises $0.20 to $0.30
mhonielsen: folds 
MühliJr: folds 
yodzik: folds 
Pokeaster: folds 
garigura: folds 
Uncalled bet ($0.20) returned to ChuikaPridi
ChuikaPridi collected $0.25 from pot
*** SUMMARY ***
Total pot $0.25 | Rake $0 
Seat 1: Pokeaster (small blind) folded before Flop
Seat 2: garigura (big blind) folded before Flop
Seat 3: ChuikaPridi collected ($0.25)
Seat 4: mhonielsen folded before Flop (didn't bet)
Seat 5: MühliJr folded before Flop (didn't bet)
Seat 6: yodzik (button) folded before Flop (didn't bet)



PokerStars Hand #166667571369:  Hold'em No Limit ($0.05/$0.10 USD) - 2017/02/23 16:03:35 ET
Table 'Vesta II' 6-max Seat #5 is the button
Seat 1: Yabidooo ($13.21 in chips) 
Seat 2: Dimka4 ($10 in chips) 
Seat 3: Pokeaster ($12.23 in chips) 
Seat 4: Dcaro31 ($10 in chips) 
Seat 5: Andy Wolf ($12.60 in chips) 
XaXaTyH4uK will be allowed to play after the button
Yabidooo: posts small blind $0.05
Dimka4: posts big blind $0.10
*** HOLE CARDS ***
Pokeaster: folds 
Dcaro31: raises $0.20 to $0.30
Andy Wolf: calls $0.30
Yabidooo: folds 
Dimka4: folds 
*** FLOP *** [7s 2c 6d]
Dcaro31: bets $0.45
Andy Wolf: folds 
Uncalled bet ($0.45) returned to Dcaro31
Dcaro31 collected $0.72 from pot
*** SUMMARY ***
Total pot $0.75 | Rake $0.03 
Board [7s 2c 6d]
Seat 1: Yabidooo (small blind) folded before Flop
Seat 2: Dimka4 (big blind) folded before Flop
Seat 3: Pokeaster folded before Flop (didn't bet)
Seat 4: Dcaro31 collected ($0.72)
Seat 5: Andy Wolf (button) folded on the Flop



PokerStars Hand #166667571613:  Hold'em No Limit ($0.05/$0.10 USD) - 2017/02/23 16:03:36 ET
Table 'Camilla II' 6-max Seat #1 is the button
Seat 1: paxit71 ($8 in chips) 
Seat 2: Giyorod ($15.71 in chips) 
Seat 3: Andy Wolf ($10 in chips) 
Seat 4: chimera252 ($12.41 in chips) 
Seat 5: LarryTheStar ($11.49 in chips) 
Seat 6: david_sara83 ($10.15 in chips) 
Giyorod: posts small blind $0.05
Andy Wolf: posts big blind $0.10
*** HOLE CARDS ***
chimera252: folds 
LarryTheStar: raises $0.20 to $0.30
david_sara83: folds 
paxit71: folds 
Giyorod: raises $0.70 to $1
Andy Wolf: folds 
LarryTheStar: folds 
Uncalled bet ($0.70) returned to Giyorod
Giyorod collected $0.70 from pot
*** SUMMARY ***
Total pot $0.70 | Rake $0 
Seat 1: paxit71 (button) folded before Flop (didn't bet)
Seat 2: Giyorod (small blind) collected ($0.70)
Seat 3: Andy Wolf (big blind) folded before Flop
Seat 4: chimera252 folded before Flop (didn't bet)
Seat 5: LarryTheStar folded before Flop
Seat 6: david_sara83 folded before Flop (didn't bet)



PokerStars Hand #166667571694:  Hold'em No Limit ($0.05/$0.10 USD) - 2017/02/23 16:03:36 ET
Table 'Hyakutake' 6-max Seat #3 is the button
Seat 1: Asilvagoat ($11.58 in chips) 
Seat 2: boxer821 ($10.79 in chips) 
Seat 3: lenboysprite ($6.60 in chips) 
Seat 4: eniksenik ($13.70 in chips) 
Seat 5: RoJ1 ($11.59 in chips) 
Seat 6: maxiv608 ($13.42 in chips) 
eniksenik: posts small blind $0.05
RoJ1: posts big blind $0.10
*** HOLE CARDS ***
maxiv608: folds 
Asilvagoat: raises $0.20 to $0.30
boxer821: folds 
lenboysprite: folds 
eniksenik: folds 
RoJ1: folds 
Uncalled bet ($0.20) returned to Asilvagoat
Asilvagoat collected $0.25 from pot
*** SUMMARY ***
Total pot $0.25 | Rake $0 
Seat 1: Asilvagoat collected ($0.25)
Seat 2: boxer821 folded before Flop (didn't bet)
Seat 3: lenboysprite (button) folded before Flop (didn't bet)
Seat 4: eniksenik (small blind) folded before Flop
Seat 5: RoJ1 (big blind) folded before Flop
Seat 6: maxiv608 folded before Flop (didn't bet)



PokerStars Hand #166667571793:  Hold'em No Limit ($0.05/$0.10 USD) - 2017/02/23 16:03:36 ET
Table 'Pompeja III' 6-max Seat #1 is the button
Seat 1: Iarlei ($11.89 in chips) 
Seat 2: steepfell ($10.59 in chips) 
Seat 3: Yspenyanin ($12 in chips) 
Seat 4: Cluckh ($12.36 in chips) 
Seat 5: Spud014 ($12.14 in chips) 
Seat 6: mega spasser ($4.95 in chips) 
steepfell: posts small blind $0.05
Yspenyanin: posts big blind $0.10
*** HOLE CARDS ***
Cluckh: folds 
Spud014: folds 
mega spasser: folds 
Iarlei: raises $0.15 to $0.25
steepfell: folds 
Yspenyanin: folds 
Uncalled bet ($0.15) returned to Iarlei
Iarlei collected $0.25 from pot
*** SUMMARY ***
Total pot $0.25 | Rake $0 
Seat 1: Iarlei (button) collected ($0.25)
Seat 2: steepfell (small blind) folded before Flop
Seat 3: Yspenyanin (big blind) folded before Flop
Seat 4: Cluckh folded before Flop (didn't bet)
Seat 5: Spud014 folded before Flop (didn't bet)
Seat 6: mega spasser folded before Flop (didn't bet)



PokerStars Hand #166667571934:  Hold'em No Limit ($0.05/$0.10 USD) - 2017/02/23 16:03:36 ET
Table 'Landi II' 6-max Seat #1 is the button
Seat 1: dersiemer ($11.97 in chips) 
Seat 2: Aescul@pius ($11 in chips) 
Seat 3: dr.goofy ($21.59 in chips) 
Seat 4: alesi13 ($6.20 in chips) 
Seat 5: Bird et al ($10 in chips) 
Aescul@pius: posts small blind $0.05
dr.goofy: posts big blind $0.10
*** HOLE CARDS ***
alesi13: folds 
Bird et al: folds 
dersiemer: calls $0.10
Aescul@pius: folds 
dr.goofy: checks 
*** FLOP *** [Qc 7d 7s]
dr.goofy: checks 
dersiemer: checks 
*** TURN *** [Qc 7d 7s] [Kc]
dr.goofy: checks 
dersiemer: checks 
*** RIVER *** [Qc 7d 7s Kc] [Js]
dr.goofy: checks 
dersiemer: bets $0.10
dr.goofy: folds 
Uncalled bet ($0.10) returned to dersiemer
dersiemer collected $0.24 from pot
*** SUMMARY ***
Total pot $0.25 | Rake $0.01 
Board [Qc 7d 7s Kc Js]
Seat 1: dersiemer (button) collected ($0.24)
Seat 2: Aescul@pius (small blind) folded before Flop
Seat 3: dr.goofy (big blind) folded on the River
Seat 4: alesi13 folded before Flop (didn't bet)
Seat 5: Bird et al folded before Flop (didn't bet)



PokerStars Hand #166667572048:  Hold'em No Limit ($0.05/$0.10 USD) - 2017/02/23 16:03:36 ET
Table 'Hercynia III' 6-max Seat #6 is the button
Seat 1: Bird et al ($14.63 in chips) 
Seat 2: Action_Gibi ($8.25 in chips) 
Seat 3: Dcaro31 ($20.54 in chips) 
Seat 4: Darkfrai ($17.37 in chips) 
Seat 5: THIMUCHIN ($14.79 in chips) 
Seat 6: bdixon_5 ($10.72 in chips) 
Bird et al: posts small blind $0.05
Action_Gibi: posts big blind $0.10
*** HOLE CARDS ***
Dcaro31: folds 
Darkfrai: folds 
THIMUCHIN: folds 
bdixon_5: raises $0.20 to $0.30
Bird et al: folds 
Action_Gibi: calls $0.20
*** FLOP *** [9h Ah 6d]
Action_Gibi: checks 
bdixon_5: bets $0.40
Action_Gibi: folds 
Uncalled bet ($0.40) returned to bdixon_5
bdixon_5 collected $0.62 from pot
*** SUMMARY ***
Total pot $0.65 | Rake $0.03 
Board [9h Ah 6d]
Seat 1: Bird et al (small blind) folded before Flop
Seat 2: Action_Gibi (big blind) folded on the Flop
Seat 3: Dcaro31 folded before Flop (didn't bet)
Seat 4: Darkfrai folded before Flop (didn't bet)
Seat 5: THIMUCHIN folded before Flop (didn't bet)
Seat 6: bdixon_5 (button) collected ($0.62)



PokerStars Hand #166667572403:  Hold'em No Limit ($0.05/$0.10 USD) - 2017/02/23 16:03:36 ET
Table 'Carina' 6-max Seat #6 is the button
Seat 1: Kupi007 ($10 in chips) 
Seat 2: kickereens ($24.39 in chips) 
Seat 3: LarryTheStar ($10.10 in chips) 
Seat 4: crazydevill ($10 in chips) 
Seat 5: IAntikI ($10.15 in chips) 
Seat 6: alexweezer ($9.80 in chips) 
Kupi007: posts small blind $0.05
kickereens: posts big blind $0.10
*** HOLE CARDS ***
LarryTheStar: folds 
crazydevill: folds 
IAntikI: raises $0.20 to $0.30
alexweezer: folds 
Kupi007: folds 
kickereens: folds 
Uncalled bet ($0.20) returned to IAntikI
IAntikI collected $0.25 from pot
*** SUMMARY ***
Total pot $0.25 | Rake $0 
Seat 1: Kupi007 (small blind) folded before Flop
Seat 2: kickereens (big blind) folded before Flop
Seat 3: LarryTheStar folded before Flop (didn't bet)
Seat 4: crazydevill folded before Flop (didn't bet)
Seat 5: IAntikI collected ($0.25)
Seat 6: alexweezer (button) folded before Flop (didn't bet)



PokerStars Hand #166667572452:  Hold'em No Limit ($0.05/$0.10 USD) - 2017/02/23 16:03:36 ET
Table 'Lesath III' 6-max Seat #6 is the button
Seat 1: Gogeta26 ($6.47 in chips) 
Seat 2: WinninBikini ($10.18 in chips) 
Seat 3: Giyorod ($10 in chips) 
Seat 4: Eddys Edge ($10 in chips) 
Seat 5: eniksenik ($16.15 in chips) 
Seat 6: patrick19111 ($10.56 in chips) 
Gogeta26: posts small blind $0.05
WinninBikini: posts big blind $0.10
*** HOLE CARDS ***
Giyorod: raises $0.20 to $0.30
Eddys Edge: folds 
eniksenik: folds 
patrick19111: folds 
Gogeta26: folds 
WinninBikini: folds 
Uncalled bet ($0.20) returned to Giyorod
Giyorod collected $0.25 from pot
*** SUMMARY ***
Total pot $0.25 | Rake $0 
Seat 1: Gogeta26 (small blind) folded before Flop
Seat 2: WinninBikini (big blind) folded before Flop
Seat 3: Giyorod collected ($0.25)
Seat 4: Eddys Edge folded before Flop (didn't bet)
Seat 5: eniksenik folded before Flop (didn't bet)
Seat 6: patrick19111 (button) folded before Flop (didn't bet)



PokerStars Hand #166667572627:  Hold'em No Limit ($0.05/$0.10 USD) - 2017/02/23 16:03:37 ET
Table 'Grietje' 6-max Seat #2 is the button
Seat 1: WinninBikini ($14.63 in chips) 
Seat 2: Feverhead ($13.32 in chips) 
Seat 3: voledy ($10 in chips) 
Seat 6: Prometheu$8 ($21.20 in chips) 
voledy: posts small blind $0.05
6ePeMeHHa9: is sitting out 
6ePeMeHHa9 leaves the table
Prometheu$8: posts big blind $0.10
*** HOLE CARDS ***
MihaGr joins the table at seat #4 
WinninBikini: folds 
steepfell joins the table at seat #5 
steepfell leaves the table
Feverhead: raises $0.10 to $0.20
iThreeBarrel joins the table at seat #5 
voledy: folds 
Prometheu$8: raises $0.45 to $0.65
Feverhead: folds 
Uncalled bet ($0.45) returned to Prometheu$8
Prometheu$8 collected $0.45 from pot
*** SUMMARY ***
Total pot $0.45 | Rake $0 
Seat 1: WinninBikini folded before Flop (didn't bet)
Seat 2: Feverhead (button) folded before Flop
Seat 3: voledy (small blind) folded before Flop
Seat 6: Prometheu$8 (big blind) collected ($0.45)



PokerStars Hand #166667572860:  Hold'em No Limit ($0.05/$0.10 USD) - 2017/02/23 16:03:37 ET
Table 'California II' 6-max Seat #1 is the button
Seat 1: fedorka rus ($10.23 in chips) 
Seat 2: homelessdan ($10.05 in chips) 
Seat 3: Bird et al ($10.35 in chips) 
Seat 5: bambolejro ($16.43 in chips) 
Seat 6: chiko4040 ($7.27 in chips) 
homelessdan: posts small blind $0.05
Bird et al: posts big blind $0.10
pokekrk: sits out 
*** HOLE CARDS ***
bambolejro: folds 
chiko4040: folds 
fedorka rus: folds 
homelessdan: raises $0.10 to $0.20
Bird et al: folds 
Uncalled bet ($0.10) returned to homelessdan
homelessdan collected $0.20 from pot
*** SUMMARY ***
Total pot $0.20 | Rake $0 
Seat 1: fedorka rus (button) folded before Flop (didn't bet)
Seat 2: homelessdan (small blind) collected ($0.20)
Seat 3: Bird et al (big blind) folded before Flop
Seat 5: bambolejro folded before Flop (didn't bet)
Seat 6: chiko4040 folded before Flop (didn't bet)



PokerStars Hand #166667572915:  Hold'em No Limit ($0.05/$0.10 USD) - 2017/02/23 16:03:37 ET
Table 'Azelfafage' 6-max Seat #5 is the button
Seat 1: Sbozzz ($15.76 in chips) 
Seat 2: tr41n3r12 ($10.30 in chips) 
Seat 3: todor1711 ($20.49 in chips) 
Seat 4: fedorka rus ($10.12 in chips) 
Seat 5: 8th wonders ($12.58 in chips) 
Seat 6: KA3AXCTAHEU, ($10 in chips) 
KA3AXCTAHEU,: posts small blind $0.05
Sbozzz: posts big blind $0.10
*** HOLE CARDS ***
tr41n3r12: folds 
todor1711: raises $0.10 to $0.20
fedorka rus: calls $0.20
8th wonders: folds 
KA3AXCTAHEU,: folds 
Sbozzz: folds 
*** FLOP *** [Ks 4d 5h]
todor1711: bets $1.30
fedorka rus: folds 
Uncalled bet ($1.30) returned to todor1711
todor1711 collected $0.53 from pot
*** SUMMARY ***
Total pot $0.55 | Rake $0.02 
Board [Ks 4d 5h]
Seat 1: Sbozzz (big blind) folded before Flop
Seat 2: tr41n3r12 folded before Flop (didn't bet)
Seat 3: todor1711 collected ($0.53)
Seat 4: fedorka rus folded on the Flop
Seat 5: 8th wonders (button) folded before Flop (didn't bet)
Seat 6: KA3AXCTAHEU, (small blind) folded before Flop



PokerStars Hand #166667572950:  Hold'em No Limit ($0.05/$0.10 USD) - 2017/02/23 16:03:37 ET
Table 'Aisakos II' 6-max Seat #1 is the button
Seat 1: Crafty23@PS ($10 in chips) 
Seat 2: svaika24 ($16.98 in chips) 
Seat 3: iamkakaroto ($10.69 in chips) 
Seat 4: T9MS ($10 in chips) 
Seat 5: KokoulinV ($12.40 in chips) 
Seat 6: LarryTheStar ($10 in chips) 
svaika24: posts small blind $0.05
iamkakaroto: posts big blind $0.10
*** HOLE CARDS ***
T9MS: folds 
KokoulinV: folds 
LarryTheStar: folds 
Crafty23@PS: raises $0.15 to $0.25
svaika24: folds 
iamkakaroto: folds 
Uncalled bet ($0.15) returned to Crafty23@PS
Crafty23@PS collected $0.25 from pot
*** SUMMARY ***
Total pot $0.25 | Rake $0 
Seat 1: Crafty23@PS (button) collected ($0.25)
Seat 2: svaika24 (small blind) folded before Flop
Seat 3: iamkakaroto (big blind) folded before Flop
Seat 4: T9MS folded before Flop (didn't bet)
Seat 5: KokoulinV folded before Flop (didn't bet)
Seat 6: LarryTheStar folded before Flop (didn't bet)



PokerStars Hand #166667573057:  Hold'em No Limit ($0.05/$0.10 USD) - 2017/02/23 16:03:37 ET
Table 'Reginhild' 6-max Seat #1 is the button
Seat 1: iamkakaroto ($11.40 in chips) 
Seat 2: Kow6oy ($10.05 in chips) 
Seat 3: ARCHITECT83 ($6.18 in chips) 
Seat 4: Raymondo21 ($23.36 in chips) 
Seat 5: XCarlos610 ($29.25 in chips) 
Seat 6: eniksenik ($10 in chips) 
Kow6oy: posts small blind $0.05
ARCHITECT83: posts big blind $0.10
*** HOLE CARDS ***
Raymondo21: folds 
XCarlos610: calls $0.10
eniksenik: folds 
iamkakaroto: folds 
Kow6oy: folds 
ARCHITECT83: checks 
*** FLOP *** [4h Qs 5c]
ARCHITECT83: bets $0.30
XCarlos610: calls $0.30
*** TURN *** [4h Qs 5c] [Th]
ARCHITECT83: bets $0.40
XCarlos610: calls $0.40
*** RIVER *** [4h Qs 5c Th] [Qc]
ARCHITECT83: checks 
XCarlos610: checks 
*** SHOW DOWN ***
ARCHITECT83: shows [7c Jc] (a pair of Queens)
XCarlos610: shows [Ah As] (two pair, Aces and Queens)
XCarlos610 collected $1.58 from pot
*** SUMMARY ***
Total pot $1.65 | Rake $0.07 
Board [4h Qs 5c Th Qc]
Seat 1: iamkakaroto (button) folded before Flop (didn't bet)
Seat 2: Kow6oy (small blind) folded before Flop
Seat 3: ARCHITECT83 (big blind) showed [7c Jc] and lost with a pair of Queens
Seat 4: Raymondo21 folded before Flop (didn't bet)
Seat 5: XCarlos610 showed [Ah As] and won ($1.58) with two pair, Aces and Queens
Seat 6: eniksenik folded before Flop (didn't bet)



PokerStars Hand #166667573062:  Hold'em No Limit ($0.05/$0.10 USD) - 2017/02/23 16:03:37 ET
Table 'Wilkens II' 6-max Seat #2 is the button
Seat 1: Islamiq-GuRL ($12.15 in chips) 
Seat 2: manashov ($10.75 in chips) 
Seat 3: Namhkal ($10.70 in chips) 
Seat 5: patrick19111 ($10 in chips) 
Seat 6: XaXaTyH4uK ($14.46 in chips) 
Namhkal: posts small blind $0.05
patrick19111: posts big blind $0.10
*** HOLE CARDS ***
XaXaTyH4uK: folds 
Islamiq-GuRL: folds 
manashov: folds 
Namhkal: folds 
Uncalled bet ($0.05) returned to patrick19111
patrick19111 collected $0.10 from pot
*** SUMMARY ***
Total pot $0.10 | Rake $0 
Seat 1: Islamiq-GuRL folded before Flop (didn't bet)
Seat 2: manashov (button) folded before Flop (didn't bet)
Seat 3: Namhkal (small blind) folded before Flop
Seat 5: patrick19111 (big blind) collected ($0.10)
Seat 6: XaXaTyH4uK folded before Flop (didn't bet)



PokerStars Hand #166667573069:  Hold'em No Limit ($0.05/$0.10 USD) - 2017/02/23 16:03:37 ET
Table 'Torrence II' 6-max Seat #2 is the button
Seat 1: Starbooks ($4.22 in chips) 
Seat 2: scorpionfish ($16.10 in chips) 
Seat 3: coolisses111 ($9.75 in chips) 
Seat 4: Zooplack ($10.23 in chips) 
Seat 5: Kow6oy ($12.33 in chips) 
coolisses111: posts small blind $0.05
Zooplack: posts big blind $0.10
mhonielsen: sits out 
*** HOLE CARDS ***
Kow6oy: folds 
Starbooks: calls $0.10
scorpionfish: folds 
coolisses111: calls $0.05
Zooplack: raises $0.40 to $0.50
Starbooks: calls $0.40
coolisses111: folds 
*** FLOP *** [Ac 6s Tc]
Zooplack: bets $0.63
Starbooks: raises $0.87 to $1.50
Zooplack: calls $0.87
*** TURN *** [Ac 6s Tc] [2d]
Zooplack: checks 
Starbooks: bets $2.22 and is all-in
Zooplack: folds 
Uncalled bet ($2.22) returned to Starbooks
Starbooks collected $3.92 from pot
*** SUMMARY ***
Total pot $4.10 | Rake $0.18 
Board [Ac 6s Tc 2d]
Seat 1: Starbooks collected ($3.92)
Seat 2: scorpionfish (button) folded before Flop (didn't bet)
Seat 3: coolisses111 (small blind) folded before Flop
Seat 4: Zooplack (big blind) folded on the Turn
Seat 5: Kow6oy folded before Flop (didn't bet)



PokerStars Hand #166667573129:  Hold'em No Limit ($0.05/$0.10 USD) - 2017/02/23 16:03:37 ET
Table 'Juliet II' 6-max Seat #3 is the button
Seat 1: alexpolevaja ($11.23 in chips) 
Seat 2: KA3AXCTAHEU, ($15.43 in chips) 
Seat 3: patrick19111 ($11.57 in chips) 
Seat 4: x3ultimate ($10 in chips) 
Seat 5: Dcaro31 ($19.02 in chips) 
Seat 6: BookWorm78 ($33.10 in chips) 
x3ultimate: posts small blind $0.05
Dcaro31: posts big blind $0.10
*** HOLE CARDS ***
BookWorm78: folds 
alexpolevaja: calls $0.10
KA3AXCTAHEU,: raises $0.25 to $0.35
patrick19111: folds 
x3ultimate: raises $1.05 to $1.40
Dcaro31: folds 
alexpolevaja: folds 
KA3AXCTAHEU,: folds 
Uncalled bet ($1.05) returned to x3ultimate
x3ultimate collected $0.90 from pot
*** SUMMARY ***
Total pot $0.90 | Rake $0 
Seat 1: alexpolevaja folded before Flop
Seat 2: KA3AXCTAHEU, folded before Flop
Seat 3: patrick19111 (button) folded before Flop (didn't bet)
Seat 4: x3ultimate (small blind) collected ($0.90)
Seat 5: Dcaro31 (big blind) folded before Flop
Seat 6: BookWorm78 folded before Flop (didn't bet)



PokerStars Hand #166667573138:  Hold'em No Limit ($0.05/$0.10 USD) - 2017/02/23 16:03:37 ET
Table 'Brendelia II' 6-max Seat #6 is the button
Seat 2: Crimsonr ($5.61 in chips) 
Seat 3: ValdemorS ($18.49 in chips) 
Seat 6: luckyPositiv ($10.17 in chips) 
Crimsonr: posts small blind $0.05
ValdemorS: posts big blind $0.10
Crimsonr: posts the ante $0.02
ValdemorS: posts the ante $0.02
luckyPositiv: posts the ante $0.02
*** HOLE CARDS ***
luckyPositiv: folds 
Crimsonr: calls $0.05
ValdemorS: checks 
*** FLOP *** [Kd 5c 3c]
Crimsonr: checks 
ValdemorS: checks 
*** TURN *** [Kd 5c 3c] [8s]
Crimsonr: bets $0.50
ValdemorS: calls $0.50
*** RIVER *** [Kd 5c 3c 8s] [Ah]
Crimsonr: checks 
ValdemorS: bets $0.90
Crimsonr: folds 
Uncalled bet ($0.90) returned to ValdemorS
ValdemorS collected $1.20 from pot
*** SUMMARY ***
Total pot $1.26 | Rake $0.06 
Board [Kd 5c 3c 8s Ah]
Seat 2: Crimsonr (small blind) folded on the River
Seat 3: ValdemorS (big blind) collected ($1.20)
Seat 6: luckyPositiv (button) folded before Flop (didn't bet)



PokerStars Hand #166667573528:  Hold'em No Limit ($0.05/$0.10 USD) - 2017/02/23 16:03:38 ET
Table 'Clavel' 6-max Seat #6 is the button
Seat 1: KRZuff ($14.56 in chips) 
Seat 4: Dcaro31 ($11.81 in chips) 
Seat 5: Vrinni ($10.39 in chips) 
Seat 6: Gra_anD77 ($4.39 in chips) 
KRZuff: posts small blind $0.05
RoJ1: is sitting out 
Dcaro31: posts big blind $0.10
*** HOLE CARDS ***
RoJ1 leaves the table
Namhkal joins the table at seat #2 
Vrinni: folds 
Gra_anD77: raises $0.10 to $0.20
KRZuff: folds 
Dcaro31: folds 
Uncalled bet ($0.10) returned to Gra_anD77
Gra_anD77 collected $0.25 from pot
*** SUMMARY ***
Total pot $0.25 | Rake $0 
Seat 1: KRZuff (small blind) folded before Flop
Seat 4: Dcaro31 (big blind) folded before Flop
Seat 5: Vrinni folded before Flop (didn't bet)
Seat 6: Gra_anD77 (button) collected ($0.25)



PokerStars Hand #166667574008:  Hold'em No Limit ($0.05/$0.10 USD) - 2017/02/23 16:03:38 ET
Table 'Bootes' 6-max Seat #1 is the button
Seat 1: Namhkal ($12.95 in chips) 
Seat 2: Bird et al ($19.35 in chips) 
Seat 3: KA3AXCTAHEU, ($19.63 in chips) 
Seat 4: totonove ($4.56 in chips) 
Seat 5: Pekaml ($15.42 in chips) 
Bird et al: posts small blind $0.05
KA3AXCTAHEU,: posts big blind $0.10
cherep61987: sits out 
*** HOLE CARDS ***
totonove: raises $0.10 to $0.20
Pekaml: folds 
Namhkal: folds 
Bird et al: folds 
KA3AXCTAHEU,: folds 
Uncalled bet ($0.10) returned to totonove
totonove collected $0.25 from pot
*** SUMMARY ***
Total pot $0.25 | Rake $0 
Seat 1: Namhkal (button) folded before Flop (didn't bet)
Seat 2: Bird et al (small blind) folded before Flop
Seat 3: KA3AXCTAHEU, (big blind) folded before Flop
Seat 4: totonove collected ($0.25)
Seat 5: Pekaml folded before Flop (didn't bet)



PokerStars Hand #166667574038:  Hold'em No Limit ($0.05/$0.10 USD) - 2017/02/23 16:03:38 ET
Table 'Thia' 6-max Seat #5 is the button
Seat 1: Eddys Edge ($10 in chips) 
Seat 2: sugrob86 ($20 in chips) 
Seat 3: northug18 ($9.07 in chips) 
Seat 4: Bandyaev ($10.35 in chips) 
Seat 5: ab260414 ($10.57 in chips) 
Seat 6: ex3Lero86 ($15.50 in chips) 
ex3Lero86: posts small blind $0.05
Eddys Edge: posts big blind $0.10
*** HOLE CARDS ***
sugrob86: calls $0.10
northug18: raises $0.20 to $0.30
Bandyaev: folds 
ab260414: folds 
ex3Lero86: folds 
Eddys Edge: folds 
sugrob86: calls $0.20
*** FLOP *** [8d 4c 4h]
sugrob86: checks 
northug18: checks 
*** TURN *** [8d 4c 4h] [7c]
sugrob86: checks 
northug18: checks 
*** RIVER *** [8d 4c 4h 7c] [Jc]
sugrob86: checks 
northug18: checks 
*** SHOW DOWN ***
sugrob86: shows [3d 2c] (a pair of Fours)
northug18: shows [Jd Ah] (two pair, Jacks and Fours)
northug18 collected $0.72 from pot
*** SUMMARY ***
Total pot $0.75 | Rake $0.03 
Board [8d 4c 4h 7c Jc]
Seat 1: Eddys Edge (big blind) folded before Flop
Seat 2: sugrob86 showed [3d 2c] and lost with a pair of Fours
Seat 3: northug18 showed [Jd Ah] and won ($0.72) with two pair, Jacks and Fours
Seat 4: Bandyaev folded before Flop (didn't bet)
Seat 5: ab260414 (button) folded before Flop (didn't bet)
Seat 6: ex3Lero86 (small blind) folded before Flop



PokerStars Hand #166667574293:  Hold'em No Limit ($0.05/$0.10 USD) - 2017/02/23 16:03:38 ET
Table 'Bengt' 6-max Seat #4 is the button
Seat 1: Lucky HoBBiT ($12.50 in chips) 
Seat 2: ChefRocco ($21.46 in chips) 
Seat 3: nantes15 ($12.88 in chips) 
Seat 4: 8th wonders ($10 in chips) 
Seat 5: RoJ1 ($10.36 in chips) 
Seat 6: Goroshkos88 ($10 in chips) 
RoJ1: posts small blind $0.05
Goroshkos88: posts big blind $0.10
*** HOLE CARDS ***
Lucky HoBBiT: folds 
ChefRocco: folds 
nantes15: raises $0.15 to $0.25
8th wonders: folds 
RoJ1: folds 
Goroshkos88: folds 
Uncalled bet ($0.15) returned to nantes15
nantes15 collected $0.25 from pot
*** SUMMARY ***
Total pot $0.25 | Rake $0 
Seat 1: Lucky HoBBiT folded before Flop (didn't bet)
Seat 2: ChefRocco folded before Flop (didn't bet)
Seat 3: nantes15 collected ($0.25)
Seat 4: 8th wonders (button) folded before Flop (didn't bet)
Seat 5: RoJ1 (small blind) folded before Flop
Seat 6: Goroshkos88 (big blind) folded before Flop



PokerStars Hand #166667574337:  Hold'em No Limit ($0.05/$0.10 USD) - 2017/02/23 16:03:39 ET
Table 'Lehigh' 6-max Seat #3 is the button
Seat 1: kowe4ka565 ($11.03 in chips) 
Seat 3: Therodorus ($10 in chips) 
Seat 4: Chodemuncher ($10.10 in chips) 
Seat 5: Xander188 ($10.15 in chips) 
Seat 6: CallByValue ($10 in chips) 
Chodemuncher: posts small blind $0.05
Xander188: posts big blind $0.10
Sbozzz: sits out 
*** HOLE CARDS ***
CallByValue has timed out
CallByValue: folds 
kowe4ka565: calls $0.10
Therodorus: folds 
Chodemuncher: calls $0.05
Xander188: checks 
*** FLOP *** [9h 6h Kh]
Chodemuncher: checks 
Xander188: checks 
kowe4ka565: bets $0.29
Chodemuncher: folds 
Xander188: folds 
Uncalled bet ($0.29) returned to kowe4ka565
kowe4ka565 collected $0.29 from pot
*** SUMMARY ***
Total pot $0.30 | Rake $0.01 
Board [9h 6h Kh]
Seat 1: kowe4ka565 collected ($0.29)
Seat 3: Therodorus (button) folded before Flop (didn't bet)
Seat 4: Chodemuncher (small blind) folded on the Flop
Seat 5: Xander188 (big blind) folded on the Flop
Seat 6: CallByValue folded before Flop (didn't bet)



PokerStars Hand #166667574364:  Hold'em No Limit ($0.05/$0.10 USD) - 2017/02/23 16:03:39 ET
Table 'Lacroute' 6-max Seat #5 is the button
Seat 1: johnnyPieper ($6.09 in chips) 
Seat 2: Andy Wolf ($10 in chips) 
Seat 3: Croplayer1 ($14.90 in chips) 
Seat 4: st4tion ($15.91 in chips) 
Seat 5: steepfell ($10.97 in chips) 
Seat 6: IAntikI ($10 in chips) 
IAntikI: posts small blind $0.05
johnnyPieper: posts big blind $0.10
*** HOLE CARDS ***
Andy Wolf: folds 
Croplayer1: folds 
st4tion: folds 
steepfell: raises $0.20 to $0.30
IAntikI: folds 
johnnyPieper: calls $0.20
*** FLOP *** [Qh 2d Kc]
johnnyPieper: checks 
steepfell: checks 
*** TURN *** [Qh 2d Kc] [Ks]
johnnyPieper: checks 
steepfell: checks 
*** RIVER *** [Qh 2d Kc Ks] [3d]
johnnyPieper: checks 
steepfell: checks 
*** SHOW DOWN ***
johnnyPieper: shows [7s Td] (a pair of Kings)
steepfell: shows [Jd Js] (two pair, Kings and Jacks)
steepfell collected $0.62 from pot
*** SUMMARY ***
Total pot $0.65 | Rake $0.03 
Board [Qh 2d Kc Ks 3d]
Seat 1: johnnyPieper (big blind) showed [7s Td] and lost with a pair of Kings
Seat 2: Andy Wolf folded before Flop (didn't bet)
Seat 3: Croplayer1 folded before Flop (didn't bet)
Seat 4: st4tion folded before Flop (didn't bet)
Seat 5: steepfell (button) showed [Jd Js] and won ($0.62) with two pair, Kings and Jacks
Seat 6: IAntikI (small blind) folded before Flop



PokerStars Hand #166667574514:  Hold'em No Limit ($0.05/$0.10 USD) - 2017/02/23 16:03:39 ET
Table 'Wabash' 6-max Seat #3 is the button
Seat 1: pivanki11 ($10 in chips) 
Seat 2: ex3Lero86 ($32.55 in chips) 
Seat 3: sszabi28 ($5.56 in chips) 
Seat 4: Nr847 ($10 in chips) 
Seat 5: popypaleta ($10.10 in chips) 
Seat 6: weez3r ($10.44 in chips) 
Nr847: posts small blind $0.05
popypaleta: posts big blind $0.10
*** HOLE CARDS ***
weez3r: raises $0.20 to $0.30
pivanki11: folds 
ex3Lero86: raises $0.70 to $1
sszabi28: calls $1
Nr847: folds 
popypaleta: folds 
weez3r: raises $9.44 to $10.44 and is all-in
ex3Lero86: raises $9.44 to $19.88
sszabi28: folds 
Uncalled bet ($9.44) returned to ex3Lero86
*** FLOP *** [Th Jd 8h]
*** TURN *** [Th Jd 8h] [9c]
*** RIVER *** [Th Jd 8h 9c] [7d]
*** SHOW DOWN ***
weez3r: shows [As Ad] (a straight, Seven to Jack)
ex3Lero86: shows [Kd Kh] (a straight, Seven to Jack)
weez3r collected $10.52 from pot
ex3Lero86 collected $10.52 from pot
*** SUMMARY ***
Total pot $22.03 | Rake $0.99 
Board [Th Jd 8h 9c 7d]
Seat 1: pivanki11 folded before Flop (didn't bet)
Seat 2: ex3Lero86 showed [Kd Kh] and won ($10.52) with a straight, Seven to Jack
Seat 3: sszabi28 (button) folded before Flop
Seat 4: Nr847 (small blind) folded before Flop
Seat 5: popypaleta (big blind) folded before Flop
Seat 6: weez3r showed [As Ad] and won ($10.52) with a straight, Seven to Jack



PokerStars Hand #166667575254:  Hold'em No Limit ($0.05/$0.10 USD) - 2017/02/23 16:03:39 ET
Table 'Pirola III' 6-max Seat #3 is the button
Seat 1: bdixon_5 ($9.47 in chips) 
Seat 2: gaHy_HaXeP ($10 in chips) 
Seat 3: kingartur222 ($11.07 in chips) 
Seat 4: McCleans ($10.35 in chips) 
Seat 5: tequila_joop ($10 in chips) 
Seat 6: T9MS ($10 in chips) 
McCleans: posts small blind $0.05
tequila_joop: posts big blind $0.10
*** HOLE CARDS ***
T9MS: folds 
bdixon_5: folds 
gaHy_HaXeP: folds 
kingartur222: raises $0.15 to $0.25
McCleans: folds 
tequila_joop: raises $0.65 to $0.90
kingartur222: folds 
Uncalled bet ($0.65) returned to tequila_joop
tequila_joop collected $0.55 from pot
*** SUMMARY ***
Total pot $0.55 | Rake $0 
Seat 1: bdixon_5 folded before Flop (didn't bet)
Seat 2: gaHy_HaXeP folded before Flop (didn't bet)
Seat 3: kingartur222 (button) folded before Flop
Seat 4: McCleans (small blind) folded before Flop
Seat 5: tequila_joop (big blind) collected ($0.55)
Seat 6: T9MS folded before Flop (didn't bet)



PokerStars Hand #166667575335:  Hold'em No Limit ($0.05/$0.10 USD) - 2017/02/23 16:03:40 ET
Table 'Alzirr II' 6-max Seat #4 is the button
Seat 1: KA3AXCTAHEU, ($10.61 in chips) 
Seat 2: popypaleta ($10.32 in chips) 
Seat 4: Scanner17 ($17.64 in chips) 
Seat 5: yodzik ($5.05 in chips) 
Seat 6: AM-L-SL ($5 in chips) 
yodzik: posts small blind $0.05
AM-L-SL: posts big blind $0.10
devon_red: sits out 
*** HOLE CARDS ***
KA3AXCTAHEU,: raises $0.20 to $0.30
popypaleta: folds 
Scanner17: raises $0.70 to $1
yodzik: folds 
AM-L-SL: folds 
KA3AXCTAHEU,: folds 
Uncalled bet ($0.70) returned to Scanner17
Scanner17 collected $0.75 from pot
*** SUMMARY ***
Total pot $0.75 | Rake $0 
Seat 1: KA3AXCTAHEU, folded before Flop
Seat 2: popypaleta folded before Flop (didn't bet)
Seat 4: Scanner17 (button) collected ($0.75)
Seat 5: yodzik (small blind) folded before Flop
Seat 6: AM-L-SL (big blind) folded before Flop



PokerStars Hand #166667575461:  Hold'em No Limit ($0.05/$0.10 USD) - 2017/02/23 16:03:40 ET
Table 'Emma II' 6-max Seat #2 is the button
Seat 1: LarryTheStar ($10 in chips) 
Seat 2: T9MS ($11.64 in chips) 
Seat 3: oddshoff ($9.57 in chips) 
Seat 4: Jucatorul823 ($5.97 in chips) 
Seat 5: Scanner17 ($11.21 in chips) 
Seat 6: CHRO8 ($14.82 in chips) 
oddshoff: posts small blind $0.05
Jucatorul823: posts big blind $0.10
*** HOLE CARDS ***
Scanner17: raises $0.20 to $0.30
CHRO8 has timed out
CHRO8: folds 
LarryTheStar: folds 
T9MS: folds 
oddshoff: folds 
Jucatorul823: folds 
Uncalled bet ($0.20) returned to Scanner17
Scanner17 collected $0.25 from pot
*** SUMMARY ***
Total pot $0.25 | Rake $0 
Seat 1: LarryTheStar folded before Flop (didn't bet)
Seat 2: T9MS (button) folded before Flop (didn't bet)
Seat 3: oddshoff (small blind) folded before Flop
Seat 4: Jucatorul823 (big blind) folded before Flop
Seat 5: Scanner17 collected ($0.25)
Seat 6: CHRO8 folded before Flop (didn't bet)



PokerStars Hand #166667575757:  Hold'em No Limit ($0.05/$0.10 USD) - 2017/02/23 16:03:40 ET
Table 'Gyldenia II' 6-max Seat #2 is the button
Seat 1: KokoulinV ($10.40 in chips) 
Seat 2: Bandyaev ($11.09 in chips) 
Seat 3: ex3Lero86 ($23.42 in chips) 
Seat 5: CHRO8 ($17.41 in chips) 
Seat 6: 8th wonders ($10 in chips) 
ex3Lero86: posts small blind $0.05
CHRO8: posts big blind $0.10
*** HOLE CARDS ***
8th wonders: raises $0.20 to $0.30
KokoulinV: folds 
Bandyaev: folds 
ex3Lero86: folds 
CHRO8: calls $0.20
*** FLOP *** [5s Jc 7s]
CHRO8: checks 
8th wonders: bets $0.60
CHRO8: calls $0.60
*** TURN *** [5s Jc 7s] [7d]
CHRO8: bets $0.89
8th wonders: raises $2.11 to $3
CHRO8: folds 
Uncalled bet ($2.11) returned to 8th wonders
8th wonders collected $3.47 from pot
*** SUMMARY ***
Total pot $3.63 | Rake $0.16 
Board [5s Jc 7s 7d]
Seat 1: KokoulinV folded before Flop (didn't bet)
Seat 2: Bandyaev (button) folded before Flop (didn't bet)
Seat 3: ex3Lero86 (small blind) folded before Flop
Seat 5: CHRO8 (big blind) folded on the Turn
Seat 6: 8th wonders collected ($3.47)



PokerStars Hand #166667576005:  Hold'em No Limit ($0.05/$0.10 USD) - 2017/02/23 16:03:40 ET
Table 'Fechtig III' 6-max Seat #1 is the button
Seat 1: Scanner17 ($10 in chips) 
Seat 2: GV82 ($17.23 in chips) 
Seat 3: eniksenik ($10 in chips) 
Seat 4: kickereens ($11.23 in chips) 
Seat 5: ksandr_hom ($10.10 in chips) 
Seat 6: Glatzemandse ($19.19 in chips) 
GV82: posts small blind $0.05
eniksenik: posts big blind $0.10
*** HOLE CARDS ***
kickereens: folds 
ksandr_hom: folds 
Glatzemandse: calls $0.10
kickereens leaves the table
Kow6oy joins the table at seat #4 
Scanner17: raises $0.30 to $0.40
GV82: calls $0.35
eniksenik: folds 
Glatzemandse: calls $0.30
*** FLOP *** [9h 5s 3h]
GV82: checks 
Glatzemandse: checks 
Scanner17: checks 
*** TURN *** [9h 5s 3h] [Qc]
GV82: checks 
Glatzemandse: checks 
Scanner17: bets $0.75
GV82: calls $0.75
Glatzemandse: calls $0.75
*** RIVER *** [9h 5s 3h Qc] [3d]
GV82: checks 
Glatzemandse: checks 
Scanner17: checks 
*** SHOW DOWN ***
GV82: shows [Kh 4h] (a pair of Threes)
Glatzemandse: mucks hand 
Scanner17: shows [Ks Ts] (a pair of Threes - King+Queen+Ten kicker)
Scanner17 collected $3.39 from pot
*** SUMMARY ***
Total pot $3.55 | Rake $0.16 
Board [9h 5s 3h Qc 3d]
Seat 1: Scanner17 (button) showed [Ks Ts] and won ($3.39) with a pair of Threes
Seat 2: GV82 (small blind) showed [Kh 4h] and lost with a pair of Threes
Seat 3: eniksenik (big blind) folded before Flop
Seat 4: kickereens folded before Flop (didn't bet)
Seat 5: ksandr_hom folded before Flop (didn't bet)
Seat 6: Glatzemandse mucked



PokerStars Hand #166667576044:  Hold'em No Limit ($0.05/$0.10 USD) - 2017/02/23 16:03:40 ET
Table 'Postrema' 6-max Seat #3 is the button
Seat 1: CHRO8 ($13.27 in chips) 
Seat 2: pancernik21 ($12.61 in chips) 
Seat 3: edcc19 ($2.91 in chips) 
Seat 4: ChuikaPridi ($13.38 in chips) 
Seat 5: Comeback3392 ($12.20 in chips) 
Seat 6: Scanner17 ($10 in chips) 
ChuikaPridi: posts small blind $0.05
Comeback3392: posts big blind $0.10
*** HOLE CARDS ***
Scanner17: folds 
CHRO8: folds 
pancernik21: raises $0.20 to $0.30
edcc19: folds 
ChuikaPridi: folds 
Comeback3392: folds 
Uncalled bet ($0.20) returned to pancernik21
pancernik21 collected $0.25 from pot
*** SUMMARY ***
Total pot $0.25 | Rake $0 
Seat 1: CHRO8 folded before Flop (didn't bet)
Seat 2: pancernik21 collected ($0.25)
Seat 3: edcc19 (button) folded before Flop (didn't bet)
Seat 4: ChuikaPridi (small blind) folded before Flop
Seat 5: Comeback3392 (big blind) folded before Flop
Seat 6: Scanner17 folded before Flop (didn't bet)



PokerStars Hand #166667576334:  Hold'em No Limit ($0.05/$0.10 USD) - 2017/02/23 16:03:41 ET
Table 'Kochera' 6-max Seat #6 is the button
Seat 1: chimera252 ($11.55 in chips) 
Seat 2: bartabs2 ($10.61 in chips) 
Seat 3: KA3AXCTAHEU, ($10.25 in chips) 
Seat 4: johkom ($5.46 in chips) 
Seat 5: univibe68 ($11.85 in chips) 
Seat 6: oddshoff ($9.48 in chips) 
chimera252: posts small blind $0.05
bartabs2: posts big blind $0.10
*** HOLE CARDS ***
KA3AXCTAHEU,: folds 
johkom: folds 
univibe68: folds 
oddshoff: raises $0.10 to $0.20
chimera252: folds 
bartabs2: folds 
Uncalled bet ($0.10) returned to oddshoff
oddshoff collected $0.25 from pot
*** SUMMARY ***
Total pot $0.25 | Rake $0 
Seat 1: chimera252 (small blind) folded before Flop
Seat 2: bartabs2 (big blind) folded before Flop
Seat 3: KA3AXCTAHEU, folded before Flop (didn't bet)
Seat 4: johkom folded before Flop (didn't bet)
Seat 5: univibe68 folded before Flop (didn't bet)
Seat 6: oddshoff (button) collected ($0.25)



PokerStars Hand #166667576381:  Hold'em No Limit ($0.05/$0.10 USD) - 2017/02/23 16:03:41 ET
Table 'Gelria' 6-max Seat #1 is the button
Seat 1: ab260414 ($10 in chips) 
Seat 2: fishhook5 ($10 in chips) 
Seat 3: Orlangoor ($11.57 in chips) 
Seat 5: apenvel ($8.18 in chips) 
Seat 6: Andrei ProFF ($10.42 in chips) 
fishhook5: posts small blind $0.05
Orlangoor: posts big blind $0.10
*** HOLE CARDS ***
apenvel: calls $0.10
Andrei ProFF: folds 
ab260414: folds 
fishhook5: folds 
Orlangoor: checks 
*** FLOP *** [2c 5h 6s]
Orlangoor: checks 
apenvel: checks 
*** TURN *** [2c 5h 6s] [5d]
Orlangoor: bets $0.13
apenvel: calls $0.13
*** RIVER *** [2c 5h 6s 5d] [2d]
Orlangoor: bets $0.21
apenvel: folds 
Uncalled bet ($0.21) returned to Orlangoor
Orlangoor collected $0.49 from pot
*** SUMMARY ***
Total pot $0.51 | Rake $0.02 
Board [2c 5h 6s 5d 2d]
Seat 1: ab260414 (button) folded before Flop (didn't bet)
Seat 2: fishhook5 (small blind) folded before Flop
Seat 3: Orlangoor (big blind) collected ($0.49)
Seat 5: apenvel folded on the River
Seat 6: Andrei ProFF folded before Flop (didn't bet)



PokerStars Hand #166667576626:  Hold'em No Limit ($0.05/$0.10 USD) - 2017/02/23 16:03:41 ET
Table 'Nerthus II' 6-max Seat #1 is the button
Seat 1: mdelfin0 ($10.33 in chips) 
Seat 2: Hovhannes990 ($9.33 in chips) 
Seat 3: Mamm0nism ($18.82 in chips) 
Seat 5: Hyd SK ($12.15 in chips) 
Seat 6: Lucky HoBBiT ($10 in chips) 
Hovhannes990: posts small blind $0.05
Mamm0nism: posts big blind $0.10
*** HOLE CARDS ***
Hyd SK: folds 
Lucky HoBBiT: folds 
mdelfin0: raises $0.12 to $0.22
Hovhannes990: calls $0.17
Mamm0nism: folds 
*** FLOP *** [2h 7d 9d]
Hovhannes990: bets $0.10
mdelfin0: folds 
Uncalled bet ($0.10) returned to Hovhannes990
Hovhannes990 collected $0.52 from pot
*** SUMMARY ***
Total pot $0.54 | Rake $0.02 
Board [2h 7d 9d]
Seat 1: mdelfin0 (button) folded on the Flop
Seat 2: Hovhannes990 (small blind) collected ($0.52)
Seat 3: Mamm0nism (big blind) folded before Flop
Seat 5: Hyd SK folded before Flop (didn't bet)
Seat 6: Lucky HoBBiT folded before Flop (didn't bet)



PokerStars Hand #166667576935:  Hold'em No Limit ($0.05/$0.10 USD) - 2017/02/23 16:03:41 ET
Table 'Thoas' 6-max Seat #6 is the button
Seat 1: Pekaml ($11.48 in chips) 
Seat 2: themacer24 ($8.52 in chips) 
Seat 3: by.y.y.y86 ($10 in chips) 
Seat 4: Morris_Chair ($17.81 in chips) 
Seat 5: Kow6oy ($10.17 in chips) 
Seat 6: takis nik ($10 in chips) 
Pekaml: posts small blind $0.05
themacer24: posts big blind $0.10
*** HOLE CARDS ***
by.y.y.y86: folds 
Morris_Chair: folds 
Kow6oy: folds 
by.y.y.y86 leaves the table
takis nik: folds 
Pekaml: folds 
Uncalled bet ($0.05) returned to themacer24
themacer24 collected $0.10 from pot
*** SUMMARY ***
Total pot $0.10 | Rake $0 
Seat 1: Pekaml (small blind) folded before Flop
Seat 2: themacer24 (big blind) collected ($0.10)
Seat 3: by.y.y.y86 folded before Flop (didn't bet)
Seat 4: Morris_Chair folded before Flop (didn't bet)
Seat 5: Kow6oy folded before Flop (didn't bet)
Seat 6: takis nik (button) folded before Flop (didn't bet)



PokerStars Hand #166667577414:  Hold'em No Limit ($0.05/$0.10 USD) - 2017/02/23 16:03:42 ET
Table 'Huberta II' 6-max Seat #3 is the button
Seat 1: tr41n3r12 ($10 in chips) 
Seat 2: Ice_Isayev ($12.08 in chips) 
Seat 3: patrick19111 ($10.75 in chips) 
Seat 4: VAD21 ($12.16 in chips) 
Seat 5: Feverhead ($27.13 in chips) 
VAD21: posts small blind $0.05
Feverhead: posts big blind $0.10
*** HOLE CARDS ***
tr41n3r12: raises $0.20 to $0.30
Ice_Isayev: folds 
patrick19111: folds 
VAD21: folds 
Feverhead: folds 
Uncalled bet ($0.20) returned to tr41n3r12
tr41n3r12 collected $0.25 from pot
*** SUMMARY ***
Total pot $0.25 | Rake $0 
Seat 1: tr41n3r12 collected ($0.25)
Seat 2: Ice_Isayev folded before Flop (didn't bet)
Seat 3: patrick19111 (button) folded before Flop (didn't bet)
Seat 4: VAD21 (small blind) folded before Flop
Seat 5: Feverhead (big blind) folded before Flop



PokerStars Hand #166667577493:  Hold'em No Limit ($0.05/$0.10 USD) - 2017/02/23 16:03:42 ET
Table 'Virginia II' 6-max Seat #5 is the button
Seat 1: Iarlei ($11.76 in chips) 
Seat 2: Yspenyanin ($10 in chips) 
Seat 3: garigura ($14.56 in chips) 
Seat 4: onkelottoHH ($11.03 in chips) 
Seat 5: dr.goofy ($20.68 in chips) 
NvR.m1nD will be allowed to play after the button
Iarlei: posts small blind $0.05
Yspenyanin: posts big blind $0.10
*** HOLE CARDS ***
garigura: folds 
onkelottoHH: folds 
dr.goofy: folds 
Iarlei: folds 
Uncalled bet ($0.05) returned to Yspenyanin
Yspenyanin collected $0.10 from pot
*** SUMMARY ***
Total pot $0.10 | Rake $0 
Seat 1: Iarlei (small blind) folded before Flop
Seat 2: Yspenyanin (big blind) collected ($0.10)
Seat 3: garigura folded before Flop (didn't bet)
Seat 4: onkelottoHH folded before Flop (didn't bet)
Seat 5: dr.goofy (button) folded before Flop (didn't bet)



PokerStars Hand #166667577510:  Hold'em No Limit ($0.05/$0.10 USD) - 2017/02/23 16:03:42 ET
Table 'Arpola' 6-max Seat #4 is the button
Seat 1: dincimus ($10 in chips) 
Seat 2: patrick19111 ($10.13 in chips) 
Seat 3: simaryk ($2.34 in chips) 
Seat 4: Orlangoor ($19.05 in chips) 
Seat 5: truck1234 ($11.71 in chips) 
Seat 6: Andrei ProFF ($10.47 in chips) 
truck1234: posts small blind $0.05
Andrei ProFF: posts big blind $0.10
*** HOLE CARDS ***
dincimus: folds 
patrick19111: folds 
simaryk: folds 
Orlangoor: raises $0.12 to $0.22
truck1234: folds 
Andrei ProFF: folds 
Uncalled bet ($0.12) returned to Orlangoor
Orlangoor collected $0.25 from pot
*** SUMMARY ***
Total pot $0.25 | Rake $0 
Seat 1: dincimus folded before Flop (didn't bet)
Seat 2: patrick19111 folded before Flop (didn't bet)
Seat 3: simaryk folded before Flop (didn't bet)
Seat 4: Orlangoor (button) collected ($0.25)
Seat 5: truck1234 (small blind) folded before Flop
Seat 6: Andrei ProFF (big blind) folded before Flop



PokerStars Hand #166667577579:  Hold'em No Limit ($0.05/$0.10 USD) - 2017/02/23 16:03:42 ET
Table 'Heka II' 6-max Seat #3 is the button
Seat 1: Mamm0nism ($14.37 in chips) 
Seat 2: oddshoff ($11.57 in chips) 
Seat 3: MühliJr ($10.30 in chips) 
Seat 4: theNot0r1ous ($10 in chips) 
Seat 5: ArcticBearDK ($12.53 in chips) 
Seat 6: MonteCris92 ($10 in chips) 
theNot0r1ous: posts small blind $0.05
ArcticBearDK: posts big blind $0.10
*** HOLE CARDS ***
MonteCris92: folds 
Mamm0nism: folds 
oddshoff: folds 
MühliJr: folds 
theNot0r1ous: folds 
Uncalled bet ($0.05) returned to ArcticBearDK
ArcticBearDK collected $0.10 from pot
*** SUMMARY ***
Total pot $0.10 | Rake $0 
Seat 1: Mamm0nism folded before Flop (didn't bet)
Seat 2: oddshoff folded before Flop (didn't bet)
Seat 3: MühliJr (button) folded before Flop (didn't bet)
Seat 4: theNot0r1ous (small blind) folded before Flop
Seat 5: ArcticBearDK (big blind) collected ($0.10)
Seat 6: MonteCris92 folded before Flop (didn't bet)



PokerStars Hand #166667577933:  Hold'em No Limit ($0.05/$0.10 USD) - 2017/02/23 16:03:42 ET
Table 'Samitchell III' 6-max Seat #1 is the button
Seat 1: dr.goofy ($10.12 in chips) 
Seat 3: Kow6oy ($10.05 in chips) 
Seat 6: fedorka rus ($13.11 in chips) 
Kow6oy: posts small blind $0.05
fedorka rus: posts big blind $0.10
*** HOLE CARDS ***
dr.goofy: folds 
steepfell joins the table at seat #5 
iThreeBarrel joins the table at seat #4 
Kow6oy: raises $0.20 to $0.30
scorpionfish joins the table at seat #2 
fedorka rus: folds 
Uncalled bet ($0.20) returned to Kow6oy
Kow6oy collected $0.20 from pot
*** SUMMARY ***
Total pot $0.20 | Rake $0 
Seat 1: dr.goofy (button) folded before Flop (didn't bet)
Seat 3: Kow6oy (small blind) collected ($0.20)
Seat 6: fedorka rus (big blind) folded before Flop



PokerStars Hand #166667578258:  Hold'em No Limit ($0.05/$0.10 USD) - 2017/02/23 16:03:43 ET
Table 'Antinous' 6-max Seat #6 is the button
Seat 1: Andrei ProFF ($16.08 in chips) 
Seat 2: Nr847 ($10.61 in chips) 
Seat 3: dittoro ($10 in chips) 
Seat 4: Pekaml ($15.42 in chips) 
Seat 5: Covetsoles ($6.50 in chips) 
Seat 6: coolisses111 ($10.20 in chips) 
Andrei ProFF: posts small blind $0.05
Nr847: posts big blind $0.10
*** HOLE CARDS ***
dittoro: folds 
Pekaml: folds 
Covetsoles: calls $0.10
coolisses111: folds 
Andrei ProFF: calls $0.05
Nr847: raises $0.30 to $0.40
Covetsoles: calls $0.30
Andrei ProFF: calls $0.30
*** FLOP *** [2c 8s Td]
Andrei ProFF: checks 
Nr847: bets $0.77
Covetsoles: calls $0.77
Pekaml is disconnected 
Andrei ProFF: folds 
*** TURN *** [2c 8s Td] [6c]
Nr847: bets $1.75
Covetsoles: calls $1.75
*** RIVER *** [2c 8s Td 6c] [Jd]
Nr847: bets $4.47
Covetsoles: folds 
Uncalled bet ($4.47) returned to Nr847
Nr847 collected $5.96 from pot
*** SUMMARY ***
Total pot $6.24 | Rake $0.28 
Board [2c 8s Td 6c Jd]
Seat 1: Andrei ProFF (small blind) folded on the Flop
Seat 2: Nr847 (big blind) collected ($5.96)
Seat 3: dittoro folded before Flop (didn't bet)
Seat 4: Pekaml folded before Flop (didn't bet)
Seat 5: Covetsoles folded on the River
Seat 6: coolisses111 (button) folded before Flop (didn't bet)



PokerStars Hand #166667578481:  Hold'em No Limit ($0.05/$0.10 USD) - 2017/02/23 16:03:43 ET
Table 'Nauheima II' 6-max Seat #2 is the button
Seat 2: Peter0087 ($9.82 in chips) 
Seat 3: KokoulinV ($13.54 in chips) 
Seat 4: Innerwuss ($10.12 in chips) 
Seat 5: Kow6oy ($10.45 in chips) 
Seat 6: bonyo71 ($5.04 in chips) 
KokoulinV: posts small blind $0.05
Innerwuss: posts big blind $0.10
*** HOLE CARDS ***
Kow6oy: folds 
bonyo71: raises $0.20 to $0.30
Peter0087: folds 
KokoulinV: folds 
Innerwuss: folds 
Uncalled bet ($0.20) returned to bonyo71
bonyo71 collected $0.25 from pot
*** SUMMARY ***
Total pot $0.25 | Rake $0 
Seat 2: Peter0087 (button) folded before Flop (didn't bet)
Seat 3: KokoulinV (small blind) folded before Flop
Seat 4: Innerwuss (big blind) folded before Flop
Seat 5: Kow6oy folded before Flop (didn't bet)
Seat 6: bonyo71 collected ($0.25)



PokerStars Hand #166667578553:  Hold'em No Limit ($0.05/$0.10 USD) - 2017/02/23 16:03:43 ET
Table 'Pirola' 6-max Seat #3 is the button
Seat 1: Rodik002 ($12.78 in chips) 
Seat 2: lmlmlmlm90 ($18.54 in chips) 
Seat 3: XaXaTyH4uK ($11.62 in chips) 
Seat 4: barons89 ($8.87 in chips) 
Seat 5: Iarlei ($14.39 in chips) 
Seat 6: Hyd SK ($10 in chips) 
barons89: posts small blind $0.05
Iarlei: posts big blind $0.10
*** HOLE CARDS ***
Hyd SK: folds 
Rodik002: raises $0.20 to $0.30
lmlmlmlm90: folds 
XaXaTyH4uK: calls $0.30
barons89: calls $0.25
Iarlei: folds 
*** FLOP *** [5c 2d Jd]
barons89: checks 
Rodik002: bets $0.56
XaXaTyH4uK: calls $0.56
barons89: calls $0.56
*** TURN *** [5c 2d Jd] [8s]
barons89: checks 
Rodik002: bets $1.64
XaXaTyH4uK: folds 
barons89: calls $1.64
*** RIVER *** [5c 2d Jd 8s] [9d]
barons89: checks 
Rodik002: checks 
*** SHOW DOWN ***
barons89: shows [Ad 6d] (a flush, Ace high)
Rodik002: mucks hand 
barons89 collected $5.69 from pot
*** SUMMARY ***
Total pot $5.96 | Rake $0.27 
Board [5c 2d Jd 8s 9d]
Seat 1: Rodik002 mucked
Seat 2: lmlmlmlm90 folded before Flop (didn't bet)
Seat 3: XaXaTyH4uK (button) folded on the Turn
Seat 4: barons89 (small blind) showed [Ad 6d] and won ($5.69) with a flush, Ace high
Seat 5: Iarlei (big blind) folded before Flop
Seat 6: Hyd SK folded before Flop (didn't bet)



PokerStars Hand #166667578832:  Hold'em No Limit ($0.05/$0.10 USD) - 2017/02/23 16:03:43 ET
Table 'Tomita II' 6-max Seat #4 is the button
Seat 2: mhonielsen ($10.05 in chips) 
Seat 3: Lucky HoBBiT ($12.16 in chips) 
Seat 4: Hyd SK ($10 in chips) 
mhonielsen: posts small blind $0.05
Lucky HoBBiT: posts big blind $0.10
*** HOLE CARDS ***
Hyd SK: folds 
mhonielsen: raises $0.10 to $0.20
Lucky HoBBiT: calls $0.10
*** FLOP *** [Js 5c 6d]
KRZuff joins the table at seat #6 
mhonielsen: bets $0.30
Lucky HoBBiT: folds 
Uncalled bet ($0.30) returned to mhonielsen
mhonielsen collected $0.38 from pot
*** SUMMARY ***
Total pot $0.40 | Rake $0.02 
Board [Js 5c 6d]
Seat 2: mhonielsen (small blind) collected ($0.38)
Seat 3: Lucky HoBBiT (big blind) folded on the Flop
Seat 4: Hyd SK (button) folded before Flop (didn't bet)



PokerStars Hand #166667578947:  Hold'em No Limit ($0.05/$0.10 USD) - 2017/02/23 16:03:43 ET
Table 'Xanthippe II' 6-max Seat #5 is the button
Seat 1: ade22345 ($8.70 in chips) 
Seat 2: Bird et al ($13.51 in chips) 
Seat 3: Dcaro31 ($10 in chips) 
Seat 4: Barcardi14 ($5.81 in chips) 
Seat 5: yodzik ($5 in chips) 
Seat 6: Orlangoor ($10.94 in chips) 
Orlangoor: posts small blind $0.05
ade22345: posts big blind $0.10
*** HOLE CARDS ***
Bird et al: folds 
Dcaro31: raises $0.20 to $0.30
Barcardi14: raises $5.51 to $5.81 and is all-in
yodzik: folds 
Orlangoor: folds 
ade22345: folds 
Dcaro31: folds 
Uncalled bet ($5.51) returned to Barcardi14
Barcardi14 collected $0.75 from pot
*** SUMMARY ***
Total pot $0.75 | Rake $0 
Seat 1: ade22345 (big blind) folded before Flop
Seat 2: Bird et al folded before Flop (didn't bet)
Seat 3: Dcaro31 folded before Flop
Seat 4: Barcardi14 collected ($0.75)
Seat 5: yodzik (button) folded before Flop (didn't bet)
Seat 6: Orlangoor (small blind) folded before Flop



PokerStars Hand #166667579094:  Hold'em No Limit ($0.05/$0.10 USD) - 2017/02/23 16:03:44 ET
Table 'Halawe II' 6-max Seat #6 is the button
Seat 1: DIGOR100 ($6.92 in chips) 
Seat 3: cherep61987 ($10.72 in chips) 
Seat 4: voledy ($12.55 in chips) 
Seat 5: takis nik ($12.43 in chips) 
Seat 6: Rodik002 ($20.37 in chips) 
DIGOR100: posts small blind $0.05
Darkfrai: is sitting out 
cherep61987: posts big blind $0.10
*** HOLE CARDS ***
voledy: raises $0.20 to $0.30
takis nik: folds 
Rodik002: folds 
DIGOR100: folds 
cherep61987: calls $0.20
*** FLOP *** [Tc Jh 6d]
cherep61987: checks 
voledy: checks 
*** TURN *** [Tc Jh 6d] [Th]
cherep61987: bets $0.30
voledy: folds 
Uncalled bet ($0.30) returned to cherep61987
cherep61987 collected $0.62 from pot
*** SUMMARY ***
Total pot $0.65 | Rake $0.03 
Board [Tc Jh 6d Th]
Seat 1: DIGOR100 (small blind) folded before Flop
Seat 3: cherep61987 (big blind) collected ($0.62)
Seat 4: voledy folded on the Turn
Seat 5: takis nik folded before Flop (didn't bet)
Seat 6: Rodik002 (button) folded before Flop (didn't bet)



PokerStars Hand #166667579877:  Hold'em No Limit ($0.05/$0.10 USD) - 2017/02/23 16:03:44 ET
Table 'Sham' 6-max Seat #4 is the button
Seat 1: pancernik21 ($10 in chips) 
Seat 2: ex3Lero86 ($10.30 in chips) 
Seat 3: weez3r ($22.68 in chips) 
Seat 4: VAD21 ($12.95 in chips) 
Seat 5: T9MS ($10.33 in chips) 
Seat 6: bdixon_5 ($9.55 in chips) 
T9MS: posts small blind $0.05
bdixon_5: posts big blind $0.10
*** HOLE CARDS ***
pancernik21: folds 
ex3Lero86: folds 
weez3r: folds 
VAD21: raises $0.20 to $0.30
T9MS: folds 
bdixon_5: calls $0.20
*** FLOP *** [9h 2d 4s]
bdixon_5: checks 
VAD21: bets $0.40
bdixon_5: calls $0.40
*** TURN *** [9h 2d 4s] [Qs]
bdixon_5: bets $0.80
VAD21: calls $0.80
*** RIVER *** [9h 2d 4s Qs] [Ah]
bdixon_5: checks 
VAD21: checks 
*** SHOW DOWN ***
bdixon_5: shows [6s 6h] (a pair of Sixes)
VAD21: shows [Ks Qd] (a pair of Queens)
VAD21 collected $2.91 from pot
*** SUMMARY ***
Total pot $3.05 | Rake $0.14 
Board [9h 2d 4s Qs Ah]
Seat 1: pancernik21 folded before Flop (didn't bet)
Seat 2: ex3Lero86 folded before Flop (didn't bet)
Seat 3: weez3r folded before Flop (didn't bet)
Seat 4: VAD21 (button) showed [Ks Qd] and won ($2.91) with a pair of Queens
Seat 5: T9MS (small blind) folded before Flop
Seat 6: bdixon_5 (big blind) showed [6s 6h] and lost with a pair of Sixes



PokerStars Hand #166667579962:  Hold'em No Limit ($0.05/$0.10 USD) - 2017/02/23 16:03:45 ET
Table 'Nymphe II' 6-max Seat #1 is the button
Seat 1: jacktayra ($4.21 in chips) 
Seat 2: Newqbrown ($10.20 in chips) 
Seat 3: THIMUCHIN ($14.71 in chips) 
Seat 4: coolisses111 ($18.15 in chips) 
Seat 5: Yspenyanin ($10.94 in chips) 
Seat 6: Xander188 ($18.08 in chips) 
Newqbrown: posts small blind $0.05
THIMUCHIN: posts big blind $0.10
*** HOLE CARDS ***
coolisses111: folds 
Yspenyanin: folds 
Xander188: folds 
jacktayra: folds 
Newqbrown: raises $0.20 to $0.30
THIMUCHIN: calls $0.20
*** FLOP *** [7d Kc 8c]
Newqbrown: checks 
THIMUCHIN: bets $0.30
Newqbrown: calls $0.30
*** TURN *** [7d Kc 8c] [4d]
Newqbrown: checks 
THIMUCHIN: checks 
*** RIVER *** [7d Kc 8c 4d] [3h]
Newqbrown: checks 
THIMUCHIN: checks 
*** SHOW DOWN ***
Newqbrown: shows [6d 7s] (a pair of Sevens)
THIMUCHIN: mucks hand 
Newqbrown collected $1.15 from pot
*** SUMMARY ***
Total pot $1.20 | Rake $0.05 
Board [7d Kc 8c 4d 3h]
Seat 1: jacktayra (button) folded before Flop (didn't bet)
Seat 2: Newqbrown (small blind) showed [6d 7s] and won ($1.15) with a pair of Sevens
Seat 3: THIMUCHIN (big blind) mucked
Seat 4: coolisses111 folded before Flop (didn't bet)
Seat 5: Yspenyanin folded before Flop (didn't bet)
Seat 6: Xander188 folded before Flop (didn't bet)



PokerStars Hand #166667580329:  Hold'em No Limit ($0.05/$0.10 USD) - 2017/02/23 16:03:45 ET
Table 'Manto II' 6-max Seat #6 is the button
Seat 1: MihaGr ($10 in chips) 
Seat 2: voledy ($10 in chips) 
Seat 4: dr.goofy ($10.27 in chips) 
Seat 5: ArcticBearDK ($32.69 in chips) 
Seat 6: pancernik21 ($16.20 in chips) 
MihaGr: posts small blind $0.05
voledy: posts big blind $0.10
*** HOLE CARDS ***
dr.goofy: raises $0.20 to $0.30
ArcticBearDK: folds 
pancernik21: folds 
MihaGr: folds 
voledy: folds 
Uncalled bet ($0.20) returned to dr.goofy
dr.goofy collected $0.25 from pot
*** SUMMARY ***
Total pot $0.25 | Rake $0 
Seat 1: MihaGr (small blind) folded before Flop
Seat 2: voledy (big blind) folded before Flop
Seat 4: dr.goofy collected ($0.25)
Seat 5: ArcticBearDK folded before Flop (didn't bet)
Seat 6: pancernik21 (button) folded before Flop (didn't bet)



PokerStars Hand #166667580423:  Hold'em No Limit ($0.05/$0.10 USD) - 2017/02/23 16:03:45 ET
Table 'Pyrrhus III' 6-max Seat #2 is the button
Seat 1: skatejeff ($9.98 in chips) 
Seat 2: univibe68 ($20.36 in chips) 
Seat 3: coolisses111 ($9.98 in chips) 
Seat 4: ex3Lero86 ($22.30 in chips) 
Seat 5: mAEgar ($4.87 in chips) 
Seat 6: MLPlayer16 ($19.82 in chips) 
coolisses111: posts small blind $0.05
ex3Lero86: posts big blind $0.10
skatejeff: posts the ante $0.02
univibe68: posts the ante $0.02
coolisses111: posts the ante $0.02
ex3Lero86: posts the ante $0.02
mAEgar: posts the ante $0.02
MLPlayer16: posts the ante $0.02
*** HOLE CARDS ***
mAEgar: calls $0.10
MLPlayer16: folds 
skatejeff: calls $0.10
univibe68: folds 
coolisses111: folds 
ex3Lero86: checks 
*** FLOP *** [6d Tc Jc]
ex3Lero86: bets $0.36
mAEgar: calls $0.36
skatejeff: folds 
*** TURN *** [6d Tc Jc] [5s]
ex3Lero86: bets $0.76
mAEgar: calls $0.76
*** RIVER *** [6d Tc Jc 5s] [Ah]
ex3Lero86: checks 
mAEgar: checks 
*** SHOW DOWN ***
ex3Lero86: shows [8s Js] (a pair of Jacks)
mAEgar: mucks hand 
ex3Lero86 collected $2.59 from pot
*** SUMMARY ***
Total pot $2.71 | Rake $0.12 
Board [6d Tc Jc 5s Ah]
Seat 1: skatejeff folded on the Flop
Seat 2: univibe68 (button) folded before Flop (didn't bet)
Seat 3: coolisses111 (small blind) folded before Flop
Seat 4: ex3Lero86 (big blind) showed [8s Js] and won ($2.59) with a pair of Jacks
Seat 5: mAEgar mucked
Seat 6: MLPlayer16 folded before Flop (didn't bet)



PokerStars Hand #166667580629:  Hold'em No Limit ($0.05/$0.10 USD) - 2017/02/23 16:03:45 ET
Table 'Tyche III' 6-max Seat #3 is the button
Seat 1: milt65 ($10.16 in chips) 
Seat 3: ChuikaPridi ($10.11 in chips) 
Seat 4: Kazacha ($10 in chips) 
Seat 5: chimera252 ($11.75 in chips) 
Seat 6: Ice_Isayev ($10.15 in chips) 
Kazacha: posts small blind $0.05
chimera252: posts big blind $0.10
*** HOLE CARDS ***
Ice_Isayev: folds 
milt65: folds 
ChuikaPridi: raises $0.20 to $0.30
Kazacha: raises $0.70 to $1
chimera252: calls $0.90
ChuikaPridi: folds 
*** FLOP *** [Kh Ac 4d]
Kazacha: checks 
chimera252: bets $1.10
Kazacha: folds 
Uncalled bet ($1.10) returned to chimera252
chimera252 collected $2.20 from pot
*** SUMMARY ***
Total pot $2.30 | Rake $0.10 
Board [Kh Ac 4d]
Seat 1: milt65 folded before Flop (didn't bet)
Seat 3: ChuikaPridi (button) folded before Flop
Seat 4: Kazacha (small blind) folded on the Flop
Seat 5: chimera252 (big blind) collected ($2.20)
Seat 6: Ice_Isayev folded before Flop (didn't bet)



PokerStars Hand #166667580700:  Hold'em No Limit ($0.05/$0.10 USD) - 2017/02/23 16:03:45 ET
Table 'Syringa' 6-max Seat #4 is the button
Seat 1: bdixon_5 ($7.95 in chips) 
Seat 2: Goroshkos88 ($10.56 in chips) 
Seat 3: Yspenyanin ($13.37 in chips) 
Seat 4: tangler19 ($14.43 in chips) 
Seat 5: Andrei ProFF ($13.36 in chips) 
Seat 6: ibara000 ($16.43 in chips) 
Andrei ProFF: posts small blind $0.05
ibara000: posts big blind $0.10
*** HOLE CARDS ***
bdixon_5: folds 
Goroshkos88: folds 
Yspenyanin: raises $0.15 to $0.25
tangler19: folds 
Andrei ProFF: folds 
ibara000: folds 
Uncalled bet ($0.15) returned to Yspenyanin
Yspenyanin collected $0.25 from pot
*** SUMMARY ***
Total pot $0.25 | Rake $0 
Seat 1: bdixon_5 folded before Flop (didn't bet)
Seat 2: Goroshkos88 folded before Flop (didn't bet)
Seat 3: Yspenyanin collected ($0.25)
Seat 4: tangler19 (button) folded before Flop (didn't bet)
Seat 5: Andrei ProFF (small blind) folded before Flop
Seat 6: ibara000 (big blind) folded before Flop



PokerStars Hand #166667580738:  Hold'em No Limit ($0.05/$0.10 USD) - 2017/02/23 16:03:45 ET
Table 'Cyane' 6-max Seat #1 is the button
Seat 1: KA3AXCTAHEU, ($10.17 in chips) 
Seat 3: Mamm0nism ($13.84 in chips) 
Seat 4: truck1234 ($20.96 in chips) 
Seat 5: ChuikaPridi ($10.22 in chips) 
Seat 6: 8th wonders ($10.55 in chips) 
sashi18 joins the table at seat #2 
Mamm0nism: posts small blind $0.05
truck1234: posts big blind $0.10
*** HOLE CARDS ***
ChuikaPridi: folds 
8th wonders: folds 
KA3AXCTAHEU,: raises $0.15 to $0.25
Mamm0nism: folds 
truck1234: folds 
Uncalled bet ($0.15) returned to KA3AXCTAHEU,
KA3AXCTAHEU, collected $0.25 from pot
*** SUMMARY ***
Total pot $0.25 | Rake $0 
Seat 1: KA3AXCTAHEU, (button) collected ($0.25)
Seat 3: Mamm0nism (small blind) folded before Flop
Seat 4: truck1234 (big blind) folded before Flop
Seat 5: ChuikaPridi folded before Flop (didn't bet)
Seat 6: 8th wonders folded before Flop (didn't bet)



PokerStars Hand #166667580996:  Hold'em No Limit ($0.05/$0.10 USD) - 2017/02/23 16:03:46 ET
Table 'Arduina' 6-max Seat #3 is the button
Seat 2: Andy Wolf ($14.45 in chips) 
Seat 3: Dcaro31 ($13.11 in chips) 
Seat 4: ChuikaPridi ($30.63 in chips) 
Seat 5: ettedallas ($5.31 in chips) 
Seat 6: dierri ($9.99 in chips) 
ChuikaPridi: posts small blind $0.05
ettedallas: posts big blind $0.10
tauronex: sits out 
*** HOLE CARDS ***
dierri: calls $0.10
Andy Wolf: folds 
Dcaro31: folds 
ChuikaPridi: calls $0.05
ettedallas: checks 
*** FLOP *** [7c 8s Jh]
ChuikaPridi: bets $0.30
ettedallas: calls $0.30
dierri: folds 
*** TURN *** [7c 8s Jh] [9d]
ChuikaPridi: checks 
ettedallas: checks 
*** RIVER *** [7c 8s Jh 9d] [4s]
ChuikaPridi: checks 
ettedallas: bets $1
ChuikaPridi: calls $1
*** SHOW DOWN ***
ettedallas: shows [6s 5c] (a straight, Five to Nine)
ChuikaPridi: mucks hand 
ettedallas collected $2.77 from pot
*** SUMMARY ***
Total pot $2.90 | Rake $0.13 
Board [7c 8s Jh 9d 4s]
Seat 2: Andy Wolf folded before Flop (didn't bet)
Seat 3: Dcaro31 (button) folded before Flop (didn't bet)
Seat 4: ChuikaPridi (small blind) mucked
Seat 5: ettedallas (big blind) showed [6s 5c] and won ($2.77) with a straight, Five to Nine
Seat 6: dierri folded on the Flop



PokerStars Hand #166667581169:  Hold'em No Limit ($0.05/$0.10 USD) - 2017/02/23 16:03:46 ET
Table 'Eudora' 6-max Seat #3 is the button
Seat 1: archer2511 ($11.61 in chips) 
Seat 2: popypaleta ($10 in chips) 
Seat 3: Ice_Isayev ($10 in chips) 
Seat 5: chimera252 ($11.42 in chips) 
yodzik will be allowed to play after the button
chimera252: posts small blind $0.05
HARDCORE66RU: is sitting out 
archer2511: posts big blind $0.10
*** HOLE CARDS ***
popypaleta: folds 
Ice_Isayev: folds 
chimera252: raises $0.20 to $0.30
archer2511: folds 
Uncalled bet ($0.20) returned to chimera252
chimera252 collected $0.20 from pot
*** SUMMARY ***
Total pot $0.20 | Rake $0 
Seat 1: archer2511 (big blind) folded before Flop
Seat 2: popypaleta folded before Flop (didn't bet)
Seat 3: Ice_Isayev (button) folded before Flop (didn't bet)
Seat 5: chimera252 (small blind) collected ($0.20)



PokerStars Hand #166667581249:  Hold'em No Limit ($0.05/$0.10 USD) - 2017/02/23 16:03:46 ET
Table 'Iapetus III' 6-max Seat #5 is the button
Seat 1: Czezar Life ($8 in chips) 
Seat 2: Crafty23@PS ($10 in chips) 
Seat 3: takis nik ($10.10 in chips) 
Seat 4: Raggibest ($7 in chips) 
Seat 5: homelessdan ($13.61 in chips) 
Seat 6: tauronex ($10.05 in chips) 
tauronex: posts small blind $0.05
Czezar Life: posts big blind $0.10
Raggibest: posts big blind $0.10
*** HOLE CARDS ***
Crafty23@PS: folds 
takis nik: folds 
Raggibest: raises $0.10 to $0.20
takis nik leaves the table
homelessdan: folds 
Goroshkos88 joins the table at seat #3 
tauronex: calls $0.15
Czezar Life: folds 
*** FLOP *** [2c 4d 3h]
tauronex: checks 
Raggibest: checks 
*** TURN *** [2c 4d 3h] [3s]
tauronex: bets $0.26
Raggibest: folds 
Uncalled bet ($0.26) returned to tauronex
tauronex collected $0.48 from pot
*** SUMMARY ***
Total pot $0.50 | Rake $0.02 
Board [2c 4d 3h 3s]
Seat 1: Czezar Life (big blind) folded before Flop
Seat 2: Crafty23@PS folded before Flop (didn't bet)
Seat 3: takis nik folded before Flop (didn't bet)
Seat 4: Raggibest folded on the Turn
Seat 5: homelessdan (button) folded before Flop (didn't bet)
Seat 6: tauronex (small blind) collected ($0.48)



PokerStars Hand #166667582121:  Hold'em No Limit ($0.05/$0.10 USD) - 2017/02/23 16:03:47 ET
Table 'Armenia' 6-max Seat #1 is the button
Seat 1: tr41n3r12 ($12.02 in chips) 
Seat 2: Yabidooo ($11.77 in chips) 
Seat 3: XwinX25 ($10 in chips) 
Seat 4: x3ultimate ($10 in chips) 
Seat 5: boxer821 ($12.10 in chips) 
Seat 6: mega spasser ($5.94 in chips) 
Yabidooo: posts small blind $0.05
XwinX25: posts big blind $0.10
*** HOLE CARDS ***
x3ultimate: raises $0.20 to $0.30
boxer821: folds 
mega spasser: calls $0.30
tr41n3r12: folds 
Yabidooo: folds 
XwinX25: folds 
*** FLOP *** [Ts 6h 8c]
x3ultimate: checks 
mega spasser: checks 
*** TURN *** [Ts 6h 8c] [5h]
x3ultimate: checks 
mega spasser: checks 
*** RIVER *** [Ts 6h 8c 5h] [4h]
x3ultimate: checks 
mega spasser: checks 
*** SHOW DOWN ***
x3ultimate: shows [Kc Jh] (high card King)
mega spasser: shows [Qh As] (high card Ace)
mega spasser collected $0.72 from pot
*** SUMMARY ***
Total pot $0.75 | Rake $0.03 
Board [Ts 6h 8c 5h 4h]
Seat 1: tr41n3r12 (button) folded before Flop (didn't bet)
Seat 2: Yabidooo (small blind) folded before Flop
Seat 3: XwinX25 (big blind) folded before Flop
Seat 4: x3ultimate showed [Kc Jh] and lost with high card King
Seat 5: boxer821 folded before Flop (didn't bet)
Seat 6: mega spasser showed [Qh As] and won ($0.72) with high card Ace



PokerStars Hand #166667582127:  Hold'em No Limit ($0.05/$0.10 USD) - 2017/02/23 16:03:47 ET
Table 'Peiroos III' 6-max Seat #6 is the button
Seat 1: tequila_joop ($10 in chips) 
Seat 3: nabatov.m ($5.49 in chips) 
Seat 4: pivanki11 ($10.60 in chips) 
Seat 5: ChuikaPridi ($9.72 in chips) 
Seat 6: CHRO8 ($11.15 in chips) 
tequila_joop: posts small blind $0.05
nabatov.m: posts big blind $0.10
tequila_joop: posts the ante $0.02
nabatov.m: posts the ante $0.02
pivanki11: posts the ante $0.02
ChuikaPridi: posts the ante $0.02
CHRO8: posts the ante $0.02
*** HOLE CARDS ***
pivanki11: folds 
ChuikaPridi: folds 
CHRO8: raises $0.20 to $0.30
tequila_joop: folds 
nabatov.m: calls $0.20
*** FLOP *** [Ad 5s 4d]
nabatov.m: checks 
CHRO8: checks 
*** TURN *** [Ad 5s 4d] [Qc]
nabatov.m: checks 
CHRO8: bets $0.36
nabatov.m: calls $0.36
*** RIVER *** [Ad 5s 4d Qc] [2d]
nabatov.m: checks 
CHRO8: bets $0.80
nabatov.m: calls $0.80
*** SHOW DOWN ***
CHRO8: shows [Th Jd] (high card Ace)
nabatov.m: shows [8d As] (a pair of Aces)
nabatov.m collected $2.93 from pot
*** SUMMARY ***
Total pot $3.07 | Rake $0.14 
Board [Ad 5s 4d Qc 2d]
Seat 1: tequila_joop (small blind) folded before Flop
Seat 3: nabatov.m (big blind) showed [8d As] and won ($2.93) with a pair of Aces
Seat 4: pivanki11 folded before Flop (didn't bet)
Seat 5: ChuikaPridi folded before Flop (didn't bet)
Seat 6: CHRO8 (button) showed [Th Jd] and lost with high card Ace



PokerStars Hand #166667582192:  Hold'em No Limit ($0.05/$0.10 USD) - 2017/02/23 16:03:47 ET
Table 'Lederle' 6-max Seat #6 is the button
Seat 2: truck1234 ($15.75 in chips) 
Seat 3: Kazacha ($10.50 in chips) 
Seat 4: Pokeaster ($13.76 in chips) 
Seat 5: 8th wonders ($14.16 in chips) 
Seat 6: pokekrk ($10 in chips) 
truck1234: posts small blind $0.05
Kazacha: posts big blind $0.10
*** HOLE CARDS ***
Pokeaster: folds 
8th wonders: raises $0.20 to $0.30
pokekrk: folds 
truck1234: folds 
Kazacha: calls $0.20
*** FLOP *** [7d 5d 3s]
Kazacha: checks 
8th wonders: bets $0.50
Kazacha: folds 
Uncalled bet ($0.50) returned to 8th wonders
8th wonders collected $0.62 from pot
*** SUMMARY ***
Total pot $0.65 | Rake $0.03 
Board [7d 5d 3s]
Seat 2: truck1234 (small blind) folded before Flop
Seat 3: Kazacha (big blind) folded on the Flop
Seat 4: Pokeaster folded before Flop (didn't bet)
Seat 5: 8th wonders collected ($0.62)
Seat 6: pokekrk (button) folded before Flop (didn't bet)



PokerStars Hand #166667582249:  Hold'em No Limit ($0.05/$0.10 USD) - 2017/02/23 16:03:47 ET
Table 'Caupolican II' 6-max Seat #2 is the button
Seat 1: Strelok1974 ($10 in chips) 
Seat 2: MBen10 ($19.65 in chips) 
Seat 3: fedorka rus ($13.28 in chips) 
Seat 4: GESPERIA ($22.77 in chips) 
Seat 5: ArcticBearDK ($14.44 in chips) 
Seat 6: pancernik21 ($13.30 in chips) 
fedorka rus: posts small blind $0.05
GESPERIA: posts big blind $0.10
*** HOLE CARDS ***
ArcticBearDK: folds 
pancernik21: folds 
Strelok1974: folds 
MBen10: raises $0.15 to $0.25
fedorka rus: calls $0.20
GESPERIA: raises $1.05 to $1.30
MBen10: calls $1.05
fedorka rus: calls $1.05
*** FLOP *** [Td Tc Kc]
fedorka rus: checks 
GESPERIA: checks 
MBen10: checks 
*** TURN *** [Td Tc Kc] [8d]
fedorka rus: checks 
GESPERIA: checks 
MBen10: bets $1.85
fedorka rus: folds 
GESPERIA: folds 
Uncalled bet ($1.85) returned to MBen10
MBen10 collected $3.72 from pot
*** SUMMARY ***
Total pot $3.90 | Rake $0.18 
Board [Td Tc Kc 8d]
Seat 1: Strelok1974 folded before Flop (didn't bet)
Seat 2: MBen10 (button) collected ($3.72)
Seat 3: fedorka rus (small blind) folded on the Turn
Seat 4: GESPERIA (big blind) folded on the Turn
Seat 5: ArcticBearDK folded before Flop (didn't bet)
Seat 6: pancernik21 folded before Flop (didn't bet)



PokerStars Hand #166667582538:  Hold'em No Limit ($0.05/$0.10 USD) - 2017/02/23 16:03:47 ET
Table 'Atropos' 6-max Seat #4 is the button
Seat 1: ScorpionF39 ($0.88 in chips) 
Seat 3: NvR.m1nD ($10.14 in chips) 
Seat 4: iDecMate ($12.25 in chips) 
Seat 5: KokoulinV ($12.14 in chips) 
Seat 6: Iarlei ($12.20 in chips) 
KokoulinV: posts small blind $0.05
Iarlei: posts big blind $0.10
yodzik: sits out 
*** HOLE CARDS ***
ScorpionF39: folds 
NvR.m1nD: folds 
iDecMate: raises $0.15 to $0.25
KokoulinV: folds 
Iarlei: calls $0.15
*** FLOP *** [Qc 8s 4s]
Iarlei: checks 
iDecMate: checks 
*** TURN *** [Qc 8s 4s] [Th]
Iarlei: bets $0.25
iDecMate: folds 
Uncalled bet ($0.25) returned to Iarlei
Iarlei collected $0.53 from pot
*** SUMMARY ***
Total pot $0.55 | Rake $0.02 
Board [Qc 8s 4s Th]
Seat 1: ScorpionF39 folded before Flop (didn't bet)
Seat 3: NvR.m1nD folded before Flop (didn't bet)
Seat 4: iDecMate (button) folded on the Turn
Seat 5: KokoulinV (small blind) folded before Flop
Seat 6: Iarlei (big blind) collected ($0.53)



PokerStars Hand #166667582651:  Hold'em No Limit ($0.05/$0.10 USD) - 2017/02/23 16:03:48 ET
Table 'Crommelin II' 6-max Seat #5 is the button
Seat 1: THIMUCHIN ($11.67 in chips) 
Seat 2: Bird et al ($10 in chips) 
Seat 3: Strelok1974 ($21.95 in chips) 
Seat 4: Pequeño Clau ($10 in chips) 
Seat 5: Action_Gibi ($19.94 in chips) 
THIMUCHIN: posts small blind $0.05
Bird et al: posts big blind $0.10
*** HOLE CARDS ***
Strelok1974: folds 
Pequeño Clau: raises $0.20 to $0.30
Action_Gibi: raises $0.60 to $0.90
THIMUCHIN: folds 
Bird et al: folds 
Pequeño Clau: folds 
Uncalled bet ($0.60) returned to Action_Gibi
Action_Gibi collected $0.75 from pot
*** SUMMARY ***
Total pot $0.75 | Rake $0 
Seat 1: THIMUCHIN (small blind) folded before Flop
Seat 2: Bird et al (big blind) folded before Flop
Seat 3: Strelok1974 folded before Flop (didn't bet)
Seat 4: Pequeño Clau folded before Flop
Seat 5: Action_Gibi (button) collected ($0.75)



PokerStars Hand #166667582850:  Hold'em No Limit ($0.05/$0.10 USD) - 2017/02/23 16:03:48 ET
Table 'Sheragul III' 6-max Seat #6 is the button
Seat 1: danky24 ($18.84 in chips) 
Seat 2: Bird et al ($11.96 in chips) 
Seat 4: maxiv608 ($11.24 in chips) 
Seat 5: Bandyaev ($14.57 in chips) 
Seat 6: Andrei ProFF ($10 in chips) 
danky24: posts small blind $0.05
Bird et al: posts big blind $0.10
*** HOLE CARDS ***
maxiv608: raises $0.20 to $0.30
Bandyaev: folds 
Andrei ProFF: folds 
danky24: folds 
Bird et al: folds 
Uncalled bet ($0.20) returned to maxiv608
maxiv608 collected $0.25 from pot
*** SUMMARY ***
Total pot $0.25 | Rake $0 
Seat 1: danky24 (small blind) folded before Flop
Seat 2: Bird et al (big blind) folded before Flop
Seat 4: maxiv608 collected ($0.25)
Seat 5: Bandyaev folded before Flop (didn't bet)
Seat 6: Andrei ProFF (button) folded before Flop (didn't bet)



PokerStars Hand #166667583152:  Hold'em No Limit ($0.05/$0.10 USD) - 2017/02/23 16:03:48 ET
Table 'Caprera III' 6-max Seat #1 is the button
Seat 1: Vrinni ($10.25 in chips) 
Seat 2: hg123454321 ($10.04 in chips) 
Seat 4: oddshoff ($9 in chips) 
Seat 5: fedorka rus ($49.48 in chips) 
Seat 6: GESPERIA ($18.38 in chips) 
hg123454321: posts small blind $0.05
Darkfrai: is sitting out 
oddshoff: posts big blind $0.10
*** HOLE CARDS ***
fedorka rus: raises $0.20 to $0.30
GESPERIA: folds 
Vrinni: folds 
hg123454321: folds 
oddshoff: folds 
Uncalled bet ($0.20) returned to fedorka rus
fedorka rus collected $0.25 from pot
*** SUMMARY ***
Total pot $0.25 | Rake $0 
Seat 1: Vrinni (button) folded before Flop (didn't bet)
Seat 2: hg123454321 (small blind) folded before Flop
Seat 4: oddshoff (big blind) folded before Flop
Seat 5: fedorka rus collected ($0.25)
Seat 6: GESPERIA folded before Flop (didn't bet)



PokerStars Hand #166667583228:  Hold'em No Limit ($0.05/$0.10 USD) - 2017/02/23 16:03:48 ET
Table 'Persephone' 6-max Seat #1 is the button
Seat 1: FRAID358 ($9.85 in chips) 
Seat 2: AM-L-SL ($4.90 in chips) 
Seat 6: popypaleta ($14.79 in chips) 
AM-L-SL: posts small blind $0.05
Kow6oy: is sitting out 
2G28: is sitting out 
popypaleta: posts big blind $0.10
*** HOLE CARDS ***
D3NyA leaves the table
ab260414 joins the table at seat #5 
FRAID358: raises $0.15 to $0.25
AM-L-SL: folds 
popypaleta: folds 
Uncalled bet ($0.15) returned to FRAID358
Kow6oy leaves the table
FRAID358 collected $0.25 from pot
*** SUMMARY ***
Total pot $0.25 | Rake $0 
Seat 1: FRAID358 (button) collected ($0.25)
Seat 2: AM-L-SL (small blind) folded before Flop
Seat 6: popypaleta (big blind) folded before Flop



PokerStars Hand #166667583335:  Hold'em No Limit ($0.05/$0.10 USD) - 2017/02/23 16:03:48 ET
Table 'Nemo III' 6-max Seat #4 is the button
Seat 2: Bandyaev ($11.59 in chips) 
Seat 3: Therodorus ($10.40 in chips) 
Seat 4: vtalian ($9.55 in chips) 
Seat 5: Joker51_wtf! ($11.63 in chips) 
Joker51_wtf!: posts small blind $0.05
Bandyaev: posts big blind $0.10
*** HOLE CARDS ***
Therodorus: folds 
vtalian: folds 
Joker51_wtf!: folds 
Uncalled bet ($0.05) returned to Bandyaev
Bandyaev collected $0.10 from pot
*** SUMMARY ***
Total pot $0.10 | Rake $0 
Seat 2: Bandyaev (big blind) collected ($0.10)
Seat 3: Therodorus folded before Flop (didn't bet)
Seat 4: vtalian (button) folded before Flop (didn't bet)
Seat 5: Joker51_wtf! (small blind) folded before Flop



PokerStars Hand #166667583397:  Hold'em No Limit ($0.05/$0.10 USD) - 2017/02/23 16:03:48 ET
Table 'Pulcova II' 6-max Seat #1 is the button
Seat 1: sexy_seagull ($10 in chips) 
Seat 2: Kazacha ($10 in chips) 
Seat 3: Lao Tsy ($14.28 in chips) 
Seat 4: VioXion ($10.25 in chips) 
Seat 5: mdelfin0 ($12.89 in chips) 
Seat 6: Ice_Isayev ($10.65 in chips) 
Kazacha: posts small blind $0.05
Lao Tsy: posts big blind $0.10
*** HOLE CARDS ***
VioXion: folds 
mdelfin0: raises $0.20 to $0.30
Ice_Isayev: folds 
sexy_seagull: calls $0.30
Kazacha: folds 
Lao Tsy: folds 
*** FLOP *** [3d 9h 3s]
mdelfin0: bets $0.30
sexy_seagull: calls $0.30
*** TURN *** [3d 9h 3s] [Qh]
mdelfin0: checks 
sexy_seagull: bets $0.88
mdelfin0: calls $0.88
*** RIVER *** [3d 9h 3s Qh] [6c]
mdelfin0: checks 
sexy_seagull: bets $2.10
mdelfin0: calls $2.10
*** SHOW DOWN ***
sexy_seagull: shows [Qs Ah] (two pair, Queens and Threes)
mdelfin0: mucks hand 
sexy_seagull collected $6.98 from pot
*** SUMMARY ***
Total pot $7.31 | Rake $0.33 
Board [3d 9h 3s Qh 6c]
Seat 1: sexy_seagull (button) showed [Qs Ah] and won ($6.98) with two pair, Queens and Threes
Seat 2: Kazacha (small blind) folded before Flop
Seat 3: Lao Tsy (big blind) folded before Flop
Seat 4: VioXion folded before Flop (didn't bet)
Seat 5: mdelfin0 mucked
Seat 6: Ice_Isayev folded before Flop (didn't bet)



PokerStars Hand #166667583591:  Hold'em No Limit ($0.05/$0.10 USD) - 2017/02/23 16:03:49 ET
Table 'Geisha' 6-max Seat #2 is the button
Seat 1: facewald ($34.63 in chips) 
Seat 2: voledy ($10.60 in chips) 
Seat 3: Eddys Edge ($10 in chips) 
Seat 4: jvstsayyes ($11.47 in chips) 
Seat 5: KRZuff ($13.80 in chips) 
Seat 6: Namhkal ($21.48 in chips) 
Eddys Edge: posts small blind $0.05
jvstsayyes: posts big blind $0.10
*** HOLE CARDS ***
KRZuff: raises $0.20 to $0.30
Namhkal: folds 
facewald: calls $0.30
voledy: folds 
Eddys Edge: folds 
jvstsayyes: calls $0.20
*** FLOP *** [3s 9d 3h]
jvstsayyes: checks 
KRZuff: checks 
facewald: checks 
*** TURN *** [3s 9d 3h] [7s]
jvstsayyes: checks 
KRZuff: checks 
facewald: checks 
*** RIVER *** [3s 9d 3h 7s] [Tc]
jvstsayyes: bets $0.10
KRZuff: raises $0.35 to $0.45
facewald: folds 
jvstsayyes is disconnected 
jvstsayyes is connected 
jvstsayyes: folds 
Uncalled bet ($0.35) returned to KRZuff
KRZuff collected $1.10 from pot
*** SUMMARY ***
Total pot $1.15 | Rake $0.05 
Board [3s 9d 3h 7s Tc]
Seat 1: facewald folded on the River
Seat 2: voledy (button) folded before Flop (didn't bet)
Seat 3: Eddys Edge (small blind) folded before Flop
Seat 4: jvstsayyes (big blind) folded on the River
Seat 5: KRZuff collected ($1.10)
Seat 6: Namhkal folded before Flop (didn't bet)



PokerStars Hand #166667583756:  Hold'em No Limit ($0.05/$0.10 USD) - 2017/02/23 16:03:49 ET
Table 'Siebohme II' 6-max Seat #6 is the button
Seat 1: homelessdan ($18.12 in chips) 
Seat 2: townerz1991 ($14.17 in chips) 
Seat 3: D3NyA ($10.33 in chips) 
Seat 4: POT_TRADER ($12.29 in chips) 
Seat 5: NvR.m1nD ($10 in chips) 
Seat 6: Fozzy690 ($10.14 in chips) 
homelessdan: posts small blind $0.05
townerz1991: posts big blind $0.10
*** HOLE CARDS ***
D3NyA: folds 
POT_TRADER: folds 
NvR.m1nD: folds 
Fozzy690: folds 
homelessdan: folds 
Uncalled bet ($0.05) returned to townerz1991
townerz1991 collected $0.10 from pot
*** SUMMARY ***
Total pot $0.10 | Rake $0 
Seat 1: homelessdan (small blind) folded before Flop
Seat 2: townerz1991 (big blind) collected ($0.10)
Seat 3: D3NyA folded before Flop (didn't bet)
Seat 4: POT_TRADER folded before Flop (didn't bet)
Seat 5: NvR.m1nD folded before Flop (didn't bet)
Seat 6: Fozzy690 (button) folded before Flop (didn't bet)



PokerStars Hand #166667583825:  Hold'em No Limit ($0.05/$0.10 USD) - 2017/02/23 16:03:49 ET
Table 'Ushakaron II' 6-max Seat #1 is the button
Seat 1: Kow6oy ($10.15 in chips) 
Seat 2: Iarlei ($10.13 in chips) 
Seat 3: Rodik002 ($10.15 in chips) 
Seat 4: avintage176 ($27.86 in chips) 
Seat 5: 1limewax1 ($17.23 in chips) 
Seat 6: eniksenik ($11.16 in chips) 
Iarlei: posts small blind $0.05
Rodik002: posts big blind $0.10
*** HOLE CARDS ***
avintage176: folds 
1limewax1: raises $0.20 to $0.30
eniksenik: folds 
Kow6oy: folds 
Iarlei: folds 
Rodik002: folds 
Uncalled bet ($0.20) returned to 1limewax1
1limewax1 collected $0.25 from pot
*** SUMMARY ***
Total pot $0.25 | Rake $0 
Seat 1: Kow6oy (button) folded before Flop (didn't bet)
Seat 2: Iarlei (small blind) folded before Flop
Seat 3: Rodik002 (big blind) folded before Flop
Seat 4: avintage176 folded before Flop (didn't bet)
Seat 5: 1limewax1 collected ($0.25)
Seat 6: eniksenik folded before Flop (didn't bet)



PokerStars Hand #166667583933:  Hold'em No Limit ($0.05/$0.10 USD) - 2017/02/23 16:03:49 ET
Table 'Lobelia II' 6-max Seat #5 is the button
Seat 1: facewald ($20.64 in chips) 
Seat 2: Dcaro31 ($17.84 in chips) 
Seat 3: oddshoff ($19.40 in chips) 
Seat 5: Feverhead ($20.28 in chips) 
Seat 6: NvR.m1nD ($10.32 in chips) 
NvR.m1nD: posts small blind $0.05
facewald: posts big blind $0.10
*** HOLE CARDS ***
Dcaro31: folds 
oddshoff: folds 
Feverhead: raises $0.10 to $0.20
NvR.m1nD: folds 
facewald: folds 
Uncalled bet ($0.10) returned to Feverhead
Feverhead collected $0.25 from pot
*** SUMMARY ***
Total pot $0.25 | Rake $0 
Seat 1: facewald (big blind) folded before Flop
Seat 2: Dcaro31 folded before Flop (didn't bet)
Seat 3: oddshoff folded before Flop (didn't bet)
Seat 5: Feverhead (button) collected ($0.25)
Seat 6: NvR.m1nD (small blind) folded before Flop



PokerStars Hand #166667584116:  Hold'em No Limit ($0.05/$0.10 USD) - 2017/02/23 16:03:49 ET
Table 'Tyndareus II' 6-max Seat #1 is the button
Seat 1: Makc1705 ($3.65 in chips) 
Seat 2: Therodorus ($11.67 in chips) 
Seat 3: McCleans ($11.21 in chips) 
Seat 4: gaHy_HaXeP ($11.21 in chips) 
Seat 5: vtalian ($10 in chips) 
Seat 6: sexy_seagull ($10.15 in chips) 
Therodorus: posts small blind $0.05
McCleans: posts big blind $0.10
*** HOLE CARDS ***
gaHy_HaXeP: folds 
vtalian: folds 
sexy_seagull: raises $0.20 to $0.30
Makc1705: folds 
Therodorus: folds 
McCleans: folds 
Uncalled bet ($0.20) returned to sexy_seagull
sexy_seagull collected $0.25 from pot
*** SUMMARY ***
Total pot $0.25 | Rake $0 
Seat 1: Makc1705 (button) folded before Flop (didn't bet)
Seat 2: Therodorus (small blind) folded before Flop
Seat 3: McCleans (big blind) folded before Flop
Seat 4: gaHy_HaXeP folded before Flop (didn't bet)
Seat 5: vtalian folded before Flop (didn't bet)
Seat 6: sexy_seagull collected ($0.25)



PokerStars Hand #166667584183:  Hold'em No Limit ($0.05/$0.10 USD) - 2017/02/23 16:03:49 ET
Table 'Marbachia II' 6-max Seat #2 is the button
Seat 1: AC Evergreen ($10 in chips) 
Seat 2: Yabidooo ($10.93 in chips) 
Seat 4: BahiaMinhaP ($10 in chips) 
Seat 5: MihaGr ($10 in chips) 
Seat 6: DamDatsAnAce ($10 in chips) 
MisterX413 will be allowed to play after the button
BahiaMinhaP: posts small blind $0.05
MihaGr: posts big blind $0.10
*** HOLE CARDS ***
DamDatsAnAce: folds 
AC Evergreen: folds 
Yabidooo: folds 
BahiaMinhaP: folds 
Uncalled bet ($0.05) returned to MihaGr
MihaGr collected $0.10 from pot
*** SUMMARY ***
Total pot $0.10 | Rake $0 
Seat 1: AC Evergreen folded before Flop (didn't bet)
Seat 2: Yabidooo (button) folded before Flop (didn't bet)
Seat 4: BahiaMinhaP (small blind) folded before Flop
Seat 5: MihaGr (big blind) collected ($0.10)
Seat 6: DamDatsAnAce folded before Flop (didn't bet)



PokerStars Hand #166667584201:  Hold'em No Limit ($0.05/$0.10 USD) - 2017/02/23 16:03:49 ET
Table 'Selinur' 6-max Seat #3 is the button
Seat 1: KA3AXCTAHEU, ($10 in chips) 
Seat 2: hoedje72 ($8.44 in chips) 
Seat 3: bambolejro ($10.82 in chips) 
Seat 4: freezing666 ($11.53 in chips) 
Seat 5: IAntikI ($10.37 in chips) 
Seat 6: homelessdan ($17.62 in chips) 
freezing666: posts small blind $0.05
IAntikI: posts big blind $0.10
hoedje72: posts big blind $0.10
*** HOLE CARDS ***
homelessdan: folds 
KA3AXCTAHEU,: folds 
hoedje72: checks 
bambolejro: raises $0.30 to $0.40
freezing666: folds 
IAntikI: folds 
hoedje72: folds 
Uncalled bet ($0.30) returned to bambolejro
bambolejro collected $0.35 from pot
*** SUMMARY ***
Total pot $0.35 | Rake $0 
Seat 1: KA3AXCTAHEU, folded before Flop (didn't bet)
Seat 2: hoedje72 folded before Flop
Seat 3: bambolejro (button) collected ($0.35)
Seat 4: freezing666 (small blind) folded before Flop
Seat 5: IAntikI (big blind) folded before Flop
Seat 6: homelessdan folded before Flop (didn't bet)



PokerStars Hand #166667584508:  Hold'em No Limit ($0.05/$0.10 USD) - 2017/02/23 16:03:50 ET
Table 'Girtab II' 6-max Seat #3 is the button
Seat 1: Kow6oy ($10 in chips) 
Seat 2: Pokeaster ($14.02 in chips) 
Seat 3: chimera252 ($10 in chips) 
Seat 4: Hyd SK ($27.08 in chips) 
Seat 6: DamDatsAnAce ($10 in chips) 
Hyd SK: posts small blind $0.05
DamDatsAnAce: posts big blind $0.10
*** HOLE CARDS ***
Kow6oy: folds 
Kow6oy leaves the table
Pokeaster: raises $0.20 to $0.30
marianoboni joins the table at seat #1 
chimera252: folds 
Hyd SK: folds 
DamDatsAnAce: folds 
Uncalled bet ($0.20) returned to Pokeaster
Pokeaster collected $0.25 from pot
*** SUMMARY ***
Total pot $0.25 | Rake $0 
Seat 1: Kow6oy folded before Flop (didn't bet)
Seat 2: Pokeaster collected ($0.25)
Seat 3: chimera252 (button) folded before Flop (didn't bet)
Seat 4: Hyd SK (small blind) folded before Flop
Seat 6: DamDatsAnAce (big blind) folded before Flop



PokerStars Hand #166667584705:  Hold'em No Limit ($0.05/$0.10 USD) - 2017/02/23 16:03:50 ET
Table 'Deflotte' 6-max Seat #1 is the button
Seat 1: Zooplack ($15.79 in chips) 
Seat 2: MonteCris92 ($10 in chips) 
Seat 3: Croplayer1 ($10.15 in chips) 
Seat 4: 8th wonders ($10.42 in chips) 
Seat 5: Pokeaster ($11.12 in chips) 
Seat 6: Iarlei ($12 in chips) 
MonteCris92: posts small blind $0.05
Croplayer1: posts big blind $0.10
*** HOLE CARDS ***
8th wonders: folds 
Pokeaster: folds 
Iarlei: folds 
Zooplack: folds 
MonteCris92: folds 
Uncalled bet ($0.05) returned to Croplayer1
Croplayer1 collected $0.10 from pot
*** SUMMARY ***
Total pot $0.10 | Rake $0 
Seat 1: Zooplack (button) folded before Flop (didn't bet)
Seat 2: MonteCris92 (small blind) folded before Flop
Seat 3: Croplayer1 (big blind) collected ($0.10)
Seat 4: 8th wonders folded before Flop (didn't bet)
Seat 5: Pokeaster folded before Flop (didn't bet)
Seat 6: Iarlei folded before Flop (didn't bet)



PokerStars Hand #166667585514:  Hold'em No Limit ($0.05/$0.10 USD) - 2017/02/23 16:03:51 ET
Table 'Syringa II' 6-max Seat #6 is the button
Seat 1: GiveTwoMe ($13.55 in chips) 
Seat 2: Cluckh ($10 in chips) 
Seat 3: gaHy_HaXeP ($10.73 in chips) 
Seat 4: MBen10 ($10 in chips) 
Seat 5: Mishapok196 ($7.90 in chips) 
Seat 6: WinninBikini ($10.37 in chips) 
GiveTwoMe: posts small blind $0.05
Cluckh: posts big blind $0.10
*** HOLE CARDS ***
gaHy_HaXeP: folds 
MBen10: folds 
Mishapok196: calls $0.10
WinninBikini: folds 
GiveTwoMe: calls $0.05
Cluckh: checks 
*** FLOP *** [2s Ah 8c]
GiveTwoMe: checks 
Cluckh: checks 
Mishapok196: checks 
*** TURN *** [2s Ah 8c] [2d]
GiveTwoMe: checks 
Cluckh: checks 
Mishapok196: checks 
*** RIVER *** [2s Ah 8c 2d] [4d]
GiveTwoMe: checks 
Cluckh: checks 
Mishapok196: checks 
*** SHOW DOWN ***
GiveTwoMe: shows [7d Jc] (a pair of Deuces)
Cluckh: shows [4h 6c] (two pair, Fours and Deuces)
Mishapok196: mucks hand 
Cluckh collected $0.29 from pot
*** SUMMARY ***
Total pot $0.30 | Rake $0.01 
Board [2s Ah 8c 2d 4d]
Seat 1: GiveTwoMe (small blind) showed [7d Jc] and lost with a pair of Deuces
Seat 2: Cluckh (big blind) showed [4h 6c] and won ($0.29) with two pair, Fours and Deuces
Seat 3: gaHy_HaXeP folded before Flop (didn't bet)
Seat 4: MBen10 folded before Flop (didn't bet)
Seat 5: Mishapok196 mucked
Seat 6: WinninBikini (button) folded before Flop (didn't bet)



PokerStars Hand #166667585549:  Hold'em No Limit ($0.05/$0.10 USD) - 2017/02/23 16:03:51 ET
Table 'Tyndareus III' 6-max Seat #4 is the button
Seat 1: MBen10 ($10 in chips) 
Seat 2: MihaGr ($10 in chips) 
Seat 4: Therodorus ($11.46 in chips) 
Seat 6: Elinaattor ($10.35 in chips) 
yodzik will be allowed to play after the button
Elinaattor: posts small blind $0.05
MBen10: posts big blind $0.10
steepfell: sits out 
*** HOLE CARDS ***
MihaGr: folds 
steepfell leaves the table
Therodorus: folds 
Therodorus leaves the table
Elinaattor: folds 
Uncalled bet ($0.05) returned to MBen10
MBen10 collected $0.10 from pot
*** SUMMARY ***
Total pot $0.10 | Rake $0 
Seat 1: MBen10 (big blind) collected ($0.10)
Seat 2: MihaGr folded before Flop (didn't bet)
Seat 4: Therodorus (button) folded before Flop (didn't bet)
Seat 6: Elinaattor (small blind) folded before Flop



PokerStars Hand #166667585719:  Hold'em No Limit ($0.05/$0.10 USD) - 2017/02/23 16:03:51 ET
Table 'Wingolfia II' 6-max Seat #3 is the button
Seat 1: BahiaMinhaP ($10 in chips) 
Seat 2: NvR.m1nD ($10.60 in chips) 
Seat 3: truck1234 ($10 in chips) 
Seat 4: zlobslob ($18.47 in chips) 
Seat 5: tr41n3r12 ($11.43 in chips) 
Seat 6: EphemeralBen ($11.84 in chips) 
zlobslob: posts small blind $0.05
tr41n3r12: posts big blind $0.10
*** HOLE CARDS ***
EphemeralBen: folds 
BahiaMinhaP: folds 
NvR.m1nD: folds 
truck1234: folds 
zlobslob: folds 
Uncalled bet ($0.05) returned to tr41n3r12
tr41n3r12 collected $0.10 from pot
*** SUMMARY ***
Total pot $0.10 | Rake $0 
Seat 1: BahiaMinhaP folded before Flop (didn't bet)
Seat 2: NvR.m1nD folded before Flop (didn't bet)
Seat 3: truck1234 (button) folded before Flop (didn't bet)
Seat 4: zlobslob (small blind) folded before Flop
Seat 5: tr41n3r12 (big blind) collected ($0.10)
Seat 6: EphemeralBen folded before Flop (didn't bet)



PokerStars Hand #166667585804:  Hold'em No Limit ($0.05/$0.10 USD) - 2017/02/23 16:03:51 ET
Table 'Kochera' 6-max Seat #1 is the button
Seat 1: chimera252 ($11.50 in chips) 
Seat 2: bartabs2 ($10.51 in chips) 
Seat 3: KA3AXCTAHEU, ($10.25 in chips) 
Seat 4: johkom ($5.46 in chips) 
Seat 5: univibe68 ($11.85 in chips) 
Seat 6: oddshoff ($9.63 in chips) 
bartabs2: posts small blind $0.05
KA3AXCTAHEU,: posts big blind $0.10
*** HOLE CARDS ***
johkom: folds 
univibe68: folds 
oddshoff: folds 
chimera252: raises $0.15 to $0.25
bartabs2: calls $0.20
KA3AXCTAHEU,: folds 
*** FLOP *** [2d Jd 8d]
bartabs2: checks 
chimera252: checks 
*** TURN *** [2d Jd 8d] [9d]
bartabs2: checks 
chimera252: checks 
*** RIVER *** [2d Jd 8d 9d] [6h]
bartabs2: checks 
chimera252: checks 
*** SHOW DOWN ***
bartabs2: shows [Kc Ts] (high card King)
chimera252: shows [Qh 6s] (a pair of Sixes)
chimera252 collected $0.57 from pot
*** SUMMARY ***
Total pot $0.60 | Rake $0.03 
Board [2d Jd 8d 9d 6h]
Seat 1: chimera252 (button) showed [Qh 6s] and won ($0.57) with a pair of Sixes
Seat 2: bartabs2 (small blind) showed [Kc Ts] and lost with high card King
Seat 3: KA3AXCTAHEU, (big blind) folded before Flop
Seat 4: johkom folded before Flop (didn't bet)
Seat 5: univibe68 folded before Flop (didn't bet)
Seat 6: oddshoff folded before Flop (didn't bet)



PokerStars Hand #166667585942:  Hold'em No Limit ($0.05/$0.10 USD) - 2017/02/23 16:03:51 ET
Table 'Kanda' 6-max Seat #2 is the button
Seat 1: Andy Wolf ($11.12 in chips) 
Seat 2: Pelotín ($5.30 in chips) 
Seat 4: Orlangoor ($10.09 in chips) 
Seat 5: Dimka4 ($10 in chips) 
Seat 6: oddshoff ($8.81 in chips) 
XaXaTyH4uK will be allowed to play after the button
Orlangoor: posts small blind $0.05
Dimka4: posts big blind $0.10
*** HOLE CARDS ***
oddshoff: folds 
Andy Wolf: raises $0.20 to $0.30
Pelotín: folds 
Orlangoor: folds 
Dimka4: folds 
Uncalled bet ($0.20) returned to Andy Wolf
Andy Wolf collected $0.25 from pot
*** SUMMARY ***
Total pot $0.25 | Rake $0 
Seat 1: Andy Wolf collected ($0.25)
Seat 2: Pelotín (button) folded before Flop (didn't bet)
Seat 4: Orlangoor (small blind) folded before Flop
Seat 5: Dimka4 (big blind) folded before Flop
Seat 6: oddshoff folded before Flop (didn't bet)



PokerStars Hand #166667586058:  Hold'em No Limit ($0.05/$0.10 USD) - 2017/02/23 16:03:51 ET
Table 'Carina' 6-max Seat #1 is the button
Seat 1: Kupi007 ($10 in chips) 
Seat 2: kickereens ($24.29 in chips) 
Seat 3: LarryTheStar ($10.10 in chips) 
Seat 4: crazydevill ($10 in chips) 
Seat 5: IAntikI ($10.30 in chips) 
Seat 6: alexweezer ($9.80 in chips) 
kickereens: posts small blind $0.05
LarryTheStar: posts big blind $0.10
*** HOLE CARDS ***
crazydevill: folds 
IAntikI: folds 
crazydevill leaves the table
alexweezer: raises $0.10 to $0.20
Kupi007: folds 
kickereens: raises $0.60 to $0.80
LarryTheStar: folds 
alexweezer: folds 
Uncalled bet ($0.60) returned to kickereens
kickereens collected $0.50 from pot
*** SUMMARY ***
Total pot $0.50 | Rake $0 
Seat 1: Kupi007 (button) folded before Flop (didn't bet)
Seat 2: kickereens (small blind) collected ($0.50)
Seat 3: LarryTheStar (big blind) folded before Flop
Seat 4: crazydevill folded before Flop (didn't bet)
Seat 5: IAntikI folded before Flop (didn't bet)
Seat 6: alexweezer folded before Flop



PokerStars Hand #166667586062:  Hold'em No Limit ($0.05/$0.10 USD) - 2017/02/23 16:03:51 ET
Table 'Serpens' 6-max Seat #1 is the button
Seat 1: Namhkal ($10.30 in chips) 
Seat 2: KA3AXCTAHEU, ($10.05 in chips) 
Seat 3: homelessdan ($29.59 in chips) 
Seat 4: Ragazzi3 ($16.29 in chips) 
Seat 5: XwinX25 ($11.81 in chips) 
Seat 6: Croplayer1 ($10.15 in chips) 
KA3AXCTAHEU,: posts small blind $0.05
homelessdan: posts big blind $0.10
*** HOLE CARDS ***
Ragazzi3: raises $0.20 to $0.30
XwinX25: folds 
Croplayer1: folds 
Namhkal: folds 
KA3AXCTAHEU,: folds 
homelessdan: folds 
Uncalled bet ($0.20) returned to Ragazzi3
Ragazzi3 collected $0.25 from pot
*** SUMMARY ***
Total pot $0.25 | Rake $0 
Seat 1: Namhkal (button) folded before Flop (didn't bet)
Seat 2: KA3AXCTAHEU, (small blind) folded before Flop
Seat 3: homelessdan (big blind) folded before Flop
Seat 4: Ragazzi3 collected ($0.25)
Seat 5: XwinX25 folded before Flop (didn't bet)
Seat 6: Croplayer1 folded before Flop (didn't bet)



PokerStars Hand #166667586340:  Hold'em No Limit ($0.05/$0.10 USD) - 2017/02/23 16:03:52 ET
Table 'Marghanna II' 6-max Seat #2 is the button
Seat 2: Namhkal ($11.41 in chips) 
Seat 3: Innerwuss ($11.82 in chips) 
Seat 4: D3NyA ($12.37 in chips) 
Seat 5: ofl21189 ($7.37 in chips) 
Seat 6: VAD21 ($13.11 in chips) 
Innerwuss: posts small blind $0.05
D3NyA: posts big blind $0.10
Goroshkos88: sits out 
*** HOLE CARDS ***
ofl21189: calls $0.10
VAD21: folds 
Namhkal: folds 
Innerwuss: raises $0.30 to $0.40
D3NyA: folds 
ofl21189: calls $0.30
*** FLOP *** [Th 5c 3c]
Innerwuss: checks 
ofl21189: bets $0.90
Innerwuss: folds 
Uncalled bet ($0.90) returned to ofl21189
ofl21189 collected $0.86 from pot
*** SUMMARY ***
Total pot $0.90 | Rake $0.04 
Board [Th 5c 3c]
Seat 2: Namhkal (button) folded before Flop (didn't bet)
Seat 3: Innerwuss (small blind) folded on the Flop
Seat 4: D3NyA (big blind) folded before Flop
Seat 5: ofl21189 collected ($0.86)
Seat 6: VAD21 folded before Flop (didn't bet)



PokerStars Hand #166667586655:  Hold'em No Limit ($0.05/$0.10 USD) - 2017/02/23 16:03:52 ET
Table 'Unitas II' 6-max Seat #6 is the button
Seat 1: Peter0087 ($9.90 in chips) 
Seat 3: CallByValue ($10 in chips) 
Seat 4: truck1234 ($10.99 in chips) 
Seat 5: chimera252 ($25.76 in chips) 
Seat 6: paxit71 ($8.27 in chips) 
Peter0087: posts small blind $0.05
dragonste89: is sitting out 
CallByValue: posts big blind $0.10
*** HOLE CARDS ***
truck1234: folds 
chimera252: raises $0.20 to $0.30
paxit71: folds 
dragonste89 leaves the table
steepfell joins the table at seat #2 
Peter0087: folds 
CallByValue: folds 
Uncalled bet ($0.20) returned to chimera252
CallByValue leaves the table
chimera252 collected $0.25 from pot
*** SUMMARY ***
Total pot $0.25 | Rake $0 
Seat 1: Peter0087 (small blind) folded before Flop
Seat 3: CallByValue (big blind) folded before Flop
Seat 4: truck1234 folded before Flop (didn't bet)
Seat 5: chimera252 collected ($0.25)
Seat 6: paxit71 (button) folded before Flop (didn't bet)



PokerStars Hand #166667587459:  Hold'em No Limit ($0.05/$0.10 USD) - 2017/02/23 16:03:53 ET
Table 'Wilkens II' 6-max Seat #3 is the button
Seat 1: Islamiq-GuRL ($12.15 in chips) 
Seat 2: manashov ($10.75 in chips) 
Seat 3: Namhkal ($10.65 in chips) 
Seat 5: patrick19111 ($10.05 in chips) 
Seat 6: XaXaTyH4uK ($14.46 in chips) 
patrick19111: posts small blind $0.05
XaXaTyH4uK: posts big blind $0.10
*** HOLE CARDS ***
Islamiq-GuRL: raises $0.15 to $0.25
manashov: folds 
Namhkal: folds 
patrick19111: calls $0.20
XaXaTyH4uK: folds 
*** FLOP *** [5d Qd 8c]
patrick19111: checks 
Islamiq-GuRL: bets $0.33
patrick19111: calls $0.33
*** TURN *** [5d Qd 8c] [7d]
patrick19111: checks 
Islamiq-GuRL: checks 
*** RIVER *** [5d Qd 8c 7d] [9c]
patrick19111: checks 
Islamiq-GuRL: bets $0.44
patrick19111: calls $0.44
*** SHOW DOWN ***
Islamiq-GuRL: shows [Jd Jc] (a pair of Jacks)
patrick19111: shows [Ah Qc] (a pair of Queens)
patrick19111 collected $2.04 from pot
*** SUMMARY ***
Total pot $2.14 | Rake $0.10 
Board [5d Qd 8c 7d 9c]
Seat 1: Islamiq-GuRL showed [Jd Jc] and lost with a pair of Jacks
Seat 2: manashov folded before Flop (didn't bet)
Seat 3: Namhkal (button) folded before Flop (didn't bet)
Seat 5: patrick19111 (small blind) showed [Ah Qc] and won ($2.04) with a pair of Queens
Seat 6: XaXaTyH4uK (big blind) folded before Flop



PokerStars Hand #166667587696:  Hold'em No Limit ($0.05/$0.10 USD) - 2017/02/23 16:03:53 ET
Table 'Walpurga' 6-max Seat #6 is the button
Seat 1: chimera252 ($12.12 in chips) 
Seat 2: paxit71 ($6.99 in chips) 
Seat 3: Innerwuss ($19.43 in chips) 
Seat 4: oddshoff ($12.79 in chips) 
Seat 6: AIONCMA1988 ($4.21 in chips) 
chimera252: posts small blind $0.05
paxit71: posts big blind $0.10
*** HOLE CARDS ***
Innerwuss: folds 
oddshoff: folds 
Innerwuss leaves the table
AIONCMA1988: raises $0.10 to $0.20
chimera252: folds 
paxit71: folds 
Uncalled bet ($0.10) returned to AIONCMA1988
marianoboni joins the table at seat #3 
AIONCMA1988 collected $0.25 from pot
*** SUMMARY ***
Total pot $0.25 | Rake $0 
Seat 1: chimera252 (small blind) folded before Flop
Seat 2: paxit71 (big blind) folded before Flop
Seat 3: Innerwuss folded before Flop (didn't bet)
Seat 4: oddshoff folded before Flop (didn't bet)
Seat 6: AIONCMA1988 (button) collected ($0.25)



PokerStars Hand #166667587818:  Hold'em No Limit ($0.05/$0.10 USD) - 2017/02/23 16:03:53 ET
Table 'Hestia' 6-max Seat #3 is the button
Seat 1: Pekaml ($10.23 in chips) 
Seat 3: MBen10 ($13.77 in chips) 
Seat 4: Lucky HoBBiT ($10 in chips) 
Seat 5: CiisCi ($16.05 in chips) 
Lucky HoBBiT: posts small blind $0.05
CiisCi: posts big blind $0.10
Smitty03300: sits out 
Kow6oy: sits out 
*** HOLE CARDS ***
Pekaml: folds 
MBen10: folds 
Lucky HoBBiT: folds 
Uncalled bet ($0.05) returned to CiisCi
CiisCi collected $0.10 from pot
*** SUMMARY ***
Total pot $0.10 | Rake $0 
Seat 1: Pekaml folded before Flop (didn't bet)
Seat 3: MBen10 (button) folded before Flop (didn't bet)
Seat 4: Lucky HoBBiT (small blind) folded before Flop
Seat 5: CiisCi (big blind) collected ($0.10)



PokerStars Hand #166667588055:  Hold'em No Limit ($0.05/$0.10 USD) - 2017/02/23 16:03:54 ET
Table 'Clavel' 6-max Seat #1 is the button
Seat 1: KRZuff ($14.51 in chips) 
Seat 4: Dcaro31 ($11.71 in chips) 
Seat 5: Vrinni ($10.39 in chips) 
Seat 6: Gra_anD77 ($4.54 in chips) 
Namhkal will be allowed to play after the button
Dcaro31: posts small blind $0.05
Vrinni: posts big blind $0.10
*** HOLE CARDS ***
Gra_anD77: folds 
KRZuff: folds 
Dcaro31: folds 
Uncalled bet ($0.05) returned to Vrinni
Vrinni collected $0.10 from pot
*** SUMMARY ***
Total pot $0.10 | Rake $0 
Seat 1: KRZuff (button) folded before Flop (didn't bet)
Seat 4: Dcaro31 (small blind) folded before Flop
Seat 5: Vrinni (big blind) collected ($0.10)
Seat 6: Gra_anD77 folded before Flop (didn't bet)



PokerStars Hand #166667588484:  Hold'em No Limit ($0.05/$0.10 USD) - 2017/02/23 16:03:54 ET
Table 'Girtab' 6-max Seat #5 is the button
Seat 1: pokekrk ($13.46 in chips) 
Seat 2: MühliJr ($10.06 in chips) 
Seat 3: kingartur222 ($10.50 in chips) 
Seat 4: Hyd SK ($11.50 in chips) 
Seat 5: sexy_seagull ($10.72 in chips) 
pokekrk: posts small blind $0.05
MühliJr: posts big blind $0.10
*** HOLE CARDS ***
kingartur222: folds 
Hyd SK: folds 
sexy_seagull: folds 
pokekrk: raises $0.15 to $0.25
MühliJr: folds 
Uncalled bet ($0.15) returned to pokekrk
pokekrk collected $0.20 from pot
*** SUMMARY ***
Total pot $0.20 | Rake $0 
Seat 1: pokekrk (small blind) collected ($0.20)
Seat 2: MühliJr (big blind) folded before Flop
Seat 3: kingartur222 folded before Flop (didn't bet)
Seat 4: Hyd SK folded before Flop (didn't bet)
Seat 5: sexy_seagull (button) folded before Flop (didn't bet)



PokerStars Hand #166667588779:  Hold'em No Limit ($0.05/$0.10 USD) - 2017/02/23 16:03:54 ET
Table 'Lagrula' 6-max Seat #3 is the button
Seat 1: Ice_Isayev ($10 in chips) 
Seat 3: micke667 ($15.68 in chips) 
Seat 4: Calimero2408 ($5.24 in chips) 
Seat 5: Iarlei ($10 in chips) 
Seat 6: Spud014 ($11.45 in chips) 
Calimero2408: posts small blind $0.05
Iarlei: posts big blind $0.10
KRZuff: sits out 
*** HOLE CARDS ***
Spud014: folds 
Ice_Isayev: raises $0.15 to $0.25
micke667: folds 
Calimero2408: calls $0.20
Iarlei: folds 
*** FLOP *** [Td Kd 6c]
Calimero2408: checks 
Ice_Isayev: bets $0.30
Calimero2408: calls $0.30
*** TURN *** [Td Kd 6c] [Jd]
Calimero2408: checks 
Ice_Isayev: bets $0.70
Calimero2408: calls $0.70
*** RIVER *** [Td Kd 6c Jd] [Ah]
Calimero2408: checks 
Ice_Isayev: checks 
*** SHOW DOWN ***
Calimero2408: shows [Qd 7c] (a straight, Ten to Ace)
Ice_Isayev: mucks hand 
Calimero2408 collected $2.48 from pot
*** SUMMARY ***
Total pot $2.60 | Rake $0.12 
Board [Td Kd 6c Jd Ah]
Seat 1: Ice_Isayev mucked
Seat 3: micke667 (button) folded before Flop (didn't bet)
Seat 4: Calimero2408 (small blind) showed [Qd 7c] and won ($2.48) with a straight, Ten to Ace
Seat 5: Iarlei (big blind) folded before Flop
Seat 6: Spud014 folded before Flop (didn't bet)



PokerStars Hand #166667589039:  Hold'em No Limit ($0.05/$0.10 USD) - 2017/02/23 16:03:55 ET
Table 'Atalante' 6-max Seat #6 is the button
Seat 1: OceanBlue100 ($5.14 in chips) 
Seat 2: CiisCi ($19.92 in chips) 
Seat 3: Kow6oy ($10 in chips) 
Seat 4: Dcaro31 ($25.07 in chips) 
Seat 5: eniksenik ($10.29 in chips) 
Seat 6: FlopsterGB ($30.23 in chips) 
OceanBlue100: posts small blind $0.05
CiisCi: posts big blind $0.10
*** HOLE CARDS ***
Kow6oy: raises $0.25 to $0.35
Dcaro31: folds 
eniksenik: folds 
FlopsterGB: folds 
OceanBlue100: folds 
CiisCi: folds 
Uncalled bet ($0.25) returned to Kow6oy
Kow6oy collected $0.25 from pot
*** SUMMARY ***
Total pot $0.25 | Rake $0 
Seat 1: OceanBlue100 (small blind) folded before Flop
Seat 2: CiisCi (big blind) folded before Flop
Seat 3: Kow6oy collected ($0.25)
Seat 4: Dcaro31 folded before Flop (didn't bet)
Seat 5: eniksenik folded before Flop (didn't bet)
Seat 6: FlopsterGB (button) folded before Flop (didn't bet)



PokerStars Hand #166667589104:  Hold'em No Limit ($0.05/$0.10 USD) - 2017/02/23 16:03:55 ET
Table 'Heka II' 6-max Seat #4 is the button
Seat 1: Mamm0nism ($14.37 in chips) 
Seat 2: oddshoff ($11.57 in chips) 
Seat 3: MühliJr ($10.30 in chips) 
Seat 4: theNot0r1ous ($10 in chips) 
Seat 5: ArcticBearDK ($12.58 in chips) 
Seat 6: MonteCris92 ($10 in chips) 
ArcticBearDK: posts small blind $0.05
MonteCris92: posts big blind $0.10
*** HOLE CARDS ***
Mamm0nism: folds 
oddshoff: raises $0.20 to $0.30
MühliJr: folds 
theNot0r1ous: raises $0.60 to $0.90
ArcticBearDK: folds 
MonteCris92: folds 
oddshoff: folds 
Uncalled bet ($0.60) returned to theNot0r1ous
theNot0r1ous collected $0.75 from pot
*** SUMMARY ***
Total pot $0.75 | Rake $0 
Seat 1: Mamm0nism folded before Flop (didn't bet)
Seat 2: oddshoff folded before Flop
Seat 3: MühliJr folded before Flop (didn't bet)
Seat 4: theNot0r1ous (button) collected ($0.75)
Seat 5: ArcticBearDK (small blind) folded before Flop
Seat 6: MonteCris92 (big blind) folded before Flop



PokerStars Hand #166667589232:  Hold'em No Limit ($0.05/$0.10 USD) - 2017/02/23 16:03:55 ET
Table 'Oongaq' 6-max Seat #5 is the button
Seat 1: Dmitrij218 ($13.60 in chips) 
Seat 2: homelessdan ($19.05 in chips) 
Seat 3: iDecMate ($10 in chips) 
Seat 4: Bird et al ($10 in chips) 
Seat 5: Dizzler1991 ($4.55 in chips) 
Seat 6: boxer821 ($10 in chips) 
boxer821: posts small blind $0.05
Dmitrij218: posts big blind $0.10
*** HOLE CARDS ***
homelessdan: calls $0.10
iDecMate: folds 
Bird et al: folds 
Dizzler1991: calls $0.10
boxer821: raises $0.40 to $0.50
Dmitrij218: folds 
homelessdan: calls $0.40
Dizzler1991: calls $0.40
*** FLOP *** [Ts 8h 4s]
boxer821: checks 
homelessdan: checks 
Dizzler1991: bets $4.05 and is all-in
boxer821: folds 
homelessdan: folds 
Uncalled bet ($4.05) returned to Dizzler1991
Dizzler1991 collected $1.53 from pot
*** SUMMARY ***
Total pot $1.60 | Rake $0.07 
Board [Ts 8h 4s]
Seat 1: Dmitrij218 (big blind) folded before Flop
Seat 2: homelessdan folded on the Flop
Seat 3: iDecMate folded before Flop (didn't bet)
Seat 4: Bird et al folded before Flop (didn't bet)
Seat 5: Dizzler1991 (button) collected ($1.53)
Seat 6: boxer821 (small blind) folded on the Flop



PokerStars Hand #166667589364:  Hold'em No Limit ($0.05/$0.10 USD) - 2017/02/23 16:03:55 ET
Table 'Alnasl' 6-max Seat #6 is the button
Seat 1: KA3AXCTAHEU, ($11.12 in chips) 
Seat 3: david_sara83 ($22.84 in chips) 
Seat 4: oddshoff ($9.83 in chips) 
Seat 5: steepfell ($10.43 in chips) 
Seat 6: Zooplack ($13.28 in chips) 
KA3AXCTAHEU,: posts small blind $0.05
XaXaTyH4uK: is sitting out 
XaXaTyH4uK leaves the table
david_sara83: posts big blind $0.10
*** HOLE CARDS ***
oddshoff: raises $0.20 to $0.30
steepfell: folds 
Zooplack: folds 
KA3AXCTAHEU,: folds 
david_sara83: folds 
Uncalled bet ($0.20) returned to oddshoff
oddshoff collected $0.25 from pot
*** SUMMARY ***
Total pot $0.25 | Rake $0 
Seat 1: KA3AXCTAHEU, (small blind) folded before Flop
Seat 3: david_sara83 (big blind) folded before Flop
Seat 4: oddshoff collected ($0.25)
Seat 5: steepfell folded before Flop (didn't bet)
Seat 6: Zooplack (button) folded before Flop (didn't bet)



PokerStars Hand #166667589767:  Hold'em No Limit ($0.05/$0.10 USD) - 2017/02/23 16:03:55 ET
Table 'Joella' 6-max Seat #5 is the button
Seat 1: Dcaro31 ($13.25 in chips) 
Seat 2: Kaelyns_Bark ($7.81 in chips) 
Seat 3: Joker51_wtf! ($10 in chips) 
Seat 5: Anestakis777 ($5.79 in chips) 
Seat 6: dr.goofy ($11.66 in chips) 
dr.goofy: posts small blind $0.05
Dcaro31: posts big blind $0.10
*** HOLE CARDS ***
Kaelyns_Bark: raises $0.30 to $0.40
Joker51_wtf!: folds 
Anestakis777: folds 
dr.goofy: folds 
Dcaro31: folds 
Uncalled bet ($0.30) returned to Kaelyns_Bark
Kaelyns_Bark collected $0.25 from pot
*** SUMMARY ***
Total pot $0.25 | Rake $0 
Seat 1: Dcaro31 (big blind) folded before Flop
Seat 2: Kaelyns_Bark collected ($0.25)
Seat 3: Joker51_wtf! folded before Flop (didn't bet)
Seat 5: Anestakis777 (button) folded before Flop (didn't bet)
Seat 6: dr.goofy (small blind) folded before Flop



PokerStars Hand #166667590055:  Hold'em No Limit ($0.05/$0.10 USD) - 2017/02/23 16:03:56 ET
Table 'Scabiosa III' 6-max Seat #6 is the button
Seat 1: Feverhead ($13.31 in chips) 
Seat 2: yodzik ($5 in chips) 
Seat 3: Goroshkos88 ($11.40 in chips) 
Seat 4: voledy ($10.10 in chips) 
Seat 5: patrick19111 ($25.60 in chips) 
Seat 6: Smitty03300 ($10 in chips) 
Feverhead: posts small blind $0.05
yodzik: posts big blind $0.10
*** HOLE CARDS ***
Goroshkos88: folds 
voledy: raises $0.20 to $0.30
patrick19111: folds 
Smitty03300: folds 
Feverhead: folds 
yodzik: folds 
Uncalled bet ($0.20) returned to voledy
voledy collected $0.25 from pot
*** SUMMARY ***
Total pot $0.25 | Rake $0 
Seat 1: Feverhead (small blind) folded before Flop
Seat 2: yodzik (big blind) folded before Flop
Seat 3: Goroshkos88 folded before Flop (didn't bet)
Seat 4: voledy collected ($0.25)
Seat 5: patrick19111 folded before Flop (didn't bet)
Seat 6: Smitty03300 (button) folded before Flop (didn't bet)



PokerStars Hand #166667590206:  Hold'em No Limit ($0.05/$0.10 USD) - 2017/02/23 16:03:56 ET
Table 'Rostia' 6-max Seat #4 is the button
Seat 1: paxit71 ($7.70 in chips) 
Seat 2: david_sara83 ($19.41 in chips) 
Seat 4: Hyd SK ($11.53 in chips) 
Seat 5: silsilviu ($7.10 in chips) 
Seat 6: Giyorod ($10.85 in chips) 
silsilviu: posts small blind $0.05
Giyorod: posts big blind $0.10
iThreeBarrel: sits out 
*** HOLE CARDS ***
paxit71: raises $0.10 to $0.20
david_sara83: calls $0.20
Hyd SK: folds 
silsilviu: folds 
Giyorod: folds 
*** FLOP *** [2s Qd Ts]
paxit71: bets $0.30
david_sara83: folds 
Uncalled bet ($0.30) returned to paxit71
paxit71 collected $0.53 from pot
*** SUMMARY ***
Total pot $0.55 | Rake $0.02 
Board [2s Qd Ts]
Seat 1: paxit71 collected ($0.53)
Seat 2: david_sara83 folded on the Flop
Seat 4: Hyd SK (button) folded before Flop (didn't bet)
Seat 5: silsilviu (small blind) folded before Flop
Seat 6: Giyorod (big blind) folded before Flop



PokerStars Hand #166667590284:  Hold'em No Limit ($0.05/$0.10 USD) - 2017/02/23 16:03:56 ET
Table 'Hyakutake' 6-max Seat #4 is the button
Seat 1: Asilvagoat ($11.73 in chips) 
Seat 2: boxer821 ($10.79 in chips) 
Seat 3: lenboysprite ($6.60 in chips) 
Seat 4: eniksenik ($13.65 in chips) 
Seat 5: RoJ1 ($11.49 in chips) 
Seat 6: maxiv608 ($13.42 in chips) 
RoJ1: posts small blind $0.05
maxiv608: posts big blind $0.10
*** HOLE CARDS ***
Asilvagoat: raises $0.20 to $0.30
boxer821: folds 
lenboysprite: calls $0.30
eniksenik: folds 
RoJ1: folds 
maxiv608: folds 
*** FLOP *** [Ks 5s 9s]
Asilvagoat: checks 
lenboysprite: checks 
*** TURN *** [Ks 5s 9s] [7d]
Asilvagoat: bets $0.36
lenboysprite: calls $0.36
*** RIVER *** [Ks 5s 9s 7d] [Kd]
Asilvagoat: checks 
lenboysprite: checks 
*** SHOW DOWN ***
Asilvagoat: shows [Ah 7h] (two pair, Kings and Sevens)
lenboysprite: mucks hand 
Asilvagoat collected $1.40 from pot
*** SUMMARY ***
Total pot $1.47 | Rake $0.07 
Board [Ks 5s 9s 7d Kd]
Seat 1: Asilvagoat showed [Ah 7h] and won ($1.40) with two pair, Kings and Sevens
Seat 2: boxer821 folded before Flop (didn't bet)
Seat 3: lenboysprite mucked
Seat 4: eniksenik (button) folded before Flop (didn't bet)
Seat 5: RoJ1 (small blind) folded before Flop
Seat 6: maxiv608 (big blind) folded before Flop



PokerStars Hand #166667590494:  Hold'em No Limit ($0.05/$0.10 USD) - 2017/02/23 16:03:56 ET
Table 'Kraz II' 6-max Seat #3 is the button
Seat 1: bdixon_5 ($9.70 in chips) 
Seat 3: Eddys Edge ($10 in chips) 
Seat 4: WinninBikini ($11.71 in chips) 
Seat 5: Joker51_wtf! ($10 in chips) 
Seat 6: tr41n3r12 ($10.15 in chips) 
WinninBikini: posts small blind $0.05
Joker51_wtf!: posts big blind $0.10
shellyld: sits out 
*** HOLE CARDS ***
tr41n3r12: folds 
bdixon_5: folds 
Eddys Edge: folds 
WinninBikini: raises $0.20 to $0.30
Joker51_wtf!: calls $0.20
*** FLOP *** [7s As Ad]
WinninBikini: bets $0.33
Joker51_wtf!: calls $0.33
*** TURN *** [7s As Ad] [Kc]
WinninBikini: bets $0.85
Joker51_wtf!: folds 
Uncalled bet ($0.85) returned to WinninBikini
WinninBikini collected $1.20 from pot
*** SUMMARY ***
Total pot $1.26 | Rake $0.06 
Board [7s As Ad Kc]
Seat 1: bdixon_5 folded before Flop (didn't bet)
Seat 3: Eddys Edge (button) folded before Flop (didn't bet)
Seat 4: WinninBikini (small blind) collected ($1.20)
Seat 5: Joker51_wtf! (big blind) folded on the Turn
Seat 6: tr41n3r12 folded before Flop (didn't bet)



PokerStars Hand #166667590556:  Hold'em No Limit ($0.05/$0.10 USD) - 2017/02/23 16:03:56 ET
Table 'Vaisala' 6-max Seat #6 is the button
Seat 1: Pekaml ($10.05 in chips) 
Seat 2: XaXaTyH4uK ($10 in chips) 
Seat 3: x3ultimate ($10.15 in chips) 
Seat 4: sexy_seagull ($11.53 in chips) 
Seat 5: AIONCMA1988 ($6.10 in chips) 
Seat 6: Aleksey K228 ($15.28 in chips) 
Pekaml: posts small blind $0.05
XaXaTyH4uK: posts big blind $0.10
*** HOLE CARDS ***
x3ultimate: folds 
sexy_seagull: folds 
AIONCMA1988: raises $0.10 to $0.20
Aleksey K228: folds 
Pekaml is disconnected 
Pekaml has timed out while disconnected
Pekaml: folds 
XaXaTyH4uK: calls $0.10
*** FLOP *** [6h 4h 7s]
XaXaTyH4uK: checks 
AIONCMA1988: bets $0.22
XaXaTyH4uK: raises $0.68 to $0.90
AIONCMA1988: calls $0.68
*** TURN *** [6h 4h 7s] [Tc]
XaXaTyH4uK: checks 
AIONCMA1988: bets $1.20
XaXaTyH4uK: raises $7.70 to $8.90 and is all-in
AIONCMA1988: folds 
Uncalled bet ($7.70) returned to XaXaTyH4uK
XaXaTyH4uK collected $4.44 from pot
*** SUMMARY ***
Total pot $4.65 | Rake $0.21 
Board [6h 4h 7s Tc]
Seat 1: Pekaml (small blind) folded before Flop
Seat 2: XaXaTyH4uK (big blind) collected ($4.44)
Seat 3: x3ultimate folded before Flop (didn't bet)
Seat 4: sexy_seagull folded before Flop (didn't bet)
Seat 5: AIONCMA1988 folded on the Turn
Seat 6: Aleksey K228 (button) folded before Flop (didn't bet)



PokerStars Hand #166667590634:  Hold'em No Limit ($0.05/$0.10 USD) - 2017/02/23 16:03:56 ET
Table 'Pallas II' 6-max Seat #1 is the button
Seat 1: mdelfin0 ($15.73 in chips) 
Seat 2: FRAID358 ($10 in chips) 
Seat 3: KRZuff ($10 in chips) 
Seat 4: Mr. Bluff 34 ($11.71 in chips) 
Seat 5: Yspenyanin ($19.71 in chips) 
FRAID358: posts small blind $0.05
KRZuff: posts big blind $0.10
Orlangoor: sits out 
*** HOLE CARDS ***
Mr. Bluff 34: raises $0.10 to $0.20
Yspenyanin: folds 
mdelfin0: folds 
FRAID358: folds 
KRZuff: raises $0.80 to $1
Mr. Bluff 34: calls $0.80
*** FLOP *** [Ad 9c As]
KRZuff: bets $1.30
Mr. Bluff 34: raises $9.41 to $10.71 and is all-in
KRZuff: folds 
Uncalled bet ($9.41) returned to Mr. Bluff 34
Mr. Bluff 34 collected $4.44 from pot
*** SUMMARY ***
Total pot $4.65 | Rake $0.21 
Board [Ad 9c As]
Seat 1: mdelfin0 (button) folded before Flop (didn't bet)
Seat 2: FRAID358 (small blind) folded before Flop
Seat 3: KRZuff (big blind) folded on the Flop
Seat 4: Mr. Bluff 34 collected ($4.44)
Seat 5: Yspenyanin folded before Flop (didn't bet)



PokerStars Hand #166667590870:  Hold'em No Limit ($0.05/$0.10 USD) - 2017/02/23 16:03:57 ET
Table 'Glarona' 6-max Seat #6 is the button
Seat 1: LarryTheStar ($10.70 in chips) 
Seat 2: BookWorm78 ($10.02 in chips) 
Seat 3: hoedje72 ($3.86 in chips) 
Seat 4: CrippledGod ($6.72 in chips) 
Seat 5: david_sara83 ($10.50 in chips) 
Seat 6: Namhkal ($10.93 in chips) 
LarryTheStar: posts small blind $0.05
BookWorm78: posts big blind $0.10
*** HOLE CARDS ***
hoedje72: folds 
CrippledGod: folds 
david_sara83: raises $0.15 to $0.25
Namhkal: raises $0.50 to $0.75
LarryTheStar: folds 
BookWorm78: folds 
david_sara83: folds 
Uncalled bet ($0.50) returned to Namhkal
Namhkal collected $0.65 from pot
*** SUMMARY ***
Total pot $0.65 | Rake $0 
Seat 1: LarryTheStar (small blind) folded before Flop
Seat 2: BookWorm78 (big blind) folded before Flop
Seat 3: hoedje72 folded before Flop (didn't bet)
Seat 4: CrippledGod folded before Flop (didn't bet)
Seat 5: david_sara83 folded before Flop
Seat 6: Namhkal (button) collected ($0.65)



PokerStars Hand #166667591094:  Hold'em No Limit ($0.05/$0.10 USD) - 2017/02/23 16:03:57 ET
Table 'Crocus' 6-max Seat #5 is the button
Seat 1: truck1234 ($24.91 in chips) 
Seat 2: garigura ($11.19 in chips) 
Seat 3: Limpa Meza ($0.88 in chips) 
Seat 4: patrick19111 ($12.26 in chips) 
Seat 5: Golsuorsi ($10 in chips) 
Seat 6: Rodik002 ($10.02 in chips) 
Rodik002: posts small blind $0.05
truck1234: posts big blind $0.10
*** HOLE CARDS ***
garigura has timed out
garigura: folds 
Limpa Meza: calls $0.10
patrick19111: folds 
Golsuorsi: folds 
Rodik002: folds 
truck1234: checks 
*** FLOP *** [Kh Qd 5h]
truck1234: checks 
Limpa Meza: checks 
*** TURN *** [Kh Qd 5h] [3d]
truck1234: checks 
Limpa Meza: checks 
*** RIVER *** [Kh Qd 5h 3d] [Qc]
truck1234: checks 
Limpa Meza: checks 
*** SHOW DOWN ***
truck1234: shows [Ah 3s] (two pair, Queens and Threes)
Limpa Meza: mucks hand 
truck1234 collected $0.24 from pot
*** SUMMARY ***
Total pot $0.25 | Rake $0.01 
Board [Kh Qd 5h 3d Qc]
Seat 1: truck1234 (big blind) showed [Ah 3s] and won ($0.24) with two pair, Queens and Threes
Seat 2: garigura folded before Flop (didn't bet)
Seat 3: Limpa Meza mucked
Seat 4: patrick19111 folded before Flop (didn't bet)
Seat 5: Golsuorsi (button) folded before Flop (didn't bet)
Seat 6: Rodik002 (small blind) folded before Flop



PokerStars Hand #166667591242:  Hold'em No Limit ($0.05/$0.10 USD) - 2017/02/23 16:03:57 ET
Table 'Bengt' 6-max Seat #5 is the button
Seat 1: Lucky HoBBiT ($12.50 in chips) 
Seat 2: ChefRocco ($21.46 in chips) 
Seat 3: nantes15 ($13.03 in chips) 
Seat 4: 8th wonders ($10 in chips) 
Seat 5: RoJ1 ($10.31 in chips) 
Seat 6: Goroshkos88 ($10 in chips) 
Goroshkos88: posts small blind $0.05
Lucky HoBBiT: posts big blind $0.10
*** HOLE CARDS ***
ChefRocco: folds 
nantes15: raises $0.15 to $0.25
8th wonders: folds 
RoJ1: folds 
Goroshkos88: folds 
Lucky HoBBiT: folds 
Uncalled bet ($0.15) returned to nantes15
nantes15 collected $0.25 from pot
*** SUMMARY ***
Total pot $0.25 | Rake $0 
Seat 1: Lucky HoBBiT (big blind) folded before Flop
Seat 2: ChefRocco folded before Flop (didn't bet)
Seat 3: nantes15 collected ($0.25)
Seat 4: 8th wonders folded before Flop (didn't bet)
Seat 5: RoJ1 (button) folded before Flop (didn't bet)
Seat 6: Goroshkos88 (small blind) folded before Flop



PokerStars Hand #166667591507:  Hold'em No Limit ($0.05/$0.10 USD) - 2017/02/23 16:03:57 ET
Table 'Euryalos II' 6-max Seat #1 is the button
Seat 1: acekid403 ($9.90 in chips) 
Seat 2: silsilviu ($7.10 in chips) 
Seat 3: Hyd SK ($10.50 in chips) 
Seat 4: popypaleta ($15.62 in chips) 
Seat 5: horang2 ($8.25 in chips) 
Seat 6: MihaGr ($10 in chips) 
silsilviu: posts small blind $0.05
Hyd SK: posts big blind $0.10
*** HOLE CARDS ***
popypaleta: folds 
horang2: folds 
MihaGr: folds 
acekid403: folds 
silsilviu: folds 
Uncalled bet ($0.05) returned to Hyd SK
Hyd SK collected $0.10 from pot
*** SUMMARY ***
Total pot $0.10 | Rake $0 
Seat 1: acekid403 (button) folded before Flop (didn't bet)
Seat 2: silsilviu (small blind) folded before Flop
Seat 3: Hyd SK (big blind) collected ($0.10)
Seat 4: popypaleta folded before Flop (didn't bet)
Seat 5: horang2 folded before Flop (didn't bet)
Seat 6: MihaGr folded before Flop (didn't bet)



PokerStars Hand #166667591675:  Hold'em No Limit ($0.05/$0.10 USD) - 2017/02/23 16:03:58 ET
Table 'Stroobantia' 6-max Seat #6 is the button
Seat 1: mam9zyc ($8.64 in chips) 
Seat 2: XwinX25 ($10.04 in chips) 
Seat 3: Namhkal ($10 in chips) 
Seat 4: Yspenyanin ($10.13 in chips) 
Seat 5: boxer821 ($11.24 in chips) 
Seat 6: KokoulinV ($15.52 in chips) 
mam9zyc: posts small blind $0.05
XwinX25: posts big blind $0.10
*** HOLE CARDS ***
Namhkal: folds 
Yspenyanin: folds 
boxer821: folds 
KokoulinV: raises $0.10 to $0.20
mam9zyc: folds 
XwinX25: folds 
Uncalled bet ($0.10) returned to KokoulinV
KokoulinV collected $0.25 from pot
*** SUMMARY ***
Total pot $0.25 | Rake $0 
Seat 1: mam9zyc (small blind) folded before Flop
Seat 2: XwinX25 (big blind) folded before Flop
Seat 3: Namhkal folded before Flop (didn't bet)
Seat 4: Yspenyanin folded before Flop (didn't bet)
Seat 5: boxer821 folded before Flop (didn't bet)
Seat 6: KokoulinV (button) collected ($0.25)



PokerStars Hand #166667591967:  Hold'em No Limit ($0.05/$0.10 USD) - 2017/02/23 16:03:58 ET
Table 'Samitchell III' 6-max Seat #3 is the button
Seat 1: dr.goofy ($10.12 in chips) 
Seat 3: Kow6oy ($10.15 in chips) 
Seat 6: fedorka rus ($13.01 in chips) 
iThreeBarrel will be allowed to play after the button
steepfell will be allowed to play after the button
fedorka rus: posts small blind $0.05
dr.goofy: posts big blind $0.10
scorpionfish: sits out 
*** HOLE CARDS ***
Kow6oy: folds 
fedorka rus: folds 
Uncalled bet ($0.05) returned to dr.goofy
iThreeBarrel leaves the table
dr.goofy collected $0.10 from pot
*** SUMMARY ***
Total pot $0.10 | Rake $0 
Seat 1: dr.goofy (big blind) collected ($0.10)
Seat 3: Kow6oy (button) folded before Flop (didn't bet)
Seat 6: fedorka rus (small blind) folded before Flop



PokerStars Hand #166667592248:  Hold'em No Limit ($0.05/$0.10 USD) - 2017/02/23 16:03:58 ET
Table 'Martha' 6-max Seat #5 is the button
Seat 1: Peter0087 ($10.59 in chips) 
Seat 2: pauli95 ($8.05 in chips) 
Seat 3: Hyd SK ($12.16 in chips) 
Seat 4: dittoro ($10.49 in chips) 
Seat 5: MihaGr ($10 in chips) 
Seat 6: 8th wonders ($10 in chips) 
8th wonders: posts small blind $0.05
Peter0087: posts big blind $0.10
*** HOLE CARDS ***
pauli95: raises $0.20 to $0.30
Hyd SK: folds 
dittoro: calls $0.30
MihaGr: folds 
8th wonders: folds 
Peter0087: folds 
*** FLOP *** [Jh 5h Ac]
pauli95: checks 
dittoro: checks 
*** TURN *** [Jh 5h Ac] [Kc]
pauli95: bets $0.36
dittoro: calls $0.36
*** RIVER *** [Jh 5h Ac Kc] [6d]
pauli95: bets $0.70
dittoro: folds 
Uncalled bet ($0.70) returned to pauli95
pauli95 collected $1.40 from pot
*** SUMMARY ***
Total pot $1.47 | Rake $0.07 
Board [Jh 5h Ac Kc 6d]
Seat 1: Peter0087 (big blind) folded before Flop
Seat 2: pauli95 collected ($1.40)
Seat 3: Hyd SK folded before Flop (didn't bet)
Seat 4: dittoro folded on the River
Seat 5: MihaGr (button) folded before Flop (didn't bet)
Seat 6: 8th wonders (small blind) folded before Flop



PokerStars Hand #166667592274:  Hold'em No Limit ($0.05/$0.10 USD) - 2017/02/23 16:03:58 ET
Table 'Giclas' 6-max Seat #2 is the button
Seat 1: david_sara83 ($10 in chips) 
Seat 2: Crafty23@PS ($10 in chips) 
Seat 3: fidas1972 ($10.16 in chips) 
Seat 4: Eddys Edge ($10 in chips) 
Seat 5: dedea1989 ($25.45 in chips) 
Seat 6: eniksenik ($14.63 in chips) 
fidas1972: posts small blind $0.05
Eddys Edge: posts big blind $0.10
*** HOLE CARDS ***
dedea1989: calls $0.10
eniksenik: folds 
david_sara83: folds 
Crafty23@PS: raises $0.15 to $0.25
fidas1972: calls $0.20
Eddys Edge: calls $0.15
dedea1989: calls $0.15
*** FLOP *** [7c 6d 2d]
fidas1972: checks 
Eddys Edge: checks 
dedea1989: checks 
Crafty23@PS: bets $0.63
fidas1972: folds 
Eddys Edge: folds 
dedea1989: folds 
Uncalled bet ($0.63) returned to Crafty23@PS
Crafty23@PS collected $0.96 from pot
*** SUMMARY ***
Total pot $1 | Rake $0.04 
Board [7c 6d 2d]
Seat 1: david_sara83 folded before Flop (didn't bet)
Seat 2: Crafty23@PS (button) collected ($0.96)
Seat 3: fidas1972 (small blind) folded on the Flop
Seat 4: Eddys Edge (big blind) folded on the Flop
Seat 5: dedea1989 folded on the Flop
Seat 6: eniksenik folded before Flop (didn't bet)



PokerStars Hand #166667592406:  Hold'em No Limit ($0.05/$0.10 USD) - 2017/02/23 16:03:58 ET
Table 'Izar' 6-max Seat #6 is the button
Seat 1: bambolejro ($10.44 in chips) 
Seat 2: mvp0013 ($10.89 in chips) 
Seat 3: Yspenyanin ($11.27 in chips) 
Seat 4: Matee92 ($6.26 in chips) 
Seat 5: fishhook5 ($11.30 in chips) 
Seat 6: yodzik ($5 in chips) 
bambolejro: posts small blind $0.05
mvp0013: posts big blind $0.10
*** HOLE CARDS ***
Yspenyanin: folds 
Matee92: calls $0.10
fishhook5: folds 
yodzik: folds 
bambolejro: folds 
mvp0013: checks 
*** FLOP *** [3s Kd 6d]
mvp0013: checks 
Matee92: checks 
*** TURN *** [3s Kd 6d] [Ts]
mvp0013: checks 
Matee92: checks 
*** RIVER *** [3s Kd 6d Ts] [7c]
mvp0013: bets $0.10
Matee92: folds 
Uncalled bet ($0.10) returned to mvp0013
mvp0013 collected $0.24 from pot
*** SUMMARY ***
Total pot $0.25 | Rake $0.01 
Board [3s Kd 6d Ts 7c]
Seat 1: bambolejro (small blind) folded before Flop
Seat 2: mvp0013 (big blind) collected ($0.24)
Seat 3: Yspenyanin folded before Flop (didn't bet)
Seat 4: Matee92 folded on the River
Seat 5: fishhook5 folded before Flop (didn't bet)
Seat 6: yodzik (button) folded before Flop (didn't bet)



PokerStars Hand #166667592575:  Hold'em No Limit ($0.05/$0.10 USD) - 2017/02/23 16:03:59 ET
Table 'Tirela' 6-max Seat #4 is the button
Seat 1: Smitty03300 ($10 in chips) 
Seat 2: Andrei ProFF ($17.79 in chips) 
Seat 3: aim444 ($16.92 in chips) 
Seat 4: ArcticBearDK ($10.01 in chips) 
Seat 5: KRZuff ($10 in chips) 
Seat 6: coolisses111 ($9.05 in chips) 
KRZuff: posts small blind $0.05
coolisses111: posts big blind $0.10
*** HOLE CARDS ***
Smitty03300: folds 
Andrei ProFF: folds 
aim444: calls $0.10
ArcticBearDK: folds 
KRZuff: raises $0.40 to $0.50
coolisses111: folds 
aim444: calls $0.40
*** FLOP *** [Th Qc Ac]
KRZuff: bets $0.65
aim444: calls $0.65
*** TURN *** [Th Qc Ac] [8c]
KRZuff: bets $1.40
aim444: folds 
Uncalled bet ($1.40) returned to KRZuff
KRZuff collected $2.29 from pot
*** SUMMARY ***
Total pot $2.40 | Rake $0.11 
Board [Th Qc Ac 8c]
Seat 1: Smitty03300 folded before Flop (didn't bet)
Seat 2: Andrei ProFF folded before Flop (didn't bet)
Seat 3: aim444 folded on the Turn
Seat 4: ArcticBearDK (button) folded before Flop (didn't bet)
Seat 5: KRZuff (small blind) collected ($2.29)
Seat 6: coolisses111 (big blind) folded before Flop



PokerStars Hand #166667593673:  Hold'em No Limit ($0.05/$0.10 USD) - 2017/02/23 16:04:00 ET
Table 'Postrema' 6-max Seat #4 is the button
Seat 1: CHRO8 ($13.27 in chips) 
Seat 2: pancernik21 ($12.76 in chips) 
Seat 3: edcc19 ($2.91 in chips) 
Seat 4: ChuikaPridi ($13.33 in chips) 
Seat 5: Comeback3392 ($12.10 in chips) 
Seat 6: Scanner17 ($10 in chips) 
Comeback3392: posts small blind $0.05
Scanner17: posts big blind $0.10
*** HOLE CARDS ***
CHRO8 has timed out
CHRO8: folds 
pancernik21: folds 
edcc19: calls $0.10
ChuikaPridi: raises $0.40 to $0.50
Comeback3392: folds 
Scanner17: calls $0.40
edcc19: folds 
*** FLOP *** [Kc 9d Ks]
Scanner17: checks 
ChuikaPridi: bets $0.50
Scanner17: folds 
Uncalled bet ($0.50) returned to ChuikaPridi
ChuikaPridi collected $1.10 from pot
*** SUMMARY ***
Total pot $1.15 | Rake $0.05 
Board [Kc 9d Ks]
Seat 1: CHRO8 folded before Flop (didn't bet)
Seat 2: pancernik21 folded before Flop (didn't bet)
Seat 3: edcc19 folded before Flop
Seat 4: ChuikaPridi (button) collected ($1.10)
Seat 5: Comeback3392 (small blind) folded before Flop
Seat 6: Scanner17 (big blind) folded on the Flop



PokerStars Hand #166667594032:  Hold'em No Limit ($0.05/$0.10 USD) - 2017/02/23 16:04:00 ET
Table 'Lesath III' 6-max Seat #1 is the button
Seat 1: Gogeta26 ($6.42 in chips) 
Seat 2: WinninBikini ($10.08 in chips) 
Seat 3: Giyorod ($10.15 in chips) 
Seat 4: Eddys Edge ($10 in chips) 
Seat 5: eniksenik ($16.15 in chips) 
Seat 6: patrick19111 ($10.56 in chips) 
WinninBikini: posts small blind $0.05
Giyorod: posts big blind $0.10
*** HOLE CARDS ***
Eddys Edge: folds 
eniksenik: folds 
patrick19111: folds 
Gogeta26: calls $0.10
WinninBikini: folds 
Giyorod: checks 
*** FLOP *** [3s 7s 4h]
Giyorod: bets $0.20
Gogeta26: calls $0.20
*** TURN *** [3s 7s 4h] [Qs]
Giyorod: bets $0.40
Gogeta26: folds 
Uncalled bet ($0.40) returned to Giyorod
Giyorod collected $0.62 from pot
*** SUMMARY ***
Total pot $0.65 | Rake $0.03 
Board [3s 7s 4h Qs]
Seat 1: Gogeta26 (button) folded on the Turn
Seat 2: WinninBikini (small blind) folded before Flop
Seat 3: Giyorod (big blind) collected ($0.62)
Seat 4: Eddys Edge folded before Flop (didn't bet)
Seat 5: eniksenik folded before Flop (didn't bet)
Seat 6: patrick19111 folded before Flop (didn't bet)



PokerStars Hand #166667594280:  Hold'em No Limit ($0.05/$0.10 USD) - 2017/02/23 16:04:00 ET
Table 'Bootes' 6-max Seat #2 is the button
Seat 1: Namhkal ($12.95 in chips) 
Seat 2: Bird et al ($19.30 in chips) 
Seat 3: KA3AXCTAHEU, ($19.53 in chips) 
Seat 4: totonove ($4.71 in chips) 
Seat 5: Pekaml ($15.42 in chips) 
KA3AXCTAHEU,: posts small blind $0.05
totonove: posts big blind $0.10
cherep61987: sits out 
*** HOLE CARDS ***
Pekaml has timed out while being disconnected
Pekaml: folds 
Pekaml is disconnected 
Namhkal: raises $0.15 to $0.25
Bird et al: folds 
KA3AXCTAHEU,: folds 
totonove: calls $0.15
*** FLOP *** [8d 7s Tc]
totonove: checks 
Namhkal: checks 
*** TURN *** [8d 7s Tc] [Ks]
totonove: bets $0.20
Namhkal: calls $0.20
*** RIVER *** [8d 7s Tc Ks] [2c]
totonove: bets $0.30
Namhkal: folds 
Uncalled bet ($0.30) returned to totonove
totonove collected $0.91 from pot
*** SUMMARY ***
Total pot $0.95 | Rake $0.04 
Board [8d 7s Tc Ks 2c]
Seat 1: Namhkal folded on the River
Seat 2: Bird et al (button) folded before Flop (didn't bet)
Seat 3: KA3AXCTAHEU, (small blind) folded before Flop
Seat 4: totonove (big blind) collected ($0.91)
Seat 5: Pekaml folded before Flop (didn't bet)



PokerStars Hand #166667594415:  Hold'em No Limit ($0.05/$0.10 USD) - 2017/02/23 16:04:01 ET
Table 'Virginia II' 6-max Seat #1 is the button
Seat 1: Iarlei ($11.71 in chips) 
Seat 2: Yspenyanin ($10.05 in chips) 
Seat 3: garigura ($14.56 in chips) 
Seat 4: onkelottoHH ($11.03 in chips) 
Seat 5: dr.goofy ($20.68 in chips) 
Yspenyanin: posts small blind $0.05
garigura: posts big blind $0.10
NvR.m1nD: sits out 
*** HOLE CARDS ***
onkelottoHH: folds 
dr.goofy: folds 
Iarlei: folds 
Yspenyanin: folds 
Uncalled bet ($0.05) returned to garigura
garigura collected $0.10 from pot
*** SUMMARY ***
Total pot $0.10 | Rake $0 
Seat 1: Iarlei (button) folded before Flop (didn't bet)
Seat 2: Yspenyanin (small blind) folded before Flop
Seat 3: garigura (big blind) collected ($0.10)
Seat 4: onkelottoHH folded before Flop (didn't bet)
Seat 5: dr.goofy folded before Flop (didn't bet)



PokerStars Hand #166667594447:  Hold'em No Limit ($0.05/$0.10 USD) - 2017/02/23 16:04:01 ET
Table 'Marbachia II' 6-max Seat #4 is the button
Seat 1: AC Evergreen ($10 in chips) 
Seat 2: Yabidooo ($10.93 in chips) 
Seat 4: BahiaMinhaP ($10 in chips) 
Seat 5: MihaGr ($10.05 in chips) 
Seat 6: DamDatsAnAce ($10 in chips) 
MihaGr: posts small blind $0.05
DamDatsAnAce: posts big blind $0.10
MisterX413: sits out 
*** HOLE CARDS ***
AC Evergreen: raises $0.16 to $0.26
Yabidooo: folds 
BahiaMinhaP: folds 
MihaGr: folds 
DamDatsAnAce: folds 
Uncalled bet ($0.16) returned to AC Evergreen
AC Evergreen collected $0.25 from pot
*** SUMMARY ***
Total pot $0.25 | Rake $0 
Seat 1: AC Evergreen collected ($0.25)
Seat 2: Yabidooo folded before Flop (didn't bet)
Seat 4: BahiaMinhaP (button) folded before Flop (didn't bet)
Seat 5: MihaGr (small blind) folded before Flop
Seat 6: DamDatsAnAce (big blind) folded before Flop



PokerStars Hand #166667594539:  Hold'em No Limit ($0.05/$0.10 USD) - 2017/02/23 16:04:01 ET
Table 'California II' 6-max Seat #2 is the button
Seat 1: fedorka rus ($10.23 in chips) 
Seat 2: homelessdan ($10.15 in chips) 
Seat 3: Bird et al ($10.25 in chips) 
Seat 4: pokekrk ($12.11 in chips) 
Seat 5: bambolejro ($16.43 in chips) 
Seat 6: chiko4040 ($7.27 in chips) 
Bird et al: posts small blind $0.05
pokekrk: posts big blind $0.10
*** HOLE CARDS ***
bambolejro: folds 
bambolejro leaves the table
chiko4040: raises $0.20 to $0.30
Namhkal joins the table at seat #5 
Namhkal leaves the table
fedorka rus: calls $0.30
homelessdan: folds 
Bird et al: folds 
pokekrk: folds 
*** FLOP *** [Qc Ah 8d]
chiko4040: bets $0.30
fedorka rus: folds 
Uncalled bet ($0.30) returned to chiko4040
chiko4040 collected $0.72 from pot
*** SUMMARY ***
Total pot $0.75 | Rake $0.03 
Board [Qc Ah 8d]
Seat 1: fedorka rus folded on the Flop
Seat 2: homelessdan (button) folded before Flop (didn't bet)
Seat 3: Bird et al (small blind) folded before Flop
Seat 4: pokekrk (big blind) folded before Flop
Seat 5: bambolejro folded before Flop (didn't bet)
Seat 6: chiko4040 collected ($0.72)



PokerStars Hand #166667594542:  Hold'em No Limit ($0.05/$0.10 USD) - 2017/02/23 16:04:01 ET
Table 'Vesta II' 6-max Seat #1 is the button
Seat 1: Yabidooo ($13.16 in chips) 
Seat 2: Dimka4 ($10 in chips) 
Seat 3: Pokeaster ($12.23 in chips) 
Seat 4: Dcaro31 ($10.42 in chips) 
Seat 5: Andy Wolf ($12.30 in chips) 
Dimka4: posts small blind $0.05
Pokeaster: posts big blind $0.10
XaXaTyH4uK: sits out 
*** HOLE CARDS ***
Dcaro31: folds 
Andy Wolf: folds 
Yabidooo: folds 
Dimka4: raises $0.15 to $0.25
Pokeaster: calls $0.15
*** FLOP *** [6h 8c 6s]
Dimka4: bets $0.24
Pokeaster: raises $0.66 to $0.90
Dimka4: folds 
Uncalled bet ($0.66) returned to Pokeaster
Pokeaster collected $0.94 from pot
*** SUMMARY ***
Total pot $0.98 | Rake $0.04 
Board [6h 8c 6s]
Seat 1: Yabidooo (button) folded before Flop (didn't bet)
Seat 2: Dimka4 (small blind) folded on the Flop
Seat 3: Pokeaster (big blind) collected ($0.94)
Seat 4: Dcaro31 folded before Flop (didn't bet)
Seat 5: Andy Wolf folded before Flop (didn't bet)



PokerStars Hand #166667594583:  Hold'em No Limit ($0.05/$0.10 USD) - 2017/02/23 16:04:01 ET
Table 'Hercynia III' 6-max Seat #1 is the button
Seat 1: Bird et al ($14.58 in chips) 
Seat 2: Action_Gibi ($7.95 in chips) 
Seat 3: Dcaro31 ($20.54 in chips) 
Seat 4: Darkfrai ($17.37 in chips) 
Seat 5: THIMUCHIN ($14.79 in chips) 
Seat 6: bdixon_5 ($11.04 in chips) 
Action_Gibi: posts small blind $0.05
Dcaro31: posts big blind $0.10
*** HOLE CARDS ***
Darkfrai: folds 
THIMUCHIN: raises $0.20 to $0.30
bdixon_5: folds 
Bird et al: folds 
Action_Gibi: calls $0.25
Dcaro31: folds 
*** FLOP *** [3c 3s 4d]
Action_Gibi: checks 
THIMUCHIN: checks 
*** TURN *** [3c 3s 4d] [4s]
Action_Gibi: bets $0.67
THIMUCHIN: folds 
Uncalled bet ($0.67) returned to Action_Gibi
Action_Gibi collected $0.67 from pot
*** SUMMARY ***
Total pot $0.70 | Rake $0.03 
Board [3c 3s 4d 4s]
Seat 1: Bird et al (button) folded before Flop (didn't bet)
Seat 2: Action_Gibi (small blind) collected ($0.67)
Seat 3: Dcaro31 (big blind) folded before Flop
Seat 4: Darkfrai folded before Flop (didn't bet)
Seat 5: THIMUCHIN folded on the Turn
Seat 6: bdixon_5 folded before Flop (didn't bet)



PokerStars Hand #166667595041:  Hold'em No Limit ($0.05/$0.10 USD) - 2017/02/23 16:04:01 ET
Table 'Hunnia' 6-max Seat #3 is the button
Seat 1: univibe68 ($22.65 in chips) 
Seat 2: mhonielsen ($10 in chips) 
Seat 3: 6ePeMeHHa9 ($10 in chips) 
Seat 4: Jalida3 ($10.60 in chips) 
Seat 5: Smarkon ($14.93 in chips) 
Seat 6: ChuikaPridi ($9.07 in chips) 
Jalida3: posts small blind $0.05
Smarkon: posts big blind $0.10
*** HOLE CARDS ***
ChuikaPridi: folds 
univibe68: raises $0.20 to $0.30
mhonielsen: folds 
6ePeMeHHa9: calls $0.30
Jalida3: folds 
Smarkon: folds 
*** FLOP *** [8c 6s 2c]
univibe68: bets $0.32
6ePeMeHHa9: raises $0.88 to $1.20
univibe68: folds 
Uncalled bet ($0.88) returned to 6ePeMeHHa9
6ePeMeHHa9 collected $1.33 from pot
*** SUMMARY ***
Total pot $1.39 | Rake $0.06 
Board [8c 6s 2c]
Seat 1: univibe68 folded on the Flop
Seat 2: mhonielsen folded before Flop (didn't bet)
Seat 3: 6ePeMeHHa9 (button) collected ($1.33)
Seat 4: Jalida3 (small blind) folded before Flop
Seat 5: Smarkon (big blind) folded before Flop
Seat 6: ChuikaPridi folded before Flop (didn't bet)



PokerStars Hand #166667595302:  Hold'em No Limit ($0.05/$0.10 USD) - 2017/02/23 16:04:02 ET
Table 'Kobresia II' 6-max Seat #5 is the button
Seat 1: RoJ1 ($13.96 in chips) 
Seat 2: Dcaro31 ($13.44 in chips) 
Seat 3: FRAID358 ($10.84 in chips) 
Seat 4: armstv ($10.87 in chips) 
Seat 5: Goroshkos88 ($12.04 in chips) 
Seat 6: WinninBikini ($10 in chips) 
WinninBikini: posts small blind $0.05
RoJ1: posts big blind $0.10
*** HOLE CARDS ***
Dcaro31: folds 
FRAID358: folds 
armstv: folds 
Goroshkos88: raises $0.15 to $0.25
WinninBikini: folds 
RoJ1: calls $0.15
*** FLOP *** [9d 8c 9s]
RoJ1: checks 
Goroshkos88: checks 
*** TURN *** [9d 8c 9s] [Jd]
RoJ1: checks 
Goroshkos88: bets $0.27
RoJ1: folds 
Uncalled bet ($0.27) returned to Goroshkos88
Goroshkos88 collected $0.53 from pot
*** SUMMARY ***
Total pot $0.55 | Rake $0.02 
Board [9d 8c 9s Jd]
Seat 1: RoJ1 (big blind) folded on the Turn
Seat 2: Dcaro31 folded before Flop (didn't bet)
Seat 3: FRAID358 folded before Flop (didn't bet)
Seat 4: armstv folded before Flop (didn't bet)
Seat 5: Goroshkos88 (button) collected ($0.53)
Seat 6: WinninBikini (small blind) folded before Flop



PokerStars Hand #166667595339:  Hold'em No Limit ($0.05/$0.10 USD) - 2017/02/23 16:04:02 ET
Table 'Persephone' 6-max Seat #6 is the button
Seat 2: AM-L-SL ($4.85 in chips) 
Seat 6: popypaleta ($14.69 in chips) 
2G28 will be allowed to play after the button
ab260414 will be allowed to play after the button
popypaleta: posts small blind $0.05
FRAID358: is sitting out 
AM-L-SL: posts big blind $0.10
*** HOLE CARDS ***
FRAID358 leaves the table
JahSoldier69 joins the table at seat #3 
popypaleta: raises $0.20 to $0.30
AM-L-SL: calls $0.20
*** FLOP *** [6h Ah 9h]
JahSoldier69 leaves the table
AM-L-SL: checks 
popypaleta: bets $0.30
AM-L-SL: calls $0.30
*** TURN *** [6h Ah 9h] [Td]
dragonste89 joins the table at seat #1 
AM-L-SL: checks 
popypaleta: checks 
*** RIVER *** [6h Ah 9h Td] [8h]
DasoII joins the table at seat #3 
AM-L-SL: bets $1.10
popypaleta: folds 
Uncalled bet ($1.10) returned to AM-L-SL
AM-L-SL collected $1.15 from pot
*** SUMMARY ***
Total pot $1.20 | Rake $0.05 
Board [6h Ah 9h Td 8h]
Seat 2: AM-L-SL (big blind) collected ($1.15)
Seat 6: popypaleta (button) (small blind) folded on the River



PokerStars Hand #166667595347:  Hold'em No Limit ($0.05/$0.10 USD) - 2017/02/23 16:04:02 ET
Table 'Iduberga II' 6-max Seat #4 is the button
Seat 1: mhonielsen ($10.76 in chips) 
Seat 2: popypaleta ($12.12 in chips) 
Seat 3: scorpionfish ($11.58 in chips) 
Seat 4: Peter0087 ($9.88 in chips) 
Seat 5: Pokeaster ($10.52 in chips) 
Seat 6: tblocos ($13.11 in chips) 
Pokeaster: posts small blind $0.05
tblocos: posts big blind $0.10
*** HOLE CARDS ***
mhonielsen: folds 
popypaleta: raises $0.20 to $0.30
scorpionfish: folds 
Peter0087: folds 
Pokeaster: folds 
tblocos: calls $0.20
*** FLOP *** [6h 6c Qh]
tblocos: checks 
popypaleta: bets $0.40
tblocos: calls $0.40
*** TURN *** [6h 6c Qh] [9s]
tblocos: checks 
popypaleta: bets $0.70
tblocos: folds 
Uncalled bet ($0.70) returned to popypaleta
popypaleta collected $1.38 from pot
*** SUMMARY ***
Total pot $1.45 | Rake $0.07 
Board [6h 6c Qh 9s]
Seat 1: mhonielsen folded before Flop (didn't bet)
Seat 2: popypaleta collected ($1.38)
Seat 3: scorpionfish folded before Flop (didn't bet)
Seat 4: Peter0087 (button) folded before Flop (didn't bet)
Seat 5: Pokeaster (small blind) folded before Flop
Seat 6: tblocos (big blind) folded on the Turn



PokerStars Hand #166667595481:  Hold'em No Limit ($0.05/$0.10 USD) - 2017/02/23 16:04:02 ET
Table 'Nekkar' 6-max Seat #4 is the button
Seat 2: Bird et al ($11.17 in chips) 
Seat 3: Zemz_Ru ($16.15 in chips) 
Seat 4: kingartur222 ($12.10 in chips) 
Seat 5: Vrinni ($11.60 in chips) 
Seat 6: Eddys Edge ($10.73 in chips) 
Vrinni: posts small blind $0.05
Eddys Edge: posts big blind $0.10
*** HOLE CARDS ***
Bird et al: folds 
Zemz_Ru: raises $0.10 to $0.20
kingartur222: calls $0.20
Vrinni: folds 
Eddys Edge: calls $0.10
*** FLOP *** [Th 5d 2s]
Eddys Edge: checks 
Zemz_Ru: checks 
kingartur222: bets $0.30
Eddys Edge: folds 
Zemz_Ru: calls $0.30
*** TURN *** [Th 5d 2s] [3h]
Zemz_Ru: checks 
kingartur222: checks 
*** RIVER *** [Th 5d 2s 3h] [7h]
Zemz_Ru: bets $0.60
kingartur222: raises $2 to $2.60
Zemz_Ru: folds 
Uncalled bet ($2) returned to kingartur222
kingartur222 collected $2.34 from pot
*** SUMMARY ***
Total pot $2.45 | Rake $0.11 
Board [Th 5d 2s 3h 7h]
Seat 2: Bird et al folded before Flop (didn't bet)
Seat 3: Zemz_Ru folded on the River
Seat 4: kingartur222 (button) collected ($2.34)
Seat 5: Vrinni (small blind) folded before Flop
Seat 6: Eddys Edge (big blind) folded on the Flop



PokerStars Hand #166667595529:  Hold'em No Limit ($0.05/$0.10 USD) - 2017/02/23 16:04:02 ET
Table 'Thoas' 6-max Seat #1 is the button
Seat 1: Pekaml ($11.43 in chips) 
Seat 2: themacer24 ($8.57 in chips) 
Seat 3: iamkakaroto ($10 in chips) 
Seat 4: Morris_Chair ($17.81 in chips) 
Seat 5: Kow6oy ($10.17 in chips) 
Seat 6: takis nik ($10 in chips) 
themacer24: posts small blind $0.05
iamkakaroto: posts big blind $0.10
*** HOLE CARDS ***
Morris_Chair: folds 
Kow6oy: raises $0.25 to $0.35
takis nik: folds 
Pekaml is disconnected 
Pekaml has timed out while disconnected
Pekaml: folds 
themacer24: folds 
iamkakaroto: folds 
Uncalled bet ($0.25) returned to Kow6oy
Kow6oy collected $0.25 from pot
*** SUMMARY ***
Total pot $0.25 | Rake $0 
Seat 1: Pekaml (button) folded before Flop (didn't bet)
Seat 2: themacer24 (small blind) folded before Flop
Seat 3: iamkakaroto (big blind) folded before Flop
Seat 4: Morris_Chair folded before Flop (didn't bet)
Seat 5: Kow6oy collected ($0.25)
Seat 6: takis nik folded before Flop (didn't bet)



PokerStars Hand #166667595747:  Hold'em No Limit ($0.05/$0.10 USD) - 2017/02/23 16:04:02 ET
Table 'Aisakos II' 6-max Seat #2 is the button
Seat 1: Crafty23@PS ($10.15 in chips) 
Seat 2: svaika24 ($16.93 in chips) 
Seat 3: iamkakaroto ($10.59 in chips) 
Seat 4: T9MS ($10 in chips) 
Seat 5: KokoulinV ($12.40 in chips) 
Seat 6: LarryTheStar ($10 in chips) 
iamkakaroto: posts small blind $0.05
T9MS: posts big blind $0.10
*** HOLE CARDS ***
KokoulinV: folds 
LarryTheStar: raises $0.20 to $0.30
Crafty23@PS: folds 
svaika24: folds 
iamkakaroto: folds 
T9MS: folds 
Uncalled bet ($0.20) returned to LarryTheStar
LarryTheStar collected $0.25 from pot
*** SUMMARY ***
Total pot $0.25 | Rake $0 
Seat 1: Crafty23@PS folded before Flop (didn't bet)
Seat 2: svaika24 (button) folded before Flop (didn't bet)
Seat 3: iamkakaroto (small blind) folded before Flop
Seat 4: T9MS (big blind) folded before Flop
Seat 5: KokoulinV folded before Flop (didn't bet)
Seat 6: LarryTheStar collected ($0.25)



PokerStars Hand #166667595787:  Hold'em No Limit ($0.05/$0.10 USD) - 2017/02/23 16:04:02 ET
Table 'Veniakaverin' 6-max Seat #1 is the button
Seat 1: pivanki11 ($11.09 in chips) 
Seat 2: david_sara83 ($10 in chips) 
Seat 3: Hyd SK ($19.75 in chips) 
Seat 4: Ampped87 ($10 in chips) 
Seat 5: Innerwuss ($24.69 in chips) 
Seat 6: bdixon_5 ($9.35 in chips) 
david_sara83: posts small blind $0.05
Hyd SK: posts big blind $0.10
*** HOLE CARDS ***
Ampped87: folds 
Innerwuss: folds 
bdixon_5: folds 
pivanki11: folds 
david_sara83: folds 
Uncalled bet ($0.05) returned to Hyd SK
Hyd SK collected $0.10 from pot
*** SUMMARY ***
Total pot $0.10 | Rake $0 
Seat 1: pivanki11 (button) folded before Flop (didn't bet)
Seat 2: david_sara83 (small blind) folded before Flop
Seat 3: Hyd SK (big blind) collected ($0.10)
Seat 4: Ampped87 folded before Flop (didn't bet)
Seat 5: Innerwuss folded before Flop (didn't bet)
Seat 6: bdixon_5 folded before Flop (didn't bet)



PokerStars Hand #166667596007:  Hold'em No Limit ($0.05/$0.10 USD) - 2017/02/23 16:04:02 ET
Table 'Krethon' 6-max Seat #4 is the button
Seat 1: boxer821 ($10.25 in chips) 
Seat 2: manashov ($12.21 in chips) 
Seat 4: chimera252 ($15.53 in chips) 
Seat 5: popypaleta ($10 in chips) 
popypaleta: posts small blind $0.05
boxer821: posts big blind $0.10
D3NyA: sits out 
*** HOLE CARDS ***
manashov: folds 
chimera252: folds 
popypaleta: raises $0.20 to $0.30
boxer821: folds 
Uncalled bet ($0.20) returned to popypaleta
popypaleta collected $0.20 from pot
*** SUMMARY ***
Total pot $0.20 | Rake $0 
Seat 1: boxer821 (big blind) folded before Flop
Seat 2: manashov folded before Flop (didn't bet)
Seat 4: chimera252 (button) folded before Flop (didn't bet)
Seat 5: popypaleta (small blind) collected ($0.20)



PokerStars Hand #166667596046:  Hold'em No Limit ($0.05/$0.10 USD) - 2017/02/23 16:04:02 ET
Table 'Caprera III' 6-max Seat #2 is the button
Seat 1: Vrinni ($10.25 in chips) 
Seat 2: hg123454321 ($9.99 in chips) 
Seat 4: oddshoff ($8.90 in chips) 
Seat 5: fedorka rus ($49.63 in chips) 
Seat 6: GESPERIA ($18.38 in chips) 
oddshoff: posts small blind $0.05
fedorka rus: posts big blind $0.10
*** HOLE CARDS ***
GESPERIA: folds 
Vrinni: raises $0.20 to $0.30
hg123454321: calls $0.30
oddshoff: calls $0.25
fedorka rus: folds 
*** FLOP *** [8d 5s 6s]
oddshoff: checks 
Vrinni: bets $0.64
hg123454321: folds 
oddshoff: calls $0.64
*** TURN *** [8d 5s 6s] [7c]
oddshoff: checks 
Vrinni: bets $1.60
oddshoff: calls $1.60
*** RIVER *** [8d 5s 6s 7c] [4h]
oddshoff: checks 
Vrinni: bets $7.71 and is all-in
oddshoff: calls $6.36 and is all-in
Uncalled bet ($1.35) returned to Vrinni
*** SHOW DOWN ***
Vrinni: shows [9d 9h] (a straight, Five to Nine)
oddshoff: shows [Jc Jd] (a straight, Four to Eight)
Vrinni collected $17.38 from pot
*** SUMMARY ***
Total pot $18.20 | Rake $0.82 
Board [8d 5s 6s 7c 4h]
Seat 1: Vrinni showed [9d 9h] and won ($17.38) with a straight, Five to Nine
Seat 2: hg123454321 (button) folded on the Flop
Seat 4: oddshoff (small blind) showed [Jc Jd] and lost with a straight, Four to Eight
Seat 5: fedorka rus (big blind) folded before Flop
Seat 6: GESPERIA folded before Flop (didn't bet)



PokerStars Hand #166667596148:  Hold'em No Limit ($0.05/$0.10 USD) - 2017/02/23 16:04:02 ET
Table 'Rosalia' 6-max Seat #5 is the button
Seat 1: Hyd SK ($10 in chips) 
Seat 2: Bandyaev ($11.84 in chips) 
Seat 3: Andy Wolf ($12.18 in chips) 
Seat 4: THIMUCHIN ($10 in chips) 
Seat 5: miron762 ($17.10 in chips) 
Seat 6: facewald ($16.83 in chips) 
facewald: posts small blind $0.05
Hyd SK: posts big blind $0.10
*** HOLE CARDS ***
Bandyaev: folds 
Andy Wolf: folds 
THIMUCHIN: raises $0.10 to $0.20
miron762: calls $0.20
facewald: folds 
Hyd SK: raises $0.80 to $1
THIMUCHIN: folds 
miron762: calls $0.80
*** FLOP *** [Qd Ks As]
Hyd SK: checks 
miron762: checks 
*** TURN *** [Qd Ks As] [Jc]
Hyd SK: checks 
miron762: checks 
*** RIVER *** [Qd Ks As Jc] [2d]
Hyd SK: checks 
miron762: bets $0.10
Hyd SK: folds 
Uncalled bet ($0.10) returned to miron762
miron762 collected $2.15 from pot
*** SUMMARY ***
Total pot $2.25 | Rake $0.10 
Board [Qd Ks As Jc 2d]
Seat 1: Hyd SK (big blind) folded on the River
Seat 2: Bandyaev folded before Flop (didn't bet)
Seat 3: Andy Wolf folded before Flop (didn't bet)
Seat 4: THIMUCHIN folded before Flop
Seat 5: miron762 (button) collected ($2.15)
Seat 6: facewald (small blind) folded before Flop



PokerStars Hand #166667596285:  Hold'em No Limit ($0.05/$0.10 USD) - 2017/02/23 16:04:03 ET
Table 'Nehalennia III' 6-max Seat #6 is the button
Seat 1: boxer821 ($13.06 in chips) 
Seat 2: fortieth ($10.31 in chips) 
Seat 3: ValdemorS ($18.07 in chips) 
Seat 4: eniksenik ($10 in chips) 
Seat 5: wulffboy ($35.51 in chips) 
Seat 6: valzeny ($20.38 in chips) 
boxer821: posts small blind $0.05
fortieth: posts big blind $0.10
boxer821: posts the ante $0.02
fortieth: posts the ante $0.02
ValdemorS: posts the ante $0.02
eniksenik: posts the ante $0.02
wulffboy: posts the ante $0.02
valzeny: posts the ante $0.02
*** HOLE CARDS ***
ValdemorS: folds 
eniksenik: raises $0.20 to $0.30
wulffboy: calls $0.30
valzeny: folds 
boxer821: calls $0.25
fortieth: folds 
*** FLOP *** [8h As Ah]
boxer821: checks 
eniksenik: checks 
wulffboy: checks 
*** TURN *** [8h As Ah] [3d]
boxer821: bets $0.56
eniksenik: calls $0.56
wulffboy: calls $0.56
*** RIVER *** [8h As Ah 3d] [Ts]
boxer821: checks 
eniksenik: checks 
wulffboy: checks 
*** SHOW DOWN ***
boxer821: shows [9c 9s] (two pair, Aces and Nines)
eniksenik: mucks hand 
wulffboy: shows [Th Jh] (two pair, Aces and Tens)
wulffboy collected $2.67 from pot
*** SUMMARY ***
Total pot $2.80 | Rake $0.13 
Board [8h As Ah 3d Ts]
Seat 1: boxer821 (small blind) showed [9c 9s] and lost with two pair, Aces and Nines
Seat 2: fortieth (big blind) folded before Flop
Seat 3: ValdemorS folded before Flop (didn't bet)
Seat 4: eniksenik mucked
Seat 5: wulffboy showed [Th Jh] and won ($2.67) with two pair, Aces and Tens
Seat 6: valzeny (button) folded before Flop (didn't bet)



PokerStars Hand #166667596338:  Hold'em No Limit ($0.05/$0.10 USD) - 2017/02/23 16:04:03 ET
Table 'Lampetia III' 6-max Seat #2 is the button
Seat 1: gaHy_HaXeP ($10.55 in chips) 
Seat 2: DamDatsAnAce ($10 in chips) 
Seat 3: Therodorus ($10 in chips) 
Seat 4: IAntikI ($11.36 in chips) 
Seat 5: robson1235 ($19.55 in chips) 
Seat 6: bdixon_5 ($9.35 in chips) 
Therodorus: posts small blind $0.05
IAntikI: posts big blind $0.10
*** HOLE CARDS ***
robson1235: folds 
bdixon_5: folds 
gaHy_HaXeP: folds 
DamDatsAnAce: raises $0.15 to $0.25
Therodorus: folds 
IAntikI: raises $0.55 to $0.80
DamDatsAnAce: folds 
Uncalled bet ($0.55) returned to IAntikI
IAntikI collected $0.55 from pot
*** SUMMARY ***
Total pot $0.55 | Rake $0 
Seat 1: gaHy_HaXeP folded before Flop (didn't bet)
Seat 2: DamDatsAnAce (button) folded before Flop
Seat 3: Therodorus (small blind) folded before Flop
Seat 4: IAntikI (big blind) collected ($0.55)
Seat 5: robson1235 folded before Flop (didn't bet)
Seat 6: bdixon_5 folded before Flop (didn't bet)



PokerStars Hand #166667596398:  Hold'em No Limit ($0.05/$0.10 USD) - 2017/02/23 16:04:03 ET
Table 'Clavel' 6-max Seat #4 is the button
Seat 1: KRZuff ($14.51 in chips) 
Seat 4: Dcaro31 ($11.66 in chips) 
Seat 5: Vrinni ($10.44 in chips) 
Seat 6: Gra_anD77 ($4.54 in chips) 
Vrinni: posts small blind $0.05
Gra_anD77: posts big blind $0.10
Namhkal: sits out 
*** HOLE CARDS ***
KRZuff: folds 
Dcaro31: raises $0.20 to $0.30
Vrinni: folds 
Gra_anD77: calls $0.20
*** FLOP *** [Kd 5c 2s]
Gra_anD77: checks 
Dcaro31: bets $0.40
Gra_anD77: folds 
Uncalled bet ($0.40) returned to Dcaro31
Dcaro31 collected $0.62 from pot
*** SUMMARY ***
Total pot $0.65 | Rake $0.03 
Board [Kd 5c 2s]
Seat 1: KRZuff folded before Flop (didn't bet)
Seat 4: Dcaro31 (button) collected ($0.62)
Seat 5: Vrinni (small blind) folded before Flop
Seat 6: Gra_anD77 (big blind) folded on the Flop



PokerStars Hand #166667596475:  Hold'em No Limit ($0.05/$0.10 USD) - 2017/02/23 16:04:03 ET
Table 'Stroobantia II' 6-max Seat #1 is the button
Seat 1: XBrosh ($7.48 in chips) 
Seat 2: IAntikI ($10 in chips) 
Seat 3: 8th wonders ($11.03 in chips) 
Seat 4: Xander188 ($10.37 in chips) 
Seat 5: Zooplack ($12.48 in chips) 
Seat 6: CHRO8 ($12.97 in chips) 
IAntikI: posts small blind $0.05
8th wonders: posts big blind $0.10
*** HOLE CARDS ***
Xander188: raises $0.20 to $0.30
Zooplack: folds 
CHRO8 has timed out
CHRO8: folds 
XBrosh: calls $0.30
IAntikI: folds 
8th wonders: calls $0.20
*** FLOP *** [Ac Qc Js]
8th wonders: checks 
Xander188: checks 
XBrosh: bets $0.90
8th wonders: folds 
Xander188: folds 
Uncalled bet ($0.90) returned to XBrosh
XBrosh collected $0.91 from pot
*** SUMMARY ***
Total pot $0.95 | Rake $0.04 
Board [Ac Qc Js]
Seat 1: XBrosh (button) collected ($0.91)
Seat 2: IAntikI (small blind) folded before Flop
Seat 3: 8th wonders (big blind) folded on the Flop
Seat 4: Xander188 folded on the Flop
Seat 5: Zooplack folded before Flop (didn't bet)
Seat 6: CHRO8 folded before Flop (didn't bet)



PokerStars Hand #166667596549:  Hold'em No Limit ($0.05/$0.10 USD) - 2017/02/23 16:04:03 ET
Table 'Cyane' 6-max Seat #3 is the button
Seat 1: KA3AXCTAHEU, ($10.32 in chips) 
Seat 2: sashi18 ($8 in chips) 
Seat 3: Mamm0nism ($13.79 in chips) 
Seat 4: truck1234 ($20.86 in chips) 
Seat 6: 8th wonders ($10.55 in chips) 
truck1234: posts small blind $0.05
ChuikaPridi: is sitting out 
8th wonders: posts big blind $0.10
sashi18: posts big blind $0.10
*** HOLE CARDS ***
KA3AXCTAHEU,: raises $0.25 to $0.35
ChuikaPridi leaves the table
sashi18: calls $0.25
RoJ1 joins the table at seat #5 
Mamm0nism: calls $0.35
truck1234: folds 
8th wonders: raises $1.25 to $1.60
KA3AXCTAHEU,: folds 
sashi18: folds 
Mamm0nism: folds 
Uncalled bet ($1.25) returned to 8th wonders
8th wonders collected $1.45 from pot
*** SUMMARY ***
Total pot $1.45 | Rake $0 
Seat 1: KA3AXCTAHEU, folded before Flop
Seat 2: sashi18 folded before Flop
Seat 3: Mamm0nism (button) folded before Flop
Seat 4: truck1234 (small blind) folded before Flop
Seat 6: 8th wonders (big blind) collected ($1.45)



PokerStars Hand #166667596702:  Hold'em No Limit ($0.05/$0.10 USD) - 2017/02/23 16:04:03 ET
Table 'Eurydome II' 6-max Seat #4 is the button
Seat 2: Elinaattor ($10.34 in chips) 
Seat 3: gaHy_HaXeP ($10 in chips) 
Seat 4: Smitty03300 ($10.32 in chips) 
Seat 5: kush-killa87 ($13.89 in chips) 
Seat 6: Jucatorul823 ($6.20 in chips) 
kush-killa87: posts small blind $0.05
Jucatorul823: posts big blind $0.10
rusu_rapid: sits out 
*** HOLE CARDS ***
Elinaattor: folds 
gaHy_HaXeP: folds 
Smitty03300: folds 
kush-killa87: calls $0.05
Jucatorul823: checks 
*** FLOP *** [Jh 4h 9h]
kush-killa87: bets $0.10
Jucatorul823: calls $0.10
*** TURN *** [Jh 4h 9h] [7s]
kush-killa87: bets $0.10
Jucatorul823: raises $0.30 to $0.40
kush-killa87: calls $0.30
*** RIVER *** [Jh 4h 9h 7s] [Tc]
kush-killa87: checks 
Jucatorul823: bets $0.70
kush-killa87: folds 
Uncalled bet ($0.70) returned to Jucatorul823
Jucatorul823 collected $1.15 from pot
*** SUMMARY ***
Total pot $1.20 | Rake $0.05 
Board [Jh 4h 9h 7s Tc]
Seat 2: Elinaattor folded before Flop (didn't bet)
Seat 3: gaHy_HaXeP folded before Flop (didn't bet)
Seat 4: Smitty03300 (button) folded before Flop (didn't bet)
Seat 5: kush-killa87 (small blind) folded on the River
Seat 6: Jucatorul823 (big blind) collected ($1.15)



PokerStars Hand #166667596937:  Hold'em No Limit ($0.05/$0.10 USD) - 2017/02/23 16:04:03 ET
Table 'Sirius II' 6-max Seat #6 is the button
Seat 1: Ampped87 ($14.21 in chips) 
Seat 2: Buddy8711 ($8 in chips) 
Seat 3: Spud014 ($10.40 in chips) 
Seat 5: pokekrk ($11.04 in chips) 
Seat 6: MihaGr ($10 in chips) 
Ampped87: posts small blind $0.05
Buddy8711: posts big blind $0.10
*** HOLE CARDS ***
Spud014: folds 
pokekrk: folds 
MihaGr: folds 
Ampped87: raises $0.20 to $0.30
Buddy8711: folds 
Uncalled bet ($0.20) returned to Ampped87
Ampped87 collected $0.20 from pot
*** SUMMARY ***
Total pot $0.20 | Rake $0 
Seat 1: Ampped87 (small blind) collected ($0.20)
Seat 2: Buddy8711 (big blind) folded before Flop
Seat 3: Spud014 folded before Flop (didn't bet)
Seat 5: pokekrk folded before Flop (didn't bet)
Seat 6: MihaGr (button) folded before Flop (didn't bet)



PokerStars Hand #166667597012:  Hold'em No Limit ($0.05/$0.10 USD) - 2017/02/23 16:04:03 ET
Table 'Nemo III' 6-max Seat #5 is the button
Seat 2: Bandyaev ($11.64 in chips) 
Seat 4: vtalian ($9.55 in chips) 
Seat 5: Joker51_wtf! ($11.58 in chips) 
Bandyaev: posts small blind $0.05
Therodorus: is sitting out 
vtalian: posts big blind $0.10
*** HOLE CARDS ***
Therodorus leaves the table
Kow6oy joins the table at seat #1 
Joker51_wtf!: folds 
Bandyaev: folds 
Uncalled bet ($0.05) returned to vtalian
vtalian collected $0.10 from pot
*** SUMMARY ***
Total pot $0.10 | Rake $0 
Seat 2: Bandyaev (small blind) folded before Flop
Seat 4: vtalian (big blind) collected ($0.10)
Seat 5: Joker51_wtf! (button) folded before Flop (didn't bet)



PokerStars Hand #166667597074:  Hold'em No Limit ($0.05/$0.10 USD) - 2017/02/23 16:04:03 ET
Table 'Rotraut' 6-max Seat #5 is the button
Seat 2: Newqbrown ($11.59 in chips) 
Seat 3: FlackoD ($11.67 in chips) 
Seat 5: Bird et al ($11.60 in chips) 
Seat 6: KokoulinV ($12.89 in chips) 
KokoulinV: posts small blind $0.05
Newqbrown: posts big blind $0.10
*** HOLE CARDS ***
FlackoD: folds 
Bird et al: raises $0.15 to $0.25
KokoulinV: folds 
Newqbrown: folds 
Uncalled bet ($0.15) returned to Bird et al
Bird et al collected $0.25 from pot
*** SUMMARY ***
Total pot $0.25 | Rake $0 
Seat 2: Newqbrown (big blind) folded before Flop
Seat 3: FlackoD folded before Flop (didn't bet)
Seat 5: Bird et al (button) collected ($0.25)
Seat 6: KokoulinV (small blind) folded before Flop



PokerStars Hand #166667597543:  Hold'em No Limit ($0.05/$0.10 USD) - 2017/02/23 16:04:04 ET
Table 'Landi II' 6-max Seat #2 is the button
Seat 1: dersiemer ($12.11 in chips) 
Seat 2: Aescul@pius ($10.95 in chips) 
Seat 3: dr.goofy ($21.49 in chips) 
Seat 4: alesi13 ($6.20 in chips) 
Seat 5: Bird et al ($10 in chips) 
dr.goofy: posts small blind $0.05
alesi13: posts big blind $0.10
*** HOLE CARDS ***
Bird et al: folds 
dersiemer: calls $0.10
Aescul@pius: folds 
dr.goofy: folds 
alesi13: checks 
*** FLOP *** [9s 2s 9d]
alesi13: checks 
dersiemer: checks 
*** TURN *** [9s 2s 9d] [Ad]
alesi13: bets $0.12
dersiemer: calls $0.12
*** RIVER *** [9s 2s 9d Ad] [4d]
alesi13: checks 
dersiemer: checks 
*** SHOW DOWN ***
alesi13: shows [5h 4s] (two pair, Nines and Fours)
dersiemer: mucks hand 
alesi13 collected $0.47 from pot
*** SUMMARY ***
Total pot $0.49 | Rake $0.02 
Board [9s 2s 9d Ad 4d]
Seat 1: dersiemer mucked
Seat 2: Aescul@pius (button) folded before Flop (didn't bet)
Seat 3: dr.goofy (small blind) folded before Flop
Seat 4: alesi13 (big blind) showed [5h 4s] and won ($0.47) with two pair, Nines and Fours
Seat 5: Bird et al folded before Flop (didn't bet)



PokerStars Hand #166667597617:  Hold'em No Limit ($0.05/$0.10 USD) - 2017/02/23 16:04:04 ET
Table 'Themisto II' 6-max Seat #3 is the button
Seat 1: kickereens ($11.61 in chips) 
Seat 2: CA225 ($10.55 in chips) 
Seat 3: eniksenik ($11.06 in chips) 
Seat 4: Innerwuss ($10.79 in chips) 
Seat 5: ex3Lero86 ($10.94 in chips) 
Seat 6: noobigrok ($4.35 in chips) 
Innerwuss: posts small blind $0.05
ex3Lero86: posts big blind $0.10
*** HOLE CARDS ***
noobigrok: raises $0.10 to $0.20
kickereens: folds 
CA225: folds 
eniksenik: folds 
Innerwuss: folds 
ex3Lero86: calls $0.10
*** FLOP *** [Jh 9d 8c]
ex3Lero86: checks 
noobigrok: checks 
*** TURN *** [Jh 9d 8c] [8d]
ex3Lero86: checks 
noobigrok: checks 
*** RIVER *** [Jh 9d 8c 8d] [3s]
ex3Lero86: checks 
noobigrok: checks 
*** SHOW DOWN ***
ex3Lero86: shows [6c 6s] (two pair, Eights and Sixes)
noobigrok: mucks hand 
ex3Lero86 collected $0.43 from pot
*** SUMMARY ***
Total pot $0.45 | Rake $0.02 
Board [Jh 9d 8c 8d 3s]
Seat 1: kickereens folded before Flop (didn't bet)
Seat 2: CA225 folded before Flop (didn't bet)
Seat 3: eniksenik (button) folded before Flop (didn't bet)
Seat 4: Innerwuss (small blind) folded before Flop
Seat 5: ex3Lero86 (big blind) showed [6c 6s] and won ($0.43) with two pair, Eights and Sixes
Seat 6: noobigrok mucked



PokerStars Hand #166667597781:  Hold'em No Limit ($0.05/$0.10 USD) - 2017/02/23 16:04:04 ET
Table 'Aconcagua' 6-max Seat #3 is the button
Seat 3: burtila1989 ($10.81 in chips) 
Seat 4: pivanki11 ($9.30 in chips) 
Seat 5: frazaunch ($6.56 in chips) 
Seat 6: coolisses111 ($8.78 in chips) 
pivanki11: posts small blind $0.05
frazaunch: posts big blind $0.10
burtila1989: posts the ante $0.02
pivanki11: posts the ante $0.02
frazaunch: posts the ante $0.02
coolisses111: posts the ante $0.02
*** HOLE CARDS ***
coolisses111: folds 
burtila1989: folds 
MLPlayer16 joins the table at seat #1 
pivanki11: folds 
Uncalled bet ($0.05) returned to frazaunch
frazaunch collected $0.18 from pot
*** SUMMARY ***
Total pot $0.18 | Rake $0 
Seat 3: burtila1989 (button) folded before Flop (didn't bet)
Seat 4: pivanki11 (small blind) folded before Flop
Seat 5: frazaunch (big blind) collected ($0.18)
Seat 6: coolisses111 folded before Flop (didn't bet)



PokerStars Hand #166667598139:  Hold'em No Limit ($0.05/$0.10 USD) - 2017/02/23 16:04:05 ET
Table 'Tyndareus III' 6-max Seat #6 is the button
Seat 1: MBen10 ($10.05 in chips) 
Seat 2: MihaGr ($10 in chips) 
Seat 6: Elinaattor ($10.30 in chips) 
XaXaTyH4uK joins the table at seat #3 
MBen10: posts small blind $0.05
MihaGr: posts big blind $0.10
yodzik: sits out 
*** HOLE CARDS ***
Elinaattor: folds 
MBen10: folds 
Uncalled bet ($0.05) returned to MihaGr
MihaGr collected $0.10 from pot
*** SUMMARY ***
Total pot $0.10 | Rake $0 
Seat 1: MBen10 (small blind) folded before Flop
Seat 2: MihaGr (big blind) collected ($0.10)
Seat 6: Elinaattor (button) folded before Flop (didn't bet)



PokerStars Hand #166667598149:  Hold'em No Limit ($0.05/$0.10 USD) - 2017/02/23 16:04:05 ET
Table 'Duhr II' 6-max Seat #2 is the button
Seat 1: Lucky HoBBiT ($10 in chips) 
Seat 2: Feverhead ($37.89 in chips) 
Seat 3: Innerwuss ($22.93 in chips) 
Seat 4: CHRO8 ($10 in chips) 
Seat 5: Punzzzer ($12.11 in chips) 
Seat 6: townerz1991 ($10 in chips) 
Innerwuss: posts small blind $0.05
CHRO8: posts big blind $0.10
*** HOLE CARDS ***
Punzzzer: folds 
townerz1991: folds 
Lucky HoBBiT: folds 
Feverhead: folds 
Innerwuss: raises $0.20 to $0.30
CHRO8: folds 
Uncalled bet ($0.20) returned to Innerwuss
Innerwuss collected $0.20 from pot
*** SUMMARY ***
Total pot $0.20 | Rake $0 
Seat 1: Lucky HoBBiT folded before Flop (didn't bet)
Seat 2: Feverhead (button) folded before Flop (didn't bet)
Seat 3: Innerwuss (small blind) collected ($0.20)
Seat 4: CHRO8 (big blind) folded before Flop
Seat 5: Punzzzer folded before Flop (didn't bet)
Seat 6: townerz1991 folded before Flop (didn't bet)



PokerStars Hand #166667598229:  Hold'em No Limit ($0.05/$0.10 USD) - 2017/02/23 16:04:05 ET
Table 'Sheragul III' 6-max Seat #1 is the button
Seat 1: danky24 ($18.79 in chips) 
Seat 2: Bird et al ($11.86 in chips) 
Seat 4: maxiv608 ($11.39 in chips) 
Seat 5: Bandyaev ($14.57 in chips) 
Seat 6: Andrei ProFF ($10 in chips) 
Bird et al: posts small blind $0.05
krepino82 was removed from the table for failing to post
maxiv608: posts big blind $0.10
*** HOLE CARDS ***
Bandyaev: raises $0.20 to $0.30
RoJ1 joins the table at seat #3 
RoJ1 leaves the table
Andrei ProFF: folds 
danky24: folds 
Bird et al: folds 
maxiv608: folds 
Uncalled bet ($0.20) returned to Bandyaev
Bandyaev collected $0.25 from pot
*** SUMMARY ***
Total pot $0.25 | Rake $0 
Seat 1: danky24 (button) folded before Flop (didn't bet)
Seat 2: Bird et al (small blind) folded before Flop
Seat 4: maxiv608 (big blind) folded before Flop
Seat 5: Bandyaev collected ($0.25)
Seat 6: Andrei ProFF folded before Flop (didn't bet)



PokerStars Hand #166667598460:  Hold'em No Limit ($0.05/$0.10 USD) - 2017/02/23 16:04:05 ET
Table 'Hirons' 6-max Seat #4 is the button
Seat 1: RoJ1 ($11.68 in chips) 
Seat 2: coolisses111 ($7.79 in chips) 
Seat 3: czeczen7 ($13.58 in chips) 
Seat 4: Smitty03300 ($10 in chips) 
Seat 6: garigura ($14.98 in chips) 
Pekaml is disconnected 
Pekaml has timed out while disconnected
Pekaml: is sitting out 
garigura: posts small blind $0.05
RoJ1: posts big blind $0.10
*** HOLE CARDS ***
coolisses111: folds 
czeczen7: calls $0.10
Smitty03300: raises $0.35 to $0.45
garigura: calls $0.40
RoJ1: folds 
czeczen7: calls $0.35
*** FLOP *** [Ks 7h 7s]
garigura: checks 
czeczen7: bets $0.40
Smitty03300: folds 
garigura: folds 
Uncalled bet ($0.40) returned to czeczen7
czeczen7 collected $1.38 from pot
*** SUMMARY ***
Total pot $1.45 | Rake $0.07 
Board [Ks 7h 7s]
Seat 1: RoJ1 (big blind) folded before Flop
Seat 2: coolisses111 folded before Flop (didn't bet)
Seat 3: czeczen7 collected ($1.38)
Seat 4: Smitty03300 (button) folded on the Flop
Seat 6: garigura (small blind) folded on the Flop



PokerStars Hand #166667598555:  Hold'em No Limit ($0.05/$0.10 USD) - 2017/02/23 16:04:05 ET
Table 'Manto II' 6-max Seat #1 is the button
Seat 1: MihaGr ($10 in chips) 
Seat 2: voledy ($10 in chips) 
Seat 3: Komap511 ($10 in chips) 
Seat 4: dr.goofy ($10.42 in chips) 
Seat 5: ArcticBearDK ($32.69 in chips) 
Seat 6: pancernik21 ($16.20 in chips) 
voledy: posts small blind $0.05
Komap511: posts big blind $0.10
*** HOLE CARDS ***
dr.goofy: folds 
ArcticBearDK: folds 
pancernik21: folds 
MihaGr: folds 
voledy: folds 
Uncalled bet ($0.05) returned to Komap511
Komap511 collected $0.10 from pot
*** SUMMARY ***
Total pot $0.10 | Rake $0 
Seat 1: MihaGr (button) folded before Flop (didn't bet)
Seat 2: voledy (small blind) folded before Flop
Seat 3: Komap511 (big blind) collected ($0.10)
Seat 4: dr.goofy folded before Flop (didn't bet)
Seat 5: ArcticBearDK folded before Flop (didn't bet)
Seat 6: pancernik21 folded before Flop (didn't bet)



PokerStars Hand #166667598873:  Hold'em No Limit ($0.05/$0.10 USD) - 2017/02/23 16:04:05 ET
Table 'Epimetheus' 6-max Seat #6 is the button
Seat 1: 6ePeMeHHa9 ($10.34 in chips) 
Seat 2: patrick19111 ($15.66 in chips) 
Seat 3: dineldidi ($9.84 in chips) 
Seat 5: afca128 ($24.13 in chips) 
Seat 6: voledy ($10 in chips) 
6ePeMeHHa9: posts small blind $0.05
patrick19111: posts big blind $0.10
*** HOLE CARDS ***
dineldidi: folds 
afca128 has timed out
afca128: folds 
voledy: raises $0.15 to $0.25
6ePeMeHHa9: folds 
patrick19111: folds 
Uncalled bet ($0.15) returned to voledy
voledy collected $0.25 from pot
*** SUMMARY ***
Total pot $0.25 | Rake $0 
Seat 1: 6ePeMeHHa9 (small blind) folded before Flop
Seat 2: patrick19111 (big blind) folded before Flop
Seat 3: dineldidi folded before Flop (didn't bet)
Seat 5: afca128 folded before Flop (didn't bet)
Seat 6: voledy (button) collected ($0.25)



PokerStars Hand #166667599222:  Hold'em No Limit ($0.05/$0.10 USD) - 2017/02/23 16:04:06 ET
Table 'Wingolfia II' 6-max Seat #4 is the button
Seat 1: BahiaMinhaP ($10 in chips) 
Seat 2: NvR.m1nD ($10.60 in chips) 
Seat 3: truck1234 ($10 in chips) 
Seat 4: zlobslob ($18.42 in chips) 
Seat 5: tr41n3r12 ($11.48 in chips) 
Seat 6: EphemeralBen ($11.84 in chips) 
tr41n3r12: posts small blind $0.05
EphemeralBen: posts big blind $0.10
*** HOLE CARDS ***
BahiaMinhaP: raises $0.20 to $0.30
NvR.m1nD: folds 
truck1234: folds 
zlobslob: folds 
tr41n3r12: folds 
EphemeralBen: folds 
Uncalled bet ($0.20) returned to BahiaMinhaP
BahiaMinhaP collected $0.25 from pot
*** SUMMARY ***
Total pot $0.25 | Rake $0 
Seat 1: BahiaMinhaP collected ($0.25)
Seat 2: NvR.m1nD folded before Flop (didn't bet)
Seat 3: truck1234 folded before Flop (didn't bet)
Seat 4: zlobslob (button) folded before Flop (didn't bet)
Seat 5: tr41n3r12 (small blind) folded before Flop
Seat 6: EphemeralBen (big blind) folded before Flop



PokerStars Hand #166667599744:  Hold'em No Limit ($0.05/$0.10 USD) - 2017/02/23 16:04:06 ET
Table 'Lorbach' 6-max Seat #6 is the button
Seat 1: LarryTheStar ($14.58 in chips) 
Seat 3: ArcticBearDK ($11.05 in chips) 
Seat 4: McCleans ($10 in chips) 
Seat 5: Cluckh ($14.62 in chips) 
Seat 6: Worlz ($12.67 in chips) 
LarryTheStar: posts small blind $0.05
fabadam: is sitting out 
ArcticBearDK: posts big blind $0.10
*** HOLE CARDS ***
McCleans: folds 
Cluckh: folds 
Worlz: folds 
LarryTheStar: raises $0.20 to $0.30
ArcticBearDK: folds 
Uncalled bet ($0.20) returned to LarryTheStar
LarryTheStar collected $0.20 from pot
*** SUMMARY ***
Total pot $0.20 | Rake $0 
Seat 1: LarryTheStar (small blind) collected ($0.20)
Seat 3: ArcticBearDK (big blind) folded before Flop
Seat 4: McCleans folded before Flop (didn't bet)
Seat 5: Cluckh folded before Flop (didn't bet)
Seat 6: Worlz (button) folded before Flop (didn't bet)



PokerStars Hand #166667599782:  Hold'em No Limit ($0.05/$0.10 USD) - 2017/02/23 16:04:06 ET
Table 'Gelria' 6-max Seat #2 is the button
Seat 1: ab260414 ($10 in chips) 
Seat 2: fishhook5 ($10 in chips) 
Seat 3: Orlangoor ($11.83 in chips) 
Seat 5: apenvel ($7.95 in chips) 
Seat 6: Andrei ProFF ($10.42 in chips) 
Orlangoor: posts small blind $0.05
ocmarigo81 was removed from the table for failing to post
apenvel: posts big blind $0.10
*** HOLE CARDS ***
eniksenik joins the table at seat #4 
Andrei ProFF: folds 
ab260414: raises $0.15 to $0.25
fishhook5: folds 
Orlangoor: folds 
apenvel: folds 
Uncalled bet ($0.15) returned to ab260414
ab260414 collected $0.25 from pot
*** SUMMARY ***
Total pot $0.25 | Rake $0 
Seat 1: ab260414 collected ($0.25)
Seat 2: fishhook5 (button) folded before Flop (didn't bet)
Seat 3: Orlangoor (small blind) folded before Flop
Seat 5: apenvel (big blind) folded before Flop
Seat 6: Andrei ProFF folded before Flop (didn't bet)



PokerStars Hand #166667599867:  Hold'em No Limit ($0.05/$0.10 USD) - 2017/02/23 16:04:06 ET
Table 'Samitchell III' 6-max Seat #6 is the button
Seat 1: dr.goofy ($10.17 in chips) 
Seat 2: scorpionfish ($10 in chips) 
Seat 3: Kow6oy ($10.15 in chips) 
Seat 6: fedorka rus ($12.96 in chips) 
dr.goofy: posts small blind $0.05
scorpionfish: posts big blind $0.10
steepfell: sits out 
*** HOLE CARDS ***
Kow6oy: folds 
Kow6oy leaves the table
fedorka rus: folds 
dr.goofy: raises $0.20 to $0.30
scorpionfish: folds 
Uncalled bet ($0.20) returned to dr.goofy
dr.goofy collected $0.20 from pot
*** SUMMARY ***
Total pot $0.20 | Rake $0 
Seat 1: dr.goofy (small blind) collected ($0.20)
Seat 2: scorpionfish (big blind) folded before Flop
Seat 3: Kow6oy folded before Flop (didn't bet)
Seat 6: fedorka rus (button) folded before Flop (didn't bet)



PokerStars Hand #166667600121:  Hold'em No Limit ($0.05/$0.10 USD) - 2017/02/23 16:04:07 ET
Table 'Serpens' 6-max Seat #2 is the button
Seat 1: Namhkal ($10.30 in chips) 
Seat 2: KA3AXCTAHEU, ($10 in chips) 
Seat 3: homelessdan ($29.49 in chips) 
Seat 4: Ragazzi3 ($16.44 in chips) 
Seat 5: XwinX25 ($11.81 in chips) 
Seat 6: Croplayer1 ($10.15 in chips) 
homelessdan: posts small blind $0.05
Ragazzi3: posts big blind $0.10
*** HOLE CARDS ***
XwinX25: folds 
Croplayer1: folds 
Namhkal: folds 
KA3AXCTAHEU,: raises $0.15 to $0.25
homelessdan: folds 
Ragazzi3: raises $0.35 to $0.60
KA3AXCTAHEU,: folds 
Uncalled bet ($0.35) returned to Ragazzi3
Ragazzi3 collected $0.55 from pot
*** SUMMARY ***
Total pot $0.55 | Rake $0 
Seat 1: Namhkal folded before Flop (didn't bet)
Seat 2: KA3AXCTAHEU, (button) folded before Flop
Seat 3: homelessdan (small blind) folded before Flop
Seat 4: Ragazzi3 (big blind) collected ($0.55)
Seat 5: XwinX25 folded before Flop (didn't bet)
Seat 6: Croplayer1 folded before Flop (didn't bet)



PokerStars Hand #166667600189:  Hold'em No Limit ($0.05/$0.10 USD) - 2017/02/23 16:04:07 ET
Table 'Arkab' 6-max Seat #5 is the button
Seat 1: iamkakaroto ($10 in chips) 
Seat 2: aktion4ik ($12.39 in chips) 
Seat 3: sexy_seagull ($10 in chips) 
Seat 4: donkucallme ($17.15 in chips) 
Seat 5: OrionYusupov ($9.44 in chips) 
Seat 6: MihaGr ($10.73 in chips) 
MihaGr: posts small blind $0.05
iamkakaroto: posts big blind $0.10
*** HOLE CARDS ***
aktion4ik: folds 
sexy_seagull: folds 
donkucallme: calls $0.10
OrionYusupov: folds 
MihaGr: calls $0.05
iamkakaroto: checks 
*** FLOP *** [Ad 5s Js]
MihaGr: checks 
iamkakaroto: checks 
donkucallme: bets $0.30
MihaGr: folds 
iamkakaroto: folds 
Uncalled bet ($0.30) returned to donkucallme
donkucallme collected $0.29 from pot
*** SUMMARY ***
Total pot $0.30 | Rake $0.01 
Board [Ad 5s Js]
Seat 1: iamkakaroto (big blind) folded on the Flop
Seat 2: aktion4ik folded before Flop (didn't bet)
Seat 3: sexy_seagull folded before Flop (didn't bet)
Seat 4: donkucallme collected ($0.29)
Seat 5: OrionYusupov (button) folded before Flop (didn't bet)
Seat 6: MihaGr (small blind) folded on the Flop



PokerStars Hand #166667600325:  Hold'em No Limit ($0.05/$0.10 USD) - 2017/02/23 16:04:07 ET
Table 'Pompeja III' 6-max Seat #2 is the button
Seat 1: Iarlei ($12.04 in chips) 
Seat 2: steepfell ($10.54 in chips) 
Seat 3: Yspenyanin ($11.90 in chips) 
Seat 4: Cluckh ($12.36 in chips) 
Seat 5: Spud014 ($12.14 in chips) 
Seat 6: mega spasser ($4.95 in chips) 
Yspenyanin: posts small blind $0.05
Cluckh: posts big blind $0.10
*** HOLE CARDS ***
Spud014: folds 
mega spasser: folds 
Iarlei: folds 
steepfell: raises $0.15 to $0.25
Yspenyanin: folds 
Cluckh: raises $0.55 to $0.80
steepfell: calls $0.55
*** FLOP *** [Qc 2c Ad]
Cluckh: bets $0.70
steepfell: calls $0.70
*** TURN *** [Qc 2c Ad] [8h]
Cluckh: bets $2.10
steepfell: folds 
Uncalled bet ($2.10) returned to Cluckh
Cluckh collected $2.91 from pot
*** SUMMARY ***
Total pot $3.05 | Rake $0.14 
Board [Qc 2c Ad 8h]
Seat 1: Iarlei folded before Flop (didn't bet)
Seat 2: steepfell (button) folded on the Turn
Seat 3: Yspenyanin (small blind) folded before Flop
Seat 4: Cluckh (big blind) collected ($2.91)
Seat 5: Spud014 folded before Flop (didn't bet)
Seat 6: mega spasser folded before Flop (didn't bet)



PokerStars Hand #166667600349:  Hold'em No Limit ($0.05/$0.10 USD) - 2017/02/23 16:04:07 ET
Table 'Nauheima II' 6-max Seat #3 is the button
Seat 2: Peter0087 ($9.82 in chips) 
Seat 3: KokoulinV ($13.49 in chips) 
Seat 4: Innerwuss ($10.02 in chips) 
Seat 5: Kow6oy ($10.45 in chips) 
Seat 6: bonyo71 ($5.19 in chips) 
Innerwuss: posts small blind $0.05
Kow6oy: posts big blind $0.10
*** HOLE CARDS ***
bonyo71: folds 
Peter0087: folds 
KokoulinV: raises $0.10 to $0.20
Innerwuss: raises $0.55 to $0.75
Kow6oy: folds 
KokoulinV: folds 
Uncalled bet ($0.55) returned to Innerwuss
Innerwuss collected $0.50 from pot
*** SUMMARY ***
Total pot $0.50 | Rake $0 
Seat 2: Peter0087 folded before Flop (didn't bet)
Seat 3: KokoulinV (button) folded before Flop
Seat 4: Innerwuss (small blind) collected ($0.50)
Seat 5: Kow6oy (big blind) folded before Flop
Seat 6: bonyo71 folded before Flop (didn't bet)



PokerStars Hand #166667600360:  Hold'em No Limit ($0.05/$0.10 USD) - 2017/02/23 16:04:07 ET
Table 'Walpurga' 6-max Seat #1 is the button
Seat 1: chimera252 ($12.07 in chips) 
Seat 2: paxit71 ($6.89 in chips) 
Seat 3: marianoboni ($10 in chips) 
Seat 4: oddshoff ($12.79 in chips) 
Seat 6: AIONCMA1988 ($4.36 in chips) 
paxit71: posts small blind $0.05
marianoboni: posts big blind $0.10
*** HOLE CARDS ***
oddshoff: folds 
AIONCMA1988: raises $0.10 to $0.20
chimera252: folds 
paxit71: calls $0.15
marianoboni: calls $0.10
*** FLOP *** [8h Qd 7c]
paxit71: checks 
marianoboni: checks 
AIONCMA1988: bets $0.29
paxit71: folds 
marianoboni: calls $0.29
*** TURN *** [8h Qd 7c] [6s]
marianoboni: checks 
AIONCMA1988: bets $0.57
marianoboni: folds 
Uncalled bet ($0.57) returned to AIONCMA1988
AIONCMA1988 collected $1.13 from pot
*** SUMMARY ***
Total pot $1.18 | Rake $0.05 
Board [8h Qd 7c 6s]
Seat 1: chimera252 (button) folded before Flop (didn't bet)
Seat 2: paxit71 (small blind) folded on the Flop
Seat 3: marianoboni (big blind) folded on the Turn
Seat 4: oddshoff folded before Flop (didn't bet)
Seat 6: AIONCMA1988 collected ($1.13)



PokerStars Hand #166667600519:  Hold'em No Limit ($0.05/$0.10 USD) - 2017/02/23 16:04:07 ET
Table 'Hamal II' 6-max Seat #6 is the button
Seat 1: saxoalto2011 ($7.84 in chips) 
Seat 2: pancernik21 ($10 in chips) 
Seat 3: Cluckh ($11.24 in chips) 
Seat 4: ArcticBearDK ($10.81 in chips) 
Seat 5: eniksenik ($11.19 in chips) 
Seat 6: LarryTheStar ($11.09 in chips) 
saxoalto2011: posts small blind $0.05
pancernik21: posts big blind $0.10
*** HOLE CARDS ***
Cluckh: folds 
ArcticBearDK: folds 
eniksenik: raises $0.20 to $0.30
LarryTheStar: raises $0.70 to $1
saxoalto2011: folds 
pancernik21: folds 
eniksenik: folds 
Uncalled bet ($0.70) returned to LarryTheStar
LarryTheStar collected $0.75 from pot
*** SUMMARY ***
Total pot $0.75 | Rake $0 
Seat 1: saxoalto2011 (small blind) folded before Flop
Seat 2: pancernik21 (big blind) folded before Flop
Seat 3: Cluckh folded before Flop (didn't bet)
Seat 4: ArcticBearDK folded before Flop (didn't bet)
Seat 5: eniksenik folded before Flop
Seat 6: LarryTheStar (button) collected ($0.75)



PokerStars Hand #166667600884:  Hold'em No Limit ($0.05/$0.10 USD) - 2017/02/23 16:04:07 ET
Table 'Gaika' 6-max Seat #2 is the button
Seat 1: oddshoff ($15.53 in chips) 
Seat 2: NvR.m1nD ($14.95 in chips) 
Seat 3: david_sara83 ($10.22 in chips) 
Seat 4: fortieth ($11.50 in chips) 
Seat 5: fedorka rus ($10.65 in chips) 
Seat 6: dr.goofy ($11 in chips) 
david_sara83: posts small blind $0.05
fortieth: posts big blind $0.10
*** HOLE CARDS ***
fedorka rus: folds 
dr.goofy: raises $0.20 to $0.30
oddshoff: folds 
NvR.m1nD: raises $0.60 to $0.90
david_sara83: folds 
fortieth: folds 
dr.goofy: raises $1.40 to $2.30
NvR.m1nD: calls $1.40
*** FLOP *** [6c 5s Ts]
dr.goofy: checks 
NvR.m1nD: checks 
*** TURN *** [6c 5s Ts] [Ac]
dr.goofy: checks 
NvR.m1nD: bets $1.91
dr.goofy: calls $1.91
*** RIVER *** [6c 5s Ts Ac] [2d]
dr.goofy: checks 
NvR.m1nD: bets $3.44
dr.goofy: calls $3.44
*** SHOW DOWN ***
NvR.m1nD: shows [As Kd] (a pair of Aces)
dr.goofy: mucks hand 
NvR.m1nD collected $14.75 from pot
*** SUMMARY ***
Total pot $15.45 | Rake $0.70 
Board [6c 5s Ts Ac 2d]
Seat 1: oddshoff folded before Flop (didn't bet)
Seat 2: NvR.m1nD (button) showed [As Kd] and won ($14.75) with a pair of Aces
Seat 3: david_sara83 (small blind) folded before Flop
Seat 4: fortieth (big blind) folded before Flop
Seat 5: fedorka rus folded before Flop (didn't bet)
Seat 6: dr.goofy mucked



PokerStars Hand #166667600963:  Hold'em No Limit ($0.05/$0.10 USD) - 2017/02/23 16:04:08 ET
Table 'Nuki' 6-max Seat #3 is the button
Seat 1: bdixon_5 ($7.80 in chips) 
Seat 2: ArcticBearDK ($19.23 in chips) 
Seat 3: david_sara83 ($13.62 in chips) 
Seat 4: GESPERIA ($28.51 in chips) 
Seat 6: Zooplack ($25.27 in chips) 
GESPERIA: posts small blind $0.05
fabadam: is sitting out 
Zooplack: posts big blind $0.10
*** HOLE CARDS ***
bdixon_5: folds 
ArcticBearDK: folds 
david_sara83: raises $0.15 to $0.25
GESPERIA: calls $0.20
Zooplack: folds 
*** FLOP *** [Jd 7h 6c]
GESPERIA: checks 
david_sara83: bets $0.29
GESPERIA: folds 
Uncalled bet ($0.29) returned to david_sara83
david_sara83 collected $0.57 from pot
*** SUMMARY ***
Total pot $0.60 | Rake $0.03 
Board [Jd 7h 6c]
Seat 1: bdixon_5 folded before Flop (didn't bet)
Seat 2: ArcticBearDK folded before Flop (didn't bet)
Seat 3: david_sara83 (button) collected ($0.57)
Seat 4: GESPERIA (small blind) folded on the Flop
Seat 6: Zooplack (big blind) folded before Flop



PokerStars Hand #166667601265:  Hold'em No Limit ($0.05/$0.10 USD) - 2017/02/23 16:04:08 ET
Table 'Nephthys II' 6-max Seat #5 is the button
Seat 1: DamDatsAnAce ($10.05 in chips) 
Seat 2: AC Evergreen ($10 in chips) 
Seat 3: Newqbrown ($21.73 in chips) 
Seat 5: kingartur222 ($9.01 in chips) 
Seat 6: CHRO8 ($14.39 in chips) 
CHRO8: posts small blind $0.05
DamDatsAnAce: posts big blind $0.10
MihaGr: sits out 
*** HOLE CARDS ***
AC Evergreen: folds 
Newqbrown: raises $0.20 to $0.30
kingartur222: folds 
CHRO8: folds 
DamDatsAnAce: folds 
Uncalled bet ($0.20) returned to Newqbrown
Newqbrown collected $0.25 from pot
*** SUMMARY ***
Total pot $0.25 | Rake $0 
Seat 1: DamDatsAnAce (big blind) folded before Flop
Seat 2: AC Evergreen folded before Flop (didn't bet)
Seat 3: Newqbrown collected ($0.25)
Seat 5: kingartur222 (button) folded before Flop (didn't bet)
Seat 6: CHRO8 (small blind) folded before Flop



PokerStars Hand #166667601509:  Hold'em No Limit ($0.05/$0.10 USD) - 2017/02/23 16:04:08 ET
Table 'Kanda' 6-max Seat #4 is the button
Seat 1: Andy Wolf ($11.27 in chips) 
Seat 2: Pelotín ($5.30 in chips) 
Seat 4: Orlangoor ($10.04 in chips) 
Seat 5: Dimka4 ($10 in chips) 
Seat 6: oddshoff ($8.81 in chips) 
Dimka4: posts small blind $0.05
oddshoff: posts big blind $0.10
XaXaTyH4uK: sits out 
*** HOLE CARDS ***
Andy Wolf: folds 
Pelotín: folds 
Orlangoor: raises $0.12 to $0.22
Dimka4: folds 
oddshoff: folds 
Uncalled bet ($0.12) returned to Orlangoor
Orlangoor collected $0.25 from pot
*** SUMMARY ***
Total pot $0.25 | Rake $0 
Seat 1: Andy Wolf folded before Flop (didn't bet)
Seat 2: Pelotín folded before Flop (didn't bet)
Seat 4: Orlangoor (button) collected ($0.25)
Seat 5: Dimka4 (small blind) folded before Flop
Seat 6: oddshoff (big blind) folded before Flop



PokerStars Hand #166667601905:  Hold'em No Limit ($0.05/$0.10 USD) - 2017/02/23 16:04:09 ET
Table 'Girtab' 6-max Seat #1 is the button
Seat 1: pokekrk ($13.56 in chips) 
Seat 2: MühliJr ($10 in chips) 
Seat 3: kingartur222 ($10.50 in chips) 
Seat 4: Hyd SK ($11.50 in chips) 
Seat 5: sexy_seagull ($10.72 in chips) 
MühliJr: posts small blind $0.05
kingartur222: posts big blind $0.10
*** HOLE CARDS ***
Hyd SK: folds 
sexy_seagull: raises $0.20 to $0.30
pokekrk: folds 
BahiaMinhaP leaves the table
MühliJr: folds 
kingartur222: calls $0.20
*** FLOP *** [2c 6d Ah]
kingartur222: checks 
sexy_seagull: bets $0.29
kingartur222: calls $0.29
*** TURN *** [2c 6d Ah] [4s]
kingartur222: checks 
sexy_seagull: bets $0.90
JahSoldier69 joins the table at seat #6 
kingartur222: folds 
Uncalled bet ($0.90) returned to sexy_seagull
JahSoldier69 leaves the table
sexy_seagull collected $1.17 from pot
*** SUMMARY ***
Total pot $1.23 | Rake $0.06 
Board [2c 6d Ah 4s]
Seat 1: pokekrk (button) folded before Flop (didn't bet)
Seat 2: MühliJr (small blind) folded before Flop
Seat 3: kingartur222 (big blind) folded on the Turn
Seat 4: Hyd SK folded before Flop (didn't bet)
Seat 5: sexy_seagull collected ($1.17)



PokerStars Hand #166667602152:  Hold'em No Limit ($0.05/$0.10 USD) - 2017/02/23 16:04:09 ET
Table 'Alnasl II' 6-max Seat #6 is the button
Seat 1: dragonste89 ($13.05 in chips) 
Seat 2: Therodorus ($11.91 in chips) 
Seat 3: ICBM-RS26 ($9.88 in chips) 
Seat 4: Eddys Edge ($10 in chips) 
Seat 5: mdelfin0 ($12.31 in chips) 
Seat 6: Bommer78 ($3.16 in chips) 
dragonste89: posts small blind $0.05
Therodorus: posts big blind $0.10
*** HOLE CARDS ***
ICBM-RS26: raises $0.10 to $0.20
Eddys Edge: folds 
mdelfin0: folds 
Bommer78: calls $0.20
dragonste89: folds 
Therodorus: folds 
*** FLOP *** [2d 7s Js]
ICBM-RS26: bets $0.30
Bommer78: calls $0.30
*** TURN *** [2d 7s Js] [Ts]
ICBM-RS26: checks 
Bommer78: checks 
*** RIVER *** [2d 7s Js Ts] [3d]
ICBM-RS26: checks 
Bommer78: bets $1.10
ICBM-RS26: calls $1.10
*** SHOW DOWN ***
Bommer78: shows [5s Qs] (a flush, Queen high)
ICBM-RS26: mucks hand 
Bommer78 collected $3.20 from pot
*** SUMMARY ***
Total pot $3.35 | Rake $0.15 
Board [2d 7s Js Ts 3d]
Seat 1: dragonste89 (small blind) folded before Flop
Seat 2: Therodorus (big blind) folded before Flop
Seat 3: ICBM-RS26 mucked
Seat 4: Eddys Edge folded before Flop (didn't bet)
Seat 5: mdelfin0 folded before Flop (didn't bet)
Seat 6: Bommer78 (button) showed [5s Qs] and won ($3.20) with a flush, Queen high



PokerStars Hand #166667602584:  Hold'em No Limit ($0.05/$0.10 USD) - 2017/02/23 16:04:09 ET
Table 'Crommelin II' 6-max Seat #1 is the button
Seat 1: THIMUCHIN ($11.62 in chips) 
Seat 2: Bird et al ($10 in chips) 
Seat 3: Strelok1974 ($21.95 in chips) 
Seat 4: Pequeño Clau ($10 in chips) 
Seat 5: Action_Gibi ($20.39 in chips) 
Bird et al: posts small blind $0.05
Strelok1974: posts big blind $0.10
*** HOLE CARDS ***
Pequeño Clau: raises $0.20 to $0.30
Action_Gibi: folds 
THIMUCHIN: folds 
Bird et al: folds 
Strelok1974: folds 
Uncalled bet ($0.20) returned to Pequeño Clau
Pequeño Clau collected $0.25 from pot
*** SUMMARY ***
Total pot $0.25 | Rake $0 
Seat 1: THIMUCHIN (button) folded before Flop (didn't bet)
Seat 2: Bird et al (small blind) folded before Flop
Seat 3: Strelok1974 (big blind) folded before Flop
Seat 4: Pequeño Clau collected ($0.25)
Seat 5: Action_Gibi folded before Flop (didn't bet)



PokerStars Hand #166667602789:  Hold'em No Limit ($0.05/$0.10 USD) - 2017/02/23 16:04:10 ET
Table 'Huberta II' 6-max Seat #4 is the button
Seat 1: tr41n3r12 ($10.15 in chips) 
Seat 2: Ice_Isayev ($12.08 in chips) 
Seat 3: patrick19111 ($10.75 in chips) 
Seat 4: VAD21 ($12.11 in chips) 
Seat 5: Feverhead ($27.03 in chips) 
Feverhead: posts small blind $0.05
iluzja12 was removed from the table for failing to post
tr41n3r12: posts big blind $0.10
*** HOLE CARDS ***
Ice_Isayev: folds 
patrick19111: folds 
JahSoldier69 joins the table at seat #6 
VAD21: folds 
JahSoldier69 leaves the table
Feverhead: raises $0.15 to $0.25
tr41n3r12: calls $0.15
*** FLOP *** [Tc Jc 6s]
Feverhead: checks 
tr41n3r12: bets $0.32
Feverhead: folds 
Uncalled bet ($0.32) returned to tr41n3r12
tr41n3r12 collected $0.48 from pot
*** SUMMARY ***
Total pot $0.50 | Rake $0.02 
Board [Tc Jc 6s]
Seat 1: tr41n3r12 (big blind) collected ($0.48)
Seat 2: Ice_Isayev folded before Flop (didn't bet)
Seat 3: patrick19111 folded before Flop (didn't bet)
Seat 4: VAD21 (button) folded before Flop (didn't bet)
Seat 5: Feverhead (small blind) folded on the Flop



PokerStars Hand #166667602829:  Hold'em No Limit ($0.05/$0.10 USD) - 2017/02/23 16:04:10 ET
Table 'Syringa' 6-max Seat #5 is the button
Seat 1: bdixon_5 ($7.95 in chips) 
Seat 2: Goroshkos88 ($10.56 in chips) 
Seat 3: Yspenyanin ($13.52 in chips) 
Seat 4: tangler19 ($14.43 in chips) 
Seat 5: Andrei ProFF ($13.31 in chips) 
Seat 6: ibara000 ($16.33 in chips) 
ibara000: posts small blind $0.05
bdixon_5: posts big blind $0.10
*** HOLE CARDS ***
Goroshkos88: folds 
Yspenyanin: folds 
tangler19 has timed out
tangler19: folds 
Andrei ProFF: raises $0.15 to $0.25
ibara000: folds 
bdixon_5: folds 
Uncalled bet ($0.15) returned to Andrei ProFF
Andrei ProFF collected $0.25 from pot
*** SUMMARY ***
Total pot $0.25 | Rake $0 
Seat 1: bdixon_5 (big blind) folded before Flop
Seat 2: Goroshkos88 folded before Flop (didn't bet)
Seat 3: Yspenyanin folded before Flop (didn't bet)
Seat 4: tangler19 folded before Flop (didn't bet)
Seat 5: Andrei ProFF (button) collected ($0.25)
Seat 6: ibara000 (small blind) folded before Flop



PokerStars Hand #166667603033:  Hold'em No Limit ($0.05/$0.10 USD) - 2017/02/23 16:04:10 ET
Table 'Lacroute' 6-max Seat #6 is the button
Seat 1: johnnyPieper ($5.79 in chips) 
Seat 2: Andy Wolf ($10 in chips) 
Seat 3: Croplayer1 ($14.90 in chips) 
Seat 4: st4tion ($15.91 in chips) 
Seat 5: steepfell ($11.29 in chips) 
Seat 6: IAntikI ($10 in chips) 
johnnyPieper: posts small blind $0.05
Andy Wolf: posts big blind $0.10
*** HOLE CARDS ***
Croplayer1: folds 
st4tion: folds 
steepfell: folds 
IAntikI: folds 
johnnyPieper: calls $0.05
Andy Wolf: checks 
*** FLOP *** [7h Ac Th]
johnnyPieper: bets $0.10
Andy Wolf: folds 
Uncalled bet ($0.10) returned to johnnyPieper
johnnyPieper collected $0.19 from pot
*** SUMMARY ***
Total pot $0.20 | Rake $0.01 
Board [7h Ac Th]
Seat 1: johnnyPieper (small blind) collected ($0.19)
Seat 2: Andy Wolf (big blind) folded on the Flop
Seat 3: Croplayer1 folded before Flop (didn't bet)
Seat 4: st4tion folded before Flop (didn't bet)
Seat 5: steepfell folded before Flop (didn't bet)
Seat 6: IAntikI (button) folded before Flop (didn't bet)



PokerStars Hand #166667603303:  Hold'em No Limit ($0.05/$0.10 USD) - 2017/02/23 16:04:10 ET
Table 'Eurykleia' 6-max Seat #6 is the button
Seat 1: Giyorod ($10.44 in chips) 
Seat 2: x3ultimate ($10.74 in chips) 
Seat 3: boxer821 ($20.56 in chips) 
Seat 4: 6ePeMeHHa9 ($16.66 in chips) 
Seat 5: fishhook5 ($10 in chips) 
Seat 6: afca128 ($6.42 in chips) 
Giyorod: posts small blind $0.05
x3ultimate: posts big blind $0.10
*** HOLE CARDS ***
boxer821: folds 
6ePeMeHHa9: raises $0.19 to $0.29
fishhook5: folds 
afca128: folds 
Giyorod: calls $0.24
x3ultimate: folds 
*** FLOP *** [5h 9d 2s]
Giyorod: checks 
6ePeMeHHa9: bets $0.40
Giyorod: folds 
Uncalled bet ($0.40) returned to 6ePeMeHHa9
6ePeMeHHa9 collected $0.65 from pot
*** SUMMARY ***
Total pot $0.68 | Rake $0.03 
Board [5h 9d 2s]
Seat 1: Giyorod (small blind) folded on the Flop
Seat 2: x3ultimate (big blind) folded before Flop
Seat 3: boxer821 folded before Flop (didn't bet)
Seat 4: 6ePeMeHHa9 collected ($0.65)
Seat 5: fishhook5 folded before Flop (didn't bet)
Seat 6: afca128 (button) folded before Flop (didn't bet)



PokerStars Hand #166667603762:  Hold'em No Limit ($0.05/$0.10 USD) - 2017/02/23 16:04:11 ET
Table 'Eudora' 6-max Seat #5 is the button
Seat 1: archer2511 ($11.51 in chips) 
Seat 2: popypaleta ($10 in chips) 
Seat 3: Ice_Isayev ($10 in chips) 
Seat 5: chimera252 ($11.52 in chips) 
archer2511: posts small blind $0.05
popypaleta: posts big blind $0.10
yodzik: sits out 
*** HOLE CARDS ***
Ice_Isayev: folds 
chimera252: raises $0.15 to $0.25
archer2511: folds 
popypaleta: folds 
Uncalled bet ($0.15) returned to chimera252
chimera252 collected $0.25 from pot
*** SUMMARY ***
Total pot $0.25 | Rake $0 
Seat 1: archer2511 (small blind) folded before Flop
Seat 2: popypaleta (big blind) folded before Flop
Seat 3: Ice_Isayev folded before Flop (didn't bet)
Seat 5: chimera252 (button) collected ($0.25)



PokerStars Hand #166667603836:  Hold'em No Limit ($0.05/$0.10 USD) - 2017/02/23 16:04:11 ET
Table 'Euryalos II' 6-max Seat #2 is the button
Seat 1: acekid403 ($9.90 in chips) 
Seat 2: silsilviu ($7.05 in chips) 
Seat 3: Hyd SK ($10.55 in chips) 
Seat 4: popypaleta ($15.62 in chips) 
Seat 5: horang2 ($8.25 in chips) 
Seat 6: MihaGr ($10 in chips) 
Hyd SK: posts small blind $0.05
popypaleta: posts big blind $0.10
*** HOLE CARDS ***
horang2: folds 
MihaGr: folds 
acekid403: folds 
silsilviu: folds 
Hyd SK: raises $0.25 to $0.35
popypaleta: folds 
Uncalled bet ($0.25) returned to Hyd SK
Hyd SK collected $0.20 from pot
*** SUMMARY ***
Total pot $0.20 | Rake $0 
Seat 1: acekid403 folded before Flop (didn't bet)
Seat 2: silsilviu (button) folded before Flop (didn't bet)
Seat 3: Hyd SK (small blind) collected ($0.20)
Seat 4: popypaleta (big blind) folded before Flop
Seat 5: horang2 folded before Flop (didn't bet)
Seat 6: MihaGr folded before Flop (didn't bet)



PokerStars Hand #166667604447:  Hold'em No Limit ($0.05/$0.10 USD) - 2017/02/23 16:04:11 ET
Table 'Jokaste II' 6-max Seat #6 is the button
Seat 1: Hyd SK ($13.23 in chips) 
Seat 2: T9MS ($12.48 in chips) 
Seat 3: crazydevill ($10.15 in chips) 
Seat 4: FRAID358 ($15.16 in chips) 
Seat 5: Vrinni ($10.28 in chips) 
Seat 6: Adailton07 ($15.05 in chips) 
Hyd SK: posts small blind $0.05
T9MS: posts big blind $0.10
*** HOLE CARDS ***
crazydevill: raises $0.20 to $0.30
FRAID358: raises $0.60 to $0.90
Vrinni: folds 
Adailton07: folds 
Hyd SK: folds 
T9MS: folds 
crazydevill: folds 
Uncalled bet ($0.60) returned to FRAID358
FRAID358 collected $0.75 from pot
*** SUMMARY ***
Total pot $0.75 | Rake $0 
Seat 1: Hyd SK (small blind) folded before Flop
Seat 2: T9MS (big blind) folded before Flop
Seat 3: crazydevill folded before Flop
Seat 4: FRAID358 collected ($0.75)
Seat 5: Vrinni folded before Flop (didn't bet)
Seat 6: Adailton07 (button) folded before Flop (didn't bet)



PokerStars Hand #166667604473:  Hold'em No Limit ($0.05/$0.10 USD) - 2017/02/23 16:04:11 ET
Table 'Alzirr II' 6-max Seat #5 is the button
Seat 1: KA3AXCTAHEU, ($10.31 in chips) 
Seat 2: popypaleta ($10.32 in chips) 
Seat 4: Scanner17 ($18.09 in chips) 
Seat 5: yodzik ($5 in chips) 
Seat 6: AM-L-SL ($4.90 in chips) 
AM-L-SL: posts small blind $0.05
KA3AXCTAHEU,: posts big blind $0.10
devon_red: sits out 
*** HOLE CARDS ***
popypaleta: folds 
Scanner17: folds 
yodzik: raises $0.20 to $0.30
AM-L-SL: calls $0.25
KA3AXCTAHEU,: folds 
*** FLOP *** [7s Ks 2h]
AM-L-SL: checks 
yodzik: bets $0.40
AM-L-SL: folds 
Uncalled bet ($0.40) returned to yodzik
yodzik collected $0.67 from pot
*** SUMMARY ***
Total pot $0.70 | Rake $0.03 
Board [7s Ks 2h]
Seat 1: KA3AXCTAHEU, (big blind) folded before Flop
Seat 2: popypaleta folded before Flop (didn't bet)
Seat 4: Scanner17 folded before Flop (didn't bet)
Seat 5: yodzik (button) collected ($0.67)
Seat 6: AM-L-SL (small blind) folded on the Flop



PokerStars Hand #166667605106:  Hold'em No Limit ($0.05/$0.10 USD) - 2017/02/23 16:04:12 ET
Table 'Joella' 6-max Seat #6 is the button
Seat 1: Dcaro31 ($13.15 in chips) 
Seat 2: Kaelyns_Bark ($7.96 in chips) 
Seat 3: Joker51_wtf! ($10 in chips) 
Seat 5: Anestakis777 ($5.79 in chips) 
Seat 6: dr.goofy ($11.61 in chips) 
Dcaro31: posts small blind $0.05
Kaelyns_Bark: posts big blind $0.10
*** HOLE CARDS ***
Joker51_wtf!: raises $0.16 to $0.26
Anestakis777: folds 
dr.goofy: calls $0.26
Dcaro31: folds 
Kaelyns_Bark: calls $0.16
*** FLOP *** [Qh Qd 7h]
Kaelyns_Bark: checks 
Joker51_wtf!: checks 
dr.goofy: checks 
*** TURN *** [Qh Qd 7h] [8d]
Kaelyns_Bark: bets $0.10
Joker51_wtf!: raises $0.40 to $0.50
dr.goofy: calls $0.50
Kaelyns_Bark: calls $0.40
*** RIVER *** [Qh Qd 7h 8d] [5c]
Kaelyns_Bark: checks 
Joker51_wtf!: bets $1.14
dr.goofy: folds 
Kaelyns_Bark: folds 
Uncalled bet ($1.14) returned to Joker51_wtf!
Joker51_wtf! collected $2.23 from pot
*** SUMMARY ***
Total pot $2.33 | Rake $0.10 
Board [Qh Qd 7h 8d 5c]
Seat 1: Dcaro31 (small blind) folded before Flop
Seat 2: Kaelyns_Bark (big blind) folded on the River
Seat 3: Joker51_wtf! collected ($2.23)
Seat 5: Anestakis777 folded before Flop (didn't bet)
Seat 6: dr.goofy (button) folded on the River



PokerStars Hand #166667605140:  Hold'em No Limit ($0.05/$0.10 USD) - 2017/02/23 16:04:12 ET
Table 'Nerthus II' 6-max Seat #2 is the button
Seat 1: mdelfin0 ($10.11 in chips) 
Seat 2: Hovhannes990 ($9.63 in chips) 
Seat 3: Mamm0nism ($18.72 in chips) 
Seat 5: Hyd SK ($12.15 in chips) 
Seat 6: Lucky HoBBiT ($10 in chips) 
Mamm0nism: posts small blind $0.05
Hyd SK: posts big blind $0.10
*** HOLE CARDS ***
Lucky HoBBiT: folds 
mdelfin0: folds 
Hovhannes990: folds 
Mamm0nism: folds 
Uncalled bet ($0.05) returned to Hyd SK
Hyd SK collected $0.10 from pot
*** SUMMARY ***
Total pot $0.10 | Rake $0 
Seat 1: mdelfin0 folded before Flop (didn't bet)
Seat 2: Hovhannes990 (button) folded before Flop (didn't bet)
Seat 3: Mamm0nism (small blind) folded before Flop
Seat 5: Hyd SK (big blind) collected ($0.10)
Seat 6: Lucky HoBBiT folded before Flop (didn't bet)



PokerStars Hand #166667605444:  Hold'em No Limit ($0.05/$0.10 USD) - 2017/02/23 16:04:13 ET
Table 'Brendelia II' 6-max Seat #2 is the button
Seat 2: Crimsonr ($4.99 in chips) 
Seat 3: ValdemorS ($19.07 in chips) 
Seat 6: luckyPositiv ($10.15 in chips) 
ValdemorS: posts small blind $0.05
luckyPositiv: posts big blind $0.10
Crimsonr: posts the ante $0.02
ValdemorS: posts the ante $0.02
luckyPositiv: posts the ante $0.02
*** HOLE CARDS ***
Crimsonr: folds 
ValdemorS: folds 
Uncalled bet ($0.05) returned to luckyPositiv
luckyPositiv collected $0.16 from pot
*** SUMMARY ***
Total pot $0.16 | Rake $0 
Seat 2: Crimsonr (button) folded before Flop (didn't bet)
Seat 3: ValdemorS (small blind) folded before Flop
Seat 6: luckyPositiv (big blind) collected ($0.16)



PokerStars Hand #166667605463:  Hold'em No Limit ($0.05/$0.10 USD) - 2017/02/23 16:04:13 ET
Table 'Wesselink II' 6-max Seat #3 is the button
Seat 1: vladcol ($5.27 in chips) 
Seat 3: Wargolandros ($8.92 in chips) 
Seat 4: BahiaMinhaP ($11.03 in chips) 
Seat 6: bambolejro ($10 in chips) 
BahiaMinhaP: posts small blind $0.05
xdjango07x: is sitting out 
bambolejro: posts big blind $0.10
KRZuff: sits out 
*** HOLE CARDS ***
vladcol: folds 
Wargolandros: raises $0.20 to $0.30
BahiaMinhaP: folds 
bambolejro: folds 
Uncalled bet ($0.20) returned to Wargolandros
Wargolandros collected $0.25 from pot
*** SUMMARY ***
Total pot $0.25 | Rake $0 
Seat 1: vladcol folded before Flop (didn't bet)
Seat 3: Wargolandros (button) collected ($0.25)
Seat 4: BahiaMinhaP (small blind) folded before Flop
Seat 6: bambolejro (big blind) folded before Flop



PokerStars Hand #166667605624:  Hold'em No Limit ($0.05/$0.10 USD) - 2017/02/23 16:04:13 ET
Table 'Virginia II' 6-max Seat #2 is the button
Seat 1: Iarlei ($11.71 in chips) 
Seat 2: Yspenyanin ($10 in chips) 
Seat 3: garigura ($14.61 in chips) 
Seat 4: onkelottoHH ($11.03 in chips) 
Seat 5: dr.goofy ($20.68 in chips) 
garigura: posts small blind $0.05
onkelottoHH: posts big blind $0.10
NvR.m1nD: sits out 
*** HOLE CARDS ***
dr.goofy: folds 
Iarlei: raises $0.20 to $0.30
Yspenyanin: folds 
garigura: folds 
onkelottoHH: folds 
Uncalled bet ($0.20) returned to Iarlei
Iarlei collected $0.25 from pot
*** SUMMARY ***
Total pot $0.25 | Rake $0 
Seat 1: Iarlei collected ($0.25)
Seat 2: Yspenyanin (button) folded before Flop (didn't bet)
Seat 3: garigura (small blind) folded before Flop
Seat 4: onkelottoHH (big blind) folded before Flop
Seat 5: dr.goofy folded before Flop (didn't bet)



PokerStars Hand #166667605730:  Hold'em No Limit ($0.05/$0.10 USD) - 2017/02/23 16:04:13 ET
Table 'Girtab II' 6-max Seat #4 is the button
Seat 1: marianoboni ($10 in chips) 
Seat 2: Pokeaster ($14.17 in chips) 
Seat 3: chimera252 ($10 in chips) 
Seat 4: Hyd SK ($27.03 in chips) 
Seat 6: DamDatsAnAce ($10 in chips) 
DamDatsAnAce: posts small blind $0.05
marianoboni: posts big blind $0.10
*** HOLE CARDS ***
Pokeaster: folds 
chimera252: folds 
Hyd SK: folds 
DamDatsAnAce: raises $0.20 to $0.30
marianoboni: calls $0.20
*** FLOP *** [4c Jd 2h]
DamDatsAnAce: bets $0.30
marianoboni: calls $0.30
*** TURN *** [4c Jd 2h] [5s]
DamDatsAnAce: checks 
marianoboni: checks 
*** RIVER *** [4c Jd 2h 5s] [7s]
DamDatsAnAce: checks 
marianoboni: bets $0.86
DamDatsAnAce: folds 
Uncalled bet ($0.86) returned to marianoboni
marianoboni collected $1.15 from pot
*** SUMMARY ***
Total pot $1.20 | Rake $0.05 
Board [4c Jd 2h 5s 7s]
Seat 1: marianoboni (big blind) collected ($1.15)
Seat 2: Pokeaster folded before Flop (didn't bet)
Seat 3: chimera252 folded before Flop (didn't bet)
Seat 4: Hyd SK (button) folded before Flop (didn't bet)
Seat 6: DamDatsAnAce (small blind) folded on the River



PokerStars Hand #166667605997:  Hold'em No Limit ($0.05/$0.10 USD) - 2017/02/23 16:04:13 ET
Table 'Juliet II' 6-max Seat #4 is the button
Seat 1: alexpolevaja ($11.13 in chips) 
Seat 2: KA3AXCTAHEU, ($15.08 in chips) 
Seat 3: patrick19111 ($11.57 in chips) 
Seat 4: x3ultimate ($10.55 in chips) 
Seat 5: Dcaro31 ($18.92 in chips) 
Seat 6: BookWorm78 ($33.10 in chips) 
Dcaro31: posts small blind $0.05
BookWorm78: posts big blind $0.10
*** HOLE CARDS ***
alexpolevaja: calls $0.10
KA3AXCTAHEU,: folds 
patrick19111: folds 
x3ultimate: folds 
Dcaro31: calls $0.05
BookWorm78: checks 
*** FLOP *** [9d Jc 2d]
Dcaro31: checks 
BookWorm78: checks 
alexpolevaja: checks 
*** TURN *** [9d Jc 2d] [Qc]
Dcaro31: checks 
BookWorm78: checks 
alexpolevaja: checks 
*** RIVER *** [9d Jc 2d Qc] [Ks]
Dcaro31: checks 
BookWorm78: checks 
alexpolevaja: checks 
*** SHOW DOWN ***
Dcaro31: shows [6s 5h] (high card King)
BookWorm78: shows [7d 3s] (high card King - Queen+Jack+Nine+Seven kicker)
alexpolevaja: shows [Kh 5s] (a pair of Kings)
alexpolevaja collected $0.29 from pot
*** SUMMARY ***
Total pot $0.30 | Rake $0.01 
Board [9d Jc 2d Qc Ks]
Seat 1: alexpolevaja showed [Kh 5s] and won ($0.29) with a pair of Kings
Seat 2: KA3AXCTAHEU, folded before Flop (didn't bet)
Seat 3: patrick19111 folded before Flop (didn't bet)
Seat 4: x3ultimate (button) folded before Flop (didn't bet)
Seat 5: Dcaro31 (small blind) showed [6s 5h] and lost with high card King
Seat 6: BookWorm78 (big blind) showed [7d 3s] and lost with high card King



PokerStars Hand #166667606017:  Hold'em No Limit ($0.05/$0.10 USD) - 2017/02/23 16:04:13 ET
Table 'Jacchia' 6-max Seat #4 is the button
Seat 1: viklundm ($35.22 in chips) 
Seat 2: VAD21 ($18.29 in chips) 
Seat 4: paterthomas ($10 in chips) 
Seat 6: RoJ1 ($13.91 in chips) 
RoJ1: posts small blind $0.05
viklundm: posts big blind $0.10
maxiv608: sits out 
*** HOLE CARDS ***
VAD21: raises $0.20 to $0.30
paterthomas: folds 
RoJ1: calls $0.25
viklundm: calls $0.20
*** FLOP *** [5c 5h 9d]
RoJ1: checks 
viklundm: checks 
VAD21: checks 
*** TURN *** [5c 5h 9d] [3s]
RoJ1: bets $0.45
viklundm: folds 
VAD21: calls $0.45
*** RIVER *** [5c 5h 9d 3s] [8h]
RoJ1: bets $1.05
VAD21: raises $2.15 to $3.20
RoJ1: folds 
Uncalled bet ($2.15) returned to VAD21
VAD21 collected $3.72 from pot
*** SUMMARY ***
Total pot $3.90 | Rake $0.18 
Board [5c 5h 9d 3s 8h]
Seat 1: viklundm (big blind) folded on the Turn
Seat 2: VAD21 collected ($3.72)
Seat 4: paterthomas (button) folded before Flop (didn't bet)
Seat 6: RoJ1 (small blind) folded on the River



PokerStars Hand #166667606132:  Hold'em No Limit ($0.05/$0.10 USD) - 2017/02/23 16:04:13 ET
Table 'Bengt' 6-max Seat #6 is the button
Seat 1: Lucky HoBBiT ($12.40 in chips) 
Seat 2: ChefRocco ($21.46 in chips) 
Seat 3: nantes15 ($13.18 in chips) 
Seat 4: 8th wonders ($10 in chips) 
Seat 5: RoJ1 ($10.31 in chips) 
Seat 6: Goroshkos88 ($10 in chips) 
Lucky HoBBiT: posts small blind $0.05
ChefRocco: posts big blind $0.10
*** HOLE CARDS ***
nantes15: folds 
8th wonders: folds 
RoJ1: folds 
Goroshkos88: raises $0.15 to $0.25
Lucky HoBBiT: folds 
ChefRocco: calls $0.15
*** FLOP *** [7h Ac 9d]
ChefRocco: checks 
Goroshkos88: bets $0.33
ChefRocco: folds 
Uncalled bet ($0.33) returned to Goroshkos88
Goroshkos88 collected $0.53 from pot
*** SUMMARY ***
Total pot $0.55 | Rake $0.02 
Board [7h Ac 9d]
Seat 1: Lucky HoBBiT (small blind) folded before Flop
Seat 2: ChefRocco (big blind) folded on the Flop
Seat 3: nantes15 folded before Flop (didn't bet)
Seat 4: 8th wonders folded before Flop (didn't bet)
Seat 5: RoJ1 folded before Flop (didn't bet)
Seat 6: Goroshkos88 (button) collected ($0.53)



PokerStars Hand #166667606315:  Hold'em No Limit ($0.05/$0.10 USD) - 2017/02/23 16:04:13 ET
Table 'Lampetia' 6-max Seat #1 is the button
Seat 1: WinninBikini ($10.29 in chips) 
Seat 2: ex3Lero86 ($10 in chips) 
Seat 3: Ice_Isayev ($20.64 in chips) 
Seat 4: Rodik002 ($10 in chips) 
Seat 5: luisantrs ($9.33 in chips) 
Seat 6: Scanner17 ($11.76 in chips) 
ex3Lero86: posts small blind $0.05
Ice_Isayev: posts big blind $0.10
*** HOLE CARDS ***
Rodik002: folds 
luisantrs: folds 
Scanner17: raises $0.20 to $0.30
WinninBikini: folds 
ex3Lero86: folds 
Ice_Isayev: calls $0.20
*** FLOP *** [3d Jc 4d]
Ice_Isayev: checks 
Scanner17: checks 
*** TURN *** [3d Jc 4d] [Ac]
Ice_Isayev: bets $0.40
Scanner17: calls $0.40
*** RIVER *** [3d Jc 4d Ac] [Jd]
Ice_Isayev: checks 
Scanner17: checks 
*** SHOW DOWN ***
Ice_Isayev: shows [Tc Kd] (a pair of Jacks)
Scanner17: shows [8d Ah] (two pair, Aces and Jacks)
Scanner17 collected $1.38 from pot
*** SUMMARY ***
Total pot $1.45 | Rake $0.07 
Board [3d Jc 4d Ac Jd]
Seat 1: WinninBikini (button) folded before Flop (didn't bet)
Seat 2: ex3Lero86 (small blind) folded before Flop
Seat 3: Ice_Isayev (big blind) showed [Tc Kd] and lost with a pair of Jacks
Seat 4: Rodik002 folded before Flop (didn't bet)
Seat 5: luisantrs folded before Flop (didn't bet)
Seat 6: Scanner17 showed [8d Ah] and won ($1.38) with two pair, Aces and Jacks



PokerStars Hand #166667606545:  Hold'em No Limit ($0.05/$0.10 USD) - 2017/02/23 16:04:14 ET
Table 'Hestia' 6-max Seat #4 is the button
Seat 1: Pekaml ($10.23 in chips) 
Seat 3: MBen10 ($13.77 in chips) 
Seat 4: Lucky HoBBiT ($10 in chips) 
Seat 5: CiisCi ($16.10 in chips) 
Seat 6: Smitty03300 ($10 in chips) 
CiisCi: posts small blind $0.05
Smitty03300: posts big blind $0.10
Kow6oy: sits out 
*** HOLE CARDS ***
Pekaml is disconnected 
Pekaml has timed out while disconnected
Pekaml: folds 
MBen10: folds 
Lucky HoBBiT: raises $0.15 to $0.25
CiisCi: raises $0.75 to $1
Smitty03300: folds 
Lucky HoBBiT: folds 
Uncalled bet ($0.75) returned to CiisCi
CiisCi collected $0.60 from pot
*** SUMMARY ***
Total pot $0.60 | Rake $0 
Seat 1: Pekaml folded before Flop (didn't bet)
Seat 3: MBen10 folded before Flop (didn't bet)
Seat 4: Lucky HoBBiT (button) folded before Flop
Seat 5: CiisCi (small blind) collected ($0.60)
Seat 6: Smitty03300 (big blind) folded before Flop



PokerStars Hand #166667607017:  Hold'em No Limit ($0.05/$0.10 USD) - 2017/02/23 16:04:14 ET
Table 'Ushakaron II' 6-max Seat #2 is the button
Seat 1: Kow6oy ($10.15 in chips) 
Seat 2: Iarlei ($10.08 in chips) 
Seat 3: Rodik002 ($10.05 in chips) 
Seat 4: avintage176 ($27.86 in chips) 
Seat 5: 1limewax1 ($17.38 in chips) 
Seat 6: eniksenik ($11.16 in chips) 
Rodik002: posts small blind $0.05
avintage176: posts big blind $0.10
*** HOLE CARDS ***
1limewax1: folds 
eniksenik: raises $0.20 to $0.30
Kow6oy: folds 
Iarlei: folds 
Rodik002: calls $0.25
avintage176: folds 
*** FLOP *** [9c 8c Jd]
Rodik002: bets $0.40
eniksenik: folds 
Uncalled bet ($0.40) returned to Rodik002
Rodik002 collected $0.67 from pot
*** SUMMARY ***
Total pot $0.70 | Rake $0.03 
Board [9c 8c Jd]
Seat 1: Kow6oy folded before Flop (didn't bet)
Seat 2: Iarlei (button) folded before Flop (didn't bet)
Seat 3: Rodik002 (small blind) collected ($0.67)
Seat 4: avintage176 (big blind) folded before Flop
Seat 5: 1limewax1 folded before Flop (didn't bet)
Seat 6: eniksenik folded on the Flop



PokerStars Hand #166667607075:  Hold'em No Limit ($0.05/$0.10 USD) - 2017/02/23 16:04:14 ET
Table 'Camilla II' 6-max Seat #2 is the button
Seat 1: paxit71 ($8 in chips) 
Seat 2: Giyorod ($16.11 in chips) 
Seat 3: Andy Wolf ($10 in chips) 
Seat 4: chimera252 ($12.41 in chips) 
Seat 5: LarryTheStar ($11.19 in chips) 
Seat 6: david_sara83 ($10.15 in chips) 
Andy Wolf: posts small blind $0.05
chimera252: posts big blind $0.10
*** HOLE CARDS ***
LarryTheStar: raises $0.20 to $0.30
david_sara83: folds 
paxit71: folds 
Giyorod: folds 
Andy Wolf: folds 
chimera252: folds 
Uncalled bet ($0.20) returned to LarryTheStar
LarryTheStar collected $0.25 from pot
*** SUMMARY ***
Total pot $0.25 | Rake $0 
Seat 1: paxit71 folded before Flop (didn't bet)
Seat 2: Giyorod (button) folded before Flop (didn't bet)
Seat 3: Andy Wolf (small blind) folded before Flop
Seat 4: chimera252 (big blind) folded before Flop
Seat 5: LarryTheStar collected ($0.25)
Seat 6: david_sara83 folded before Flop (didn't bet)



PokerStars Hand #166667607076:  Hold'em No Limit ($0.05/$0.10 USD) - 2017/02/23 16:04:14 ET
Table 'Marbachia II' 6-max Seat #5 is the button
Seat 1: AC Evergreen ($10.15 in chips) 
Seat 2: Yabidooo ($10.93 in chips) 
Seat 4: BahiaMinhaP ($10 in chips) 
Seat 5: MihaGr ($10 in chips) 
Seat 6: DamDatsAnAce ($10 in chips) 
DamDatsAnAce: posts small blind $0.05
AC Evergreen: posts big blind $0.10
MisterX413: sits out 
*** HOLE CARDS ***
Yabidooo: raises $0.20 to $0.30
BahiaMinhaP: calls $0.30
MihaGr: folds 
DamDatsAnAce: folds 
AC Evergreen: folds 
*** FLOP *** [7h 9h 7d]
Yabidooo: bets $0.20
BahiaMinhaP: calls $0.20
*** TURN *** [7h 9h 7d] [Tc]
Yabidooo: checks 
BahiaMinhaP: checks 
*** RIVER *** [7h 9h 7d Tc] [7c]
Yabidooo: bets $0.40
BahiaMinhaP: calls $0.40
*** SHOW DOWN ***
Yabidooo: shows [4c 4d] (a full house, Sevens full of Fours)
BahiaMinhaP: mucks hand 
Yabidooo collected $1.86 from pot
*** SUMMARY ***
Total pot $1.95 | Rake $0.09 
Board [7h 9h 7d Tc 7c]
Seat 1: AC Evergreen (big blind) folded before Flop
Seat 2: Yabidooo showed [4c 4d] and won ($1.86) with a full house, Sevens full of Fours
Seat 4: BahiaMinhaP mucked
Seat 5: MihaGr (button) folded before Flop (didn't bet)
Seat 6: DamDatsAnAce (small blind) folded before Flop



PokerStars Hand #166667607096:  Hold'em No Limit ($0.05/$0.10 USD) - 2017/02/23 16:04:14 ET
Table 'Ebella II' 6-max Seat #3 is the button
Seat 1: gaHy_HaXeP ($10 in chips) 
Seat 2: Therodorus ($10 in chips) 
Seat 3: Torften2 ($15.58 in chips) 
Seat 4: ValdemorS ($11.10 in chips) 
Seat 5: Bird et al ($10 in chips) 
Seat 6: Joker51_wtf! ($11.39 in chips) 
ValdemorS: posts small blind $0.05
Bird et al: posts big blind $0.10
*** HOLE CARDS ***
Joker51_wtf!: folds 
gaHy_HaXeP: folds 
Therodorus: folds 
Torften2: raises $0.30 to $0.40
ValdemorS: folds 
Bird et al: folds 
Uncalled bet ($0.30) returned to Torften2
Torften2 collected $0.25 from pot
*** SUMMARY ***
Total pot $0.25 | Rake $0 
Seat 1: gaHy_HaXeP folded before Flop (didn't bet)
Seat 2: Therodorus folded before Flop (didn't bet)
Seat 3: Torften2 (button) collected ($0.25)
Seat 4: ValdemorS (small blind) folded before Flop
Seat 5: Bird et al (big blind) folded before Flop
Seat 6: Joker51_wtf! folded before Flop (didn't bet)



PokerStars Hand #166667607303:  Hold'em No Limit ($0.05/$0.10 USD) - 2017/02/23 16:04:14 ET
Table 'Union' 6-max Seat #2 is the button
Seat 2: Zooplack ($10 in chips) 
Seat 3: Rodik002 ($12.06 in chips) 
Seat 4: Croplayer1 ($14.95 in chips) 
Seat 5: Chodemuncher ($15.48 in chips) 
Seat 6: bonyo71 ($3.85 in chips) 
Rodik002: posts small blind $0.05
Croplayer1: posts big blind $0.10
*** HOLE CARDS ***
Chodemuncher: folds 
bonyo71: folds 
Zooplack: raises $0.15 to $0.25
Rodik002: folds 
Krumi1703 leaves the table
Croplayer1: folds 
Uncalled bet ($0.15) returned to Zooplack
Zooplack collected $0.25 from pot
*** SUMMARY ***
Total pot $0.25 | Rake $0 
Seat 2: Zooplack (button) collected ($0.25)
Seat 3: Rodik002 (small blind) folded before Flop
Seat 4: Croplayer1 (big blind) folded before Flop
Seat 5: Chodemuncher folded before Flop (didn't bet)
Seat 6: bonyo71 folded before Flop (didn't bet)



PokerStars Hand #166667607574:  Hold'em No Limit ($0.05/$0.10 USD) - 2017/02/23 16:04:15 ET
Table 'Cassini' 6-max Seat #2 is the button
Seat 1: Pokeaster ($10.77 in chips) 
Seat 2: mhonielsen ($12.56 in chips) 
Seat 4: fortieth ($13.62 in chips) 
Seat 5: johkom ($7.75 in chips) 
Seat 6: JahSoldier69 ($10 in chips) 
fortieth: posts small blind $0.05
johkom: posts big blind $0.10
*** HOLE CARDS ***
JahSoldier69: raises $0.20 to $0.30
Pokeaster: folds 
mhonielsen: folds 
fortieth: folds 
johkom: calls $0.20
*** FLOP *** [8d 8h Jc]
johkom: checks 
JahSoldier69: bets $0.40
johkom: folds 
Uncalled bet ($0.40) returned to JahSoldier69
JahSoldier69 collected $0.62 from pot
*** SUMMARY ***
Total pot $0.65 | Rake $0.03 
Board [8d 8h Jc]
Seat 1: Pokeaster folded before Flop (didn't bet)
Seat 2: mhonielsen (button) folded before Flop (didn't bet)
Seat 4: fortieth (small blind) folded before Flop
Seat 5: johkom (big blind) folded on the Flop
Seat 6: JahSoldier69 collected ($0.62)



PokerStars Hand #166667607672:  Hold'em No Limit ($0.05/$0.10 USD) - 2017/02/23 16:04:15 ET
Table 'Krethon' 6-max Seat #5 is the button
Seat 1: boxer821 ($10.15 in chips) 
Seat 2: manashov ($12.21 in chips) 
Seat 4: chimera252 ($15.53 in chips) 
Seat 5: popypaleta ($10.10 in chips) 
boxer821: posts small blind $0.05
manashov: posts big blind $0.10
D3NyA: sits out 
*** HOLE CARDS ***
chimera252: raises $0.20 to $0.30
popypaleta: folds 
boxer821: calls $0.25
manashov: folds 
*** FLOP *** [3d 2d 5s]
boxer821: bets $0.44
chimera252: calls $0.44
*** TURN *** [3d 2d 5s] [4h]
boxer821: checks 
chimera252: checks 
*** RIVER *** [3d 2d 5s 4h] [3s]
boxer821: bets $1.51
chimera252: folds 
Uncalled bet ($1.51) returned to boxer821
boxer821 collected $1.51 from pot
*** SUMMARY ***
Total pot $1.58 | Rake $0.07 
Board [3d 2d 5s 4h 3s]
Seat 1: boxer821 (small blind) collected ($1.51)
Seat 2: manashov (big blind) folded before Flop
Seat 4: chimera252 folded on the River
Seat 5: popypaleta (button) folded before Flop (didn't bet)



PokerStars Hand #166667607861:  Hold'em No Limit ($0.05/$0.10 USD) - 2017/02/23 16:04:15 ET
Table 'Thia' 6-max Seat #6 is the button
Seat 1: Eddys Edge ($10 in chips) 
Seat 2: sugrob86 ($19.70 in chips) 
Seat 3: northug18 ($9.49 in chips) 
Seat 4: Bandyaev ($10.35 in chips) 
Seat 5: ab260414 ($10.57 in chips) 
Seat 6: ex3Lero86 ($15.45 in chips) 
Eddys Edge: posts small blind $0.05
sugrob86: posts big blind $0.10
*** HOLE CARDS ***
northug18: calls $0.10
Bandyaev: folds 
ab260414: folds 
ex3Lero86: folds 
Eddys Edge: calls $0.05
sugrob86: checks 
*** FLOP *** [4s 4d 3d]
Eddys Edge: checks 
sugrob86: checks 
northug18: checks 
*** TURN *** [4s 4d 3d] [Kc]
Eddys Edge: bets $0.20
sugrob86: calls $0.20
northug18: folds 
*** RIVER *** [4s 4d 3d Kc] [Qd]
Eddys Edge: bets $0.35
sugrob86: folds 
Uncalled bet ($0.35) returned to Eddys Edge
Eddys Edge collected $0.67 from pot
*** SUMMARY ***
Total pot $0.70 | Rake $0.03 
Board [4s 4d 3d Kc Qd]
Seat 1: Eddys Edge (small blind) collected ($0.67)
Seat 2: sugrob86 (big blind) folded on the River
Seat 3: northug18 folded on the Turn
Seat 4: Bandyaev folded before Flop (didn't bet)
Seat 5: ab260414 folded before Flop (didn't bet)
Seat 6: ex3Lero86 (button) folded before Flop (didn't bet)



PokerStars Hand #166667607918:  Hold'em No Limit ($0.05/$0.10 USD) - 2017/02/23 16:04:15 ET
Table 'Lederle' 6-max Seat #2 is the button
Seat 2: truck1234 ($15.70 in chips) 
Seat 3: Kazacha ($10.20 in chips) 
Seat 4: Pokeaster ($13.76 in chips) 
Seat 5: 8th wonders ($14.48 in chips) 
Seat 6: pokekrk ($10 in chips) 
Kazacha: posts small blind $0.05
Pokeaster: posts big blind $0.10
*** HOLE CARDS ***
8th wonders: folds 
pokekrk: folds 
truck1234: folds 
Kazacha: folds 
Uncalled bet ($0.05) returned to Pokeaster
Pokeaster collected $0.10 from pot
*** SUMMARY ***
Total pot $0.10 | Rake $0 
Seat 2: truck1234 (button) folded before Flop (didn't bet)
Seat 3: Kazacha (small blind) folded before Flop
Seat 4: Pokeaster (big blind) collected ($0.10)
Seat 5: 8th wonders folded before Flop (didn't bet)
Seat 6: pokekrk folded before Flop (didn't bet)



PokerStars Hand #166667608017:  Hold'em No Limit ($0.05/$0.10 USD) - 2017/02/23 16:04:15 ET
Table 'Luanda' 6-max Seat #2 is the button
Seat 1: AM-L-SL ($4.85 in chips) 
Seat 2: Xander188 ($10 in chips) 
Seat 3: DamDatsAnAce ($10.05 in chips) 
Seat 5: st4tion ($13.38 in chips) 
Seat 6: KA3AXCTAHEU, ($11.26 in chips) 
DamDatsAnAce: posts small blind $0.05
st4tion: posts big blind $0.10
*** HOLE CARDS ***
KA3AXCTAHEU,: raises $0.20 to $0.30
AM-L-SL: folds 
Xander188: folds 
DamDatsAnAce: folds 
st4tion: calls $0.20
*** FLOP *** [9s Jd 5h]
st4tion: checks 
KA3AXCTAHEU,: bets $0.10
st4tion: folds 
Uncalled bet ($0.10) returned to KA3AXCTAHEU,
KA3AXCTAHEU, collected $0.62 from pot
*** SUMMARY ***
Total pot $0.65 | Rake $0.03 
Board [9s Jd 5h]
Seat 1: AM-L-SL folded before Flop (didn't bet)
Seat 2: Xander188 (button) folded before Flop (didn't bet)
Seat 3: DamDatsAnAce (small blind) folded before Flop
Seat 5: st4tion (big blind) folded on the Flop
Seat 6: KA3AXCTAHEU, collected ($0.62)



PokerStars Hand #166667608882:  Hold'em No Limit ($0.05/$0.10 USD) - 2017/02/23 16:04:16 ET
Table 'Arpola' 6-max Seat #5 is the button
Seat 1: dincimus ($10 in chips) 
Seat 2: patrick19111 ($10.13 in chips) 
Seat 3: simaryk ($10 in chips) 
Seat 4: Orlangoor ($19.20 in chips) 
Seat 5: truck1234 ($11.66 in chips) 
Seat 6: Andrei ProFF ($10.37 in chips) 
Andrei ProFF: posts small blind $0.05
dincimus: posts big blind $0.10
*** HOLE CARDS ***
patrick19111: folds 
simaryk: folds 
Orlangoor: folds 
truck1234: folds 
Andrei ProFF: raises $0.20 to $0.30
dincimus: folds 
Uncalled bet ($0.20) returned to Andrei ProFF
Andrei ProFF collected $0.20 from pot
*** SUMMARY ***
Total pot $0.20 | Rake $0 
Seat 1: dincimus (big blind) folded before Flop
Seat 2: patrick19111 folded before Flop (didn't bet)
Seat 3: simaryk folded before Flop (didn't bet)
Seat 4: Orlangoor folded before Flop (didn't bet)
Seat 5: truck1234 (button) folded before Flop (didn't bet)
Seat 6: Andrei ProFF (small blind) collected ($0.20)



PokerStars Hand #166667609266:  Hold'em No Limit ($0.05/$0.10 USD) - 2017/02/23 16:04:17 ET
Table 'Klotho II' 6-max Seat #2 is the button
Seat 1: Alexey74516 ($8.26 in chips) 
Seat 2: kickereens ($10.05 in chips) 
Seat 3: Zooplack ($10.63 in chips) 
Seat 4: Lucky HoBBiT ($10.11 in chips) 
Seat 5: david_sara83 ($15.64 in chips) 
Seat 6: D3NyA ($11.57 in chips) 
Zooplack: posts small blind $0.05
Lucky HoBBiT: posts big blind $0.10
*** HOLE CARDS ***
david_sara83: raises $0.20 to $0.30
D3NyA: folds 
Alexey74516: calls $0.30
kickereens: folds 
Zooplack: folds 
Lucky HoBBiT: folds 
*** FLOP *** [3d 8s 7c]
david_sara83: bets $0.39
Alexey74516: folds 
Uncalled bet ($0.39) returned to david_sara83
david_sara83 collected $0.72 from pot
*** SUMMARY ***
Total pot $0.75 | Rake $0.03 
Board [3d 8s 7c]
Seat 1: Alexey74516 folded on the Flop
Seat 2: kickereens (button) folded before Flop (didn't bet)
Seat 3: Zooplack (small blind) folded before Flop
Seat 4: Lucky HoBBiT (big blind) folded before Flop
Seat 5: david_sara83 collected ($0.72)
Seat 6: D3NyA folded before Flop (didn't bet)



PokerStars Hand #166667609314:  Hold'em No Limit ($0.05/$0.10 USD) - 2017/02/23 16:04:17 ET
Table 'Orthos III' 6-max Seat #4 is the button
Seat 1: sexy_seagull ($10 in chips) 
Seat 2: Xander188 ($16.69 in chips) 
Seat 3: koka4cs ($5.75 in chips) 
Seat 4: FlopsterGB ($15.42 in chips) 
Seat 5: Bird et al ($20.52 in chips) 
Seat 6: RoJ1 ($10.79 in chips) 
Bird et al: posts small blind $0.05
RoJ1: posts big blind $0.10
*** HOLE CARDS ***
sexy_seagull: raises $0.20 to $0.30
Xander188: calls $0.30
koka4cs: folds 
FlopsterGB: folds 
Bird et al: folds 
RoJ1: folds 
*** FLOP *** [2d 9h Ac]
sexy_seagull: bets $0.49
Xander188: calls $0.49
*** TURN *** [2d 9h Ac] [Qd]
sexy_seagull: bets $0.78
Xander188: raises $1.32 to $2.10
sexy_seagull: calls $1.32
*** RIVER *** [2d 9h Ac Qd] [5c]
sexy_seagull: checks 
Xander188: bets $3.50
sexy_seagull: folds 
Uncalled bet ($3.50) returned to Xander188
Xander188 collected $5.66 from pot
*** SUMMARY ***
Total pot $5.93 | Rake $0.27 
Board [2d 9h Ac Qd 5c]
Seat 1: sexy_seagull folded on the River
Seat 2: Xander188 collected ($5.66)
Seat 3: koka4cs folded before Flop (didn't bet)
Seat 4: FlopsterGB (button) folded before Flop (didn't bet)
Seat 5: Bird et al (small blind) folded before Flop
Seat 6: RoJ1 (big blind) folded before Flop



PokerStars Hand #166667609496:  Hold'em No Limit ($0.05/$0.10 USD) - 2017/02/23 16:04:17 ET
Table 'Lorbach' 6-max Seat #1 is the button
Seat 1: LarryTheStar ($14.68 in chips) 
Seat 3: ArcticBearDK ($10.95 in chips) 
Seat 4: McCleans ($10 in chips) 
Seat 5: Cluckh ($14.62 in chips) 
Seat 6: Worlz ($12.67 in chips) 
ArcticBearDK: posts small blind $0.05
McCleans: posts big blind $0.10
*** HOLE CARDS ***
Cluckh: folds 
Worlz: folds 
LarryTheStar: folds 
ArcticBearDK: folds 
Uncalled bet ($0.05) returned to McCleans
McCleans collected $0.10 from pot
*** SUMMARY ***
Total pot $0.10 | Rake $0 
Seat 1: LarryTheStar (button) folded before Flop (didn't bet)
Seat 3: ArcticBearDK (small blind) folded before Flop
Seat 4: McCleans (big blind) collected ($0.10)
Seat 5: Cluckh folded before Flop (didn't bet)
Seat 6: Worlz folded before Flop (didn't bet)



PokerStars Hand #166667609607:  Hold'em No Limit ($0.05/$0.10 USD) - 2017/02/23 16:04:17 ET
Table 'Kunigunde II' 6-max Seat #1 is the button
Seat 1: facewald ($9.79 in chips) 
Seat 3: pancernik21 ($14.98 in chips) 
Seat 4: david_sara83 ($12.83 in chips) 
Seat 5: mdelfin0 ($11.59 in chips) 
Seat 6: Zooplack ($10 in chips) 
eniksenik will be allowed to play after the button
pancernik21: posts small blind $0.05
david_sara83: posts big blind $0.10
*** HOLE CARDS ***
mdelfin0: folds 
Zooplack: folds 
facewald: folds 
pancernik21: folds 
Uncalled bet ($0.05) returned to david_sara83
david_sara83 collected $0.10 from pot
*** SUMMARY ***
Total pot $0.10 | Rake $0 
Seat 1: facewald (button) folded before Flop (didn't bet)
Seat 3: pancernik21 (small blind) folded before Flop
Seat 4: david_sara83 (big blind) collected ($0.10)
Seat 5: mdelfin0 folded before Flop (didn't bet)
Seat 6: Zooplack folded before Flop (didn't bet)



PokerStars Hand #166667609856:  Hold'em No Limit ($0.05/$0.10 USD) - 2017/02/23 16:04:17 ET
Table 'Unitas II' 6-max Seat #1 is the button
Seat 1: Peter0087 ($9.85 in chips) 
Seat 4: truck1234 ($10.99 in chips) 
Seat 5: chimera252 ($25.91 in chips) 
Seat 6: paxit71 ($8.27 in chips) 
steepfell will be allowed to play after the button
truck1234: posts small blind $0.05
chimera252: posts big blind $0.10
*** HOLE CARDS ***
paxit71: folds 
Peter0087: folds 
truck1234: folds 
Uncalled bet ($0.05) returned to chimera252
chimera252 collected $0.10 from pot
*** SUMMARY ***
Total pot $0.10 | Rake $0 
Seat 1: Peter0087 (button) folded before Flop (didn't bet)
Seat 4: truck1234 (small blind) folded before Flop
Seat 5: chimera252 (big blind) collected ($0.10)
Seat 6: paxit71 folded before Flop (didn't bet)



PokerStars Hand #166667610040:  Hold'em No Limit ($0.05/$0.10 USD) - 2017/02/23 16:04:17 ET
Table 'Tomyris II' 6-max Seat #2 is the button
Seat 1: ArcticBearDK ($21.98 in chips) 
Seat 2: Yspenyanin ($12.39 in chips) 
Seat 3: robertsabb ($12.28 in chips) 
Seat 4: Dcaro31 ($10 in chips) 
Seat 6: StackSmakka ($11.59 in chips) 
robertsabb: posts small blind $0.05
Dcaro31: posts big blind $0.10
6ePeMeHHa9: sits out 
*** HOLE CARDS ***
StackSmakka: folds 
ArcticBearDK: folds 
Yspenyanin: folds 
robertsabb: raises $0.10 to $0.20
Dcaro31: folds 
Uncalled bet ($0.10) returned to robertsabb
robertsabb collected $0.20 from pot
*** SUMMARY ***
Total pot $0.20 | Rake $0 
Seat 1: ArcticBearDK folded before Flop (didn't bet)
Seat 2: Yspenyanin (button) folded before Flop (didn't bet)
Seat 3: robertsabb (small blind) collected ($0.20)
Seat 4: Dcaro31 (big blind) folded before Flop
Seat 6: StackSmakka folded before Flop (didn't bet)



PokerStars Hand #166667610205:  Hold'em No Limit ($0.05/$0.10 USD) - 2017/02/23 16:04:18 ET
Table 'Caupolican' 6-max Seat #1 is the button
Seat 1: kingartur222 ($11.13 in chips) 
Seat 2: garigura ($18.95 in chips) 
Seat 4: mhonielsen ($15.79 in chips) 
Seat 5: Kazacha ($10.80 in chips) 
Seat 6: crazydevill ($10.77 in chips) 
garigura: posts small blind $0.05
mhonielsen: posts big blind $0.10
*** HOLE CARDS ***
Kazacha: raises $0.14 to $0.24
crazydevill: folds 
kingartur222: calls $0.24
garigura: folds 
mhonielsen: folds 
*** FLOP *** [Jd 3s 9c]
Kazacha: checks 
kingartur222: bets $0.30
Kazacha: folds 
Uncalled bet ($0.30) returned to kingartur222
kingartur222 collected $0.60 from pot
*** SUMMARY ***
Total pot $0.63 | Rake $0.03 
Board [Jd 3s 9c]
Seat 1: kingartur222 (button) collected ($0.60)
Seat 2: garigura (small blind) folded before Flop
Seat 4: mhonielsen (big blind) folded before Flop
Seat 5: Kazacha folded on the Flop
Seat 6: crazydevill folded before Flop (didn't bet)



PokerStars Hand #166667610258:  Hold'em No Limit ($0.05/$0.10 USD) - 2017/02/23 16:04:18 ET
Table 'Carina' 6-max Seat #2 is the button
Seat 1: Kupi007 ($10 in chips) 
Seat 2: kickereens ($24.59 in chips) 
Seat 3: LarryTheStar ($10 in chips) 
Seat 5: IAntikI ($10.30 in chips) 
Seat 6: alexweezer ($9.60 in chips) 
LarryTheStar: posts small blind $0.05
IAntikI: posts big blind $0.10
*** HOLE CARDS ***
alexweezer: raises $0.10 to $0.20
Kupi007: folds 
kickereens: folds 
LarryTheStar: raises $0.70 to $0.90
IAntikI: folds 
alexweezer: calls $0.70
*** FLOP *** [5s 2s Ah]
LarryTheStar: checks 
alexweezer: checks 
*** TURN *** [5s 2s Ah] [2d]
LarryTheStar: bets $1.30
alexweezer: folds 
Uncalled bet ($1.30) returned to LarryTheStar
LarryTheStar collected $1.81 from pot
*** SUMMARY ***
Total pot $1.90 | Rake $0.09 
Board [5s 2s Ah 2d]
Seat 1: Kupi007 folded before Flop (didn't bet)
Seat 2: kickereens (button) folded before Flop (didn't bet)
Seat 3: LarryTheStar (small blind) collected ($1.81)
Seat 5: IAntikI (big blind) folded before Flop
Seat 6: alexweezer folded on the Turn



PokerStars Hand #166667610298:  Hold'em No Limit ($0.05/$0.10 USD) - 2017/02/23 16:04:18 ET
Table 'Lobelia II' 6-max Seat #6 is the button
Seat 1: facewald ($20.54 in chips) 
Seat 2: Dcaro31 ($17.84 in chips) 
Seat 3: oddshoff ($19.40 in chips) 
Seat 5: Feverhead ($20.43 in chips) 
Seat 6: NvR.m1nD ($10.27 in chips) 
facewald: posts small blind $0.05
Dcaro31: posts big blind $0.10
*** HOLE CARDS ***
oddshoff: folds 
Feverhead: folds 
NvR.m1nD: folds 
facewald: raises $0.19 to $0.29
Dcaro31: calls $0.19
*** FLOP *** [9d 5d Qc]
facewald: bets $0.29
Dcaro31: calls $0.29
*** TURN *** [9d 5d Qc] [6d]
facewald: bets $0.71
Dcaro31: folds 
Uncalled bet ($0.71) returned to facewald
facewald collected $1.11 from pot
*** SUMMARY ***
Total pot $1.16 | Rake $0.05 
Board [9d 5d Qc 6d]
Seat 1: facewald (small blind) collected ($1.11)
Seat 2: Dcaro31 (big blind) folded on the Turn
Seat 3: oddshoff folded before Flop (didn't bet)
Seat 5: Feverhead folded before Flop (didn't bet)
Seat 6: NvR.m1nD (button) folded before Flop (didn't bet)



PokerStars Hand #166667610503:  Hold'em No Limit ($0.05/$0.10 USD) - 2017/02/23 16:04:18 ET
Table 'Selinur' 6-max Seat #4 is the button
Seat 1: KA3AXCTAHEU, ($10 in chips) 
Seat 2: hoedje72 ($8.34 in chips) 
Seat 3: bambolejro ($11.07 in chips) 
Seat 4: freezing666 ($11.48 in chips) 
Seat 5: IAntikI ($10.27 in chips) 
Seat 6: homelessdan ($17.62 in chips) 
IAntikI: posts small blind $0.05
homelessdan: posts big blind $0.10
*** HOLE CARDS ***
KA3AXCTAHEU,: folds 
hoedje72: folds 
bambolejro: folds 
freezing666: raises $0.20 to $0.30
IAntikI: folds 
homelessdan: folds 
Uncalled bet ($0.20) returned to freezing666
freezing666 collected $0.25 from pot
*** SUMMARY ***
Total pot $0.25 | Rake $0 
Seat 1: KA3AXCTAHEU, folded before Flop (didn't bet)
Seat 2: hoedje72 folded before Flop (didn't bet)
Seat 3: bambolejro folded before Flop (didn't bet)
Seat 4: freezing666 (button) collected ($0.25)
Seat 5: IAntikI (small blind) folded before Flop
Seat 6: homelessdan (big blind) folded before Flop



PokerStars Hand #166667610674:  Hold'em No Limit ($0.05/$0.10 USD) - 2017/02/23 16:04:18 ET
Table 'Antielus II' 6-max Seat #3 is the button
Seat 1: Dcaro31 ($17.30 in chips) 
Seat 2: Orlangoor ($10.15 in chips) 
Seat 3: mcyi3at2 ($13.36 in chips) 
Seat 4: XwinX25 ($10 in chips) 
Seat 5: Hyd SK ($10.65 in chips) 
Seat 6: GiveTwoMe ($12.40 in chips) 
XwinX25: posts small blind $0.05
Hyd SK: posts big blind $0.10
*** HOLE CARDS ***
GiveTwoMe: folds 
Dcaro31: folds 
Orlangoor: folds 
mcyi3at2: folds 
XwinX25: folds 
Uncalled bet ($0.05) returned to Hyd SK
Hyd SK collected $0.10 from pot
*** SUMMARY ***
Total pot $0.10 | Rake $0 
Seat 1: Dcaro31 folded before Flop (didn't bet)
Seat 2: Orlangoor folded before Flop (didn't bet)
Seat 3: mcyi3at2 (button) folded before Flop (didn't bet)
Seat 4: XwinX25 (small blind) folded before Flop
Seat 5: Hyd SK (big blind) collected ($0.10)
Seat 6: GiveTwoMe folded before Flop (didn't bet)



PokerStars Hand #166667610791:  Hold'em No Limit ($0.05/$0.10 USD) - 2017/02/23 16:04:18 ET
Table 'Pandora III' 6-max Seat #1 is the button
Seat 1: Pokeaster ($10.84 in chips) 
Seat 2: garigura ($11.67 in chips) 
Seat 4: mhonielsen ($10 in chips) 
Seat 5: MühliJr ($10.55 in chips) 
Seat 6: yodzik ($5 in chips) 
garigura: posts small blind $0.05
ChuikaPridi: is sitting out 
mhonielsen: posts big blind $0.10
*** HOLE CARDS ***
MühliJr: folds 
yodzik: folds 
Pokeaster: folds 
garigura: folds 
Uncalled bet ($0.05) returned to mhonielsen
mhonielsen collected $0.10 from pot
*** SUMMARY ***
Total pot $0.10 | Rake $0 
Seat 1: Pokeaster (button) folded before Flop (didn't bet)
Seat 2: garigura (small blind) folded before Flop
Seat 4: mhonielsen (big blind) collected ($0.10)
Seat 5: MühliJr folded before Flop (didn't bet)
Seat 6: yodzik folded before Flop (didn't bet)



PokerStars Hand #166667610992:  Hold'em No Limit ($0.05/$0.10 USD) - 2017/02/23 16:04:19 ET
Table 'Sirius II' 6-max Seat #1 is the button
Seat 1: Ampped87 ($14.31 in chips) 
Seat 2: Buddy8711 ($7.90 in chips) 
Seat 3: Spud014 ($10.40 in chips) 
Seat 5: pokekrk ($11.04 in chips) 
Seat 6: MihaGr ($10 in chips) 
Buddy8711: posts small blind $0.05
Spud014: posts big blind $0.10
*** HOLE CARDS ***
pokekrk: raises $0.20 to $0.30
MihaGr: folds 
Ampped87: calls $0.30
Buddy8711: folds 
Spud014: folds 
*** FLOP *** [7s Tc 8d]
pokekrk: bets $0.54
Ampped87: calls $0.54
*** TURN *** [7s Tc 8d] [4d]
pokekrk: bets $1.31
Ampped87: raises $2.21 to $3.52
pokekrk: calls $2.21
*** RIVER *** [7s Tc 8d 4d] [Js]
pokekrk: bets $6.68 and is all-in
Ampped87: calls $6.68
*** SHOW DOWN ***
pokekrk: shows [9s 9d] (a straight, Seven to Jack)
Ampped87: shows [6c 9c] (a straight, Seven to Jack)
pokekrk collected $10.62 from pot
Ampped87 collected $10.61 from pot
*** SUMMARY ***
Total pot $22.23 | Rake $1 
Board [7s Tc 8d 4d Js]
Seat 1: Ampped87 (button) showed [6c 9c] and won ($10.61) with a straight, Seven to Jack
Seat 2: Buddy8711 (small blind) folded before Flop
Seat 3: Spud014 (big blind) folded before Flop
Seat 5: pokekrk showed [9s 9d] and won ($10.62) with a straight, Seven to Jack
Seat 6: MihaGr folded before Flop (didn't bet)



PokerStars Hand #166667611384:  Hold'em No Limit ($0.05/$0.10 USD) - 2017/02/23 16:04:19 ET
Table 'Samitchell III' 6-max Seat #1 is the button
Seat 1: dr.goofy ($10.27 in chips) 
Seat 2: scorpionfish ($10 in chips) 
Seat 5: steepfell ($10 in chips) 
Seat 6: fedorka rus ($12.96 in chips) 
scorpionfish: posts small blind $0.05
steepfell: posts big blind $0.10
*** HOLE CARDS ***
fedorka rus: folds 
dr.goofy: raises $0.15 to $0.25
scorpionfish: calls $0.20
steepfell: folds 
*** FLOP *** [Qd 8c 2c]
scorpionfish: checks 
dr.goofy: checks 
*** TURN *** [Qd 8c 2c] [3d]
scorpionfish: bets $0.40
dr.goofy: folds 
Uncalled bet ($0.40) returned to scorpionfish
scorpionfish collected $0.57 from pot
*** SUMMARY ***
Total pot $0.60 | Rake $0.03 
Board [Qd 8c 2c 3d]
Seat 1: dr.goofy (button) folded on the Turn
Seat 2: scorpionfish (small blind) collected ($0.57)
Seat 5: steepfell (big blind) folded before Flop
Seat 6: fedorka rus folded before Flop (didn't bet)



PokerStars Hand #166667611777:  Hold'em No Limit ($0.05/$0.10 USD) - 2017/02/23 16:04:19 ET
Table 'Grietje' 6-max Seat #3 is the button
Seat 2: Feverhead ($13.12 in chips) 
Seat 3: voledy ($10 in chips) 
Seat 6: Prometheu$8 ($21.45 in chips) 
MihaGr will be allowed to play after the button
iThreeBarrel will be allowed to play after the button
Prometheu$8: posts small blind $0.05
WinninBikini: is sitting out 
WinninBikini leaves the table
Feverhead: posts big blind $0.10
*** HOLE CARDS ***
voledy: folds 
dragonste89 joins the table at seat #1 
Prometheu$8: raises $0.20 to $0.30
Feverhead: folds 
Uncalled bet ($0.20) returned to Prometheu$8
Prometheu$8 collected $0.20 from pot
*** SUMMARY ***
Total pot $0.20 | Rake $0 
Seat 2: Feverhead (big blind) folded before Flop
Seat 3: voledy (button) folded before Flop (didn't bet)
Seat 6: Prometheu$8 (small blind) collected ($0.20)



PokerStars Hand #166667611829:  Hold'em No Limit ($0.05/$0.10 USD) - 2017/02/23 16:04:19 ET
Table 'Aisakos II' 6-max Seat #3 is the button
Seat 1: Crafty23@PS ($10.15 in chips) 
Seat 2: svaika24 ($16.93 in chips) 
Seat 3: iamkakaroto ($10.54 in chips) 
Seat 4: T9MS ($10 in chips) 
Seat 5: KokoulinV ($12.40 in chips) 
Seat 6: LarryTheStar ($10.15 in chips) 
T9MS: posts small blind $0.05
KokoulinV: posts big blind $0.10
*** HOLE CARDS ***
LarryTheStar: folds 
Crafty23@PS: raises $0.20 to $0.30
svaika24: folds 
iamkakaroto: folds 
T9MS: folds 
KokoulinV: folds 
Uncalled bet ($0.20) returned to Crafty23@PS
Crafty23@PS collected $0.25 from pot
*** SUMMARY ***
Total pot $0.25 | Rake $0 
Seat 1: Crafty23@PS collected ($0.25)
Seat 2: svaika24 folded before Flop (didn't bet)
Seat 3: iamkakaroto (button) folded before Flop (didn't bet)
Seat 4: T9MS (small blind) folded before Flop
Seat 5: KokoulinV (big blind) folded before Flop
Seat 6: LarryTheStar folded before Flop (didn't bet)



PokerStars Hand #166667611874:  Hold'em No Limit ($0.05/$0.10 USD) - 2017/02/23 16:04:20 ET
Table 'Heka II' 6-max Seat #5 is the button
Seat 1: Mamm0nism ($14.37 in chips) 
Seat 2: oddshoff ($11.27 in chips) 
Seat 3: MühliJr ($10.30 in chips) 
Seat 4: theNot0r1ous ($10.45 in chips) 
Seat 5: ArcticBearDK ($12.53 in chips) 
Seat 6: MonteCris92 ($10 in chips) 
MonteCris92: posts small blind $0.05
Mamm0nism: posts big blind $0.10
*** HOLE CARDS ***
oddshoff: raises $0.20 to $0.30
MühliJr: folds 
theNot0r1ous: folds 
ArcticBearDK: folds 
MonteCris92: folds 
Mamm0nism: folds 
Uncalled bet ($0.20) returned to oddshoff
oddshoff collected $0.25 from pot
*** SUMMARY ***
Total pot $0.25 | Rake $0 
Seat 1: Mamm0nism (big blind) folded before Flop
Seat 2: oddshoff collected ($0.25)
Seat 3: MühliJr folded before Flop (didn't bet)
Seat 4: theNot0r1ous folded before Flop (didn't bet)
Seat 5: ArcticBearDK (button) folded before Flop (didn't bet)
Seat 6: MonteCris92 (small blind) folded before Flop



PokerStars Hand #166667611998:  Hold'em No Limit ($0.05/$0.10 USD) - 2017/02/23 16:04:20 ET
Table 'Siebohme' 6-max Seat #4 is the button
Seat 1: kusa4ki ($11.38 in chips) 
Seat 2: el toro 1507 ($11.53 in chips) 
Seat 3: ex3Lero86 ($10.56 in chips) 
Seat 4: Innerwuss ($10 in chips) 
Seat 5: Kazacha ($10 in chips) 
Seat 6: townerz1991 ($10.68 in chips) 
Kazacha: posts small blind $0.05
townerz1991: posts big blind $0.10
*** HOLE CARDS ***
kusa4ki: folds 
el toro 1507: folds 
ex3Lero86: folds 
Innerwuss: raises $0.10 to $0.20
Kazacha: folds 
townerz1991: folds 
Uncalled bet ($0.10) returned to Innerwuss
Innerwuss collected $0.25 from pot
*** SUMMARY ***
Total pot $0.25 | Rake $0 
Seat 1: kusa4ki folded before Flop (didn't bet)
Seat 2: el toro 1507 folded before Flop (didn't bet)
Seat 3: ex3Lero86 folded before Flop (didn't bet)
Seat 4: Innerwuss (button) collected ($0.25)
Seat 5: Kazacha (small blind) folded before Flop
Seat 6: townerz1991 (big blind) folded before Flop



PokerStars Hand #166667612018:  Hold'em No Limit ($0.05/$0.10 USD) - 2017/02/23 16:04:20 ET
Table 'Xanthippe II' 6-max Seat #6 is the button
Seat 1: ade22345 ($8.60 in chips) 
Seat 2: Bird et al ($13.51 in chips) 
Seat 3: Dcaro31 ($10 in chips) 
Seat 4: Barcardi14 ($6.26 in chips) 
Seat 5: yodzik ($5 in chips) 
Seat 6: Orlangoor ($10.89 in chips) 
ade22345: posts small blind $0.05
Bird et al: posts big blind $0.10
*** HOLE CARDS ***
Dcaro31: folds 
Barcardi14: folds 
yodzik: folds 
Orlangoor: folds 
ade22345: folds 
Uncalled bet ($0.05) returned to Bird et al
Bird et al collected $0.10 from pot
*** SUMMARY ***
Total pot $0.10 | Rake $0 
Seat 1: ade22345 (small blind) folded before Flop
Seat 2: Bird et al (big blind) collected ($0.10)
Seat 3: Dcaro31 folded before Flop (didn't bet)
Seat 4: Barcardi14 folded before Flop (didn't bet)
Seat 5: yodzik folded before Flop (didn't bet)
Seat 6: Orlangoor (button) folded before Flop (didn't bet)



PokerStars Hand #166667612380:  Hold'em No Limit ($0.05/$0.10 USD) - 2017/02/23 16:04:20 ET
Table 'Rotraut' 6-max Seat #6 is the button
Seat 2: Newqbrown ($11.49 in chips) 
Seat 3: FlackoD ($11.67 in chips) 
Seat 5: Bird et al ($11.75 in chips) 
Seat 6: KokoulinV ($12.84 in chips) 
Newqbrown: posts small blind $0.05
FlackoD: posts big blind $0.10
*** HOLE CARDS ***
Bird et al: folds 
KokoulinV: raises $0.15 to $0.25
Newqbrown: calls $0.20
FlackoD: raises $0.65 to $0.90
KokoulinV: folds 
Newqbrown: folds 
Uncalled bet ($0.65) returned to FlackoD
FlackoD collected $0.75 from pot
*** SUMMARY ***
Total pot $0.75 | Rake $0 
Seat 2: Newqbrown (small blind) folded before Flop
Seat 3: FlackoD (big blind) collected ($0.75)
Seat 5: Bird et al folded before Flop (didn't bet)
Seat 6: KokoulinV (button) folded before Flop



PokerStars Hand #166667612497:  Hold'em No Limit ($0.05/$0.10 USD) - 2017/02/23 16:04:20 ET
Table 'Stroobantia' 6-max Seat #1 is the button
Seat 1: mam9zyc ($8.59 in chips) 
Seat 2: XwinX25 ($10 in chips) 
Seat 3: Namhkal ($10 in chips) 
Seat 4: Yspenyanin ($10.13 in chips) 
Seat 5: boxer821 ($11.24 in chips) 
Seat 6: KokoulinV ($15.67 in chips) 
XwinX25: posts small blind $0.05
Namhkal: posts big blind $0.10
*** HOLE CARDS ***
Yspenyanin: folds 
boxer821: folds 
KokoulinV: raises $0.15 to $0.25
mam9zyc: folds 
XwinX25: folds 
Namhkal: folds 
Uncalled bet ($0.15) returned to KokoulinV
KokoulinV collected $0.25 from pot
*** SUMMARY ***
Total pot $0.25 | Rake $0 
Seat 1: mam9zyc (button) folded before Flop (didn't bet)
Seat 2: XwinX25 (small blind) folded before Flop
Seat 3: Namhkal (big blind) folded before Flop
Seat 4: Yspenyanin folded before Flop (didn't bet)
Seat 5: boxer821 folded before Flop (didn't bet)
Seat 6: KokoulinV collected ($0.25)



PokerStars Hand #166667612640:  Hold'em No Limit ($0.05/$0.10 USD) - 2017/02/23 16:04:20 ET
Table 'Deflotte' 6-max Seat #2 is the button
Seat 1: Zooplack ($15.79 in chips) 
Seat 2: MonteCris92 ($10 in chips) 
Seat 3: Croplayer1 ($10.20 in chips) 
Seat 4: 8th wonders ($10.42 in chips) 
Seat 5: Pokeaster ($11.12 in chips) 
Seat 6: Iarlei ($12 in chips) 
Croplayer1: posts small blind $0.05
8th wonders: posts big blind $0.10
*** HOLE CARDS ***
Pokeaster: folds 
Iarlei: folds 
Zooplack: folds 
MonteCris92: raises $0.10 to $0.20
Croplayer1: folds 
8th wonders: calls $0.10
*** FLOP *** [4d Kh 7c]
8th wonders: checks 
MonteCris92: bets $0.30
8th wonders: folds 
Uncalled bet ($0.30) returned to MonteCris92
MonteCris92 collected $0.43 from pot
*** SUMMARY ***
Total pot $0.45 | Rake $0.02 
Board [4d Kh 7c]
Seat 1: Zooplack folded before Flop (didn't bet)
Seat 2: MonteCris92 (button) collected ($0.43)
Seat 3: Croplayer1 (small blind) folded before Flop
Seat 4: 8th wonders (big blind) folded on the Flop
Seat 5: Pokeaster folded before Flop (didn't bet)
Seat 6: Iarlei folded before Flop (didn't bet)



PokerStars Hand #166667612693:  Hold'em No Limit ($0.05/$0.10 USD) - 2017/02/23 16:04:20 ET
Table 'Ostara III' 6-max Seat #3 is the button
Seat 1: MühliJr ($10 in chips) 
Seat 2: Action_Gibi ($10.04 in chips) 
Seat 3: vtalian ($11.74 in chips) 
Seat 6: FlopsterGB ($10.10 in chips) 
FlopsterGB: posts small blind $0.05
MühliJr: posts big blind $0.10
*** HOLE CARDS ***
Action_Gibi: folds 
vtalian: raises $0.20 to $0.30
FlopsterGB: folds 
MühliJr: raises $0.70 to $1
vtalian: folds 
Uncalled bet ($0.70) returned to MühliJr
MühliJr collected $0.65 from pot
*** SUMMARY ***
Total pot $0.65 | Rake $0 
Seat 1: MühliJr (big blind) collected ($0.65)
Seat 2: Action_Gibi folded before Flop (didn't bet)
Seat 3: vtalian (button) folded before Flop
Seat 6: FlopsterGB (small blind) folded before Flop



PokerStars Hand #166667612952:  Hold'em No Limit ($0.05/$0.10 USD) - 2017/02/23 16:04:21 ET
Table 'Wingolfia II' 6-max Seat #5 is the button
Seat 1: BahiaMinhaP ($10.15 in chips) 
Seat 2: NvR.m1nD ($10.60 in chips) 
Seat 3: truck1234 ($10 in chips) 
Seat 4: zlobslob ($18.42 in chips) 
Seat 5: tr41n3r12 ($11.43 in chips) 
Seat 6: EphemeralBen ($11.74 in chips) 
EphemeralBen: posts small blind $0.05
BahiaMinhaP: posts big blind $0.10
*** HOLE CARDS ***
NvR.m1nD: folds 
truck1234: raises $0.30 to $0.40
zlobslob: calls $0.40
tr41n3r12: folds 
EphemeralBen: folds 
BahiaMinhaP: folds 
*** FLOP *** [7s 6d As]
truck1234: bets $0.60
zlobslob: folds 
Uncalled bet ($0.60) returned to truck1234
truck1234 collected $0.91 from pot
*** SUMMARY ***
Total pot $0.95 | Rake $0.04 
Board [7s 6d As]
Seat 1: BahiaMinhaP (big blind) folded before Flop
Seat 2: NvR.m1nD folded before Flop (didn't bet)
Seat 3: truck1234 collected ($0.91)
Seat 4: zlobslob folded on the Flop
Seat 5: tr41n3r12 (button) folded before Flop (didn't bet)
Seat 6: EphemeralBen (small blind) folded before Flop



PokerStars Hand #166667613603:  Hold'em No Limit ($0.05/$0.10 USD) - 2017/02/23 16:04:21 ET
Table 'Nemo III' 6-max Seat #2 is the button
Seat 2: Bandyaev ($11.59 in chips) 
Seat 4: vtalian ($9.60 in chips) 
Seat 5: Joker51_wtf! ($11.58 in chips) 
vtalian: posts small blind $0.05
Joker51_wtf!: posts big blind $0.10
Kow6oy: sits out 
*** HOLE CARDS ***
Bandyaev: raises $0.20 to $0.30
vtalian: folds 
Joker51_wtf!: folds 
Uncalled bet ($0.20) returned to Bandyaev
Bandyaev collected $0.25 from pot
*** SUMMARY ***
Total pot $0.25 | Rake $0 
Seat 2: Bandyaev (button) collected ($0.25)
Seat 4: vtalian (small blind) folded before Flop
Seat 5: Joker51_wtf! (big blind) folded before Flop



PokerStars Hand #166667613633:  Hold'em No Limit ($0.05/$0.10 USD) - 2017/02/23 16:04:21 ET
Table 'Nephthys II' 6-max Seat #6 is the button
Seat 1: DamDatsAnAce ($10 in chips) 
Seat 3: Newqbrown ($21.88 in chips) 
Seat 5: kingartur222 ($9.01 in chips) 
Seat 6: CHRO8 ($14.34 in chips) 
DamDatsAnAce: posts small blind $0.05
AC Evergreen: is sitting out 
Newqbrown: posts big blind $0.10
AC Evergreen leaves the table
MihaGr: sits out 
*** HOLE CARDS ***
JahSoldier69 joins the table at seat #2 
kingartur222: raises $0.15 to $0.25
JahSoldier69 leaves the table
CHRO8: folds 
DamDatsAnAce: folds 
Newqbrown: calls $0.15
*** FLOP *** [8s Jc Ac]
Newqbrown: bets $0.40
kingartur222: folds 
Uncalled bet ($0.40) returned to Newqbrown
Newqbrown collected $0.53 from pot
*** SUMMARY ***
Total pot $0.55 | Rake $0.02 
Board [8s Jc Ac]
Seat 1: DamDatsAnAce (small blind) folded before Flop
Seat 3: Newqbrown (big blind) collected ($0.53)
Seat 5: kingartur222 folded on the Flop
Seat 6: CHRO8 (button) folded before Flop (didn't bet)



PokerStars Hand #166667613649:  Hold'em No Limit ($0.05/$0.10 USD) - 2017/02/23 16:04:21 ET
Table 'Scabiosa III' 6-max Seat #1 is the button
Seat 1: Feverhead ($13.26 in chips) 
Seat 2: yodzik ($5 in chips) 
Seat 4: voledy ($10.25 in chips) 
Seat 5: patrick19111 ($25.60 in chips) 
Seat 6: Smitty03300 ($10 in chips) 
yodzik: posts small blind $0.05
Goroshkos88: is sitting out 
voledy: posts big blind $0.10
*** HOLE CARDS ***
Goroshkos88 leaves the table
patrick19111: folds 
Smitty03300: raises $0.15 to $0.25
Feverhead: folds 
yodzik: folds 
voledy: folds 
Uncalled bet ($0.15) returned to Smitty03300
Smitty03300 collected $0.25 from pot
*** SUMMARY ***
Total pot $0.25 | Rake $0 
Seat 1: Feverhead (button) folded before Flop (didn't bet)
Seat 2: yodzik (small blind) folded before Flop
Seat 4: voledy (big blind) folded before Flop
Seat 5: patrick19111 folded before Flop (didn't bet)
Seat 6: Smitty03300 collected ($0.25)



PokerStars Hand #166667614296:  Hold'em No Limit ($0.05/$0.10 USD) - 2017/02/23 16:04:22 ET
Table 'Kanda' 6-max Seat #5 is the button
Seat 1: Andy Wolf ($11.27 in chips) 
Seat 2: Pelotín ($5.30 in chips) 
Seat 4: Orlangoor ($10.19 in chips) 
Seat 5: Dimka4 ($10 in chips) 
Seat 6: oddshoff ($8.71 in chips) 
oddshoff: posts small blind $0.05
Andy Wolf: posts big blind $0.10
XaXaTyH4uK: sits out 
*** HOLE CARDS ***
Pelotín: folds 
Orlangoor: folds 
Dimka4: raises $0.15 to $0.25
oddshoff: raises $0.65 to $0.90
Andy Wolf: folds 
Dimka4: folds 
Uncalled bet ($0.65) returned to oddshoff
oddshoff collected $0.60 from pot
*** SUMMARY ***
Total pot $0.60 | Rake $0 
Seat 1: Andy Wolf (big blind) folded before Flop
Seat 2: Pelotín folded before Flop (didn't bet)
Seat 4: Orlangoor folded before Flop (didn't bet)
Seat 5: Dimka4 (button) folded before Flop
Seat 6: oddshoff (small blind) collected ($0.60)



PokerStars Hand #166667614411:  Hold'em No Limit ($0.05/$0.10 USD) - 2017/02/23 16:04:22 ET
Table 'Sheragul III' 6-max Seat #2 is the button
Seat 1: danky24 ($18.79 in chips) 
Seat 2: Bird et al ($11.81 in chips) 
Seat 4: maxiv608 ($11.29 in chips) 
Seat 5: Bandyaev ($14.72 in chips) 
Seat 6: Andrei ProFF ($10 in chips) 
FRAID358 will be allowed to play after the button
maxiv608: posts small blind $0.05
Bandyaev: posts big blind $0.10
*** HOLE CARDS ***
Andrei ProFF: folds 
danky24: raises $0.10 to $0.20
Bird et al: calls $0.20
maxiv608: folds 
Bandyaev: calls $0.10
*** FLOP *** [3c 9d 4s]
Bandyaev: checks 
danky24: bets $0.10
Bird et al: calls $0.10
Bandyaev: calls $0.10
*** TURN *** [3c 9d 4s] [8d]
Bandyaev: checks 
danky24: bets $0.10
Bird et al: raises $0.94 to $1.04
Bandyaev: raises $3.05 to $4.09
danky24: folds 
Bird et al: folds 
Uncalled bet ($3.05) returned to Bandyaev
Bandyaev collected $2.99 from pot
*** SUMMARY ***
Total pot $3.13 | Rake $0.14 
Board [3c 9d 4s 8d]
Seat 1: danky24 folded on the Turn
Seat 2: Bird et al (button) folded on the Turn
Seat 4: maxiv608 (small blind) folded before Flop
Seat 5: Bandyaev (big blind) collected ($2.99)
Seat 6: Andrei ProFF folded before Flop (didn't bet)



PokerStars Hand #166667614948:  Hold'em No Limit ($0.05/$0.10 USD) - 2017/02/23 16:04:23 ET
Table 'Tyndareus II' 6-max Seat #2 is the button
Seat 1: Makc1705 ($3.65 in chips) 
Seat 2: Therodorus ($11.62 in chips) 
Seat 3: McCleans ($11.11 in chips) 
Seat 4: gaHy_HaXeP ($11.21 in chips) 
Seat 5: vtalian ($10 in chips) 
Seat 6: sexy_seagull ($10.30 in chips) 
McCleans: posts small blind $0.05
gaHy_HaXeP: posts big blind $0.10
*** HOLE CARDS ***
vtalian: folds 
sexy_seagull: folds 
Makc1705: folds 
Therodorus: raises $0.15 to $0.25
McCleans: raises $0.60 to $0.85
gaHy_HaXeP: raises $1.15 to $2
Therodorus: folds 
McCleans: folds 
Uncalled bet ($1.15) returned to gaHy_HaXeP
gaHy_HaXeP collected $1.95 from pot
*** SUMMARY ***
Total pot $1.95 | Rake $0 
Seat 1: Makc1705 folded before Flop (didn't bet)
Seat 2: Therodorus (button) folded before Flop
Seat 3: McCleans (small blind) folded before Flop
Seat 4: gaHy_HaXeP (big blind) collected ($1.95)
Seat 5: vtalian folded before Flop (didn't bet)
Seat 6: sexy_seagull folded before Flop (didn't bet)



PokerStars Hand #166667614966:  Hold'em No Limit ($0.05/$0.10 USD) - 2017/02/23 16:04:23 ET
Table 'Crommelin II' 6-max Seat #2 is the button
Seat 1: THIMUCHIN ($11.62 in chips) 
Seat 2: Bird et al ($10 in chips) 
Seat 3: Strelok1974 ($21.85 in chips) 
Seat 4: Pequeño Clau ($10.15 in chips) 
Seat 5: Action_Gibi ($20.39 in chips) 
Strelok1974: posts small blind $0.05
Pequeño Clau: posts big blind $0.10
*** HOLE CARDS ***
Action_Gibi: folds 
THIMUCHIN: folds 
Bird et al: folds 
Strelok1974: folds 
Uncalled bet ($0.05) returned to Pequeño Clau
Pequeño Clau collected $0.10 from pot
*** SUMMARY ***
Total pot $0.10 | Rake $0 
Seat 1: THIMUCHIN folded before Flop (didn't bet)
Seat 2: Bird et al (button) folded before Flop (didn't bet)
Seat 3: Strelok1974 (small blind) folded before Flop
Seat 4: Pequeño Clau (big blind) collected ($0.10)
Seat 5: Action_Gibi folded before Flop (didn't bet)



PokerStars Hand #166667615508:  Hold'em No Limit ($0.05/$0.10 USD) - 2017/02/23 16:04:23 ET
Table 'Pirola III' 6-max Seat #4 is the button
Seat 1: bdixon_5 ($9.47 in chips) 
Seat 2: gaHy_HaXeP ($10 in chips) 
Seat 3: kingartur222 ($10.82 in chips) 
Seat 4: McCleans ($10.30 in chips) 
Seat 5: tequila_joop ($10.30 in chips) 
Seat 6: T9MS ($10 in chips) 
tequila_joop: posts small blind $0.05
T9MS: posts big blind $0.10
*** HOLE CARDS ***
bdixon_5: folds 
gaHy_HaXeP: raises $0.20 to $0.30
kingartur222: folds 
McCleans: calls $0.30
tequila_joop: folds 
T9MS: folds 
*** FLOP *** [3c Qh Qc]
gaHy_HaXeP: checks 
McCleans: bets $0.40
gaHy_HaXeP: folds 
Uncalled bet ($0.40) returned to McCleans
McCleans collected $0.72 from pot
*** SUMMARY ***
Total pot $0.75 | Rake $0.03 
Board [3c Qh Qc]
Seat 1: bdixon_5 folded before Flop (didn't bet)
Seat 2: gaHy_HaXeP folded on the Flop
Seat 3: kingartur222 folded before Flop (didn't bet)
Seat 4: McCleans (button) collected ($0.72)
Seat 5: tequila_joop (small blind) folded before Flop
Seat 6: T9MS (big blind) folded before Flop



PokerStars Hand #166667615548:  Hold'em No Limit ($0.05/$0.10 USD) - 2017/02/23 16:04:24 ET
Table 'Clavel' 6-max Seat #5 is the button
Seat 1: KRZuff ($14.51 in chips) 
Seat 4: Dcaro31 ($11.98 in chips) 
Seat 5: Vrinni ($10.39 in chips) 
Seat 6: Gra_anD77 ($4.24 in chips) 
Gra_anD77: posts small blind $0.05
KRZuff: posts big blind $0.10
Namhkal: sits out 
*** HOLE CARDS ***
Dcaro31: folds 
Vrinni: raises $0.15 to $0.25
Gra_anD77: calls $0.20
KRZuff: folds 
*** FLOP *** [Jd 3h 9d]
Gra_anD77: bets $0.29
Vrinni: folds 
Uncalled bet ($0.29) returned to Gra_anD77
Gra_anD77 collected $0.57 from pot
*** SUMMARY ***
Total pot $0.60 | Rake $0.03 
Board [Jd 3h 9d]
Seat 1: KRZuff (big blind) folded before Flop
Seat 4: Dcaro31 folded before Flop (didn't bet)
Seat 5: Vrinni (button) folded on the Flop
Seat 6: Gra_anD77 (small blind) collected ($0.57)



PokerStars Hand #166667615576:  Hold'em No Limit ($0.05/$0.10 USD) - 2017/02/23 16:04:24 ET
Table 'Isberga' 6-max Seat #6 is the button
Seat 1: Feverhead ($18.22 in chips) 
Seat 2: GESPERIA ($10.15 in chips) 
Seat 4: THIMUCHIN ($11.04 in chips) 
Seat 5: YoungGriff86 ($19.02 in chips) 
Seat 6: Goroshkos88 ($20.95 in chips) 
Feverhead: posts small blind $0.05
GESPERIA: posts big blind $0.10
*** HOLE CARDS ***
THIMUCHIN: folds 
YoungGriff86: folds 
Goroshkos88: raises $0.15 to $0.25
Feverhead: folds 
GESPERIA: calls $0.15
*** FLOP *** [7c Qd 9d]
GESPERIA: checks 
Goroshkos88: bets $0.35
GESPERIA: folds 
Uncalled bet ($0.35) returned to Goroshkos88
Goroshkos88 collected $0.53 from pot
*** SUMMARY ***
Cruger: !!???????!!??!!??
Total pot $0.55 | Rake $0.02 
Board [7c Qd 9d]
Seat 1: Feverhead (small blind) folded before Flop
Seat 2: GESPERIA (big blind) folded on the Flop
Seat 4: THIMUCHIN folded before Flop (didn't bet)
Seat 5: YoungGriff86 folded before Flop (didn't bet)
Seat 6: Goroshkos88 (button) collected ($0.53)



PokerStars Hand #166667615897:  Hold'em No Limit ($0.05/$0.10 USD) - 2017/02/23 16:04:24 ET
Table 'Serpens' 6-max Seat #3 is the button
Seat 1: Namhkal ($10.30 in chips) 
Seat 2: KA3AXCTAHEU, ($10 in chips) 
Seat 3: homelessdan ($29.44 in chips) 
Seat 4: Ragazzi3 ($16.74 in chips) 
Seat 5: XwinX25 ($11.81 in chips) 
Seat 6: Croplayer1 ($10.15 in chips) 
Ragazzi3: posts small blind $0.05
XwinX25: posts big blind $0.10
*** HOLE CARDS ***
Croplayer1: folds 
Namhkal: folds 
KA3AXCTAHEU,: raises $0.15 to $0.25
homelessdan: folds 
Ragazzi3: raises $0.35 to $0.60
XwinX25: folds 
KA3AXCTAHEU,: raises $1.30 to $1.90
Ragazzi3: calls $1.30
*** FLOP *** [9s Qc 9h]
Ragazzi3: bets $2.50
KA3AXCTAHEU,: calls $2.50
*** TURN *** [9s Qc 9h] [3s]
Ragazzi3: bets $12.34 and is all-in
KA3AXCTAHEU,: calls $5.60 and is all-in
Uncalled bet ($6.74) returned to Ragazzi3
*** RIVER *** [9s Qc 9h 3s] [3d]
*** SHOW DOWN ***
Ragazzi3: shows [Jh As] (two pair, Nines and Threes)
KA3AXCTAHEU,: shows [Ah Ac] (two pair, Aces and Nines)
KA3AXCTAHEU, collected $19.20 from pot
*** SUMMARY ***
Total pot $20.10 | Rake $0.90 
Board [9s Qc 9h 3s 3d]
Seat 1: Namhkal folded before Flop (didn't bet)
Seat 2: KA3AXCTAHEU, showed [Ah Ac] and won ($19.20) with two pair, Aces and Nines
Seat 3: homelessdan (button) folded before Flop (didn't bet)
Seat 4: Ragazzi3 (small blind) showed [Jh As] and lost with two pair, Nines and Threes
Seat 5: XwinX25 (big blind) folded before Flop
Seat 6: Croplayer1 folded before Flop (didn't bet)



PokerStars Hand #166667615981:  Hold'em No Limit ($0.05/$0.10 USD) - 2017/02/23 16:04:24 ET
Table 'Arduina' 6-max Seat #4 is the button
Seat 2: Andy Wolf ($14.45 in chips) 
Seat 3: Dcaro31 ($13.11 in chips) 
Seat 4: ChuikaPridi ($29.23 in chips) 
Seat 5: ettedallas ($6.68 in chips) 
Seat 6: dierri ($9.89 in chips) 
ettedallas: posts small blind $0.05
dierri: posts big blind $0.10
tauronex: sits out 
*** HOLE CARDS ***
Andy Wolf: folds 
Dcaro31: folds 
ChuikaPridi: folds 
ettedallas: raises $0.20 to $0.30
dierri: calls $0.20
*** FLOP *** [7h 9h 6c]
ettedallas: checks 
dierri: checks 
*** TURN *** [7h 9h 6c] [3h]
ettedallas: checks 
dierri: bets $0.29
ettedallas: calls $0.29
*** RIVER *** [7h 9h 6c 3h] [Ac]
ettedallas: bets $1.20
dierri: folds 
Uncalled bet ($1.20) returned to ettedallas
ettedallas collected $1.13 from pot
*** SUMMARY ***
Total pot $1.18 | Rake $0.05 
Board [7h 9h 6c 3h Ac]
Seat 2: Andy Wolf folded before Flop (didn't bet)
Seat 3: Dcaro31 folded before Flop (didn't bet)
Seat 4: ChuikaPridi (button) folded before Flop (didn't bet)
Seat 5: ettedallas (small blind) collected ($1.13)
Seat 6: dierri (big blind) folded on the River



PokerStars Hand #166667616082:  Hold'em No Limit ($0.05/$0.10 USD) - 2017/02/23 16:04:24 ET
Table 'Duhr II' 6-max Seat #3 is the button
Seat 1: Lucky HoBBiT ($10 in chips) 
Seat 2: Feverhead ($37.89 in chips) 
Seat 3: Innerwuss ($23.03 in chips) 
Seat 4: CHRO8 ($9.90 in chips) 
Seat 6: townerz1991 ($10 in chips) 
CHRO8: posts small blind $0.05
Punzzzer: is sitting out 
townerz1991: posts big blind $0.10
*** HOLE CARDS ***
Punzzzer leaves the table
Lucky HoBBiT: folds 
Feverhead: folds 
Innerwuss: folds 
Asilvagoat joins the table at seat #5 
CHRO8: folds 
Uncalled bet ($0.05) returned to townerz1991
townerz1991 collected $0.10 from pot
*** SUMMARY ***
Total pot $0.10 | Rake $0 
Seat 1: Lucky HoBBiT folded before Flop (didn't bet)
Seat 2: Feverhead folded before Flop (didn't bet)
Seat 3: Innerwuss (button) folded before Flop (didn't bet)
Seat 4: CHRO8 (small blind) folded before Flop
Seat 6: townerz1991 (big blind) collected ($0.10)



PokerStars Hand #166667616120:  Hold'em No Limit ($0.05/$0.10 USD) - 2017/02/23 16:04:24 ET
Table 'Manto II' 6-max Seat #2 is the button
Seat 1: MihaGr ($10 in chips) 
Seat 2: voledy ($10 in chips) 
Seat 3: Komap511 ($10.05 in chips) 
Seat 4: dr.goofy ($10.42 in chips) 
Seat 5: ArcticBearDK ($32.69 in chips) 
Seat 6: pancernik21 ($16.20 in chips) 
Komap511: posts small blind $0.05
dr.goofy: posts big blind $0.10
*** HOLE CARDS ***
ArcticBearDK: folds 
pancernik21: folds 
MihaGr: raises $0.20 to $0.30
voledy: folds 
Komap511: calls $0.25
dr.goofy: folds 
*** FLOP *** [Th 3c Qh]
Komap511: checks 
MihaGr: checks 
*** TURN *** [Th 3c Qh] [3d]
Komap511: bets $0.40
MihaGr: folds 
Uncalled bet ($0.40) returned to Komap511
Komap511 collected $0.67 from pot
*** SUMMARY ***
Total pot $0.70 | Rake $0.03 
Board [Th 3c Qh 3d]
Seat 1: MihaGr folded on the Turn
Seat 2: voledy (button) folded before Flop (didn't bet)
Seat 3: Komap511 (small blind) collected ($0.67)
Seat 4: dr.goofy (big blind) folded before Flop
Seat 5: ArcticBearDK folded before Flop (didn't bet)
Seat 6: pancernik21 folded before Flop (didn't bet)



PokerStars Hand #166667617093:  Hold'em No Limit ($0.05/$0.10 USD) - 2017/02/23 16:04:25 ET
Table 'Brambilla II' 6-max Seat #3 is the button
Seat 1: Rodik002 ($12.87 in chips) 
Seat 2: dwonder75 ($13.79 in chips) 
Seat 3: BORIS_ENEV ($14.47 in chips) 
Seat 4: david_sara83 ($11.87 in chips) 
Seat 5: FRAID358 ($10 in chips) 
Seat 6: boxer821 ($10.48 in chips) 
david_sara83: posts small blind $0.05
FRAID358: posts big blind $0.10
*** HOLE CARDS ***
boxer821: folds 
Rodik002: folds 
dwonder75: folds 
BORIS_ENEV: folds 
david_sara83: folds 
Uncalled bet ($0.05) returned to FRAID358
FRAID358 collected $0.10 from pot
*** SUMMARY ***
Total pot $0.10 | Rake $0 
Seat 1: Rodik002 folded before Flop (didn't bet)
Seat 2: dwonder75 folded before Flop (didn't bet)
Seat 3: BORIS_ENEV (button) folded before Flop (didn't bet)
Seat 4: david_sara83 (small blind) folded before Flop
Seat 5: FRAID358 (big blind) collected ($0.10)
Seat 6: boxer821 folded before Flop (didn't bet)



PokerStars Hand #166667617633:  Hold'em No Limit ($0.05/$0.10 USD) - 2017/02/23 16:04:26 ET
Table 'Lampetia III' 6-max Seat #3 is the button
Seat 1: gaHy_HaXeP ($10.55 in chips) 
Seat 2: DamDatsAnAce ($10 in chips) 
Seat 3: Therodorus ($10 in chips) 
Seat 4: IAntikI ($11.66 in chips) 
Seat 5: robson1235 ($19.55 in chips) 
Seat 6: bdixon_5 ($9.35 in chips) 
IAntikI: posts small blind $0.05
robson1235: posts big blind $0.10
*** HOLE CARDS ***
bdixon_5: folds 
gaHy_HaXeP: folds 
DamDatsAnAce: folds 
Therodorus: folds 
IAntikI: raises $0.15 to $0.25
robson1235: calls $0.15
*** FLOP *** [3d 6c Qd]
IAntikI: checks 
robson1235: checks 
*** TURN *** [3d 6c Qd] [Kh]
IAntikI: checks 
robson1235: bets $0.24
IAntikI: folds 
Uncalled bet ($0.24) returned to robson1235
robson1235 collected $0.48 from pot
*** SUMMARY ***
Total pot $0.50 | Rake $0.02 
Board [3d 6c Qd Kh]
Seat 1: gaHy_HaXeP folded before Flop (didn't bet)
Seat 2: DamDatsAnAce folded before Flop (didn't bet)
Seat 3: Therodorus (button) folded before Flop (didn't bet)
Seat 4: IAntikI (small blind) folded on the Turn
Seat 5: robson1235 (big blind) collected ($0.48)
Seat 6: bdixon_5 folded before Flop (didn't bet)



PokerStars Hand #166667617650:  Hold'em No Limit ($0.05/$0.10 USD) - 2017/02/23 16:04:26 ET
Table 'Hajek III' 6-max Seat #4 is the button
Seat 1: MBen10 ($10.75 in chips) 
Seat 2: fortieth ($10.19 in chips) 
Seat 3: fedorka rus ($10.46 in chips) 
Seat 4: NvR.m1nD ($13.39 in chips) 
Seat 5: Croplayer1 ($14.80 in chips) 
Croplayer1: posts small blind $0.05
fabadam: is sitting out 
MBen10: posts big blind $0.10
*** HOLE CARDS ***
fortieth: folds 
fedorka rus: raises $0.20 to $0.30
NvR.m1nD: folds 
Croplayer1: folds 
MBen10: folds 
Uncalled bet ($0.20) returned to fedorka rus
fedorka rus collected $0.25 from pot
*** SUMMARY ***
Total pot $0.25 | Rake $0 
Seat 1: MBen10 (big blind) folded before Flop
Seat 2: fortieth folded before Flop (didn't bet)
Seat 3: fedorka rus collected ($0.25)
Seat 4: NvR.m1nD (button) folded before Flop (didn't bet)
Seat 5: Croplayer1 (small blind) folded before Flop



PokerStars Hand #166667617708:  Hold'em No Limit ($0.05/$0.10 USD) - 2017/02/23 16:04:26 ET
Table 'Peiroos' 6-max Seat #1 is the button
Seat 1: ksandr_hom ($10 in chips) 
Seat 2: Nr847 ($10 in chips) 
Seat 3: atlx0711 ($26.87 in chips) 
Seat 4: Peter0087 ($10 in chips) 
Seat 5: sergio-cb164 ($9.10 in chips) 
Seat 6: DevonMiles88 ($4.49 in chips) 
Nr847: posts small blind $0.05
atlx0711: posts big blind $0.10
*** HOLE CARDS ***
Peter0087: folds 
sergio-cb164: folds 
DevonMiles88: raises $0.10 to $0.20
ksandr_hom: calls $0.20
Nr847: folds 
atlx0711: calls $0.10
*** FLOP *** [3c 8s Jd]
atlx0711: checks 
DevonMiles88: bets $0.40
ksandr_hom: folds 
atlx0711: folds 
Uncalled bet ($0.40) returned to DevonMiles88
DevonMiles88 collected $0.62 from pot
*** SUMMARY ***
Total pot $0.65 | Rake $0.03 
Board [3c 8s Jd]
Seat 1: ksandr_hom (button) folded on the Flop
Seat 2: Nr847 (small blind) folded before Flop
Seat 3: atlx0711 (big blind) folded on the Flop
Seat 4: Peter0087 folded before Flop (didn't bet)
Seat 5: sergio-cb164 folded before Flop (didn't bet)
Seat 6: DevonMiles88 collected ($0.62)



PokerStars Hand #166667617899:  Hold'em No Limit ($0.05/$0.10 USD) - 2017/02/23 16:04:26 ET
Table 'Unitas II' 6-max Seat #4 is the button
Seat 1: Peter0087 ($9.85 in chips) 
Seat 4: truck1234 ($10.94 in chips) 
Seat 5: chimera252 ($25.96 in chips) 
Seat 6: paxit71 ($8.27 in chips) 
chimera252: posts small blind $0.05
paxit71: posts big blind $0.10
steepfell: sits out 
*** HOLE CARDS ***
JahSoldier69 joins the table at seat #3 
Peter0087: folds 
JahSoldier69 leaves the table
truck1234: folds 
chimera252: folds 
Uncalled bet ($0.05) returned to paxit71
paxit71 collected $0.10 from pot
*** SUMMARY ***
Total pot $0.10 | Rake $0 
Seat 1: Peter0087 folded before Flop (didn't bet)
Seat 4: truck1234 (button) folded before Flop (didn't bet)
Seat 5: chimera252 (small blind) folded before Flop
Seat 6: paxit71 (big blind) collected ($0.10)



PokerStars Hand #166667617984:  Hold'em No Limit ($0.05/$0.10 USD) - 2017/02/23 16:04:26 ET
Table 'Esperanto II' 6-max Seat #3 is the button
Seat 1: kurasd ($10.91 in chips) 
Seat 2: MihaGr ($10.04 in chips) 
Seat 3: Namhkal ($12.10 in chips) 
Seat 4: Andrei ProFF ($10.55 in chips) 
Seat 5: FRAID358 ($10 in chips) 
Seat 6: ArcticBearDK ($12.73 in chips) 
Andrei ProFF: posts small blind $0.05
FRAID358: posts big blind $0.10
*** HOLE CARDS ***
ArcticBearDK: folds 
kurasd: calls $0.10
MihaGr: folds 
Namhkal: folds 
Andrei ProFF: calls $0.05
FRAID358: checks 
*** FLOP *** [7d 2d 3c]
Andrei ProFF: checks 
FRAID358: checks 
kurasd: bets $0.40
Andrei ProFF: folds 
FRAID358: folds 
Uncalled bet ($0.40) returned to kurasd
kurasd collected $0.29 from pot
*** SUMMARY ***
Total pot $0.30 | Rake $0.01 
Board [7d 2d 3c]
Seat 1: kurasd collected ($0.29)
Seat 2: MihaGr folded before Flop (didn't bet)
Seat 3: Namhkal (button) folded before Flop (didn't bet)
Seat 4: Andrei ProFF (small blind) folded on the Flop
Seat 5: FRAID358 (big blind) folded on the Flop
Seat 6: ArcticBearDK folded before Flop (didn't bet)



PokerStars Hand #166667618519:  Hold'em No Limit ($0.05/$0.10 USD) - 2017/02/23 16:04:27 ET
Table 'Reginhild' 6-max Seat #2 is the button
Seat 1: iamkakaroto ($11.40 in chips) 
Seat 2: Kow6oy ($10 in chips) 
Seat 3: ARCHITECT83 ($5.38 in chips) 
Seat 4: Raymondo21 ($23.36 in chips) 
Seat 5: XCarlos610 ($30.03 in chips) 
Seat 6: eniksenik ($10 in chips) 
ARCHITECT83: posts small blind $0.05
Raymondo21: posts big blind $0.10
*** HOLE CARDS ***
XCarlos610: calls $0.10
eniksenik: raises $0.40 to $0.50
iamkakaroto: folds 
Kow6oy: folds 
ARCHITECT83: raises $0.40 to $0.90
Raymondo21: folds 
XCarlos610: folds 
eniksenik: calls $0.40
*** FLOP *** [6c Jd Th]
ARCHITECT83: bets $4.48 and is all-in
eniksenik: folds 
Uncalled bet ($4.48) returned to ARCHITECT83
ARCHITECT83 collected $1.91 from pot
*** SUMMARY ***
Total pot $2 | Rake $0.09 
Board [6c Jd Th]
Seat 1: iamkakaroto folded before Flop (didn't bet)
Seat 2: Kow6oy (button) folded before Flop (didn't bet)
Seat 3: ARCHITECT83 (small blind) collected ($1.91)
Seat 4: Raymondo21 (big blind) folded before Flop
Seat 5: XCarlos610 folded before Flop
Seat 6: eniksenik folded on the Flop



PokerStars Hand #166667618805:  Hold'em No Limit ($0.05/$0.10 USD) - 2017/02/23 16:04:27 ET
Table 'California II' 6-max Seat #3 is the button
Seat 1: fedorka rus ($10 in chips) 
Seat 2: homelessdan ($10.15 in chips) 
Seat 3: Bird et al ($10.20 in chips) 
Seat 4: pokekrk ($12.01 in chips) 
Seat 6: chiko4040 ($7.69 in chips) 
pokekrk: posts small blind $0.05
chiko4040: posts big blind $0.10
*** HOLE CARDS ***
fedorka rus: raises $0.20 to $0.30
homelessdan: folds 
Bird et al: folds 
pokekrk: folds 
chiko4040: calls $0.20
*** FLOP *** [5s 7h 7s]
chiko4040: checks 
fedorka rus: checks 
*** TURN *** [5s 7h 7s] [2s]
chiko4040: bets $0.30
fedorka rus: folds 
Uncalled bet ($0.30) returned to chiko4040
chiko4040 collected $0.62 from pot
*** SUMMARY ***
Total pot $0.65 | Rake $0.03 
Board [5s 7h 7s 2s]
Seat 1: fedorka rus folded on the Turn
Seat 2: homelessdan folded before Flop (didn't bet)
Seat 3: Bird et al (button) folded before Flop (didn't bet)
Seat 4: pokekrk (small blind) folded before Flop
Seat 6: chiko4040 (big blind) collected ($0.62)



PokerStars Hand #166667618950:  Hold'em No Limit ($0.05/$0.10 USD) - 2017/02/23 16:04:27 ET
Table 'Pandora III' 6-max Seat #2 is the button
Seat 1: Pokeaster ($10.84 in chips) 
Seat 2: garigura ($11.62 in chips) 
Seat 4: mhonielsen ($10.05 in chips) 
Seat 5: MühliJr ($10.55 in chips) 
Seat 6: yodzik ($5 in chips) 
ChuikaPridi leaves the table
mhonielsen: posts small blind $0.05
MühliJr: posts big blind $0.10
*** HOLE CARDS ***
Chodemuncher joins the table at seat #3 
yodzik: folds 
Pokeaster: folds 
garigura: raises $0.12 to $0.22
mhonielsen: folds 
MühliJr: calls $0.12
*** FLOP *** [Ah 9c Qd]
MühliJr: checks 
garigura: bets $0.24
MühliJr: calls $0.24
*** TURN *** [Ah 9c Qd] [Jd]
MühliJr: checks 
garigura: checks 
*** RIVER *** [Ah 9c Qd Jd] [8h]
MühliJr: bets $0.60
garigura: raises $1.20 to $1.80
MühliJr: calls $1.20
*** SHOW DOWN ***
garigura: shows [Ts Js] (a straight, Eight to Queen)
MühliJr: shows [Ad Th] (a straight, Eight to Queen)
MühliJr collected $2.18 from pot
garigura collected $2.18 from pot
*** SUMMARY ***
Total pot $4.57 | Rake $0.21 
Board [Ah 9c Qd Jd 8h]
Seat 1: Pokeaster folded before Flop (didn't bet)
Seat 2: garigura (button) showed [Ts Js] and won ($2.18) with a straight, Eight to Queen
Seat 4: mhonielsen (small blind) folded before Flop
Seat 5: MühliJr (big blind) showed [Ad Th] and won ($2.18) with a straight, Eight to Queen
Seat 6: yodzik folded before Flop (didn't bet)



PokerStars Hand #166667618989:  Hold'em No Limit ($0.05/$0.10 USD) - 2017/02/23 16:04:27 ET
Table 'Ophelia' 6-max Seat #3 is the button
Seat 1: ralfi37 ($9.56 in chips) 
Seat 2: popypaleta ($16.63 in chips) 
Seat 3: mvp0013 ($11.45 in chips) 
Seat 4: Cluckh ($12.49 in chips) 
Seat 5: truck1234 ($14.01 in chips) 
Seat 6: Yabidooo ($10.86 in chips) 
Cluckh: posts small blind $0.05
truck1234: posts big blind $0.10
*** HOLE CARDS ***
Yabidooo: raises $0.20 to $0.30
ralfi37: calls $0.30
popypaleta: folds 
mvp0013: folds 
Cluckh: folds 
truck1234: folds 
*** FLOP *** [4h Kh 2d]
Yabidooo: bets $0.30
ralfi37: folds 
Uncalled bet ($0.30) returned to Yabidooo
Yabidooo collected $0.72 from pot
*** SUMMARY ***
Total pot $0.75 | Rake $0.03 
Board [4h Kh 2d]
Seat 1: ralfi37 folded on the Flop
Seat 2: popypaleta folded before Flop (didn't bet)
Seat 3: mvp0013 (button) folded before Flop (didn't bet)
Seat 4: Cluckh (small blind) folded before Flop
Seat 5: truck1234 (big blind) folded before Flop
Seat 6: Yabidooo collected ($0.72)



PokerStars Hand #166667619071:  Hold'em No Limit ($0.05/$0.10 USD) - 2017/02/23 16:04:27 ET
Table 'Nata II' 6-max Seat #6 is the button
Seat 1: luisantrs ($7.11 in chips) 
Seat 2: CHRO8 ($15.85 in chips) 
Seat 3: 8th wonders ($10 in chips) 
Seat 4: Comeback3392 ($10 in chips) 
Seat 5: RoJ1 ($12.08 in chips) 
Seat 6: IAntikI ($11.36 in chips) 
luisantrs: posts small blind $0.05
CHRO8: posts big blind $0.10
*** HOLE CARDS ***
8th wonders: folds 
Comeback3392: folds 
RoJ1: folds 
IAntikI: folds 
luisantrs: raises $0.10 to $0.20
CHRO8: folds 
Uncalled bet ($0.10) returned to luisantrs
luisantrs collected $0.20 from pot
*** SUMMARY ***
Total pot $0.20 | Rake $0 
Seat 1: luisantrs (small blind) collected ($0.20)
Seat 2: CHRO8 (big blind) folded before Flop
Seat 3: 8th wonders folded before Flop (didn't bet)
Seat 4: Comeback3392 folded before Flop (didn't bet)
Seat 5: RoJ1 folded before Flop (didn't bet)
Seat 6: IAntikI (button) folded before Flop (didn't bet)



PokerStars Hand #166667619576:  Hold'em No Limit ($0.05/$0.10 USD) - 2017/02/23 16:04:28 ET
Table 'Gaika II' 6-max Seat #4 is the button
Seat 1: Ice_Isayev ($10 in chips) 
Seat 2: steepfell ($10.32 in chips) 
Seat 3: iDecMate ($19.25 in chips) 
Seat 4: Hyd SK ($11.67 in chips) 
Seat 5: KokoulinV ($12.61 in chips) 
Seat 6: bartabs2 ($8.75 in chips) 
KokoulinV: posts small blind $0.05
bartabs2: posts big blind $0.10
*** HOLE CARDS ***
Ice_Isayev: folds 
steepfell: folds 
iDecMate: raises $0.15 to $0.25
Hyd SK: folds 
KokoulinV: folds 
bartabs2: calls $0.15
*** FLOP *** [Qs Qd Js]
bartabs2: checks 
iDecMate: bets $0.27
bartabs2: calls $0.27
*** TURN *** [Qs Qd Js] [4s]
bartabs2: bets $0.40
iDecMate has timed out
iDecMate: folds 
Uncalled bet ($0.40) returned to bartabs2
bartabs2 collected $1.04 from pot
*** SUMMARY ***
Total pot $1.09 | Rake $0.05 
Board [Qs Qd Js 4s]
Seat 1: Ice_Isayev folded before Flop (didn't bet)
Seat 2: steepfell folded before Flop (didn't bet)
Seat 3: iDecMate folded on the Turn
Seat 4: Hyd SK (button) folded before Flop (didn't bet)
Seat 5: KokoulinV (small blind) folded before Flop
Seat 6: bartabs2 (big blind) collected ($1.04)



PokerStars Hand #166667619589:  Hold'em No Limit ($0.05/$0.10 USD) - 2017/02/23 16:04:28 ET
Table 'Aconcagua' 6-max Seat #4 is the button
Seat 3: burtila1989 ($10.79 in chips) 
Seat 4: pivanki11 ($9.23 in chips) 
Seat 5: frazaunch ($6.67 in chips) 
Seat 6: coolisses111 ($8.76 in chips) 
frazaunch: posts small blind $0.05
coolisses111: posts big blind $0.10
MLPlayer16: sits out 
burtila1989: posts the ante $0.02
pivanki11: posts the ante $0.02
frazaunch: posts the ante $0.02
coolisses111: posts the ante $0.02
*** HOLE CARDS ***
Kupi007 joins the table at seat #2 
burtila1989: raises $0.10 to $0.20
pivanki11: calls $0.20
frazaunch: folds 
coolisses111: folds 
*** FLOP *** [Tc 8c 6s]
burtila1989: bets $0.10
pivanki11: calls $0.10
*** TURN *** [Tc 8c 6s] [Qs]
burtila1989: checks 
pivanki11: bets $0.40
burtila1989: calls $0.40
*** RIVER *** [Tc 8c 6s Qs] [5c]
burtila1989: checks 
pivanki11: checks 
*** SHOW DOWN ***
burtila1989: shows [Ks 6c] (a pair of Sixes)
pivanki11: shows [Ac Td] (a pair of Tens)
pivanki11 collected $1.56 from pot
*** SUMMARY ***
Total pot $1.63 | Rake $0.07 
Board [Tc 8c 6s Qs 5c]
Seat 3: burtila1989 showed [Ks 6c] and lost with a pair of Sixes
Seat 4: pivanki11 (button) showed [Ac Td] and won ($1.56) with a pair of Tens
Seat 5: frazaunch (small blind) folded before Flop
Seat 6: coolisses111 (big blind) folded before Flop



PokerStars Hand #166667619643:  Hold'em No Limit ($0.05/$0.10 USD) - 2017/02/23 16:04:28 ET
Table 'Gelria' 6-max Seat #3 is the button
Seat 1: ab260414 ($10.15 in chips) 
Seat 2: fishhook5 ($10 in chips) 
Seat 3: Orlangoor ($11.78 in chips) 
Seat 5: apenvel ($7.85 in chips) 
Seat 6: Andrei ProFF ($10.42 in chips) 
eniksenik will be allowed to play after the button
apenvel: posts small blind $0.05
Andrei ProFF: posts big blind $0.10
*** HOLE CARDS ***
ab260414: raises $0.20 to $0.30
fishhook5: calls $0.30
Orlangoor: folds 
apenvel: folds 
Andrei ProFF: folds 
*** FLOP *** [5d 2d 8h]
ab260414: checks 
fishhook5: checks 
*** TURN *** [5d 2d 8h] [Qs]
ab260414: bets $0.40
fishhook5: folds 
Uncalled bet ($0.40) returned to ab260414
ab260414 collected $0.72 from pot
*** SUMMARY ***
Total pot $0.75 | Rake $0.03 
Board [5d 2d 8h Qs]
Seat 1: ab260414 collected ($0.72)
Seat 2: fishhook5 folded on the Turn
Seat 3: Orlangoor (button) folded before Flop (didn't bet)
Seat 5: apenvel (small blind) folded before Flop
Seat 6: Andrei ProFF (big blind) folded before Flop



PokerStars Hand #166667619729:  Hold'em No Limit ($0.05/$0.10 USD) - 2017/02/23 16:04:28 ET
Table 'Euryalos II' 6-max Seat #3 is the button
Seat 1: acekid403 ($9.90 in chips) 
Seat 2: silsilviu ($7.05 in chips) 
Seat 3: Hyd SK ($10.65 in chips) 
Seat 4: popypaleta ($15.52 in chips) 
Seat 5: horang2 ($8.25 in chips) 
Seat 6: MihaGr ($10 in chips) 
popypaleta: posts small blind $0.05
horang2: posts big blind $0.10
*** HOLE CARDS ***
MihaGr: raises $0.20 to $0.30
acekid403: folds 
silsilviu: folds 
Hyd SK: folds 
popypaleta: folds 
horang2: folds 
Uncalled bet ($0.20) returned to MihaGr
MihaGr collected $0.25 from pot
*** SUMMARY ***
Total pot $0.25 | Rake $0 
Seat 1: acekid403 folded before Flop (didn't bet)
Seat 2: silsilviu folded before Flop (didn't bet)
Seat 3: Hyd SK (button) folded before Flop (didn't bet)
Seat 4: popypaleta (small blind) folded before Flop
Seat 5: horang2 (big blind) folded before Flop
Seat 6: MihaGr collected ($0.25)



PokerStars Hand #166667619763:  Hold'em No Limit ($0.05/$0.10 USD) - 2017/02/23 16:04:28 ET
Table 'Tyndareus III' 6-max Seat #1 is the button
Seat 1: MBen10 ($10 in chips) 
Seat 2: MihaGr ($10.05 in chips) 
Seat 3: XaXaTyH4uK ($10.60 in chips) 
Seat 6: Elinaattor ($10.30 in chips) 
MihaGr: posts small blind $0.05
XaXaTyH4uK: posts big blind $0.10
yodzik: sits out 
*** HOLE CARDS ***
Elinaattor: folds 
MBen10: folds 
MihaGr: folds 
Uncalled bet ($0.05) returned to XaXaTyH4uK
XaXaTyH4uK collected $0.10 from pot
*** SUMMARY ***
Total pot $0.10 | Rake $0 
Seat 1: MBen10 (button) folded before Flop (didn't bet)
Seat 2: MihaGr (small blind) folded before Flop
Seat 3: XaXaTyH4uK (big blind) collected ($0.10)
Seat 6: Elinaattor folded before Flop (didn't bet)



PokerStars Hand #166667619786:  Hold'em No Limit ($0.05/$0.10 USD) - 2017/02/23 16:04:28 ET
Table 'Virginia II' 6-max Seat #3 is the button
Seat 1: Iarlei ($11.86 in chips) 
Seat 2: Yspenyanin ($10 in chips) 
Seat 3: garigura ($14.56 in chips) 
Seat 4: onkelottoHH ($10.93 in chips) 
Seat 5: dr.goofy ($20.68 in chips) 
onkelottoHH: posts small blind $0.05
dr.goofy: posts big blind $0.10
NvR.m1nD: sits out 
*** HOLE CARDS ***
Iarlei: folds 
Yspenyanin: folds 
garigura: folds 
onkelottoHH: raises $0.30 to $0.40
dr.goofy: folds 
Uncalled bet ($0.30) returned to onkelottoHH
onkelottoHH collected $0.20 from pot
*** SUMMARY ***
Total pot $0.20 | Rake $0 
Seat 1: Iarlei folded before Flop (didn't bet)
Seat 2: Yspenyanin folded before Flop (didn't bet)
Seat 3: garigura (button) folded before Flop (didn't bet)
Seat 4: onkelottoHH (small blind) collected ($0.20)
Seat 5: dr.goofy (big blind) folded before Flop



PokerStars Hand #166667620064:  Hold'em No Limit ($0.05/$0.10 USD) - 2017/02/23 16:04:28 ET
Table 'Lorbach' 6-max Seat #3 is the button
Seat 1: LarryTheStar ($14.68 in chips) 
Seat 3: ArcticBearDK ($10.90 in chips) 
Seat 4: McCleans ($10.05 in chips) 
Seat 5: Cluckh ($14.62 in chips) 
Seat 6: Worlz ($12.67 in chips) 
McCleans: posts small blind $0.05
Cluckh: posts big blind $0.10
*** HOLE CARDS ***
Worlz: raises $0.20 to $0.30
LarryTheStar: folds 
ArcticBearDK: raises $0.60 to $0.90
McCleans: folds 
Cluckh: folds 
Worlz: raises $0.70 to $1.60
ArcticBearDK: calls $0.70
*** FLOP *** [2h Th Jh]
Worlz: bets $1.60
ArcticBearDK: calls $1.60
*** TURN *** [2h Th Jh] [Qs]
Worlz: bets $2.80
ArcticBearDK: folds 
Uncalled bet ($2.80) returned to Worlz
Worlz collected $6.26 from pot
*** SUMMARY ***
Total pot $6.55 | Rake $0.29 
Board [2h Th Jh Qs]
Seat 1: LarryTheStar folded before Flop (didn't bet)
Seat 3: ArcticBearDK (button) folded on the Turn
Seat 4: McCleans (small blind) folded before Flop
Seat 5: Cluckh (big blind) folded before Flop
Seat 6: Worlz collected ($6.26)



PokerStars Hand #166667620188:  Hold'em No Limit ($0.05/$0.10 USD) - 2017/02/23 16:04:29 ET
Table 'Tomita II' 6-max Seat #2 is the button
Seat 2: mhonielsen ($10.23 in chips) 
Seat 3: Lucky HoBBiT ($11.96 in chips) 
Seat 4: Hyd SK ($10 in chips) 
Lucky HoBBiT: posts small blind $0.05
Hyd SK: posts big blind $0.10
*** HOLE CARDS ***
mhonielsen: raises $0.10 to $0.20
Lucky HoBBiT: calls $0.15
KRZuff leaves the table
Hyd SK: calls $0.10
*** FLOP *** [8h 6s Ts]
saniasmir joins the table at seat #6 
Lucky HoBBiT: checks 
Hyd SK: checks 
mhonielsen: bets $0.33
Lucky HoBBiT: calls $0.33
Hyd SK: folds 
*** TURN *** [8h 6s Ts] [Qc]
Lucky HoBBiT: checks 
mhonielsen: checks 
*** RIVER *** [8h 6s Ts Qc] [Ks]
Lucky HoBBiT: bets $0.63
mhonielsen: folds 
Uncalled bet ($0.63) returned to Lucky HoBBiT
Lucky HoBBiT collected $1.20 from pot
*** SUMMARY ***
Total pot $1.26 | Rake $0.06 
Board [8h 6s Ts Qc Ks]
Seat 2: mhonielsen (button) folded on the River
Seat 3: Lucky HoBBiT (small blind) collected ($1.20)
Seat 4: Hyd SK (big blind) folded on the Flop



PokerStars Hand #166667620333:  Hold'em No Limit ($0.05/$0.10 USD) - 2017/02/23 16:04:29 ET
Table 'Grietje' 6-max Seat #6 is the button
Seat 2: Feverhead ($13.02 in chips) 
Seat 4: MihaGr ($10 in chips) 
Seat 6: Prometheu$8 ($21.55 in chips) 
dragonste89 will be allowed to play after the button
Feverhead: posts small blind $0.05
voledy: is sitting out 
voledy leaves the table
MihaGr: posts big blind $0.10
iThreeBarrel: sits out 
*** HOLE CARDS ***
Prometheu$8: raises $0.25 to $0.35
Feverhead: folds 
MihaGr: folds 
Uncalled bet ($0.25) returned to Prometheu$8
Prometheu$8 collected $0.25 from pot
*** SUMMARY ***
Total pot $0.25 | Rake $0 
Seat 2: Feverhead (small blind) folded before Flop
Seat 4: MihaGr (big blind) folded before Flop
Seat 6: Prometheu$8 (button) collected ($0.25)



PokerStars Hand #166667620702:  Hold'em No Limit ($0.05/$0.10 USD) - 2017/02/23 16:04:29 ET
Table 'Wesselink II' 6-max Seat #4 is the button
Seat 1: vladcol ($5.27 in chips) 
Seat 3: Wargolandros ($9.07 in chips) 
Seat 4: BahiaMinhaP ($10.98 in chips) 
Seat 6: bambolejro ($10 in chips) 
bambolejro: posts small blind $0.05
vladcol: posts big blind $0.10
KRZuff: sits out 
*** HOLE CARDS ***
Wargolandros: folds 
BahiaMinhaP: folds 
bambolejro: folds 
Uncalled bet ($0.05) returned to vladcol
vladcol collected $0.10 from pot
*** SUMMARY ***
Total pot $0.10 | Rake $0 
Seat 1: vladcol (big blind) collected ($0.10)
Seat 3: Wargolandros folded before Flop (didn't bet)
Seat 4: BahiaMinhaP (button) folded before Flop (didn't bet)
Seat 6: bambolejro (small blind) folded before Flop



PokerStars Hand #166667620779:  Hold'em No Limit ($0.05/$0.10 USD) - 2017/02/23 16:04:29 ET
Table 'Brendelia II' 6-max Seat #3 is the button
Seat 2: Crimsonr ($4.97 in chips) 
Seat 3: ValdemorS ($19 in chips) 
Seat 6: luckyPositiv ($10.24 in chips) 
luckyPositiv: posts small blind $0.05
Crimsonr: posts big blind $0.10
Crimsonr: posts the ante $0.02
ValdemorS: posts the ante $0.02
luckyPositiv: posts the ante $0.02
*** HOLE CARDS ***
ValdemorS: folds 
luckyPositiv: folds 
Uncalled bet ($0.05) returned to Crimsonr
Crimsonr collected $0.16 from pot
*** SUMMARY ***
Total pot $0.16 | Rake $0 
Seat 2: Crimsonr (big blind) collected ($0.16)
Seat 3: ValdemorS (button) folded before Flop (didn't bet)
Seat 6: luckyPositiv (small blind) folded before Flop



PokerStars Hand #166667620837:  Hold'em No Limit ($0.05/$0.10 USD) - 2017/02/23 16:04:29 ET
Table 'Lederle' 6-max Seat #3 is the button
Seat 2: truck1234 ($15.70 in chips) 
Seat 3: Kazacha ($10.15 in chips) 
Seat 4: Pokeaster ($13.81 in chips) 
Seat 5: 8th wonders ($14.48 in chips) 
Seat 6: pokekrk ($10 in chips) 
Pokeaster: posts small blind $0.05
8th wonders: posts big blind $0.10
*** HOLE CARDS ***
pokekrk: folds 
truck1234: raises $0.20 to $0.30
Kazacha: folds 
Pokeaster: folds 
8th wonders: folds 
Uncalled bet ($0.20) returned to truck1234
truck1234 collected $0.25 from pot
*** SUMMARY ***
Total pot $0.25 | Rake $0 
Seat 2: truck1234 collected ($0.25)
Seat 3: Kazacha (button) folded before Flop (didn't bet)
Seat 4: Pokeaster (small blind) folded before Flop
Seat 5: 8th wonders (big blind) folded before Flop
Seat 6: pokekrk folded before Flop (didn't bet)



PokerStars Hand #166667621121:  Hold'em No Limit ($0.05/$0.10 USD) - 2017/02/23 16:04:30 ET
Table 'Lehigh' 6-max Seat #4 is the button
Seat 1: kowe4ka565 ($11.22 in chips) 
Seat 3: Therodorus ($10 in chips) 
Seat 4: Chodemuncher ($10 in chips) 
Seat 5: Xander188 ($10.05 in chips) 
Seat 6: CallByValue ($10 in chips) 
Xander188: posts small blind $0.05
CallByValue: posts big blind $0.10
Sbozzz: sits out 
*** HOLE CARDS ***
kowe4ka565: calls $0.10
Therodorus: raises $0.35 to $0.45
Chodemuncher: folds 
Xander188: folds 
CallByValue: folds 
kowe4ka565: calls $0.35
*** FLOP *** [Ad Ac Td]
kowe4ka565: bets $0.50
Therodorus: calls $0.50
*** TURN *** [Ad Ac Td] [9c]
kowe4ka565: checks 
Therodorus: checks 
*** RIVER *** [Ad Ac Td 9c] [2s]
kowe4ka565: bets $1.96
Therodorus: calls $1.96
*** SHOW DOWN ***
kowe4ka565: shows [4d 5s] (a pair of Aces)
Therodorus: shows [7h 7d] (two pair, Aces and Sevens)
Therodorus collected $5.70 from pot
*** SUMMARY ***
Total pot $5.97 | Rake $0.27 
Board [Ad Ac Td 9c 2s]
Seat 1: kowe4ka565 showed [4d 5s] and lost with a pair of Aces
Seat 3: Therodorus showed [7h 7d] and won ($5.70) with two pair, Aces and Sevens
Seat 4: Chodemuncher (button) folded before Flop (didn't bet)
Seat 5: Xander188 (small blind) folded before Flop
Seat 6: CallByValue (big blind) folded before Flop



PokerStars Hand #166667621379:  Hold'em No Limit ($0.05/$0.10 USD) - 2017/02/23 16:04:30 ET
Table 'Atalante' 6-max Seat #1 is the button
Seat 1: OceanBlue100 ($5.09 in chips) 
Seat 2: CiisCi ($19.82 in chips) 
Seat 3: Kow6oy ($10.15 in chips) 
Seat 4: Dcaro31 ($25.07 in chips) 
Seat 5: eniksenik ($10.29 in chips) 
Seat 6: FlopsterGB ($30.23 in chips) 
CiisCi: posts small blind $0.05
Kow6oy: posts big blind $0.10
*** HOLE CARDS ***
Dcaro31: folds 
eniksenik: folds 
FlopsterGB: raises $0.15 to $0.25
OceanBlue100: folds 
CiisCi: folds 
Kow6oy: folds 
Uncalled bet ($0.15) returned to FlopsterGB
FlopsterGB collected $0.25 from pot
*** SUMMARY ***
Total pot $0.25 | Rake $0 
Seat 1: OceanBlue100 (button) folded before Flop (didn't bet)
Seat 2: CiisCi (small blind) folded before Flop
Seat 3: Kow6oy (big blind) folded before Flop
Seat 4: Dcaro31 folded before Flop (didn't bet)
Seat 5: eniksenik folded before Flop (didn't bet)
Seat 6: FlopsterGB collected ($0.25)



PokerStars Hand #166667621424:  Hold'em No Limit ($0.05/$0.10 USD) - 2017/02/23 16:04:30 ET
Table 'Siebohme II' 6-max Seat #1 is the button
Seat 1: homelessdan ($18.07 in chips) 
Seat 2: townerz1991 ($14.22 in chips) 
Seat 3: D3NyA ($10.33 in chips) 
Seat 4: POT_TRADER ($12.29 in chips) 
Seat 5: NvR.m1nD ($10 in chips) 
Seat 6: Fozzy690 ($10.14 in chips) 
townerz1991: posts small blind $0.05
D3NyA: posts big blind $0.10
*** HOLE CARDS ***
POT_TRADER: folds 
NvR.m1nD: raises $0.15 to $0.25
Fozzy690: folds 
homelessdan: calls $0.25
townerz1991: folds 
D3NyA: folds 
*** FLOP *** [4h Th Qc]
NvR.m1nD: bets $0.32
homelessdan: folds 
Uncalled bet ($0.32) returned to NvR.m1nD
NvR.m1nD collected $0.62 from pot
*** SUMMARY ***
Total pot $0.65 | Rake $0.03 
Board [4h Th Qc]
Seat 1: homelessdan (button) folded on the Flop
Seat 2: townerz1991 (small blind) folded before Flop
Seat 3: D3NyA (big blind) folded before Flop
Seat 4: POT_TRADER folded before Flop (didn't bet)
Seat 5: NvR.m1nD collected ($0.62)
Seat 6: Fozzy690 folded before Flop (didn't bet)



PokerStars Hand #166667621467:  Hold'em No Limit ($0.05/$0.10 USD) - 2017/02/23 16:04:30 ET
Table 'Pyrrhus III' 6-max Seat #3 is the button
Seat 1: skatejeff ($9.86 in chips) 
Seat 2: univibe68 ($20.34 in chips) 
Seat 3: coolisses111 ($9.91 in chips) 
Seat 4: ex3Lero86 ($23.65 in chips) 
Seat 5: mAEgar ($3.63 in chips) 
Seat 6: MLPlayer16 ($19.80 in chips) 
ex3Lero86: posts small blind $0.05
mAEgar: posts big blind $0.10
skatejeff: posts the ante $0.02
univibe68: posts the ante $0.02
coolisses111: posts the ante $0.02
ex3Lero86: posts the ante $0.02
mAEgar: posts the ante $0.02
MLPlayer16: posts the ante $0.02
*** HOLE CARDS ***
MLPlayer16: folds 
skatejeff: calls $0.10
univibe68: folds 
coolisses111: folds 
ex3Lero86: raises $0.40 to $0.50
mAEgar: calls $0.40
skatejeff: calls $0.40
*** FLOP *** [4s Qs Qh]
ex3Lero86: checks 
mAEgar: checks 
skatejeff: checks 
*** TURN *** [4s Qs Qh] [7c]
ex3Lero86: checks 
mAEgar: bets $0.20
skatejeff: calls $0.20
ex3Lero86: folds 
*** RIVER *** [4s Qs Qh 7c] [3c]
mAEgar: bets $0.40
skatejeff: raises $2.73 to $3.13
mAEgar: calls $2.51 and is all-in
Uncalled bet ($0.22) returned to skatejeff
*** SHOW DOWN ***
skatejeff: shows [6s 5c] (a straight, Three to Seven)
mAEgar: shows [As Qd] (three of a kind, Queens)
skatejeff collected $7.49 from pot
*** SUMMARY ***
Total pot $7.84 | Rake $0.35 
Board [4s Qs Qh 7c 3c]
Seat 1: skatejeff showed [6s 5c] and won ($7.49) with a straight, Three to Seven
Seat 2: univibe68 folded before Flop (didn't bet)
Seat 3: coolisses111 (button) folded before Flop (didn't bet)
Seat 4: ex3Lero86 (small blind) folded on the Turn
Seat 5: mAEgar (big blind) showed [As Qd] and lost with three of a kind, Queens
Seat 6: MLPlayer16 folded before Flop (didn't bet)



PokerStars Hand #166667622057:  Hold'em No Limit ($0.05/$0.10 USD) - 2017/02/23 16:04:31 ET
Table 'Aludra II' 6-max Seat #4 is the button
Seat 1: voledy ($10 in chips) 
Seat 2: JahSoldier69 ($14.05 in chips) 
Seat 3: 2G28 ($12.65 in chips) 
Seat 4: MihaGr ($10 in chips) 
Seat 5: kingartur222 ($15.75 in chips) 
Seat 6: call me haaa ($14.79 in chips) 
kingartur222: posts small blind $0.05
call me haaa: posts big blind $0.10
*** HOLE CARDS ***
voledy: folds 
JahSoldier69: raises $0.20 to $0.30
2G28: folds 
2G28 leaves the table
MihaGr: folds 
kingartur222: folds 
call me haaa: folds 
Uncalled bet ($0.20) returned to JahSoldier69
JahSoldier69 collected $0.25 from pot
*** SUMMARY ***
Total pot $0.25 | Rake $0 
Seat 1: voledy folded before Flop (didn't bet)
Seat 2: JahSoldier69 collected ($0.25)
Seat 3: 2G28 folded before Flop (didn't bet)
Seat 4: MihaGr (button) folded before Flop (didn't bet)
Seat 5: kingartur222 (small blind) folded before Flop
Seat 6: call me haaa (big blind) folded before Flop



PokerStars Hand #166667622756:  Hold'em No Limit ($0.05/$0.10 USD) - 2017/02/23 16:04:31 ET
Table 'Ebella II' 6-max Seat #4 is the button
Seat 1: gaHy_HaXeP ($10 in chips) 
Seat 2: Therodorus ($10 in chips) 
Seat 3: Torften2 ($15.73 in chips) 
Seat 4: ValdemorS ($11.05 in chips) 
Seat 5: Bird et al ($10 in chips) 
Seat 6: Joker51_wtf! ($11.39 in chips) 
Bird et al: posts small blind $0.05
Joker51_wtf!: posts big blind $0.10
*** HOLE CARDS ***
gaHy_HaXeP: folds 
Therodorus: folds 
Torften2: raises $0.20 to $0.30
ValdemorS: folds 
Bird et al: folds 
Joker51_wtf!: folds 
Uncalled bet ($0.20) returned to Torften2
Torften2 collected $0.25 from pot
*** SUMMARY ***
Total pot $0.25 | Rake $0 
Seat 1: gaHy_HaXeP folded before Flop (didn't bet)
Seat 2: Therodorus folded before Flop (didn't bet)
Seat 3: Torften2 collected ($0.25)
Seat 4: ValdemorS (button) folded before Flop (didn't bet)
Seat 5: Bird et al (small blind) folded before Flop
Seat 6: Joker51_wtf! (big blind) folded before Flop



PokerStars Hand #166667622875:  Hold'em No Limit ($0.05/$0.10 USD) - 2017/02/23 16:04:31 ET
Table 'Nerthus II' 6-max Seat #3 is the button
Seat 1: mdelfin0 ($10.11 in chips) 
Seat 2: Hovhannes990 ($9.63 in chips) 
Seat 3: Mamm0nism ($18.67 in chips) 
Seat 5: Hyd SK ($12.20 in chips) 
Seat 6: Lucky HoBBiT ($10 in chips) 
Hyd SK: posts small blind $0.05
Lucky HoBBiT: posts big blind $0.10
*** HOLE CARDS ***
mdelfin0: raises $0.20 to $0.30
Hovhannes990: folds 
Mamm0nism: folds 
Hyd SK: folds 
Lucky HoBBiT: folds 
Uncalled bet ($0.20) returned to mdelfin0
mdelfin0 collected $0.25 from pot
*** SUMMARY ***
Total pot $0.25 | Rake $0 
Seat 1: mdelfin0 collected ($0.25)
Seat 2: Hovhannes990 folded before Flop (didn't bet)
Seat 3: Mamm0nism (button) folded before Flop (didn't bet)
Seat 5: Hyd SK (small blind) folded before Flop
Seat 6: Lucky HoBBiT (big blind) folded before Flop



PokerStars Hand #166667623015:  Hold'em No Limit ($0.05/$0.10 USD) - 2017/02/23 16:04:32 ET
Table 'Amalia' 6-max Seat #2 is the button
Seat 1: voledy ($12.59 in chips) 
Seat 2: DamDatsAnAce ($10.55 in chips) 
Seat 3: kickereens ($10.28 in chips) 
Seat 4: Rodik002 ($16.38 in chips) 
Seat 5: coolisses111 ($11.10 in chips) 
Seat 6: oktomber778 ($23.39 in chips) 
kickereens: posts small blind $0.05
Rodik002: posts big blind $0.10
*** HOLE CARDS ***
coolisses111: folds 
oktomber778: calls $0.10
voledy: folds 
DamDatsAnAce: folds 
kickereens: calls $0.05
Rodik002: checks 
*** FLOP *** [6s 7c Kc]
kickereens: checks 
Rodik002: checks 
oktomber778: bets $0.10
kickereens: calls $0.10
Rodik002: calls $0.10
*** TURN *** [6s 7c Kc] [2s]
kickereens: checks 
Rodik002: checks 
oktomber778: bets $0.50
kickereens: folds 
Rodik002: folds 
Uncalled bet ($0.50) returned to oktomber778
oktomber778 collected $0.57 from pot
*** SUMMARY ***
Total pot $0.60 | Rake $0.03 
Board [6s 7c Kc 2s]
Seat 1: voledy folded before Flop (didn't bet)
Seat 2: DamDatsAnAce (button) folded before Flop (didn't bet)
Seat 3: kickereens (small blind) folded on the Turn
Seat 4: Rodik002 (big blind) folded on the Turn
Seat 5: coolisses111 folded before Flop (didn't bet)
Seat 6: oktomber778 collected ($0.57)



PokerStars Hand #166667623042:  Hold'em No Limit ($0.05/$0.10 USD) - 2017/02/23 16:04:32 ET
Table 'Xanthippe II' 6-max Seat #1 is the button
Seat 1: ade22345 ($8.55 in chips) 
Seat 2: Bird et al ($13.56 in chips) 
Seat 3: Dcaro31 ($10 in chips) 
Seat 4: Barcardi14 ($6.26 in chips) 
Seat 5: yodzik ($5 in chips) 
Seat 6: Orlangoor ($10.89 in chips) 
Bird et al: posts small blind $0.05
Dcaro31: posts big blind $0.10
*** HOLE CARDS ***
Barcardi14: calls $0.10
yodzik: folds 
Orlangoor: raises $0.15 to $0.25
ade22345: folds 
Bird et al: folds 
Dcaro31: calls $0.15
Barcardi14: calls $0.15
*** FLOP *** [4s 2c 5s]
Dcaro31: checks 
Barcardi14: checks 
Orlangoor: checks 
*** TURN *** [4s 2c 5s] [7s]
Dcaro31: bets $0.10
Barcardi14: raises $0.40 to $0.50
Orlangoor: folds 
Dcaro31: calls $0.40
*** RIVER *** [4s 2c 5s 7s] [5d]
Dcaro31: checks 
Barcardi14: checks 
*** SHOW DOWN ***
Dcaro31: shows [Ad 7d] (two pair, Sevens and Fives)
Barcardi14: mucks hand 
Dcaro31 collected $1.72 from pot
*** SUMMARY ***
Total pot $1.80 | Rake $0.08 
Board [4s 2c 5s 7s 5d]
Seat 1: ade22345 (button) folded before Flop (didn't bet)
Seat 2: Bird et al (small blind) folded before Flop
Seat 3: Dcaro31 (big blind) showed [Ad 7d] and won ($1.72) with two pair, Sevens and Fives
Seat 4: Barcardi14 mucked
Seat 5: yodzik folded before Flop (didn't bet)
Seat 6: Orlangoor folded on the Turn



PokerStars Hand #166667623231:  Hold'em No Limit ($0.05/$0.10 USD) - 2017/02/23 16:04:32 ET
Table 'Glarona' 6-max Seat #1 is the button
Seat 1: LarryTheStar ($10.65 in chips) 
Seat 2: BookWorm78 ($10 in chips) 
Seat 3: hoedje72 ($3.86 in chips) 
Seat 4: CrippledGod ($6.72 in chips) 
Seat 5: david_sara83 ($10.25 in chips) 
Seat 6: Namhkal ($11.33 in chips) 
BookWorm78: posts small blind $0.05
hoedje72: posts big blind $0.10
*** HOLE CARDS ***
CrippledGod: raises $0.20 to $0.30
david_sara83: folds 
Namhkal: folds 
LarryTheStar: calls $0.30
BookWorm78: folds 
hoedje72: folds 
*** FLOP *** [Kh Kc Ts]
CrippledGod: checks 
LarryTheStar: checks 
*** TURN *** [Kh Kc Ts] [6s]
CrippledGod: bets $0.36
LarryTheStar: folds 
Uncalled bet ($0.36) returned to CrippledGod
CrippledGod collected $0.72 from pot
*** SUMMARY ***
Total pot $0.75 | Rake $0.03 
Board [Kh Kc Ts 6s]
Seat 1: LarryTheStar (button) folded on the Turn
Seat 2: BookWorm78 (small blind) folded before Flop
Seat 3: hoedje72 (big blind) folded before Flop
Seat 4: CrippledGod collected ($0.72)
Seat 5: david_sara83 folded before Flop (didn't bet)
Seat 6: Namhkal folded before Flop (didn't bet)



PokerStars Hand #166667623511:  Hold'em No Limit ($0.05/$0.10 USD) - 2017/02/23 16:04:32 ET
Table 'Antielus II' 6-max Seat #4 is the button
Seat 1: Dcaro31 ($17.30 in chips) 
Seat 2: Orlangoor ($10.15 in chips) 
Seat 3: mcyi3at2 ($13.36 in chips) 
Seat 4: XwinX25 ($10 in chips) 
Seat 5: Hyd SK ($10.70 in chips) 
Seat 6: GiveTwoMe ($12.40 in chips) 
Hyd SK: posts small blind $0.05
GiveTwoMe: posts big blind $0.10
*** HOLE CARDS ***
Dcaro31: folds 
Orlangoor: folds 
mcyi3at2: raises $0.20 to $0.30
XwinX25: folds 
Hyd SK: raises $0.90 to $1.20
GiveTwoMe: folds 
mcyi3at2: calls $0.90
*** FLOP *** [4s Jc 4d]
Hyd SK: bets $1.20
mcyi3at2: folds 
Uncalled bet ($1.20) returned to Hyd SK
Hyd SK collected $2.39 from pot
*** SUMMARY ***
Total pot $2.50 | Rake $0.11 
Board [4s Jc 4d]
Seat 1: Dcaro31 folded before Flop (didn't bet)
Seat 2: Orlangoor folded before Flop (didn't bet)
Seat 3: mcyi3at2 folded on the Flop
Seat 4: XwinX25 (button) folded before Flop (didn't bet)
Seat 5: Hyd SK (small blind) collected ($2.39)
Seat 6: GiveTwoMe (big blind) folded before Flop



PokerStars Hand #166667623515:  Hold'em No Limit ($0.05/$0.10 USD) - 2017/02/23 16:04:32 ET
Table 'Emma II' 6-max Seat #3 is the button
Seat 1: LarryTheStar ($10 in chips) 
Seat 2: T9MS ($11.64 in chips) 
Seat 3: oddshoff ($9.52 in chips) 
Seat 4: Jucatorul823 ($5.87 in chips) 
Seat 5: Scanner17 ($11.36 in chips) 
Seat 6: CHRO8 ($14.82 in chips) 
Jucatorul823: posts small blind $0.05
Scanner17: posts big blind $0.10
*** HOLE CARDS ***
CHRO8: folds 
LarryTheStar: folds 
T9MS: folds 
oddshoff: folds 
Jucatorul823: folds 
Uncalled bet ($0.05) returned to Scanner17
Scanner17 collected $0.10 from pot
*** SUMMARY ***
Total pot $0.10 | Rake $0 
Seat 1: LarryTheStar folded before Flop (didn't bet)
Seat 2: T9MS folded before Flop (didn't bet)
Seat 3: oddshoff (button) folded before Flop (didn't bet)
Seat 4: Jucatorul823 (small blind) folded before Flop
Seat 5: Scanner17 (big blind) collected ($0.10)
Seat 6: CHRO8 folded before Flop (didn't bet)



PokerStars Hand #166667623808:  Hold'em No Limit ($0.05/$0.10 USD) - 2017/02/23 16:04:33 ET
Table 'Markab II' 6-max Seat #1 is the button
Seat 1: david_sara83 ($10.67 in chips) 
Seat 2: truck1234 ($10.95 in chips) 
Seat 3: sexy_seagull ($10.15 in chips) 
Seat 4: Crafty23@PS ($11.69 in chips) 
Seat 5: Rodik002 ($19.17 in chips) 
Seat 6: Comeback3392 ($10 in chips) 
truck1234: posts small blind $0.05
sexy_seagull: posts big blind $0.10
*** HOLE CARDS ***
Crafty23@PS: folds 
Rodik002: folds 
Comeback3392: folds 
david_sara83: folds 
truck1234: raises $0.20 to $0.30
sexy_seagull: folds 
Uncalled bet ($0.20) returned to truck1234
truck1234 collected $0.20 from pot
*** SUMMARY ***
Total pot $0.20 | Rake $0 
Seat 1: david_sara83 (button) folded before Flop (didn't bet)
Seat 2: truck1234 (small blind) collected ($0.20)
Seat 3: sexy_seagull (big blind) folded before Flop
Seat 4: Crafty23@PS folded before Flop (didn't bet)
Seat 5: Rodik002 folded before Flop (didn't bet)
Seat 6: Comeback3392 folded before Flop (didn't bet)



PokerStars Hand #166667624175:  Hold'em No Limit ($0.05/$0.10 USD) - 2017/02/23 16:04:33 ET
Table 'Arpola' 6-max Seat #6 is the button
Seat 1: dincimus ($9.90 in chips) 
Seat 2: patrick19111 ($10.13 in chips) 
Seat 3: simaryk ($10 in chips) 
Seat 4: Orlangoor ($19.20 in chips) 
Seat 5: truck1234 ($11.66 in chips) 
Seat 6: Andrei ProFF ($10.47 in chips) 
dincimus: posts small blind $0.05
patrick19111: posts big blind $0.10
*** HOLE CARDS ***
simaryk: folds 
Orlangoor: folds 
truck1234: folds 
Andrei ProFF: raises $0.15 to $0.25
dincimus: calls $0.20
patrick19111: calls $0.15
*** FLOP *** [4s Jh Td]
dincimus: checks 
patrick19111: checks 
Andrei ProFF: checks 
*** TURN *** [4s Jh Td] [Qd]
dincimus: checks 
patrick19111: checks 
Andrei ProFF: checks 
*** RIVER *** [4s Jh Td Qd] [9h]
dincimus: checks 
patrick19111: checks 
Andrei ProFF: checks 
*** SHOW DOWN ***
dincimus: shows [Th Ac] (a pair of Tens)
patrick19111: mucks hand 
Andrei ProFF: mucks hand 
dincimus collected $0.72 from pot
*** SUMMARY ***
Total pot $0.75 | Rake $0.03 
Board [4s Jh Td Qd 9h]
Seat 1: dincimus (small blind) showed [Th Ac] and won ($0.72) with a pair of Tens
Seat 2: patrick19111 (big blind) mucked
Seat 3: simaryk folded before Flop (didn't bet)
Seat 4: Orlangoor folded before Flop (didn't bet)
Seat 5: truck1234 folded before Flop (didn't bet)
Seat 6: Andrei ProFF (button) mucked



PokerStars Hand #166667624284:  Hold'em No Limit ($0.05/$0.10 USD) - 2017/02/23 16:04:33 ET
Table 'Laetitia II' 6-max Seat #2 is the button
Seat 1: Cluckh ($10 in chips) 
Seat 2: manashov ($10.22 in chips) 
Seat 3: 6ePeMeHHa9 ($10.19 in chips) 
Seat 4: Feverhead ($16.81 in chips) 
Seat 5: D3NyA ($16.63 in chips) 
Seat 6: Dima91360 ($5.80 in chips) 
6ePeMeHHa9: posts small blind $0.05
Feverhead: posts big blind $0.10
*** HOLE CARDS ***
D3NyA: folds 
Dima91360: calls $0.10
Cluckh: raises $0.40 to $0.50
manashov: folds 
6ePeMeHHa9: folds 
Feverhead: folds 
Dima91360: calls $0.40
*** FLOP *** [2d As 6c]
Dima91360: bets $0.20
Cluckh: calls $0.20
*** TURN *** [2d As 6c] [3h]
Dima91360: bets $0.20
Cluckh: raises $1.10 to $1.30
Dima91360: folds 
Uncalled bet ($1.10) returned to Cluckh
Cluckh collected $1.86 from pot
*** SUMMARY ***
Total pot $1.95 | Rake $0.09 
Board [2d As 6c 3h]
Seat 1: Cluckh collected ($1.86)
Seat 2: manashov (button) folded before Flop (didn't bet)
Seat 3: 6ePeMeHHa9 (small blind) folded before Flop
Seat 4: Feverhead (big blind) folded before Flop
Seat 5: D3NyA folded before Flop (didn't bet)
Seat 6: Dima91360 folded on the Turn



PokerStars Hand #166667624648:  Hold'em No Limit ($0.05/$0.10 USD) - 2017/02/23 16:04:33 ET
Table 'Iapetus III' 6-max Seat #6 is the button
Seat 1: Czezar Life ($7.90 in chips) 
Seat 2: Crafty23@PS ($10 in chips) 
Seat 4: Raggibest ($6.80 in chips) 
Seat 5: homelessdan ($13.61 in chips) 
Seat 6: tauronex ($10.33 in chips) 
Czezar Life: posts small blind $0.05
Crafty23@PS: posts big blind $0.10
Goroshkos88: sits out 
*** HOLE CARDS ***
Raggibest: folds 
homelessdan: raises $0.20 to $0.30
tauronex: folds 
Czezar Life: folds 
Crafty23@PS: calls $0.20
*** FLOP *** [8h 6d Qs]
Crafty23@PS: checks 
homelessdan: checks 
*** TURN *** [8h 6d Qs] [Ah]
Crafty23@PS: checks 
homelessdan: bets $0.40
Crafty23@PS: calls $0.40
*** RIVER *** [8h 6d Qs Ah] [Tc]
Crafty23@PS: checks 
homelessdan: bets $0.70
Crafty23@PS: calls $0.70
*** SHOW DOWN ***
homelessdan: shows [Qh Qc] (three of a kind, Queens)
Crafty23@PS: mucks hand 
homelessdan collected $2.72 from pot
*** SUMMARY ***
Total pot $2.85 | Rake $0.13 
Board [8h 6d Qs Ah Tc]
Seat 1: Czezar Life (small blind) folded before Flop
Seat 2: Crafty23@PS (big blind) mucked
Seat 4: Raggibest folded before Flop (didn't bet)
Seat 5: homelessdan showed [Qh Qc] and won ($2.72) with three of a kind, Queens
Seat 6: tauronex (button) folded before Flop (didn't bet)



PokerStars Hand #166667624829:  Hold'em No Limit ($0.05/$0.10 USD) - 2017/02/23 16:04:34 ET
Table 'Mesarthim' 6-max Seat #3 is the button
Seat 1: Mancuso2010 ($16.30 in chips) 
Seat 2: MühliJr ($10 in chips) 
Seat 3: Damage514 ($10.35 in chips) 
Seat 4: Strelok1974 ($10.41 in chips) 
Seat 5: Iarlei ($11.05 in chips) 
Seat 6: bdixon_5 ($8.96 in chips) 
Strelok1974: posts small blind $0.05
Iarlei: posts big blind $0.10
*** HOLE CARDS ***
bdixon_5: folds 
Mancuso2010: folds 
MühliJr: raises $0.20 to $0.30
Damage514: folds 
Strelok1974: calls $0.25
Iarlei: folds 
*** FLOP *** [Th 6d Kc]
Strelok1974: checks 
MühliJr: bets $0.39
Strelok1974: folds 
Uncalled bet ($0.39) returned to MühliJr
MühliJr collected $0.67 from pot
*** SUMMARY ***
Total pot $0.70 | Rake $0.03 
Board [Th 6d Kc]
Seat 1: Mancuso2010 folded before Flop (didn't bet)
Seat 2: MühliJr collected ($0.67)
Seat 3: Damage514 (button) folded before Flop (didn't bet)
Seat 4: Strelok1974 (small blind) folded on the Flop
Seat 5: Iarlei (big blind) folded before Flop
Seat 6: bdixon_5 folded before Flop (didn't bet)



PokerStars Hand #166667625102:  Hold'em No Limit ($0.05/$0.10 USD) - 2017/02/23 16:04:34 ET
Table 'Veniakaverin' 6-max Seat #2 is the button
Seat 1: pivanki11 ($11.09 in chips) 
Seat 2: david_sara83 ($10 in chips) 
Seat 3: Hyd SK ($19.80 in chips) 
Seat 4: Ampped87 ($10 in chips) 
Seat 5: Innerwuss ($24.69 in chips) 
Seat 6: bdixon_5 ($9.35 in chips) 
Hyd SK: posts small blind $0.05
Ampped87: posts big blind $0.10
*** HOLE CARDS ***
Innerwuss: folds 
Innerwuss leaves the table
bdixon_5: folds 
pivanki11: raises $0.20 to $0.30
Tox1cel joins the table at seat #5 
david_sara83: calls $0.30
Hyd SK: calls $0.25
Ampped87: calls $0.20
*** FLOP *** [Ts 8s 6d]
Hyd SK: bets $0.58
Ampped87: calls $0.58
pivanki11: calls $0.58
david_sara83: folds 
*** TURN *** [Ts 8s 6d] [Kc]
Hyd SK: bets $1.41
Ampped87: raises $3.11 to $4.52
pivanki11: folds 
Hyd SK: raises $8.89 to $13.41
Ampped87: calls $4.60 and is all-in
Uncalled bet ($4.29) returned to Hyd SK
*** RIVER *** [Ts 8s 6d Kc] [7d]
*** SHOW DOWN ***
Hyd SK: shows [8d 8c] (three of a kind, Eights)
Ampped87: shows [Td Kh] (two pair, Kings and Tens)
Hyd SK collected $20.23 from pot
*** SUMMARY ***
Total pot $21.18 | Rake $0.95 
Board [Ts 8s 6d Kc 7d]
Seat 1: pivanki11 folded on the Turn
Seat 2: david_sara83 (button) folded on the Flop
Seat 3: Hyd SK (small blind) showed [8d 8c] and won ($20.23) with three of a kind, Eights
Seat 4: Ampped87 (big blind) showed [Td Kh] and lost with two pair, Kings and Tens
Seat 5: Innerwuss folded before Flop (didn't bet)
Seat 6: bdixon_5 folded before Flop (didn't bet)



PokerStars Hand #166667625285:  Hold'em No Limit ($0.05/$0.10 USD) - 2017/02/23 16:04:34 ET
Table 'Tirela' 6-max Seat #5 is the button
Seat 1: Smitty03300 ($10 in chips) 
Seat 2: Andrei ProFF ($17.79 in chips) 
Seat 3: aim444 ($15.77 in chips) 
Seat 4: ArcticBearDK ($10.01 in chips) 
Seat 5: KRZuff ($11.14 in chips) 
Seat 6: coolisses111 ($10 in chips) 
coolisses111: posts small blind $0.05
Smitty03300: posts big blind $0.10
*** HOLE CARDS ***
Andrei ProFF: folds 
aim444: folds 
ArcticBearDK: folds 
KRZuff: raises $0.15 to $0.25
coolisses111: folds 
Smitty03300: folds 
Uncalled bet ($0.15) returned to KRZuff
KRZuff collected $0.25 from pot
*** SUMMARY ***
Total pot $0.25 | Rake $0 
Seat 1: Smitty03300 (big blind) folded before Flop
Seat 2: Andrei ProFF folded before Flop (didn't bet)
Seat 3: aim444 folded before Flop (didn't bet)
Seat 4: ArcticBearDK folded before Flop (didn't bet)
Seat 5: KRZuff (button) collected ($0.25)
Seat 6: coolisses111 (small blind) folded before Flop



PokerStars Hand #166667625410:  Hold'em No Limit ($0.05/$0.10 USD) - 2017/02/23 16:04:34 ET
Table 'Aegle' 6-max Seat #5 is the button
Seat 1: phatts76 ($3.90 in chips) 
Seat 2: yodzik ($5 in chips) 
Seat 3: DrejAtom ($12.59 in chips) 
Seat 4: ab260414 ($10.37 in chips) 
Seat 5: KokoulinV ($10.98 in chips) 
Seat 6: CHRO8 ($20.49 in chips) 
CHRO8: posts small blind $0.05
phatts76: posts big blind $0.10
*** HOLE CARDS ***
yodzik: folds 
DrejAtom: folds 
ab260414: folds 
KokoulinV: folds 
CHRO8: folds 
Uncalled bet ($0.05) returned to phatts76
phatts76 collected $0.10 from pot
*** SUMMARY ***
Total pot $0.10 | Rake $0 
Seat 1: phatts76 (big blind) collected ($0.10)
Seat 2: yodzik folded before Flop (didn't bet)
Seat 3: DrejAtom folded before Flop (didn't bet)
Seat 4: ab260414 folded before Flop (didn't bet)
Seat 5: KokoulinV (button) folded before Flop (didn't bet)
Seat 6: CHRO8 (small blind) folded before Flop



PokerStars Hand #166667626064:  Hold'em No Limit ($0.05/$0.10 USD) - 2017/02/23 16:04:35 ET
Table 'Nemo III' 6-max Seat #4 is the button
Seat 1: Kow6oy ($10 in chips) 
Seat 2: Bandyaev ($11.74 in chips) 
Seat 4: vtalian ($9.55 in chips) 
Seat 5: Joker51_wtf! ($11.48 in chips) 
Joker51_wtf!: posts small blind $0.05
Kow6oy: posts big blind $0.10
*** HOLE CARDS ***
RoJ1 leaves the table
Bandyaev: folds 
Dimka4 joins the table at seat #3 
vtalian: raises $0.20 to $0.30
Joker51_wtf!: folds 
Kow6oy: folds 
Uncalled bet ($0.20) returned to vtalian
vtalian collected $0.25 from pot
*** SUMMARY ***
Total pot $0.25 | Rake $0 
Seat 1: Kow6oy (big blind) folded before Flop
Seat 2: Bandyaev folded before Flop (didn't bet)
Seat 4: vtalian (button) collected ($0.25)
Seat 5: Joker51_wtf! (small blind) folded before Flop



PokerStars Hand #166667626196:  Hold'em No Limit ($0.05/$0.10 USD) - 2017/02/23 16:04:35 ET
Table 'Huberta II' 6-max Seat #5 is the button
Seat 1: tr41n3r12 ($10.38 in chips) 
Seat 2: Ice_Isayev ($12.08 in chips) 
Seat 3: patrick19111 ($10.75 in chips) 
Seat 4: VAD21 ($12.11 in chips) 
Seat 5: Feverhead ($26.78 in chips) 
tr41n3r12: posts small blind $0.05
Ice_Isayev: posts big blind $0.10
*** HOLE CARDS ***
patrick19111: folds 
VAD21: folds 
Feverhead: folds 
tr41n3r12: folds 
Uncalled bet ($0.05) returned to Ice_Isayev
Ice_Isayev collected $0.10 from pot
*** SUMMARY ***
Total pot $0.10 | Rake $0 
Seat 1: tr41n3r12 (small blind) folded before Flop
Seat 2: Ice_Isayev (big blind) collected ($0.10)
Seat 3: patrick19111 folded before Flop (didn't bet)
Seat 4: VAD21 folded before Flop (didn't bet)
Seat 5: Feverhead (button) folded before Flop (didn't bet)



PokerStars Hand #166667626330:  Hold'em No Limit ($0.05/$0.10 USD) - 2017/02/23 16:04:35 ET
Table 'Marghanna II' 6-max Seat #3 is the button
Seat 2: Namhkal ($11.41 in chips) 
Seat 3: Innerwuss ($11.42 in chips) 
Seat 4: D3NyA ($12.27 in chips) 
Seat 5: ofl21189 ($7.83 in chips) 
Seat 6: VAD21 ($13.11 in chips) 
D3NyA: posts small blind $0.05
ofl21189: posts big blind $0.10
Goroshkos88: sits out 
*** HOLE CARDS ***
VAD21: folds 
Namhkal: folds 
Innerwuss: folds 
D3NyA: folds 
Uncalled bet ($0.05) returned to ofl21189
ofl21189 collected $0.10 from pot
*** SUMMARY ***
Total pot $0.10 | Rake $0 
Seat 2: Namhkal folded before Flop (didn't bet)
Seat 3: Innerwuss (button) folded before Flop (didn't bet)
Seat 4: D3NyA (small blind) folded before Flop
Seat 5: ofl21189 (big blind) collected ($0.10)
Seat 6: VAD21 folded before Flop (didn't bet)



PokerStars Hand #166667626477:  Hold'em No Limit ($0.05/$0.10 USD) - 2017/02/23 16:04:35 ET
Table 'Syringa II' 6-max Seat #1 is the button
Seat 1: GiveTwoMe ($13.45 in chips) 
Seat 2: Cluckh ($10.19 in chips) 
Seat 3: gaHy_HaXeP ($10.73 in chips) 
Seat 4: MBen10 ($10 in chips) 
Seat 5: Mishapok196 ($7.80 in chips) 
Seat 6: WinninBikini ($10.37 in chips) 
Cluckh: posts small blind $0.05
gaHy_HaXeP: posts big blind $0.10
*** HOLE CARDS ***
MBen10: folds 
Mishapok196: calls $0.10
WinninBikini: folds 
GiveTwoMe: raises $0.20 to $0.30
Cluckh: folds 
gaHy_HaXeP: folds 
Mishapok196: calls $0.20
*** FLOP *** [Kc 7c 3c]
Mishapok196: checks 
GiveTwoMe: bets $0.57
Mishapok196: folds 
Uncalled bet ($0.57) returned to GiveTwoMe
GiveTwoMe collected $0.72 from pot
*** SUMMARY ***
Total pot $0.75 | Rake $0.03 
Board [Kc 7c 3c]
Seat 1: GiveTwoMe (button) collected ($0.72)
Seat 2: Cluckh (small blind) folded before Flop
Seat 3: gaHy_HaXeP (big blind) folded before Flop
Seat 4: MBen10 folded before Flop (didn't bet)
Seat 5: Mishapok196 folded on the Flop
Seat 6: WinninBikini folded before Flop (didn't bet)



PokerStars Hand #166667626568:  Hold'em No Limit ($0.05/$0.10 USD) - 2017/02/23 16:04:36 ET
Table 'Tomyris II' 6-max Seat #3 is the button
Seat 1: ArcticBearDK ($21.98 in chips) 
Seat 2: Yspenyanin ($12.39 in chips) 
Seat 3: robertsabb ($12.38 in chips) 
Seat 4: Dcaro31 ($10 in chips) 
Seat 5: 6ePeMeHHa9 ($10 in chips) 
Seat 6: StackSmakka ($11.59 in chips) 
Dcaro31: posts small blind $0.05
6ePeMeHHa9: posts big blind $0.10
*** HOLE CARDS ***
StackSmakka: folds 
ArcticBearDK: folds 
Yspenyanin: folds 
robertsabb: raises $0.10 to $0.20
Dcaro31: folds 
6ePeMeHHa9: folds 
Uncalled bet ($0.10) returned to robertsabb
robertsabb collected $0.25 from pot
*** SUMMARY ***
Total pot $0.25 | Rake $0 
Seat 1: ArcticBearDK folded before Flop (didn't bet)
Seat 2: Yspenyanin folded before Flop (didn't bet)
Seat 3: robertsabb (button) collected ($0.25)
Seat 4: Dcaro31 (small blind) folded before Flop
Seat 5: 6ePeMeHHa9 (big blind) folded before Flop
Seat 6: StackSmakka folded before Flop (didn't bet)



PokerStars Hand #166667626912:  Hold'em No Limit ($0.05/$0.10 USD) - 2017/02/23 16:04:36 ET
Table 'Kochera' 6-max Seat #2 is the button
Seat 1: chimera252 ($11.82 in chips) 
Seat 2: bartabs2 ($10.26 in chips) 
Seat 3: KA3AXCTAHEU, ($10.15 in chips) 
Seat 4: johkom ($5.46 in chips) 
Seat 5: univibe68 ($11.85 in chips) 
Seat 6: oddshoff ($9.63 in chips) 
KA3AXCTAHEU,: posts small blind $0.05
johkom: posts big blind $0.10
*** HOLE CARDS ***
univibe68: folds 
oddshoff: folds 
chimera252: folds 
bartabs2: raises $0.10 to $0.20
KA3AXCTAHEU,: calls $0.15
johkom: folds 
*** FLOP *** [Kc 3d 5s]
KA3AXCTAHEU,: checks 
bartabs2: checks 
*** TURN *** [Kc 3d 5s] [6s]
KA3AXCTAHEU,: checks 
bartabs2: checks 
*** RIVER *** [Kc 3d 5s 6s] [Tc]
KA3AXCTAHEU,: checks 
bartabs2: bets $0.10
KA3AXCTAHEU,: folds 
Uncalled bet ($0.10) returned to bartabs2
bartabs2 collected $0.48 from pot
*** SUMMARY ***
Total pot $0.50 | Rake $0.02 
Board [Kc 3d 5s 6s Tc]
Seat 1: chimera252 folded before Flop (didn't bet)
Seat 2: bartabs2 (button) collected ($0.48)
Seat 3: KA3AXCTAHEU, (small blind) folded on the River
Seat 4: johkom (big blind) folded before Flop
Seat 5: univibe68 folded before Flop (didn't bet)
Seat 6: oddshoff folded before Flop (didn't bet)



PokerStars Hand #166667627008:  Hold'em No Limit ($0.05/$0.10 USD) - 2017/02/23 16:04:36 ET
Table 'Kunigunde II' 6-max Seat #3 is the button
Seat 1: facewald ($9.79 in chips) 
Seat 3: pancernik21 ($14.93 in chips) 
Seat 4: david_sara83 ($12.88 in chips) 
Seat 5: mdelfin0 ($11.59 in chips) 
Seat 6: Zooplack ($10 in chips) 
david_sara83: posts small blind $0.05
mdelfin0: posts big blind $0.10
eniksenik: sits out 
*** HOLE CARDS ***
Zooplack: folds 
facewald: raises $0.19 to $0.29
pancernik21: folds 
david_sara83: folds 
mdelfin0: folds 
Uncalled bet ($0.19) returned to facewald
facewald collected $0.25 from pot
*** SUMMARY ***
Total pot $0.25 | Rake $0 
Seat 1: facewald collected ($0.25)
Seat 3: pancernik21 (button) folded before Flop (didn't bet)
Seat 4: david_sara83 (small blind) folded before Flop
Seat 5: mdelfin0 (big blind) folded before Flop
Seat 6: Zooplack folded before Flop (didn't bet)



PokerStars Hand #166667627056:  Hold'em No Limit ($0.05/$0.10 USD) - 2017/02/23 16:04:36 ET
Table 'Landi II' 6-max Seat #3 is the button
Seat 1: dersiemer ($11.89 in chips) 
Seat 2: Aescul@pius ($10.95 in chips) 
Seat 3: dr.goofy ($21.44 in chips) 
Seat 4: alesi13 ($6.45 in chips) 
Seat 5: Bird et al ($10 in chips) 
alesi13: posts small blind $0.05
Bird et al: posts big blind $0.10
*** HOLE CARDS ***
dersiemer: raises $0.20 to $0.30
Aescul@pius: folds 
dr.goofy: folds 
alesi13: folds 
Bird et al: folds 
Uncalled bet ($0.20) returned to dersiemer
dersiemer collected $0.25 from pot
*** SUMMARY ***
Total pot $0.25 | Rake $0 
Seat 1: dersiemer collected ($0.25)
Seat 2: Aescul@pius folded before Flop (didn't bet)
Seat 3: dr.goofy (button) folded before Flop (didn't bet)
Seat 4: alesi13 (small blind) folded before Flop
Seat 5: Bird et al (big blind) folded before Flop



PokerStars Hand #166667627419:  Hold'em No Limit ($0.05/$0.10 USD) - 2017/02/23 16:04:36 ET
Table 'Apollonia' 6-max Seat #4 is the button
Seat 1: ex3Lero86 ($10.11 in chips) 
Seat 2: ibara000 ($18.84 in chips) 
Seat 4: Goroshkos88 ($17.31 in chips) 
Seat 5: EphemeralBen ($22.05 in chips) 
Seat 6: Namhkal ($10.40 in chips) 
EphemeralBen: posts small blind $0.05
Namhkal: posts big blind $0.10
*** HOLE CARDS ***
ex3Lero86: folds 
ibara000: raises $0.16 to $0.26
derbesteojr leaves the table
Goroshkos88: raises $0.64 to $0.90
EphemeralBen: folds 
Namhkal: folds 
ibara000: folds 
Uncalled bet ($0.64) returned to Goroshkos88
Goroshkos88 collected $0.67 from pot
*** SUMMARY ***
Total pot $0.67 | Rake $0 
Seat 1: ex3Lero86 folded before Flop (didn't bet)
Seat 2: ibara000 folded before Flop
Seat 4: Goroshkos88 (button) collected ($0.67)
Seat 5: EphemeralBen (small blind) folded before Flop
Seat 6: Namhkal (big blind) folded before Flop



PokerStars Hand #166667627675:  Hold'em No Limit ($0.05/$0.10 USD) - 2017/02/23 16:04:37 ET
Table 'Lesath III' 6-max Seat #2 is the button
Seat 1: Gogeta26 ($6.12 in chips) 
Seat 2: WinninBikini ($10.03 in chips) 
Seat 3: Giyorod ($10.47 in chips) 
Seat 4: Eddys Edge ($10 in chips) 
Seat 5: eniksenik ($16.15 in chips) 
Seat 6: patrick19111 ($10.56 in chips) 
Giyorod: posts small blind $0.05
Eddys Edge: posts big blind $0.10
*** HOLE CARDS ***
eniksenik: folds 
patrick19111: folds 
Gogeta26: folds 
WinninBikini: folds 
Giyorod: raises $0.20 to $0.30
Eddys Edge: calls $0.20
*** FLOP *** [4h 7c As]
Giyorod: bets $0.31
Eddys Edge: calls $0.31
*** TURN *** [4h 7c As] [5s]
Giyorod: checks 
Eddys Edge: checks 
*** RIVER *** [4h 7c As 5s] [Ad]
Giyorod: checks 
Eddys Edge: checks 
*** SHOW DOWN ***
Giyorod: shows [7s Jh] (two pair, Aces and Sevens)
Eddys Edge: shows [7d Kh] (two pair, Aces and Sevens - King kicker)
Eddys Edge collected $1.17 from pot
*** SUMMARY ***
Total pot $1.22 | Rake $0.05 
Board [4h 7c As 5s Ad]
Seat 1: Gogeta26 folded before Flop (didn't bet)
Seat 2: WinninBikini (button) folded before Flop (didn't bet)
Seat 3: Giyorod (small blind) showed [7s Jh] and lost with two pair, Aces and Sevens
Seat 4: Eddys Edge (big blind) showed [7d Kh] and won ($1.17) with two pair, Aces and Sevens
Seat 5: eniksenik folded before Flop (didn't bet)
Seat 6: patrick19111 folded before Flop (didn't bet)



PokerStars Hand #166667627723:  Hold'em No Limit ($0.05/$0.10 USD) - 2017/02/23 16:04:37 ET
Table 'Tyche III' 6-max Seat #4 is the button
Seat 1: milt65 ($10.16 in chips) 
Seat 3: ChuikaPridi ($10 in chips) 
Seat 4: Kazacha ($10 in chips) 
Seat 5: chimera252 ($12.95 in chips) 
Seat 6: Ice_Isayev ($10.15 in chips) 
chimera252: posts small blind $0.05
Ice_Isayev: posts big blind $0.10
*** HOLE CARDS ***
milt65: raises $0.15 to $0.25
ChuikaPridi: folds 
Kazacha: folds 
chimera252: folds 
Ice_Isayev: folds 
Uncalled bet ($0.15) returned to milt65
milt65 collected $0.25 from pot
*** SUMMARY ***
Total pot $0.25 | Rake $0 
Seat 1: milt65 collected ($0.25)
Seat 3: ChuikaPridi folded before Flop (didn't bet)
Seat 4: Kazacha (button) folded before Flop (didn't bet)
Seat 5: chimera252 (small blind) folded before Flop
Seat 6: Ice_Isayev (big blind) folded before Flop



PokerStars Hand #166667628022:  Hold'em No Limit ($0.05/$0.10 USD) - 2017/02/23 16:04:37 ET
Table 'Scabiosa III' 6-max Seat #2 is the button
Seat 1: Feverhead ($13.26 in chips) 
Seat 2: yodzik ($5 in chips) 
Seat 4: voledy ($10.15 in chips) 
Seat 5: patrick19111 ($25.60 in chips) 
voledy: posts small blind $0.05
patrick19111: posts big blind $0.10
*** HOLE CARDS ***
Feverhead: folds 
yodzik: raises $0.20 to $0.30
Smitty03300 leaves the table
voledy: folds 
patrick19111: folds 
Uncalled bet ($0.20) returned to yodzik
yodzik collected $0.25 from pot
*** SUMMARY ***
Total pot $0.25 | Rake $0 
Seat 1: Feverhead folded before Flop (didn't bet)
Seat 2: yodzik (button) collected ($0.25)
Seat 4: voledy (small blind) folded before Flop
Seat 5: patrick19111 (big blind) folded before Flop



PokerStars Hand #166667628217:  Hold'em No Limit ($0.05/$0.10 USD) - 2017/02/23 16:04:37 ET
Table 'Izar' 6-max Seat #1 is the button
Seat 1: bambolejro ($10.39 in chips) 
Seat 2: mvp0013 ($11.03 in chips) 
Seat 3: Yspenyanin ($11.27 in chips) 
Seat 4: Matee92 ($6.16 in chips) 
Seat 5: fishhook5 ($11.30 in chips) 
Seat 6: yodzik ($5 in chips) 
mvp0013: posts small blind $0.05
Yspenyanin: posts big blind $0.10
*** HOLE CARDS ***
Matee92: folds 
fishhook5: raises $0.19 to $0.29
yodzik: folds 
bambolejro: folds 
mvp0013: folds 
Yspenyanin: folds 
Uncalled bet ($0.19) returned to fishhook5
fishhook5 collected $0.25 from pot
*** SUMMARY ***
Total pot $0.25 | Rake $0 
Seat 1: bambolejro (button) folded before Flop (didn't bet)
Seat 2: mvp0013 (small blind) folded before Flop
Seat 3: Yspenyanin (big blind) folded before Flop
Seat 4: Matee92 folded before Flop (didn't bet)
Seat 5: fishhook5 collected ($0.25)
Seat 6: yodzik folded before Flop (didn't bet)



PokerStars Hand #166667628937:  Hold'em No Limit ($0.05/$0.10 USD) - 2017/02/23 16:04:38 ET
Table 'Armenia' 6-max Seat #2 is the button
Seat 1: tr41n3r12 ($12.02 in chips) 
Seat 2: Yabidooo ($11.72 in chips) 
Seat 3: XwinX25 ($10 in chips) 
Seat 5: boxer821 ($12.10 in chips) 
Seat 6: mega spasser ($6.36 in chips) 
XwinX25: posts small blind $0.05
x3ultimate: is sitting out 
boxer821: posts big blind $0.10
x3ultimate leaves the table
*** HOLE CARDS ***
mega spasser: folds 
tr41n3r12: folds 
Yabidooo: folds 
XwinX25: raises $0.15 to $0.25
boxer821: calls $0.15
*** FLOP *** [5s Ah 7c]
XwinX25: checks 
boxer821: bets $0.30
XwinX25: folds 
Uncalled bet ($0.30) returned to boxer821
boxer821 collected $0.48 from pot
*** SUMMARY ***
Total pot $0.50 | Rake $0.02 
Board [5s Ah 7c]
Seat 1: tr41n3r12 folded before Flop (didn't bet)
Seat 2: Yabidooo (button) folded before Flop (didn't bet)
Seat 3: XwinX25 (small blind) folded on the Flop
Seat 5: boxer821 (big blind) collected ($0.48)
Seat 6: mega spasser folded before Flop (didn't bet)



PokerStars Hand #166667629005:  Hold'em No Limit ($0.05/$0.10 USD) - 2017/02/23 16:04:38 ET
Table 'Iduberga II' 6-max Seat #5 is the button
Seat 1: mhonielsen ($10.76 in chips) 
Seat 2: popypaleta ($12.80 in chips) 
Seat 3: scorpionfish ($11.58 in chips) 
Seat 4: Peter0087 ($9.88 in chips) 
Seat 5: Pokeaster ($10.47 in chips) 
Seat 6: tblocos ($12.41 in chips) 
tblocos: posts small blind $0.05
mhonielsen: posts big blind $0.10
*** HOLE CARDS ***
popypaleta: raises $0.20 to $0.30
scorpionfish: folds 
Peter0087: folds 
Pokeaster: folds 
tblocos: folds 
mhonielsen: folds 
Uncalled bet ($0.20) returned to popypaleta
popypaleta collected $0.25 from pot
*** SUMMARY ***
Total pot $0.25 | Rake $0 
Seat 1: mhonielsen (big blind) folded before Flop
Seat 2: popypaleta collected ($0.25)
Seat 3: scorpionfish folded before Flop (didn't bet)
Seat 4: Peter0087 folded before Flop (didn't bet)
Seat 5: Pokeaster (button) folded before Flop (didn't bet)
Seat 6: tblocos (small blind) folded before Flop



PokerStars Hand #166667629007:  Hold'em No Limit ($0.05/$0.10 USD) - 2017/02/23 16:04:38 ET
Table 'Hunnia' 6-max Seat #4 is the button
Seat 1: univibe68 ($22.03 in chips) 
Seat 2: mhonielsen ($10 in chips) 
Seat 3: 6ePeMeHHa9 ($10.71 in chips) 
Seat 4: Jalida3 ($10.55 in chips) 
Seat 5: Smarkon ($14.83 in chips) 
Seat 6: ChuikaPridi ($10 in chips) 
Smarkon: posts small blind $0.05
ChuikaPridi: posts big blind $0.10
*** HOLE CARDS ***
univibe68: folds 
mhonielsen: folds 
6ePeMeHHa9: folds 
Jalida3: folds 
Smarkon: folds 
Uncalled bet ($0.05) returned to ChuikaPridi
ChuikaPridi collected $0.10 from pot
*** SUMMARY ***
Total pot $0.10 | Rake $0 
Seat 1: univibe68 folded before Flop (didn't bet)
Seat 2: mhonielsen folded before Flop (didn't bet)
Seat 3: 6ePeMeHHa9 folded before Flop (didn't bet)
Seat 4: Jalida3 (button) folded before Flop (didn't bet)
Seat 5: Smarkon (small blind) folded before Flop
Seat 6: ChuikaPridi (big blind) collected ($0.10)



PokerStars Hand #166667629646:  Hold'em No Limit ($0.05/$0.10 USD) - 2017/02/23 16:04:39 ET
Table 'Eudora' 6-max Seat #1 is the button
Seat 1: archer2511 ($11.46 in chips) 
Seat 2: popypaleta ($10 in chips) 
Seat 3: Ice_Isayev ($10 in chips) 
Seat 5: chimera252 ($11.67 in chips) 
popypaleta: posts small blind $0.05
Ice_Isayev: posts big blind $0.10
yodzik: sits out 
*** HOLE CARDS ***
chimera252: folds 
archer2511: folds 
popypaleta: folds 
Uncalled bet ($0.05) returned to Ice_Isayev
Ice_Isayev collected $0.10 from pot
*** SUMMARY ***
Total pot $0.10 | Rake $0 
Seat 1: archer2511 (button) folded before Flop (didn't bet)
Seat 2: popypaleta (small blind) folded before Flop
Seat 3: Ice_Isayev (big blind) collected ($0.10)
Seat 5: chimera252 folded before Flop (didn't bet)



PokerStars Hand #166667629704:  Hold'em No Limit ($0.05/$0.10 USD) - 2017/02/23 16:04:39 ET
Table 'Anhui II' 6-max Seat #5 is the button
Seat 1: kingartur222 ($11.99 in chips) 
Seat 2: kikus334 ($13.16 in chips) 
Seat 3: lochniak556 ($26 in chips) 
Seat 4: dragonste89 ($10 in chips) 
Seat 5: Bandyaev ($10 in chips) 
Seat 6: .BaRReL.1122 ($5.55 in chips) 
.BaRReL.1122: posts small blind $0.05
kingartur222: posts big blind $0.10
*** HOLE CARDS ***
kikus334: calls $0.10
lochniak556: folds 
dragonste89: folds 
Bandyaev: folds 
.BaRReL.1122: calls $0.05
kingartur222: raises $0.40 to $0.50
kikus334: calls $0.40
.BaRReL.1122: calls $0.40
*** FLOP *** [Kd 3h 5s]
.BaRReL.1122: checks 
kingartur222: bets $1.07
kikus334: folds 
.BaRReL.1122: folds 
Uncalled bet ($1.07) returned to kingartur222
kingartur222 collected $1.43 from pot
*** SUMMARY ***
Total pot $1.50 | Rake $0.07 
Board [Kd 3h 5s]
Seat 1: kingartur222 (big blind) collected ($1.43)
Seat 2: kikus334 folded on the Flop
Seat 3: lochniak556 folded before Flop (didn't bet)
Seat 4: dragonste89 folded before Flop (didn't bet)
Seat 5: Bandyaev (button) folded before Flop (didn't bet)
Seat 6: .BaRReL.1122 (small blind) folded on the Flop



PokerStars Hand #166667629815:  Hold'em No Limit ($0.05/$0.10 USD) - 2017/02/23 16:04:39 ET
Table 'Union' 6-max Seat #3 is the button
Seat 2: Zooplack ($10.15 in chips) 
Seat 3: Rodik002 ($12.01 in chips) 
Seat 4: Croplayer1 ($14.85 in chips) 
Seat 5: Chodemuncher ($15.48 in chips) 
Seat 6: bonyo71 ($3.85 in chips) 
Croplayer1: posts small blind $0.05
Chodemuncher: posts big blind $0.10
*** HOLE CARDS ***
bonyo71: folds 
Zooplack: raises $0.15 to $0.25
Rodik002: folds 
Croplayer1: folds 
Chodemuncher: calls $0.15
*** FLOP *** [8s 2c Kh]
Chodemuncher: checks 
Zooplack: bets $0.32
Chodemuncher: calls $0.32
*** TURN *** [8s 2c Kh] [Th]
IAntikI joins the table at seat #1 
Chodemuncher: checks 
Zooplack: checks 
*** RIVER *** [8s 2c Kh Th] [Ts]
Chodemuncher: checks 
Zooplack: checks 
*** SHOW DOWN ***
Chodemuncher: shows [Ks Js] (two pair, Kings and Tens)
Zooplack: mucks hand 
Chodemuncher collected $1.14 from pot
*** SUMMARY ***
Total pot $1.19 | Rake $0.05 
Board [8s 2c Kh Th Ts]
Seat 2: Zooplack mucked
Seat 3: Rodik002 (button) folded before Flop (didn't bet)
Seat 4: Croplayer1 (small blind) folded before Flop
Seat 5: Chodemuncher (big blind) showed [Ks Js] and won ($1.14) with two pair, Kings and Tens
Seat 6: bonyo71 folded before Flop (didn't bet)



PokerStars Hand #166667629970:  Hold'em No Limit ($0.05/$0.10 USD) - 2017/02/23 16:04:39 ET
Table 'Unitas II' 6-max Seat #5 is the button
Seat 1: Peter0087 ($9.85 in chips) 
Seat 4: truck1234 ($10.94 in chips) 
Seat 5: chimera252 ($25.91 in chips) 
Seat 6: paxit71 ($8.32 in chips) 
paxit71: posts small blind $0.05
Peter0087: posts big blind $0.10
steepfell: sits out 
*** HOLE CARDS ***
truck1234: folds 
chimera252: raises $0.15 to $0.25
paxit71: calls $0.20
Peter0087: folds 
*** FLOP *** [5d Jd Tc]
paxit71: bets $0.29
chimera252: raises $0.74 to $1.03
paxit71: calls $0.74
*** TURN *** [5d Jd Tc] [6d]
paxit71: bets $1.27
chimera252: folds 
Uncalled bet ($1.27) returned to paxit71
paxit71 collected $2.54 from pot
*** SUMMARY ***
Total pot $2.66 | Rake $0.12 
Board [5d Jd Tc 6d]
Seat 1: Peter0087 (big blind) folded before Flop
Seat 4: truck1234 folded before Flop (didn't bet)
Seat 5: chimera252 (button) folded on the Turn
Seat 6: paxit71 (small blind) collected ($2.54)



PokerStars Hand #166667630084:  Hold'em No Limit ($0.05/$0.10 USD) - 2017/02/23 16:04:39 ET
Table 'Selinur' 6-max Seat #5 is the button
Seat 1: KA3AXCTAHEU, ($10 in chips) 
Seat 2: hoedje72 ($8.34 in chips) 
Seat 3: bambolejro ($11.07 in chips) 
Seat 4: freezing666 ($11.63 in chips) 
Seat 5: IAntikI ($10.22 in chips) 
Seat 6: homelessdan ($17.52 in chips) 
homelessdan: posts small blind $0.05
KA3AXCTAHEU,: posts big blind $0.10
*** HOLE CARDS ***
hoedje72: folds 
bambolejro: folds 
freezing666: folds 
IAntikI: raises $0.15 to $0.25
homelessdan: folds 
KA3AXCTAHEU,: folds 
Uncalled bet ($0.15) returned to IAntikI
IAntikI collected $0.25 from pot
*** SUMMARY ***
Total pot $0.25 | Rake $0 
Seat 1: KA3AXCTAHEU, (big blind) folded before Flop
Seat 2: hoedje72 folded before Flop (didn't bet)
Seat 3: bambolejro folded before Flop (didn't bet)
Seat 4: freezing666 folded before Flop (didn't bet)
Seat 5: IAntikI (button) collected ($0.25)
Seat 6: homelessdan (small blind) folded before Flop



PokerStars Hand #166667630211:  Hold'em No Limit ($0.05/$0.10 USD) - 2017/02/23 16:04:40 ET
Table 'Epimetheus' 6-max Seat #1 is the button
Seat 1: 6ePeMeHHa9 ($10.29 in chips) 
Seat 2: patrick19111 ($15.56 in chips) 
Seat 3: dineldidi ($9.84 in chips) 
Seat 5: afca128 ($24.13 in chips) 
Seat 6: voledy ($10.15 in chips) 
patrick19111: posts small blind $0.05
dineldidi: posts big blind $0.10
*** HOLE CARDS ***
afca128: raises $0.20 to $0.30
voledy: raises $0.60 to $0.90
6ePeMeHHa9: folds 
patrick19111: folds 
dineldidi: folds 
afca128: folds 
Uncalled bet ($0.60) returned to voledy
voledy collected $0.75 from pot
*** SUMMARY ***
Total pot $0.75 | Rake $0 
Seat 1: 6ePeMeHHa9 (button) folded before Flop (didn't bet)
Seat 2: patrick19111 (small blind) folded before Flop
Seat 3: dineldidi (big blind) folded before Flop
Seat 5: afca128 folded before Flop
Seat 6: voledy collected ($0.75)



PokerStars Hand #166667630283:  Hold'em No Limit ($0.05/$0.10 USD) - 2017/02/23 16:04:40 ET
Table 'Brendelia II' 6-max Seat #6 is the button
Seat 2: Crimsonr ($5.06 in chips) 
Seat 3: ValdemorS ($18.98 in chips) 
Seat 6: luckyPositiv ($10.17 in chips) 
Crimsonr: posts small blind $0.05
ValdemorS: posts big blind $0.10
Crimsonr: posts the ante $0.02
ValdemorS: posts the ante $0.02
luckyPositiv: posts the ante $0.02
*** HOLE CARDS ***
luckyPositiv: folds 
Crimsonr: folds 
Uncalled bet ($0.05) returned to ValdemorS
ValdemorS collected $0.16 from pot
*** SUMMARY ***
Total pot $0.16 | Rake $0 
Seat 2: Crimsonr (small blind) folded before Flop
Seat 3: ValdemorS (big blind) collected ($0.16)
Seat 6: luckyPositiv (button) folded before Flop (didn't bet)



PokerStars Hand #166667630454:  Hold'em No Limit ($0.05/$0.10 USD) - 2017/02/23 16:04:40 ET
Table 'Luanda' 6-max Seat #3 is the button
Seat 1: AM-L-SL ($4.85 in chips) 
Seat 2: Xander188 ($10 in chips) 
Seat 3: DamDatsAnAce ($10 in chips) 
Seat 5: st4tion ($13.08 in chips) 
Seat 6: KA3AXCTAHEU, ($11.58 in chips) 
st4tion: posts small blind $0.05
KA3AXCTAHEU,: posts big blind $0.10
*** HOLE CARDS ***
AM-L-SL: folds 
Xander188: folds 
DamDatsAnAce: raises $0.15 to $0.25
st4tion: folds 
KA3AXCTAHEU,: folds 
Uncalled bet ($0.15) returned to DamDatsAnAce
DamDatsAnAce collected $0.25 from pot
*** SUMMARY ***
Total pot $0.25 | Rake $0 
Seat 1: AM-L-SL folded before Flop (didn't bet)
Seat 2: Xander188 folded before Flop (didn't bet)
Seat 3: DamDatsAnAce (button) collected ($0.25)
Seat 5: st4tion (small blind) folded before Flop
Seat 6: KA3AXCTAHEU, (big blind) folded before Flop



PokerStars Hand #166667630622:  Hold'em No Limit ($0.05/$0.10 USD) - 2017/02/23 16:04:40 ET
Table 'Ruvuma' 6-max Seat #2 is the button
Seat 1: FRAID358 ($14.15 in chips) 
Seat 2: Fab_1512 ($12.62 in chips) 
Seat 3: Spud014 ($10 in chips) 
Seat 4: DamDatsAnAce ($10 in chips) 
Seat 5: sexy_seagull ($10 in chips) 
Seat 6: Elinaattor ($9.60 in chips) 
Spud014: posts small blind $0.05
DamDatsAnAce: posts big blind $0.10
*** HOLE CARDS ***
sexy_seagull: folds 
Elinaattor: folds 
FRAID358: folds 
Fab_1512: folds 
Spud014: folds 
Uncalled bet ($0.05) returned to DamDatsAnAce
DamDatsAnAce collected $0.10 from pot
*** SUMMARY ***
Total pot $0.10 | Rake $0 
Seat 1: FRAID358 folded before Flop (didn't bet)
Seat 2: Fab_1512 (button) folded before Flop (didn't bet)
Seat 3: Spud014 (small blind) folded before Flop
Seat 4: DamDatsAnAce (big blind) collected ($0.10)
Seat 5: sexy_seagull folded before Flop (didn't bet)
Seat 6: Elinaattor folded before Flop (didn't bet)



PokerStars Hand #166667630649:  Hold'em No Limit ($0.05/$0.10 USD) - 2017/02/23 16:04:40 ET
Table 'Tyndareus III' 6-max Seat #2 is the button
Seat 1: MBen10 ($10 in chips) 
Seat 2: MihaGr ($10 in chips) 
Seat 3: XaXaTyH4uK ($10.65 in chips) 
Seat 5: yodzik ($5 in chips) 
Seat 6: Elinaattor ($10.30 in chips) 
XaXaTyH4uK: posts small blind $0.05
yodzik: posts big blind $0.10
*** HOLE CARDS ***
Elinaattor: folds 
MBen10: raises $0.15 to $0.25
MihaGr: folds 
XaXaTyH4uK: folds 
yodzik: folds 
Uncalled bet ($0.15) returned to MBen10
MBen10 collected $0.25 from pot
*** SUMMARY ***
Total pot $0.25 | Rake $0 
Seat 1: MBen10 collected ($0.25)
Seat 2: MihaGr (button) folded before Flop (didn't bet)
Seat 3: XaXaTyH4uK (small blind) folded before Flop
Seat 5: yodzik (big blind) folded before Flop
Seat 6: Elinaattor folded before Flop (didn't bet)



PokerStars Hand #166667630815:  Hold'em No Limit ($0.05/$0.10 USD) - 2017/02/23 16:04:40 ET
Table 'Alzirr II' 6-max Seat #6 is the button
Seat 1: KA3AXCTAHEU, ($10.21 in chips) 
Seat 2: popypaleta ($10.32 in chips) 
Seat 4: Scanner17 ($18.09 in chips) 
Seat 5: yodzik ($5.37 in chips) 
Seat 6: AM-L-SL ($4.60 in chips) 
KA3AXCTAHEU,: posts small blind $0.05
popypaleta: posts big blind $0.10
devon_red: sits out 
*** HOLE CARDS ***
Scanner17 has timed out
Scanner17: folds 
yodzik: folds 
AM-L-SL: calls $0.10
KA3AXCTAHEU,: folds 
popypaleta: checks 
*** FLOP *** [9d 2s 7s]
popypaleta: checks 
AM-L-SL: checks 
*** TURN *** [9d 2s 7s] [Qd]
popypaleta: checks 
AM-L-SL: checks 
*** RIVER *** [9d 2s 7s Qd] [As]
popypaleta: checks 
AM-L-SL: bets $0.20
popypaleta: folds 
Uncalled bet ($0.20) returned to AM-L-SL
AM-L-SL collected $0.24 from pot
*** SUMMARY ***
Total pot $0.25 | Rake $0.01 
Board [9d 2s 7s Qd As]
Seat 1: KA3AXCTAHEU, (small blind) folded before Flop
Seat 2: popypaleta (big blind) folded on the River
Seat 4: Scanner17 folded before Flop (didn't bet)
Seat 5: yodzik folded before Flop (didn't bet)
Seat 6: AM-L-SL (button) collected ($0.24)



PokerStars Hand #166667630928:  Hold'em No Limit ($0.05/$0.10 USD) - 2017/02/23 16:04:40 ET
Table 'Crommelin II' 6-max Seat #3 is the button
Seat 1: THIMUCHIN ($11.62 in chips) 
Seat 2: Bird et al ($10 in chips) 
Seat 3: Strelok1974 ($21.80 in chips) 
Seat 4: Pequeño Clau ($10.20 in chips) 
Seat 5: Action_Gibi ($20.39 in chips) 
Pequeño Clau: posts small blind $0.05
Action_Gibi: posts big blind $0.10
*** HOLE CARDS ***
THIMUCHIN: folds 
Bird et al: folds 
Strelok1974: folds 
Pequeño Clau: raises $0.20 to $0.30
Action_Gibi: raises $0.30 to $0.60
Pequeño Clau: calls $0.30
*** FLOP *** [Th 5d Tc]
Pequeño Clau: checks 
Action_Gibi: bets $0.58
Pequeño Clau: calls $0.58
*** TURN *** [Th 5d Tc] [4s]
Pequeño Clau: checks 
Action_Gibi: checks 
*** RIVER *** [Th 5d Tc 4s] [Ts]
Pequeño Clau: bets $2.03
Action_Gibi: calls $2.03
*** SHOW DOWN ***
Pequeño Clau: shows [Td 8d] (four of a kind, Tens)
Action_Gibi: mucks hand 
Pequeño Clau collected $6.13 from pot
*** SUMMARY ***
Total pot $6.42 | Rake $0.29 
Board [Th 5d Tc 4s Ts]
Seat 1: THIMUCHIN folded before Flop (didn't bet)
Seat 2: Bird et al folded before Flop (didn't bet)
Seat 3: Strelok1974 (button) folded before Flop (didn't bet)
Seat 4: Pequeño Clau (small blind) showed [Td 8d] and won ($6.13) with four of a kind, Tens
Seat 5: Action_Gibi (big blind) mucked



PokerStars Hand #166667631092:  Hold'em No Limit ($0.05/$0.10 USD) - 2017/02/23 16:04:41 ET
Table 'Alnasl' 6-max Seat #1 is the button
Seat 1: KA3AXCTAHEU, ($11.07 in chips) 
Seat 3: david_sara83 ($22.74 in chips) 
Seat 4: oddshoff ($9.98 in chips) 
Seat 5: steepfell ($10.43 in chips) 
Seat 6: Zooplack ($13.28 in chips) 
david_sara83: posts small blind $0.05
oddshoff: posts big blind $0.10
*** HOLE CARDS ***
saddur joins the table at seat #2 
steepfell: folds 
Zooplack: raises $0.20 to $0.30
KA3AXCTAHEU,: folds 
david_sara83: folds 
oddshoff: folds 
Uncalled bet ($0.20) returned to Zooplack
Zooplack collected $0.25 from pot
*** SUMMARY ***
Total pot $0.25 | Rake $0 
Seat 1: KA3AXCTAHEU, (button) folded before Flop (didn't bet)
Seat 3: david_sara83 (small blind) folded before Flop
Seat 4: oddshoff (big blind) folded before Flop
Seat 5: steepfell folded before Flop (didn't bet)
Seat 6: Zooplack collected ($0.25)



PokerStars Hand #166667631096:  Hold'em No Limit ($0.05/$0.10 USD) - 2017/02/23 16:04:41 ET
Table 'Phereclos II' 6-max Seat #6 is the button
Seat 1: Croplayer1 ($10 in chips) 
Seat 2: Kazacha ($10.28 in chips) 
Seat 3: kickereens ($21.16 in chips) 
Seat 4: DamDatsAnAce ($10.53 in chips) 
Seat 6: mhonielsen ($16.02 in chips) 
Croplayer1: posts small blind $0.05
Kazacha: posts big blind $0.10
crazydevill: sits out 
*** HOLE CARDS ***
kickereens: folds 
DamDatsAnAce: folds 
mhonielsen: raises $0.10 to $0.20
Croplayer1: calls $0.15
Kazacha: folds 
*** FLOP *** [Ts 6s 7s]
Croplayer1: checks 
mhonielsen: bets $0.34
Croplayer1: folds 
Uncalled bet ($0.34) returned to mhonielsen
mhonielsen collected $0.48 from pot
*** SUMMARY ***
Total pot $0.50 | Rake $0.02 
Board [Ts 6s 7s]
Seat 1: Croplayer1 (small blind) folded on the Flop
Seat 2: Kazacha (big blind) folded before Flop
Seat 3: kickereens folded before Flop (didn't bet)
Seat 4: DamDatsAnAce folded before Flop (didn't bet)
Seat 6: mhonielsen (button) collected ($0.48)



PokerStars Hand #166667631212:  Hold'em No Limit ($0.05/$0.10 USD) - 2017/02/23 16:04:41 ET
Table 'Nymphe II' 6-max Seat #2 is the button
Seat 1: jacktayra ($4.21 in chips) 
Seat 2: Newqbrown ($10.75 in chips) 
Seat 3: THIMUCHIN ($14.11 in chips) 
Seat 4: coolisses111 ($18.15 in chips) 
Seat 5: Yspenyanin ($10.94 in chips) 
Seat 6: Xander188 ($18.08 in chips) 
THIMUCHIN: posts small blind $0.05
coolisses111: posts big blind $0.10
*** HOLE CARDS ***
Yspenyanin: folds 
Xander188: folds 
jacktayra: folds 
Newqbrown: raises $0.20 to $0.30
THIMUCHIN: folds 
coolisses111: folds 
Uncalled bet ($0.20) returned to Newqbrown
Newqbrown collected $0.25 from pot
*** SUMMARY ***
Total pot $0.25 | Rake $0 
Seat 1: jacktayra folded before Flop (didn't bet)
Seat 2: Newqbrown (button) collected ($0.25)
Seat 3: THIMUCHIN (small blind) folded before Flop
Seat 4: coolisses111 (big blind) folded before Flop
Seat 5: Yspenyanin folded before Flop (didn't bet)
Seat 6: Xander188 folded before Flop (didn't bet)



PokerStars Hand #166667631352:  Hold'em No Limit ($0.05/$0.10 USD) - 2017/02/23 16:04:41 ET
Table 'Atropos' 6-max Seat #5 is the button
Seat 1: ScorpionF39 ($0.88 in chips) 
Seat 3: NvR.m1nD ($10.14 in chips) 
Seat 4: iDecMate ($12 in chips) 
Seat 5: KokoulinV ($12.09 in chips) 
Seat 6: Iarlei ($12.48 in chips) 
Iarlei: posts small blind $0.05
ScorpionF39: posts big blind $0.10
yodzik: sits out 
*** HOLE CARDS ***
NvR.m1nD: raises $0.15 to $0.25
iDecMate: raises $0.65 to $0.90
KokoulinV: folds 
Iarlei: folds 
ScorpionF39: calls $0.78 and is all-in
NvR.m1nD: folds 
Uncalled bet ($0.02) returned to iDecMate
*** FLOP *** [Th 3d 9s]
*** TURN *** [Th 3d 9s] [Td]
*** RIVER *** [Th 3d 9s Td] [2d]
*** SHOW DOWN ***
ScorpionF39: shows [Ad Ks] (a pair of Tens)
iDecMate: shows [Ac Qc] (a pair of Tens - lower kicker)
ScorpionF39 collected $1.97 from pot
*** SUMMARY ***
Total pot $2.06 | Rake $0.09 
Board [Th 3d 9s Td 2d]
Seat 1: ScorpionF39 (big blind) showed [Ad Ks] and won ($1.97) with a pair of Tens
Seat 3: NvR.m1nD folded before Flop
Seat 4: iDecMate showed [Ac Qc] and lost with a pair of Tens
Seat 5: KokoulinV (button) folded before Flop (didn't bet)
Seat 6: Iarlei (small blind) folded before Flop



PokerStars Hand #166667631551:  Hold'em No Limit ($0.05/$0.10 USD) - 2017/02/23 16:04:41 ET
Table 'Lacroute' 6-max Seat #1 is the button
Seat 1: johnnyPieper ($5.88 in chips) 
Seat 2: Andy Wolf ($10 in chips) 
Seat 3: Croplayer1 ($14.90 in chips) 
Seat 4: st4tion ($15.91 in chips) 
Seat 5: steepfell ($11.29 in chips) 
Seat 6: IAntikI ($10 in chips) 
Andy Wolf: posts small blind $0.05
Croplayer1: posts big blind $0.10
*** HOLE CARDS ***
st4tion: raises $0.15 to $0.25
steepfell: folds 
IAntikI: folds 
johnnyPieper: calls $0.25
Andy Wolf: folds 
Croplayer1: folds 
*** FLOP *** [Kd 3c 3d]
st4tion: checks 
johnnyPieper: bets $0.10
st4tion: raises $0.10 to $0.20
johnnyPieper: calls $0.10
*** TURN *** [Kd 3c 3d] [6h]
st4tion: bets $0.36
johnnyPieper: calls $0.36
*** RIVER *** [Kd 3c 3d 6h] [Ts]
st4tion: checks 
johnnyPieper: bets $0.80
st4tion: calls $0.80
*** SHOW DOWN ***
johnnyPieper: shows [7c 7s] (two pair, Sevens and Threes)
st4tion: shows [Qc Kc] (two pair, Kings and Threes)
st4tion collected $3.22 from pot
*** SUMMARY ***
Total pot $3.37 | Rake $0.15 
Board [Kd 3c 3d 6h Ts]
Seat 1: johnnyPieper (button) showed [7c 7s] and lost with two pair, Sevens and Threes
Seat 2: Andy Wolf (small blind) folded before Flop
Seat 3: Croplayer1 (big blind) folded before Flop
Seat 4: st4tion showed [Qc Kc] and won ($3.22) with two pair, Kings and Threes
Seat 5: steepfell folded before Flop (didn't bet)
Seat 6: IAntikI folded before Flop (didn't bet)



PokerStars Hand #166667631969:  Hold'em No Limit ($0.05/$0.10 USD) - 2017/02/23 16:04:42 ET
Table 'Thoas' 6-max Seat #2 is the button
Seat 2: themacer24 ($8.52 in chips) 
Seat 3: iamkakaroto ($10 in chips) 
Seat 4: Morris_Chair ($17.81 in chips) 
Seat 5: Kow6oy ($10.32 in chips) 
Seat 6: takis nik ($10 in chips) 
iamkakaroto: posts small blind $0.05
Morris_Chair: posts big blind $0.10
*** HOLE CARDS ***
Kow6oy: folds 
takis nik: folds 
themacer24: folds 
iamkakaroto: folds 
Uncalled bet ($0.05) returned to Morris_Chair
Morris_Chair collected $0.10 from pot
*** SUMMARY ***
Total pot $0.10 | Rake $0 
Seat 2: themacer24 (button) folded before Flop (didn't bet)
Seat 3: iamkakaroto (small blind) folded before Flop
Seat 4: Morris_Chair (big blind) collected ($0.10)
Seat 5: Kow6oy folded before Flop (didn't bet)
Seat 6: takis nik folded before Flop (didn't bet)



PokerStars Hand #166667632028:  Hold'em No Limit ($0.05/$0.10 USD) - 2017/02/23 16:04:42 ET
Table 'Nauheima II' 6-max Seat #4 is the button
Seat 2: Peter0087 ($9.82 in chips) 
Seat 3: KokoulinV ($13.29 in chips) 
Seat 4: Innerwuss ($10.32 in chips) 
Seat 5: Kow6oy ($10.35 in chips) 
Seat 6: bonyo71 ($5.19 in chips) 
Kow6oy: posts small blind $0.05
bonyo71: posts big blind $0.10
*** HOLE CARDS ***
Peter0087: folds 
KokoulinV: folds 
Innerwuss: raises $0.10 to $0.20
Kow6oy: folds 
bonyo71: folds 
Uncalled bet ($0.10) returned to Innerwuss
Innerwuss collected $0.25 from pot
*** SUMMARY ***
Total pot $0.25 | Rake $0 
Seat 2: Peter0087 folded before Flop (didn't bet)
Seat 3: KokoulinV folded before Flop (didn't bet)
Seat 4: Innerwuss (button) collected ($0.25)
Seat 5: Kow6oy (small blind) folded before Flop
Seat 6: bonyo71 (big blind) folded before Flop



PokerStars Hand #166667632088:  Hold'em No Limit ($0.05/$0.10 USD) - 2017/02/23 16:04:42 ET
Table 'Risha II' 6-max Seat #5 is the button
Seat 1: R. Lemonte ($13.57 in chips) 
Seat 2: KA3AXCTAHEU, ($12.65 in chips) 
Seat 3: steepfell ($10 in chips) 
Seat 4: Comeback3392 ($20.66 in chips) 
Seat 5: m.c-alkatraz ($10.20 in chips) 
Seat 6: univibe68 ($10.36 in chips) 
univibe68: posts small blind $0.05
R. Lemonte: posts big blind $0.10
*** HOLE CARDS ***
KA3AXCTAHEU,: folds 
steepfell: folds 
Comeback3392: folds 
m.c-alkatraz: folds 
univibe68: raises $0.20 to $0.30
R. Lemonte: folds 
Uncalled bet ($0.20) returned to univibe68
univibe68 collected $0.20 from pot
*** SUMMARY ***
Total pot $0.20 | Rake $0 
Seat 1: R. Lemonte (big blind) folded before Flop
Seat 2: KA3AXCTAHEU, folded before Flop (didn't bet)
Seat 3: steepfell folded before Flop (didn't bet)
Seat 4: Comeback3392 folded before Flop (didn't bet)
Seat 5: m.c-alkatraz (button) folded before Flop (didn't bet)
Seat 6: univibe68 (small blind) collected ($0.20)



PokerStars Hand #166667632150:  Hold'em No Limit ($0.05/$0.10 USD) - 2017/02/23 16:04:42 ET
Table 'Wesselink II' 6-max Seat #6 is the button
Seat 1: vladcol ($5.32 in chips) 
Seat 2: KRZuff ($10 in chips) 
Seat 3: Wargolandros ($9.07 in chips) 
Seat 4: BahiaMinhaP ($10.98 in chips) 
Seat 6: bambolejro ($10 in chips) 
vladcol: posts small blind $0.05
KRZuff: posts big blind $0.10
*** HOLE CARDS ***
Wargolandros: folds 
BahiaMinhaP: folds 
bambolejro: raises $0.15 to $0.25
vladcol: calls $0.20
KRZuff: folds 
*** FLOP *** [Ah 4c Ts]
vladcol: checks 
bambolejro: bets $0.39
vladcol: folds 
Uncalled bet ($0.39) returned to bambolejro
bambolejro collected $0.57 from pot
*** SUMMARY ***
Total pot $0.60 | Rake $0.03 
Board [Ah 4c Ts]
Seat 1: vladcol (small blind) folded on the Flop
Seat 2: KRZuff (big blind) folded before Flop
Seat 3: Wargolandros folded before Flop (didn't bet)
Seat 4: BahiaMinhaP folded before Flop (didn't bet)
Seat 6: bambolejro (button) collected ($0.57)



PokerStars Hand #166667632186:  Hold'em No Limit ($0.05/$0.10 USD) - 2017/02/23 16:04:42 ET
Table 'Cyane' 6-max Seat #4 is the button
Seat 1: KA3AXCTAHEU, ($10 in chips) 
Seat 2: sashi18 ($7.65 in chips) 
Seat 3: Mamm0nism ($13.44 in chips) 
Seat 4: truck1234 ($20.81 in chips) 
Seat 6: 8th wonders ($11.65 in chips) 
8th wonders: posts small blind $0.05
KA3AXCTAHEU,: posts big blind $0.10
*** HOLE CARDS ***
sashi18: calls $0.10
Mamm0nism: raises $0.30 to $0.40
truck1234: folds 
8th wonders: folds 
KA3AXCTAHEU,: folds 
sashi18: calls $0.30
*** FLOP *** [6s Ah 7s]
sashi18: checks 
Mamm0nism: checks 
*** TURN *** [6s Ah 7s] [6h]
sashi18: bets $0.60
Mamm0nism: folds 
Uncalled bet ($0.60) returned to sashi18
sashi18 collected $0.91 from pot
*** SUMMARY ***
Total pot $0.95 | Rake $0.04 
Board [6s Ah 7s 6h]
Seat 1: KA3AXCTAHEU, (big blind) folded before Flop
Seat 2: sashi18 collected ($0.91)
Seat 3: Mamm0nism folded on the Turn
Seat 4: truck1234 (button) folded before Flop (didn't bet)
Seat 6: 8th wonders (small blind) folded before Flop



PokerStars Hand #166667632262:  Hold'em No Limit ($0.05/$0.10 USD) - 2017/02/23 16:04:42 ET
Table 'Siebohme' 6-max Seat #5 is the button
Seat 1: kusa4ki ($11.38 in chips) 
Seat 2: el toro 1507 ($11.53 in chips) 
Seat 3: ex3Lero86 ($10.56 in chips) 
Seat 4: Innerwuss ($10.15 in chips) 
Seat 5: Kazacha ($10 in chips) 
Seat 6: townerz1991 ($10.58 in chips) 
townerz1991: posts small blind $0.05
kusa4ki: posts big blind $0.10
*** HOLE CARDS ***
el toro 1507: folds 
ex3Lero86: folds 
Innerwuss: folds 
Kazacha: folds 
townerz1991: folds 
Uncalled bet ($0.05) returned to kusa4ki
kusa4ki collected $0.10 from pot
*** SUMMARY ***
Total pot $0.10 | Rake $0 
Seat 1: kusa4ki (big blind) collected ($0.10)
Seat 2: el toro 1507 folded before Flop (didn't bet)
Seat 3: ex3Lero86 folded before Flop (didn't bet)
Seat 4: Innerwuss folded before Flop (didn't bet)
Seat 5: Kazacha (button) folded before Flop (didn't bet)
Seat 6: townerz1991 (small blind) folded before Flop



PokerStars Hand #166667632365:  Hold'em No Limit ($0.05/$0.10 USD) - 2017/02/23 16:04:42 ET
Table 'Hamal II' 6-max Seat #1 is the button
Seat 1: saxoalto2011 ($7.79 in chips) 
Seat 2: pancernik21 ($10 in chips) 
Seat 3: Cluckh ($11.24 in chips) 
Seat 4: ArcticBearDK ($10.81 in chips) 
Seat 5: eniksenik ($10.89 in chips) 
Seat 6: LarryTheStar ($11.54 in chips) 
pancernik21: posts small blind $0.05
Cluckh: posts big blind $0.10
*** HOLE CARDS ***
ArcticBearDK: folds 
eniksenik: folds 
LarryTheStar: folds 
saxoalto2011: folds 
pancernik21: folds 
Uncalled bet ($0.05) returned to Cluckh
Cluckh collected $0.10 from pot
*** SUMMARY ***
Total pot $0.10 | Rake $0 
Seat 1: saxoalto2011 (button) folded before Flop (didn't bet)
Seat 2: pancernik21 (small blind) folded before Flop
Seat 3: Cluckh (big blind) collected ($0.10)
Seat 4: ArcticBearDK folded before Flop (didn't bet)
Seat 5: eniksenik folded before Flop (didn't bet)
Seat 6: LarryTheStar folded before Flop (didn't bet)



PokerStars Hand #166667632876:  Hold'em No Limit ($0.05/$0.10 USD) - 2017/02/23 16:04:43 ET
Table 'Rostia' 6-max Seat #5 is the button
Seat 1: paxit71 ($8.03 in chips) 
Seat 2: david_sara83 ($19.21 in chips) 
Seat 4: Hyd SK ($11.53 in chips) 
Seat 5: silsilviu ($7.05 in chips) 
Seat 6: Giyorod ($10.75 in chips) 
Giyorod: posts small blind $0.05
paxit71: posts big blind $0.10
iThreeBarrel: sits out 
*** HOLE CARDS ***
david_sara83: folds 
Hyd SK: raises $0.25 to $0.35
silsilviu: folds 
Giyorod: folds 
paxit71: folds 
Uncalled bet ($0.25) returned to Hyd SK
Hyd SK collected $0.25 from pot
*** SUMMARY ***
Total pot $0.25 | Rake $0 
Seat 1: paxit71 (big blind) folded before Flop
Seat 2: david_sara83 folded before Flop (didn't bet)
Seat 4: Hyd SK collected ($0.25)
Seat 5: silsilviu (button) folded before Flop (didn't bet)
Seat 6: Giyorod (small blind) folded before Flop



PokerStars Hand #166667632894:  Hold'em No Limit ($0.05/$0.10 USD) - 2017/02/23 16:04:43 ET
Table 'Syringa' 6-max Seat #6 is the button
Seat 1: bdixon_5 ($7.85 in chips) 
Seat 2: Goroshkos88 ($10.56 in chips) 
Seat 3: Yspenyanin ($13.52 in chips) 
Seat 5: Andrei ProFF ($13.46 in chips) 
Seat 6: ibara000 ($16.28 in chips) 
bdixon_5: posts small blind $0.05
Goroshkos88: posts big blind $0.10
*** HOLE CARDS ***
Yspenyanin: folds 
Andrei ProFF: raises $0.20 to $0.30
ibara000: folds 
bdixon_5: folds 
Goroshkos88: folds 
Uncalled bet ($0.20) returned to Andrei ProFF
Andrei ProFF collected $0.25 from pot
*** SUMMARY ***
Total pot $0.25 | Rake $0 
Seat 1: bdixon_5 (small blind) folded before Flop
Seat 2: Goroshkos88 (big blind) folded before Flop
Seat 3: Yspenyanin folded before Flop (didn't bet)
Seat 5: Andrei ProFF collected ($0.25)
Seat 6: ibara000 (button) folded before Flop (didn't bet)



PokerStars Hand #166667633016:  Hold'em No Limit ($0.05/$0.10 USD) - 2017/02/23 16:04:43 ET
Table 'Wingolfia II' 6-max Seat #6 is the button
Seat 1: BahiaMinhaP ($10.05 in chips) 
Seat 2: NvR.m1nD ($10.60 in chips) 
Seat 3: truck1234 ($10.51 in chips) 
Seat 4: zlobslob ($18.02 in chips) 
Seat 5: tr41n3r12 ($11.43 in chips) 
Seat 6: EphemeralBen ($11.69 in chips) 
BahiaMinhaP: posts small blind $0.05
NvR.m1nD: posts big blind $0.10
*** HOLE CARDS ***
truck1234: folds 
zlobslob: folds 
tr41n3r12: folds 
EphemeralBen: folds 
BahiaMinhaP: raises $0.20 to $0.30
NvR.m1nD: calls $0.20
*** FLOP *** [7c 6s 8h]
BahiaMinhaP: checks 
NvR.m1nD: checks 
*** TURN *** [7c 6s 8h] [5c]
BahiaMinhaP: bets $0.35
NvR.m1nD: folds 
Uncalled bet ($0.35) returned to BahiaMinhaP
BahiaMinhaP collected $0.57 from pot
*** SUMMARY ***
Total pot $0.60 | Rake $0.03 
Board [7c 6s 8h 5c]
Seat 1: BahiaMinhaP (small blind) collected ($0.57)
Seat 2: NvR.m1nD (big blind) folded on the Turn
Seat 3: truck1234 folded before Flop (didn't bet)
Seat 4: zlobslob folded before Flop (didn't bet)
Seat 5: tr41n3r12 folded before Flop (didn't bet)
Seat 6: EphemeralBen (button) folded before Flop (didn't bet)



PokerStars Hand #166667633067:  Hold'em No Limit ($0.05/$0.10 USD) - 2017/02/23 16:04:43 ET
Table 'Grietje' 6-max Seat #2 is the button
Seat 2: Feverhead ($12.97 in chips) 
Seat 4: MihaGr ($10 in chips) 
Seat 5: iThreeBarrel ($10 in chips) 
Seat 6: Prometheu$8 ($21.70 in chips) 
MihaGr: posts small blind $0.05
iThreeBarrel: posts big blind $0.10
dragonste89: sits out 
*** HOLE CARDS ***
Prometheu$8: folds 
Feverhead: folds 
MihaGr: raises $0.15 to $0.25
iThreeBarrel: folds 
Uncalled bet ($0.15) returned to MihaGr
MihaGr collected $0.20 from pot
*** SUMMARY ***
Total pot $0.20 | Rake $0 
Seat 2: Feverhead (button) folded before Flop (didn't bet)
Seat 4: MihaGr (small blind) collected ($0.20)
Seat 5: iThreeBarrel (big blind) folded before Flop
Seat 6: Prometheu$8 folded before Flop (didn't bet)



PokerStars Hand #166667633356:  Hold'em No Limit ($0.05/$0.10 USD) - 2017/02/23 16:04:43 ET
Table 'Vesta II' 6-max Seat #2 is the button
Seat 1: Yabidooo ($13.16 in chips) 
Seat 2: Dimka4 ($10 in chips) 
Seat 3: Pokeaster ($12.68 in chips) 
Seat 4: Dcaro31 ($10.42 in chips) 
Seat 5: Andy Wolf ($12.30 in chips) 
Pokeaster: posts small blind $0.05
Dcaro31: posts big blind $0.10
XaXaTyH4uK: sits out 
*** HOLE CARDS ***
Andy Wolf: folds 
Yabidooo: folds 
Dimka4: raises $0.15 to $0.25
Pokeaster: folds 
Dcaro31: folds 
Uncalled bet ($0.15) returned to Dimka4
Dimka4 collected $0.25 from pot
*** SUMMARY ***
Total pot $0.25 | Rake $0 
Seat 1: Yabidooo folded before Flop (didn't bet)
Seat 2: Dimka4 (button) collected ($0.25)
Seat 3: Pokeaster (small blind) folded before Flop
Seat 4: Dcaro31 (big blind) folded before Flop
Seat 5: Andy Wolf folded before Flop (didn't bet)



PokerStars Hand #166667633783:  Hold'em No Limit ($0.05/$0.10 USD) - 2017/02/23 16:04:44 ET
Table 'Wilkens II' 6-max Seat #5 is the button
Seat 1: Islamiq-GuRL ($11.13 in chips) 
Seat 2: manashov ($10.75 in chips) 
Seat 3: Namhkal ($10.65 in chips) 
Seat 5: patrick19111 ($11.07 in chips) 
Seat 6: XaXaTyH4uK ($14.36 in chips) 
XaXaTyH4uK: posts small blind $0.05
Islamiq-GuRL: posts big blind $0.10
myevc: sits out 
*** HOLE CARDS ***
manashov: folds 
Namhkal: raises $0.15 to $0.25
patrick19111: calls $0.25
XaXaTyH4uK: folds 
Islamiq-GuRL: calls $0.15
*** FLOP *** [2d 5d Ad]
Islamiq-GuRL: checks 
Namhkal: checks 
patrick19111: checks 
*** TURN *** [2d 5d Ad] [5h]
Islamiq-GuRL: checks 
Namhkal: checks 
patrick19111: checks 
*** RIVER *** [2d 5d Ad 5h] [6c]
Islamiq-GuRL: checks 
Namhkal: checks 
patrick19111: checks 
*** SHOW DOWN ***
Islamiq-GuRL: shows [9c 7d] (a pair of Fives)
Namhkal: shows [7h 6h] (two pair, Sixes and Fives)
patrick19111: shows [8c 8d] (two pair, Eights and Fives)
patrick19111 collected $0.76 from pot
*** SUMMARY ***
Total pot $0.80 | Rake $0.04 
Board [2d 5d Ad 5h 6c]
Seat 1: Islamiq-GuRL (big blind) showed [9c 7d] and lost with a pair of Fives
Seat 2: manashov folded before Flop (didn't bet)
Seat 3: Namhkal showed [7h 6h] and lost with two pair, Sixes and Fives
Seat 5: patrick19111 (button) showed [8c 8d] and won ($0.76) with two pair, Eights and Fives
Seat 6: XaXaTyH4uK (small blind) folded before Flop



PokerStars Hand #166667634011:  Hold'em No Limit ($0.05/$0.10 USD) - 2017/02/23 16:04:44 ET
Table 'Themisto II' 6-max Seat #4 is the button
Seat 1: kickereens ($11.61 in chips) 
Seat 2: CA225 ($10.55 in chips) 
Seat 3: eniksenik ($11.06 in chips) 
Seat 4: Innerwuss ($10.74 in chips) 
Seat 5: ex3Lero86 ($11.17 in chips) 
Seat 6: noobigrok ($4.15 in chips) 
ex3Lero86: posts small blind $0.05
noobigrok: posts big blind $0.10
*** HOLE CARDS ***
kickereens: folds 
CA225: folds 
eniksenik: raises $0.20 to $0.30
Innerwuss: raises $0.75 to $1.05
ex3Lero86: folds 
noobigrok: folds 
eniksenik: calls $0.75
*** FLOP *** [8s 9d 3d]
eniksenik: checks 
Innerwuss: bets $1.08
eniksenik: raises $2.62 to $3.70
Innerwuss: calls $2.62
*** TURN *** [8s 9d 3d] [6d]
eniksenik: bets $3
Innerwuss: folds 
Uncalled bet ($3) returned to eniksenik
eniksenik collected $9.22 from pot
*** SUMMARY ***
Total pot $9.65 | Rake $0.43 
Board [8s 9d 3d 6d]
Seat 1: kickereens folded before Flop (didn't bet)
Seat 2: CA225 folded before Flop (didn't bet)
Seat 3: eniksenik collected ($9.22)
Seat 4: Innerwuss (button) folded on the Turn
Seat 5: ex3Lero86 (small blind) folded before Flop
Seat 6: noobigrok (big blind) folded before Flop



PokerStars Hand #166667634021:  Hold'em No Limit ($0.05/$0.10 USD) - 2017/02/23 16:04:44 ET
Table 'Rosalia' 6-max Seat #6 is the button
Seat 1: Hyd SK ($10 in chips) 
Seat 2: Bandyaev ($11.84 in chips) 
Seat 3: Andy Wolf ($12.18 in chips) 
Seat 4: THIMUCHIN ($10 in chips) 
Seat 5: miron762 ($18.25 in chips) 
Seat 6: facewald ($16.78 in chips) 
Hyd SK: posts small blind $0.05
Bandyaev: posts big blind $0.10
*** HOLE CARDS ***
Andy Wolf: folds 
THIMUCHIN: raises $0.15 to $0.25
miron762: folds 
facewald: folds 
Hyd SK: folds 
Bandyaev: folds 
Uncalled bet ($0.15) returned to THIMUCHIN
THIMUCHIN collected $0.25 from pot
*** SUMMARY ***
Total pot $0.25 | Rake $0 
Seat 1: Hyd SK (small blind) folded before Flop
Seat 2: Bandyaev (big blind) folded before Flop
Seat 3: Andy Wolf folded before Flop (didn't bet)
Seat 4: THIMUCHIN collected ($0.25)
Seat 5: miron762 folded before Flop (didn't bet)
Seat 6: facewald (button) folded before Flop (didn't bet)



PokerStars Hand #166667634587:  Hold'em No Limit ($0.05/$0.10 USD) - 2017/02/23 16:04:44 ET
Table 'Virginia II' 6-max Seat #4 is the button
Seat 1: Iarlei ($11.86 in chips) 
Seat 2: Yspenyanin ($10 in chips) 
Seat 3: garigura ($14.56 in chips) 
Seat 4: onkelottoHH ($11.03 in chips) 
Seat 5: dr.goofy ($20.58 in chips) 
Seat 6: NvR.m1nD ($10 in chips) 
dr.goofy: posts small blind $0.05
NvR.m1nD: posts big blind $0.10
*** HOLE CARDS ***
Iarlei: raises $0.20 to $0.30
Yspenyanin: calls $0.30
garigura: calls $0.30
onkelottoHH: folds 
dr.goofy: folds 
NvR.m1nD: folds 
*** FLOP *** [5h 7c Kh]
Iarlei: checks 
Yspenyanin: checks 
garigura: bets $0.75
Iarlei: folds 
Yspenyanin: folds 
Uncalled bet ($0.75) returned to garigura
garigura collected $1 from pot
*** SUMMARY ***
Total pot $1.05 | Rake $0.05 
Board [5h 7c Kh]
Seat 1: Iarlei folded on the Flop
Seat 2: Yspenyanin folded on the Flop
Seat 3: garigura collected ($1)
Seat 4: onkelottoHH (button) folded before Flop (didn't bet)
Seat 5: dr.goofy (small blind) folded before Flop
Seat 6: NvR.m1nD (big blind) folded before Flop



PokerStars Hand #166667634803:  Hold'em No Limit ($0.05/$0.10 USD) - 2017/02/23 16:04:45 ET
Table 'Wabash' 6-max Seat #4 is the button
Seat 1: pivanki11 ($10 in chips) 
Seat 2: ex3Lero86 ($32.63 in chips) 
Seat 3: sszabi28 ($4.56 in chips) 
Seat 4: Nr847 ($10 in chips) 
Seat 5: popypaleta ($10 in chips) 
Seat 6: weez3r ($10.52 in chips) 
popypaleta: posts small blind $0.05
weez3r: posts big blind $0.10
*** HOLE CARDS ***
pivanki11: folds 
ex3Lero86: folds 
sszabi28: folds 
Nr847: folds 
popypaleta: folds 
Uncalled bet ($0.05) returned to weez3r
weez3r collected $0.10 from pot
*** SUMMARY ***
Total pot $0.10 | Rake $0 
Seat 1: pivanki11 folded before Flop (didn't bet)
Seat 2: ex3Lero86 folded before Flop (didn't bet)
Seat 3: sszabi28 folded before Flop (didn't bet)
Seat 4: Nr847 (button) folded before Flop (didn't bet)
Seat 5: popypaleta (small blind) folded before Flop
Seat 6: weez3r (big blind) collected ($0.10)



PokerStars Hand #166667635434:  Hold'em No Limit ($0.05/$0.10 USD) - 2017/02/23 16:04:45 ET
Table 'Aludra II' 6-max Seat #5 is the button
Seat 1: voledy ($10 in chips) 
Seat 2: JahSoldier69 ($14.20 in chips) 
Seat 4: MihaGr ($10 in chips) 
Seat 5: kingartur222 ($15.70 in chips) 
Seat 6: call me haaa ($14.69 in chips) 
call me haaa: posts small blind $0.05
voledy: posts big blind $0.10
*** HOLE CARDS ***
JahSoldier69: folds 
MihaGr: folds 
kingartur222: raises $0.15 to $0.25
call me haaa: folds 
voledy: calls $0.15
*** FLOP *** [4d 3d Ks]
voledy: checks 
kingartur222: checks 
*** TURN *** [4d 3d Ks] [7h]
voledy: bets $0.35
kingartur222: folds 
Uncalled bet ($0.35) returned to voledy
voledy collected $0.53 from pot
*** SUMMARY ***
Total pot $0.55 | Rake $0.02 
Board [4d 3d Ks 7h]
Seat 1: voledy (big blind) collected ($0.53)
Seat 2: JahSoldier69 folded before Flop (didn't bet)
Seat 4: MihaGr folded before Flop (didn't bet)
Seat 5: kingartur222 (button) folded on the Turn
Seat 6: call me haaa (small blind) folded before Flop



PokerStars Hand #166667635543:  Hold'em No Limit ($0.05/$0.10 USD) - 2017/02/23 16:04:45 ET
Table 'Nehalennia III' 6-max Seat #1 is the button
Seat 1: boxer821 ($12.18 in chips) 
Seat 2: fortieth ($10.19 in chips) 
Seat 3: ValdemorS ($18.05 in chips) 
Seat 4: eniksenik ($10 in chips) 
Seat 5: wulffboy ($37.30 in chips) 
Seat 6: valzeny ($20.36 in chips) 
fortieth: posts small blind $0.05
ValdemorS: posts big blind $0.10
boxer821: posts the ante $0.02
fortieth: posts the ante $0.02
ValdemorS: posts the ante $0.02
eniksenik: posts the ante $0.02
wulffboy: posts the ante $0.02
valzeny: posts the ante $0.02
*** HOLE CARDS ***
eniksenik: raises $0.20 to $0.30
wulffboy: calls $0.30
valzeny: calls $0.30
boxer821: folds 
fortieth: calls $0.25
ValdemorS: folds 
*** FLOP *** [3s 9d 3d]
fortieth: checks 
eniksenik: checks 
wulffboy: checks 
valzeny: bets $0.68
fortieth: calls $0.68
eniksenik: folds 
wulffboy: folds 
*** TURN *** [3s 9d 3d] [6h]
fortieth: checks 
valzeny: bets $1.33
fortieth: folds 
Uncalled bet ($1.33) returned to valzeny
valzeny collected $2.65 from pot
*** SUMMARY ***
Total pot $2.78 | Rake $0.13 
Board [3s 9d 3d 6h]
Seat 1: boxer821 (button) folded before Flop (didn't bet)
Seat 2: fortieth (small blind) folded on the Turn
Seat 3: ValdemorS (big blind) folded before Flop
Seat 4: eniksenik folded on the Flop
Seat 5: wulffboy folded on the Flop
Seat 6: valzeny collected ($2.65)



PokerStars Hand #166667635743:  Hold'em No Limit ($0.05/$0.10 USD) - 2017/02/23 16:04:46 ET
Table 'Nikko II' 6-max Seat #6 is the button
Seat 1: bdixon_5 ($10.42 in chips) 
Seat 2: popypaleta ($10 in chips) 
Seat 3: Hyd SK ($11.36 in chips) 
Seat 4: Peter0087 ($9.54 in chips) 
Seat 5: Aescul@pius ($12.53 in chips) 
Seat 6: JahSoldier69 ($10 in chips) 
bdixon_5: posts small blind $0.05
popypaleta: posts big blind $0.10
*** HOLE CARDS ***
Hyd SK: raises $0.25 to $0.35
Peter0087: calls $0.35
Aescul@pius: calls $0.35
JahSoldier69: folds 
bdixon_5: folds 
popypaleta: folds 
*** FLOP *** [2s Ah 6h]
Hyd SK: bets $0.58
Peter0087: folds 
Aescul@pius: folds 
Uncalled bet ($0.58) returned to Hyd SK
Hyd SK collected $1.15 from pot
*** SUMMARY ***
Total pot $1.20 | Rake $0.05 
Board [2s Ah 6h]
Seat 1: bdixon_5 (small blind) folded before Flop
Seat 2: popypaleta (big blind) folded before Flop
Seat 3: Hyd SK collected ($1.15)
Seat 4: Peter0087 folded on the Flop
Seat 5: Aescul@pius folded on the Flop
Seat 6: JahSoldier69 (button) folded before Flop (didn't bet)



PokerStars Hand #166667635923:  Hold'em No Limit ($0.05/$0.10 USD) - 2017/02/23 16:04:46 ET
Table 'Azelfafage' 6-max Seat #6 is the button
Seat 1: Sbozzz ($15.66 in chips) 
Seat 2: tr41n3r12 ($10.30 in chips) 
Seat 3: todor1711 ($20.82 in chips) 
Seat 4: fedorka rus ($10 in chips) 
Seat 5: 8th wonders ($12.58 in chips) 
Seat 6: KA3AXCTAHEU, ($10 in chips) 
Sbozzz: posts small blind $0.05
tr41n3r12: posts big blind $0.10
*** HOLE CARDS ***
todor1711: calls $0.10
fedorka rus: folds 
8th wonders: folds 
KA3AXCTAHEU,: raises $0.25 to $0.35
Sbozzz: folds 
tr41n3r12: folds 
todor1711: calls $0.25
*** FLOP *** [5h 3h As]
todor1711: checks 
KA3AXCTAHEU,: bets $0.60
todor1711: folds 
Uncalled bet ($0.60) returned to KA3AXCTAHEU,
KA3AXCTAHEU, collected $0.81 from pot
*** SUMMARY ***
Total pot $0.85 | Rake $0.04 
Board [5h 3h As]
Seat 1: Sbozzz (small blind) folded before Flop
Seat 2: tr41n3r12 (big blind) folded before Flop
Seat 3: todor1711 folded on the Flop
Seat 4: fedorka rus folded before Flop (didn't bet)
Seat 5: 8th wonders folded before Flop (didn't bet)
Seat 6: KA3AXCTAHEU, (button) collected ($0.81)



PokerStars Hand #166667636060:  Hold'em No Limit ($0.05/$0.10 USD) - 2017/02/23 16:04:46 ET
Table 'Aisakos II' 6-max Seat #4 is the button
Seat 1: Crafty23@PS ($10.30 in chips) 
Seat 2: svaika24 ($16.93 in chips) 
Seat 3: iamkakaroto ($10.54 in chips) 
Seat 4: T9MS ($10 in chips) 
Seat 5: KokoulinV ($12.30 in chips) 
Seat 6: LarryTheStar ($10.15 in chips) 
KokoulinV: posts small blind $0.05
LarryTheStar: posts big blind $0.10
*** HOLE CARDS ***
Crafty23@PS: folds 
svaika24: raises $0.10 to $0.20
iamkakaroto: folds 
T9MS: folds 
KokoulinV: folds 
LarryTheStar: folds 
Uncalled bet ($0.10) returned to svaika24
svaika24 collected $0.25 from pot
*** SUMMARY ***
Total pot $0.25 | Rake $0 
Seat 1: Crafty23@PS folded before Flop (didn't bet)
Seat 2: svaika24 collected ($0.25)
Seat 3: iamkakaroto folded before Flop (didn't bet)
Seat 4: T9MS (button) folded before Flop (didn't bet)
Seat 5: KokoulinV (small blind) folded before Flop
Seat 6: LarryTheStar (big blind) folded before Flop



PokerStars Hand #166667636331:  Hold'em No Limit ($0.05/$0.10 USD) - 2017/02/23 16:04:46 ET
Table 'Ebella II' 6-max Seat #5 is the button
Seat 1: gaHy_HaXeP ($10 in chips) 
Seat 2: Therodorus ($10 in chips) 
Seat 3: Torften2 ($15.88 in chips) 
Seat 4: ValdemorS ($11.05 in chips) 
Seat 5: Bird et al ($10 in chips) 
Seat 6: Joker51_wtf! ($11.29 in chips) 
Joker51_wtf!: posts small blind $0.05
gaHy_HaXeP: posts big blind $0.10
*** HOLE CARDS ***
Therodorus: raises $0.20 to $0.30
Torften2: folds 
ValdemorS: raises $0.75 to $1.05
Bird et al: folds 
Joker51_wtf!: folds 
gaHy_HaXeP: folds 
Therodorus: folds 
Uncalled bet ($0.75) returned to ValdemorS
ValdemorS collected $0.75 from pot
*** SUMMARY ***
Total pot $0.75 | Rake $0 
Seat 1: gaHy_HaXeP (big blind) folded before Flop
Seat 2: Therodorus folded before Flop
Seat 3: Torften2 folded before Flop (didn't bet)
Seat 4: ValdemorS collected ($0.75)
Seat 5: Bird et al (button) folded before Flop (didn't bet)
Seat 6: Joker51_wtf! (small blind) folded before Flop



PokerStars Hand #166667636432:  Hold'em No Limit ($0.05/$0.10 USD) - 2017/02/23 16:04:46 ET
Table 'Lagrula' 6-max Seat #4 is the button
Seat 1: Ice_Isayev ($10 in chips) 
Seat 3: micke667 ($15.68 in chips) 
Seat 4: Calimero2408 ($6.47 in chips) 
Seat 5: Iarlei ($10 in chips) 
Seat 6: Spud014 ($11.45 in chips) 
Iarlei: posts small blind $0.05
Spud014: posts big blind $0.10
KRZuff: sits out 
*** HOLE CARDS ***
Ice_Isayev: folds 
micke667: calls $0.10
Calimero2408: folds 
Iarlei: folds 
Spud014: checks 
*** FLOP *** [Qc Ts 6d]
Spud014: checks 
micke667: bets $0.10
Spud014: folds 
Uncalled bet ($0.10) returned to micke667
micke667 collected $0.24 from pot
*** SUMMARY ***
Total pot $0.25 | Rake $0.01 
Board [Qc Ts 6d]
Seat 1: Ice_Isayev folded before Flop (didn't bet)
Seat 3: micke667 collected ($0.24)
Seat 4: Calimero2408 (button) folded before Flop (didn't bet)
Seat 5: Iarlei (small blind) folded before Flop
Seat 6: Spud014 (big blind) folded on the Flop



PokerStars Hand #166667636728:  Hold'em No Limit ($0.05/$0.10 USD) - 2017/02/23 16:04:47 ET
Table 'Duhr II' 6-max Seat #4 is the button
Seat 1: Lucky HoBBiT ($10 in chips) 
Seat 2: Feverhead ($37.89 in chips) 
Seat 3: Innerwuss ($23.03 in chips) 
Seat 4: CHRO8 ($9.85 in chips) 
Seat 6: townerz1991 ($10.05 in chips) 
Asilvagoat will be allowed to play after the button
townerz1991: posts small blind $0.05
Lucky HoBBiT: posts big blind $0.10
*** HOLE CARDS ***
Feverhead: folds 
Asilvagoat leaves the table
Innerwuss: raises $0.15 to $0.25
Kow6oy joins the table at seat #5 
Kow6oy leaves the table
CHRO8: folds 
Dimka4 joins the table at seat #5 
townerz1991: folds 
Lucky HoBBiT: folds 
Uncalled bet ($0.15) returned to Innerwuss
Innerwuss collected $0.25 from pot
*** SUMMARY ***
Total pot $0.25 | Rake $0 
Seat 1: Lucky HoBBiT (big blind) folded before Flop
Seat 2: Feverhead folded before Flop (didn't bet)
Seat 3: Innerwuss collected ($0.25)
Seat 4: CHRO8 (button) folded before Flop (didn't bet)
Seat 6: townerz1991 (small blind) folded before Flop



PokerStars Hand #166667636967:  Hold'em No Limit ($0.05/$0.10 USD) - 2017/02/23 16:04:47 ET
Table 'Euryalos II' 6-max Seat #4 is the button
Seat 1: acekid403 ($9.90 in chips) 
Seat 2: silsilviu ($7.05 in chips) 
Seat 3: Hyd SK ($10.65 in chips) 
Seat 4: popypaleta ($15.47 in chips) 
Seat 5: horang2 ($8.15 in chips) 
Seat 6: MihaGr ($10.15 in chips) 
horang2: posts small blind $0.05
MihaGr: posts big blind $0.10
*** HOLE CARDS ***
acekid403: folds 
silsilviu: folds 
Hyd SK: folds 
popypaleta: folds 
horang2: raises $0.10 to $0.20
MihaGr: folds 
Uncalled bet ($0.10) returned to horang2
horang2 collected $0.20 from pot
*** SUMMARY ***
Total pot $0.20 | Rake $0 
Seat 1: acekid403 folded before Flop (didn't bet)
Seat 2: silsilviu folded before Flop (didn't bet)
Seat 3: Hyd SK folded before Flop (didn't bet)
Seat 4: popypaleta (button) folded before Flop (didn't bet)
Seat 5: horang2 (small blind) collected ($0.20)
Seat 6: MihaGr (big blind) folded before Flop



PokerStars Hand #166667636993:  Hold'em No Limit ($0.05/$0.10 USD) - 2017/02/23 16:04:47 ET
Table 'Stroobantia' 6-max Seat #2 is the button
Seat 1: mam9zyc ($8.59 in chips) 
Seat 2: XwinX25 ($10 in chips) 
Seat 3: Namhkal ($10 in chips) 
Seat 4: Yspenyanin ($10.13 in chips) 
Seat 5: boxer821 ($11.24 in chips) 
Seat 6: KokoulinV ($15.82 in chips) 
Namhkal: posts small blind $0.05
Yspenyanin: posts big blind $0.10
*** HOLE CARDS ***
boxer821: raises $0.25 to $0.35
KokoulinV: folds 
mam9zyc: folds 
XwinX25: folds 
Namhkal: folds 
Yspenyanin: folds 
Uncalled bet ($0.25) returned to boxer821
boxer821 collected $0.25 from pot
*** SUMMARY ***
Total pot $0.25 | Rake $0 
Seat 1: mam9zyc folded before Flop (didn't bet)
Seat 2: XwinX25 (button) folded before Flop (didn't bet)
Seat 3: Namhkal (small blind) folded before Flop
Seat 4: Yspenyanin (big blind) folded before Flop
Seat 5: boxer821 collected ($0.25)
Seat 6: KokoulinV folded before Flop (didn't bet)



PokerStars Hand #166667636994:  Hold'em No Limit ($0.05/$0.10 USD) - 2017/02/23 16:04:47 ET
Table 'Heka II' 6-max Seat #6 is the button
Seat 1: Mamm0nism ($14.27 in chips) 
Seat 2: oddshoff ($11.42 in chips) 
Seat 3: MühliJr ($10.30 in chips) 
Seat 4: theNot0r1ous ($10.45 in chips) 
Seat 5: ArcticBearDK ($12.53 in chips) 
Seat 6: MonteCris92 ($10 in chips) 
Mamm0nism: posts small blind $0.05
oddshoff: posts big blind $0.10
*** HOLE CARDS ***
MühliJr: folds 
theNot0r1ous: folds 
ArcticBearDK: folds 
MonteCris92: folds 
Mamm0nism: folds 
Uncalled bet ($0.05) returned to oddshoff
oddshoff collected $0.10 from pot
*** SUMMARY ***
Total pot $0.10 | Rake $0 
Seat 1: Mamm0nism (small blind) folded before Flop
Seat 2: oddshoff (big blind) collected ($0.10)
Seat 3: MühliJr folded before Flop (didn't bet)
Seat 4: theNot0r1ous folded before Flop (didn't bet)
Seat 5: ArcticBearDK folded before Flop (didn't bet)
Seat 6: MonteCris92 (button) folded before Flop (didn't bet)



PokerStars Hand #166667637455:  Hold'em No Limit ($0.05/$0.10 USD) - 2017/02/23 16:04:48 ET
Table 'Lederle' 6-max Seat #4 is the button
Seat 2: truck1234 ($15.85 in chips) 
Seat 3: Kazacha ($10.15 in chips) 
Seat 4: Pokeaster ($13.76 in chips) 
Seat 5: 8th wonders ($14.38 in chips) 
Seat 6: pokekrk ($10 in chips) 
8th wonders: posts small blind $0.05
pokekrk: posts big blind $0.10
*** HOLE CARDS ***
truck1234: raises $0.30 to $0.40
Kazacha: folds 
Pokeaster: folds 
8th wonders: folds 
pokekrk: folds 
Uncalled bet ($0.30) returned to truck1234
truck1234 collected $0.25 from pot
*** SUMMARY ***
Total pot $0.25 | Rake $0 
Seat 2: truck1234 collected ($0.25)
Seat 3: Kazacha folded before Flop (didn't bet)
Seat 4: Pokeaster (button) folded before Flop (didn't bet)
Seat 5: 8th wonders (small blind) folded before Flop
Seat 6: pokekrk (big blind) folded before Flop



PokerStars Hand #166667638124:  Hold'em No Limit ($0.05/$0.10 USD) - 2017/02/23 16:04:48 ET
Table 'Atalante' 6-max Seat #2 is the button
Seat 1: OceanBlue100 ($5.09 in chips) 
Seat 2: CiisCi ($19.77 in chips) 
Seat 3: Kow6oy ($10.05 in chips) 
Seat 4: Dcaro31 ($25.07 in chips) 
Seat 5: eniksenik ($10.29 in chips) 
Seat 6: FlopsterGB ($30.38 in chips) 
Kow6oy: posts small blind $0.05
Dcaro31: posts big blind $0.10
*** HOLE CARDS ***
eniksenik: raises $0.20 to $0.30
FlopsterGB: folds 
OceanBlue100: folds 
CiisCi: folds 
Kow6oy: folds 
Dcaro31: folds 
Uncalled bet ($0.20) returned to eniksenik
eniksenik collected $0.25 from pot
*** SUMMARY ***
Total pot $0.25 | Rake $0 
Seat 1: OceanBlue100 folded before Flop (didn't bet)
Seat 2: CiisCi (button) folded before Flop (didn't bet)
Seat 3: Kow6oy (small blind) folded before Flop
Seat 4: Dcaro31 (big blind) folded before Flop
Seat 5: eniksenik collected ($0.25)
Seat 6: FlopsterGB folded before Flop (didn't bet)



PokerStars Hand #166667638165:  Hold'em No Limit ($0.05/$0.10 USD) - 2017/02/23 16:04:48 ET
Table 'Persephone' 6-max Seat #6 is the button
Seat 2: AM-L-SL ($5.40 in chips) 
Seat 3: DasoII ($5 in chips) 
Seat 6: popypaleta ($14.09 in chips) 
dragonste89 will be allowed to play after the button
AM-L-SL: posts small blind $0.05
DasoII: posts big blind $0.10
2G28: sits out 
ab260414: sits out 
*** HOLE CARDS ***
popypaleta: raises $0.20 to $0.30
AM-L-SL: folds 
DasoII: folds 
Uncalled bet ($0.20) returned to popypaleta
popypaleta collected $0.25 from pot
*** SUMMARY ***
Total pot $0.25 | Rake $0 
Seat 2: AM-L-SL (small blind) folded before Flop
Seat 3: DasoII (big blind) folded before Flop
Seat 6: popypaleta (button) collected ($0.25)



PokerStars Hand #166667638186:  Hold'em No Limit ($0.05/$0.10 USD) - 2017/02/23 16:04:48 ET
Table 'Ushakaron II' 6-max Seat #3 is the button
Seat 1: Kow6oy ($10.15 in chips) 
Seat 2: Iarlei ($10.08 in chips) 
Seat 3: Rodik002 ($10.42 in chips) 
Seat 4: avintage176 ($27.76 in chips) 
Seat 5: 1limewax1 ($17.38 in chips) 
Seat 6: eniksenik ($10.86 in chips) 
avintage176: posts small blind $0.05
1limewax1: posts big blind $0.10
*** HOLE CARDS ***
eniksenik: folds 
Kow6oy: folds 
Iarlei: raises $0.20 to $0.30
Rodik002: calls $0.30
avintage176: folds 
1limewax1: calls $0.20
*** FLOP *** [Ad 4d 5c]
1limewax1: checks 
Iarlei: bets $0.55
Rodik002: folds 
1limewax1: calls $0.55
*** TURN *** [Ad 4d 5c] [7h]
1limewax1: checks 
Iarlei: bets $1.35
1limewax1: folds 
Uncalled bet ($1.35) returned to Iarlei
Iarlei collected $1.96 from pot
*** SUMMARY ***
Total pot $2.05 | Rake $0.09 
Board [Ad 4d 5c 7h]
Seat 1: Kow6oy folded before Flop (didn't bet)
Seat 2: Iarlei collected ($1.96)
Seat 3: Rodik002 (button) folded on the Flop
Seat 4: avintage176 (small blind) folded before Flop
Seat 5: 1limewax1 (big blind) folded on the Turn
Seat 6: eniksenik folded before Flop (didn't bet)



PokerStars Hand #166667638646:  Hold'em No Limit ($0.05/$0.10 USD) - 2017/02/23 16:04:49 ET
Table 'Hercynia III' 6-max Seat #2 is the button
Seat 1: Bird et al ($14.58 in chips) 
Seat 2: Action_Gibi ($8.32 in chips) 
Seat 3: Dcaro31 ($20.44 in chips) 
Seat 5: THIMUCHIN ($14.49 in chips) 
Seat 6: bdixon_5 ($11.04 in chips) 
Dcaro31: posts small blind $0.05
Darkfrai: is sitting out 
THIMUCHIN: posts big blind $0.10
*** HOLE CARDS ***
bdixon_5: folds 
Bird et al: folds 
Action_Gibi: raises $0.17 to $0.27
Dcaro31: calls $0.22
THIMUCHIN: calls $0.17
*** FLOP *** [Kd 9h Th]
Dcaro31: checks 
THIMUCHIN: checks 
Action_Gibi: bets $0.30
Dcaro31: folds 
THIMUCHIN: calls $0.30
*** TURN *** [Kd 9h Th] [2h]
THIMUCHIN: checks 
Action_Gibi: checks 
*** RIVER *** [Kd 9h Th 2h] [Ts]
THIMUCHIN: checks 
Action_Gibi: checks 
*** SHOW DOWN ***
THIMUCHIN: shows [Ks Qd] (two pair, Kings and Tens)
Action_Gibi: mucks hand 
THIMUCHIN collected $1.35 from pot
*** SUMMARY ***
Total pot $1.41 | Rake $0.06 
Board [Kd 9h Th 2h Ts]
Seat 1: Bird et al folded before Flop (didn't bet)
Seat 2: Action_Gibi (button) mucked
Seat 3: Dcaro31 (small blind) folded on the Flop
Seat 5: THIMUCHIN (big blind) showed [Ks Qd] and won ($1.35) with two pair, Kings and Tens
Seat 6: bdixon_5 folded before Flop (didn't bet)



PokerStars Hand #166667638709:  Hold'em No Limit ($0.05/$0.10 USD) - 2017/02/23 16:04:49 ET
Table 'Martha' 6-max Seat #6 is the button
Seat 1: Peter0087 ($10.49 in chips) 
Seat 2: pauli95 ($8.79 in chips) 
Seat 3: Hyd SK ($12.16 in chips) 
Seat 4: dittoro ($10 in chips) 
Seat 5: MihaGr ($10 in chips) 
Seat 6: 8th wonders ($10 in chips) 
Peter0087: posts small blind $0.05
pauli95: posts big blind $0.10
*** HOLE CARDS ***
Hyd SK: folds 
dittoro: folds 
MihaGr: folds 
8th wonders: raises $0.10 to $0.20
Peter0087: folds 
pauli95: calls $0.10
*** FLOP *** [6d 5s Ad]
pauli95: checks 
8th wonders: bets $0.30
pauli95: calls $0.30
*** TURN *** [6d 5s Ad] [Jc]
pauli95: checks 
8th wonders: checks 
*** RIVER *** [6d 5s Ad Jc] [9h]
pauli95: checks 
8th wonders: checks 
*** SHOW DOWN ***
pauli95: shows [Jd Ac] (two pair, Aces and Jacks)
8th wonders: mucks hand 
pauli95 collected $1 from pot
*** SUMMARY ***
Total pot $1.05 | Rake $0.05 
Board [6d 5s Ad Jc 9h]
Seat 1: Peter0087 (small blind) folded before Flop
Seat 2: pauli95 (big blind) showed [Jd Ac] and won ($1) with two pair, Aces and Jacks
Seat 3: Hyd SK folded before Flop (didn't bet)
Seat 4: dittoro folded before Flop (didn't bet)
Seat 5: MihaGr folded before Flop (didn't bet)
Seat 6: 8th wonders (button) mucked



PokerStars Hand #166667638971:  Hold'em No Limit ($0.05/$0.10 USD) - 2017/02/23 16:04:49 ET
Table 'Ostara III' 6-max Seat #6 is the button
Seat 1: MühliJr ($10.35 in chips) 
Seat 2: Action_Gibi ($10.04 in chips) 
Seat 3: vtalian ($11.44 in chips) 
Seat 6: FlopsterGB ($10.05 in chips) 
MühliJr: posts small blind $0.05
Action_Gibi: posts big blind $0.10
*** HOLE CARDS ***
vtalian: raises $0.20 to $0.30
FlopsterGB: calls $0.30
MühliJr: folds 
Action_Gibi: folds 
*** FLOP *** [5c 2s 6c]
vtalian: bets $0.40
FlopsterGB: calls $0.40
*** TURN *** [5c 2s 6c] [Jc]
vtalian: bets $1
FlopsterGB: calls $1
*** RIVER *** [5c 2s 6c Jc] [Js]
vtalian: bets $3.20
FlopsterGB: folds 
Uncalled bet ($3.20) returned to vtalian
vtalian collected $3.39 from pot
*** SUMMARY ***
Total pot $3.55 | Rake $0.16 
Board [5c 2s 6c Jc Js]
Seat 1: MühliJr (small blind) folded before Flop
Seat 2: Action_Gibi (big blind) folded before Flop
Seat 3: vtalian collected ($3.39)
Seat 6: FlopsterGB (button) folded on the River



PokerStars Hand #166667639028:  Hold'em No Limit ($0.05/$0.10 USD) - 2017/02/23 16:04:49 ET
Table 'Brambilla II' 6-max Seat #4 is the button
Seat 1: Rodik002 ($12.87 in chips) 
Seat 2: dwonder75 ($13.79 in chips) 
Seat 3: BORIS_ENEV ($14.47 in chips) 
Seat 4: david_sara83 ($11.82 in chips) 
Seat 5: FRAID358 ($10.05 in chips) 
Seat 6: boxer821 ($10.48 in chips) 
FRAID358: posts small blind $0.05
boxer821: posts big blind $0.10
*** HOLE CARDS ***
Rodik002: folds 
dwonder75: folds 
BORIS_ENEV: folds 
david_sara83: folds 
FRAID358: raises $0.20 to $0.30
boxer821: folds 
Uncalled bet ($0.20) returned to FRAID358
FRAID358 collected $0.20 from pot
*** SUMMARY ***
Total pot $0.20 | Rake $0 
Seat 1: Rodik002 folded before Flop (didn't bet)
Seat 2: dwonder75 folded before Flop (didn't bet)
Seat 3: BORIS_ENEV folded before Flop (didn't bet)
Seat 4: david_sara83 (button) folded before Flop (didn't bet)
Seat 5: FRAID358 (small blind) collected ($0.20)
Seat 6: boxer821 (big blind) folded before Flop



PokerStars Hand #166667639179:  Hold'em No Limit ($0.05/$0.10 USD) - 2017/02/23 16:04:49 ET
Table 'Hunnia' 6-max Seat #5 is the button
Seat 1: univibe68 ($22.03 in chips) 
Seat 2: mhonielsen ($10 in chips) 
Seat 3: 6ePeMeHHa9 ($10.71 in chips) 
Seat 4: Jalida3 ($10.55 in chips) 
Seat 5: Smarkon ($14.78 in chips) 
Seat 6: ChuikaPridi ($10.05 in chips) 
ChuikaPridi: posts small blind $0.05
univibe68: posts big blind $0.10
*** HOLE CARDS ***
mhonielsen: folds 
6ePeMeHHa9: folds 
Jalida3: folds 
Smarkon: raises $0.20 to $0.30
ChuikaPridi: folds 
univibe68: folds 
Uncalled bet ($0.20) returned to Smarkon
Smarkon collected $0.25 from pot
*** SUMMARY ***
Total pot $0.25 | Rake $0 
Seat 1: univibe68 (big blind) folded before Flop
Seat 2: mhonielsen folded before Flop (didn't bet)
Seat 3: 6ePeMeHHa9 folded before Flop (didn't bet)
Seat 4: Jalida3 folded before Flop (didn't bet)
Seat 5: Smarkon (button) collected ($0.25)
Seat 6: ChuikaPridi (small blind) folded before Flop



PokerStars Hand #166667639182:  Hold'em No Limit ($0.05/$0.10 USD) - 2017/02/23 16:04:49 ET
Table 'Repsolda' 6-max Seat #6 is the button
Seat 2: MBen10 ($23.98 in chips) 
Seat 3: manashov ($13.10 in chips) 
Seat 5: danky24 ($7.35 in chips) 
Seat 6: RkaczoR ($11.26 in chips) 
MBen10: posts small blind $0.05
manashov: posts big blind $0.10
MihaGr: sits out 
*** HOLE CARDS ***
danky24: calls $0.10
RkaczoR: folds 
MBen10: calls $0.05
manashov: checks 
*** FLOP *** [6d 7s 7d]
MBen10: checks 
manashov: checks 
danky24: bets $0.30
MBen10: folds 
manashov: calls $0.30
*** TURN *** [6d 7s 7d] [Qc]
manashov: checks 
danky24: bets $0.20
manashov: calls $0.20
*** RIVER *** [6d 7s 7d Qc] [Td]
manashov: checks 
danky24: bets $1.24
manashov: raises $1.49 to $2.73
danky24: folds 
Uncalled bet ($1.49) returned to manashov
manashov collected $3.61 from pot
*** SUMMARY ***
Total pot $3.78 | Rake $0.17 
Board [6d 7s 7d Qc Td]
Seat 2: MBen10 (small blind) folded on the Flop
Seat 3: manashov (big blind) collected ($3.61)
Seat 5: danky24 folded on the River
Seat 6: RkaczoR (button) folded before Flop (didn't bet)



PokerStars Hand #166667639260:  Hold'em No Limit ($0.05/$0.10 USD) - 2017/02/23 16:04:49 ET
Table 'Jokaste II' 6-max Seat #1 is the button
Seat 1: Hyd SK ($13.18 in chips) 
Seat 2: T9MS ($12.38 in chips) 
Seat 3: crazydevill ($10 in chips) 
Seat 4: FRAID358 ($15.61 in chips) 
Seat 5: Vrinni ($10.28 in chips) 
Seat 6: Adailton07 ($15.05 in chips) 
T9MS: posts small blind $0.05
crazydevill: posts big blind $0.10
*** HOLE CARDS ***
FRAID358: raises $0.15 to $0.25
Vrinni: folds 
Adailton07: folds 
Hyd SK: calls $0.25
T9MS: folds 
crazydevill: folds 
*** FLOP *** [Js 5s Kd]
FRAID358: checks 
Hyd SK: bets $0.41
FRAID358: folds 
Uncalled bet ($0.41) returned to Hyd SK
Hyd SK collected $0.62 from pot
*** SUMMARY ***
Total pot $0.65 | Rake $0.03 
Board [Js 5s Kd]
Seat 1: Hyd SK (button) collected ($0.62)
Seat 2: T9MS (small blind) folded before Flop
Seat 3: crazydevill (big blind) folded before Flop
Seat 4: FRAID358 folded on the Flop
Seat 5: Vrinni folded before Flop (didn't bet)
Seat 6: Adailton07 folded before Flop (didn't bet)



PokerStars Hand #166667639459:  Hold'em No Limit ($0.05/$0.10 USD) - 2017/02/23 16:04:50 ET
Table 'Aegle' 6-max Seat #6 is the button
Seat 1: phatts76 ($3.95 in chips) 
Seat 2: yodzik ($5 in chips) 
Seat 3: DrejAtom ($12.59 in chips) 
Seat 4: ab260414 ($10.37 in chips) 
Seat 5: KokoulinV ($10.98 in chips) 
Seat 6: CHRO8 ($20.44 in chips) 
phatts76: posts small blind $0.05
yodzik: posts big blind $0.10
*** HOLE CARDS ***
DrejAtom: raises $0.25 to $0.35
ab260414: folds 
KokoulinV: folds 
CHRO8: folds 
phatts76: folds 
yodzik: folds 
Uncalled bet ($0.25) returned to DrejAtom
DrejAtom collected $0.25 from pot
*** SUMMARY ***
Total pot $0.25 | Rake $0 
Seat 1: phatts76 (small blind) folded before Flop
Seat 2: yodzik (big blind) folded before Flop
Seat 3: DrejAtom collected ($0.25)
Seat 4: ab260414 folded before Flop (didn't bet)
Seat 5: KokoulinV folded before Flop (didn't bet)
Seat 6: CHRO8 (button) folded before Flop (didn't bet)



PokerStars Hand #166667639574:  Hold'em No Limit ($0.05/$0.10 USD) - 2017/02/23 16:04:50 ET
Table 'Bengt' 6-max Seat #1 is the button
Seat 1: Lucky HoBBiT ($12.35 in chips) 
Seat 2: ChefRocco ($21.21 in chips) 
Seat 3: nantes15 ($13.18 in chips) 
Seat 4: 8th wonders ($10 in chips) 
Seat 5: RoJ1 ($10.31 in chips) 
Seat 6: Goroshkos88 ($10.28 in chips) 
ChefRocco: posts small blind $0.05
nantes15: posts big blind $0.10
*** HOLE CARDS ***
8th wonders: folds 
RoJ1: folds 
Goroshkos88: folds 
Lucky HoBBiT: folds 
ChefRocco: calls $0.05
nantes15: raises $0.40 to $0.50
ChefRocco: folds 
Uncalled bet ($0.40) returned to nantes15
nantes15 collected $0.20 from pot
*** SUMMARY ***
Total pot $0.20 | Rake $0 
Seat 1: Lucky HoBBiT (button) folded before Flop (didn't bet)
Seat 2: ChefRocco (small blind) folded before Flop
Seat 3: nantes15 (big blind) collected ($0.20)
Seat 4: 8th wonders folded before Flop (didn't bet)
Seat 5: RoJ1 folded before Flop (didn't bet)
Seat 6: Goroshkos88 folded before Flop (didn't bet)



PokerStars Hand #166667639688:  Hold'em No Limit ($0.05/$0.10 USD) - 2017/02/23 16:04:50 ET
Table 'Nerthus II' 6-max Seat #5 is the button
Seat 1: mdelfin0 ($10.26 in chips) 
Seat 2: Hovhannes990 ($9.63 in chips) 
Seat 3: Mamm0nism ($18.67 in chips) 
Seat 5: Hyd SK ($12.15 in chips) 
Seat 6: Lucky HoBBiT ($10 in chips) 
Lucky HoBBiT: posts small blind $0.05
mdelfin0: posts big blind $0.10
myevc: sits out 
*** HOLE CARDS ***
Hovhannes990: folds 
Mamm0nism: folds 
Hyd SK: folds 
Lucky HoBBiT: raises $0.20 to $0.30
mdelfin0: calls $0.20
*** FLOP *** [Qh 5d 4d]
Lucky HoBBiT: bets $0.31
mdelfin0: calls $0.31
*** TURN *** [Qh 5d 4d] [8h]
Lucky HoBBiT: checks 
mdelfin0: bets $0.80
Lucky HoBBiT: folds 
Uncalled bet ($0.80) returned to mdelfin0
mdelfin0 collected $1.17 from pot
*** SUMMARY ***
Total pot $1.22 | Rake $0.05 
Board [Qh 5d 4d 8h]
Seat 1: mdelfin0 (big blind) collected ($1.17)
Seat 2: Hovhannes990 folded before Flop (didn't bet)
Seat 3: Mamm0nism folded before Flop (didn't bet)
Seat 5: Hyd SK (button) folded before Flop (didn't bet)
Seat 6: Lucky HoBBiT (small blind) folded on the Turn



PokerStars Hand #166667639830:  Hold'em No Limit ($0.05/$0.10 USD) - 2017/02/23 16:04:50 ET
Table 'Brendelia II' 6-max Seat #2 is the button
Seat 2: Crimsonr ($4.99 in chips) 
Seat 3: ValdemorS ($19.07 in chips) 
Seat 6: luckyPositiv ($10.15 in chips) 
ValdemorS: posts small blind $0.05
luckyPositiv: posts big blind $0.10
Crimsonr: posts the ante $0.02
ValdemorS: posts the ante $0.02
luckyPositiv: posts the ante $0.02
*** HOLE CARDS ***
Crimsonr: folds 
ValdemorS: folds 
Uncalled bet ($0.05) returned to luckyPositiv
luckyPositiv collected $0.16 from pot
*** SUMMARY ***
Total pot $0.16 | Rake $0 
Seat 2: Crimsonr (button) folded before Flop (didn't bet)
Seat 3: ValdemorS (small blind) folded before Flop
Seat 6: luckyPositiv (big blind) collected ($0.16)



PokerStars Hand #166667639955:  Hold'em No Limit ($0.05/$0.10 USD) - 2017/02/23 16:04:50 ET
Table 'Girtab' 6-max Seat #2 is the button
Seat 1: pokekrk ($13.56 in chips) 
Seat 2: MühliJr ($10 in chips) 
Seat 3: kingartur222 ($9.91 in chips) 
Seat 4: Hyd SK ($11.50 in chips) 
Seat 5: sexy_seagull ($11.30 in chips) 
kingartur222: posts small blind $0.05
Hyd SK: posts big blind $0.10
*** HOLE CARDS ***
sexy_seagull: folds 
pokekrk: folds 
MühliJr: folds 
kingartur222: raises $0.19 to $0.29
Hyd SK: calls $0.19
*** FLOP *** [7c 6d 5c]
kingartur222: bets $0.30
Hyd SK: calls $0.30
*** TURN *** [7c 6d 5c] [Jc]
kingartur222: bets $0.70
Hyd SK: folds 
Uncalled bet ($0.70) returned to kingartur222
kingartur222 collected $1.13 from pot
*** SUMMARY ***
Total pot $1.18 | Rake $0.05 
Board [7c 6d 5c Jc]
Seat 1: pokekrk folded before Flop (didn't bet)
Seat 2: MühliJr (button) folded before Flop (didn't bet)
Seat 3: kingartur222 (small blind) collected ($1.13)
Seat 4: Hyd SK (big blind) folded on the Turn
Seat 5: sexy_seagull folded before Flop (didn't bet)



PokerStars Hand #166667640113:  Hold'em No Limit ($0.05/$0.10 USD) - 2017/02/23 16:04:50 ET
Table 'Cassini' 6-max Seat #4 is the button
Seat 1: Pokeaster ($10.77 in chips) 
Seat 2: mhonielsen ($12.56 in chips) 
Seat 4: fortieth ($13.57 in chips) 
Seat 5: johkom ($7.45 in chips) 
Seat 6: JahSoldier69 ($10.32 in chips) 
johkom: posts small blind $0.05
JahSoldier69: posts big blind $0.10
*** HOLE CARDS ***
Pokeaster: folds 
mhonielsen: folds 
fortieth: folds 
johkom: raises $0.20 to $0.30
JahSoldier69: folds 
Uncalled bet ($0.20) returned to johkom
johkom collected $0.20 from pot
*** SUMMARY ***
Total pot $0.20 | Rake $0 
Seat 1: Pokeaster folded before Flop (didn't bet)
Seat 2: mhonielsen folded before Flop (didn't bet)
Seat 4: fortieth (button) folded before Flop (didn't bet)
Seat 5: johkom (small blind) collected ($0.20)
Seat 6: JahSoldier69 (big blind) folded before Flop



PokerStars Hand #166667640224:  Hold'em No Limit ($0.05/$0.10 USD) - 2017/02/23 16:04:50 ET
Table 'Huberta II' 6-max Seat #1 is the button
Seat 1: tr41n3r12 ($10.33 in chips) 
Seat 2: Ice_Isayev ($12.13 in chips) 
Seat 3: patrick19111 ($10.75 in chips) 
Seat 4: VAD21 ($12.11 in chips) 
Seat 5: Feverhead ($26.78 in chips) 
Ice_Isayev: posts small blind $0.05
patrick19111: posts big blind $0.10
*** HOLE CARDS ***
VAD21: folds 
Feverhead: raises $0.15 to $0.25
tr41n3r12: folds 
yodzik joins the table at seat #6 
Ice_Isayev: folds 
patrick19111: folds 
Uncalled bet ($0.15) returned to Feverhead
Feverhead collected $0.25 from pot
*** SUMMARY ***
Total pot $0.25 | Rake $0 
Seat 1: tr41n3r12 (button) folded before Flop (didn't bet)
Seat 2: Ice_Isayev (small blind) folded before Flop
Seat 3: patrick19111 (big blind) folded before Flop
Seat 4: VAD21 folded before Flop (didn't bet)
Seat 5: Feverhead collected ($0.25)



PokerStars Hand #166667640225:  Hold'em No Limit ($0.05/$0.10 USD) - 2017/02/23 16:04:50 ET
Table 'Halawe II' 6-max Seat #1 is the button
Seat 1: DIGOR100 ($6.87 in chips) 
Seat 3: cherep61987 ($11.04 in chips) 
Seat 4: voledy ($12.25 in chips) 
Seat 5: takis nik ($12.43 in chips) 
Seat 6: Rodik002 ($20.37 in chips) 
cherep61987: posts small blind $0.05
voledy: posts big blind $0.10
*** HOLE CARDS ***
takis nik: folds 
Rodik002: folds 
DIGOR100: folds 
cherep61987: raises $0.15 to $0.25
voledy: raises $0.65 to $0.90
cherep61987: folds 
Uncalled bet ($0.65) returned to voledy
voledy collected $0.50 from pot
*** SUMMARY ***
Total pot $0.50 | Rake $0 
Seat 1: DIGOR100 (button) folded before Flop (didn't bet)
Seat 3: cherep61987 (small blind) folded before Flop
Seat 4: voledy (big blind) collected ($0.50)
Seat 5: takis nik folded before Flop (didn't bet)
Seat 6: Rodik002 folded before Flop (didn't bet)



PokerStars Hand #166667640523:  Hold'em No Limit ($0.05/$0.10 USD) - 2017/02/23 16:04:51 ET
Table 'Sham' 6-max Seat #5 is the button
Seat 1: pancernik21 ($10 in chips) 
Seat 2: ex3Lero86 ($10.30 in chips) 
Seat 3: weez3r ($22.68 in chips) 
Seat 4: VAD21 ($14.36 in chips) 
Seat 5: T9MS ($10.28 in chips) 
Seat 6: bdixon_5 ($8.05 in chips) 
bdixon_5: posts small blind $0.05
pancernik21: posts big blind $0.10
*** HOLE CARDS ***
ex3Lero86: raises $0.20 to $0.30
weez3r: folds 
VAD21: folds 
T9MS: folds 
bdixon_5: folds 
pancernik21: folds 
Uncalled bet ($0.20) returned to ex3Lero86
ex3Lero86 collected $0.25 from pot
*** SUMMARY ***
Total pot $0.25 | Rake $0 
Seat 1: pancernik21 (big blind) folded before Flop
Seat 2: ex3Lero86 collected ($0.25)
Seat 3: weez3r folded before Flop (didn't bet)
Seat 4: VAD21 folded before Flop (didn't bet)
Seat 5: T9MS (button) folded before Flop (didn't bet)
Seat 6: bdixon_5 (small blind) folded before Flop



PokerStars Hand #166667640583:  Hold'em No Limit ($0.05/$0.10 USD) - 2017/02/23 16:04:51 ET
Table 'Landi II' 6-max Seat #4 is the button
Seat 1: dersiemer ($12.04 in chips) 
Seat 2: Aescul@pius ($10.95 in chips) 
Seat 3: dr.goofy ($21.44 in chips) 
Seat 4: alesi13 ($6.40 in chips) 
Seat 5: Bird et al ($10 in chips) 
Bird et al: posts small blind $0.05
dersiemer is connected 
dersiemer: posts big blind $0.10
*** HOLE CARDS ***
Aescul@pius: folds 
dr.goofy: folds 
alesi13: folds 
Bird et al: raises $0.20 to $0.30
dersiemer: folds 
Uncalled bet ($0.20) returned to Bird et al
Bird et al collected $0.20 from pot
*** SUMMARY ***
Total pot $0.20 | Rake $0 
Seat 1: dersiemer (big blind) folded before Flop
Seat 2: Aescul@pius folded before Flop (didn't bet)
Seat 3: dr.goofy folded before Flop (didn't bet)
Seat 4: alesi13 (button) folded before Flop (didn't bet)
Seat 5: Bird et al (small blind) collected ($0.20)



PokerStars Hand #166667640693:  Hold'em No Limit ($0.05/$0.10 USD) - 2017/02/23 16:04:51 ET
Table 'Nuki' 6-max Seat #4 is the button
Seat 1: bdixon_5 ($7.80 in chips) 
Seat 2: ArcticBearDK ($19.23 in chips) 
Seat 3: david_sara83 ($13.94 in chips) 
Seat 4: GESPERIA ($28.26 in chips) 
Seat 6: Zooplack ($25.17 in chips) 
Zooplack: posts small blind $0.05
bdixon_5: posts big blind $0.10
*** HOLE CARDS ***
ArcticBearDK: folds 
david_sara83: folds 
GESPERIA: folds 
Zooplack: folds 
Uncalled bet ($0.05) returned to bdixon_5
bdixon_5 collected $0.10 from pot
*** SUMMARY ***
Total pot $0.10 | Rake $0 
Seat 1: bdixon_5 (big blind) collected ($0.10)
Seat 2: ArcticBearDK folded before Flop (didn't bet)
Seat 3: david_sara83 folded before Flop (didn't bet)
Seat 4: GESPERIA (button) folded before Flop (didn't bet)
Seat 6: Zooplack (small blind) folded before Flop



PokerStars Hand #166667640770:  Hold'em No Limit ($0.05/$0.10 USD) - 2017/02/23 16:04:51 ET
Table 'Walpurga' 6-max Seat #2 is the button
Seat 1: chimera252 ($12.07 in chips) 
Seat 2: paxit71 ($6.69 in chips) 
Seat 3: marianoboni ($10 in chips) 
Seat 4: oddshoff ($12.79 in chips) 
Seat 6: AIONCMA1988 ($5 in chips) 
marianoboni: posts small blind $0.05
oddshoff: posts big blind $0.10
*** HOLE CARDS ***
AIONCMA1988: folds 
chimera252: folds 
paxit71: folds 
marianoboni: raises $0.20 to $0.30
oddshoff: raises $0.60 to $0.90
marianoboni: folds 
Uncalled bet ($0.60) returned to oddshoff
oddshoff collected $0.60 from pot
*** SUMMARY ***
Total pot $0.60 | Rake $0 
Seat 1: chimera252 folded before Flop (didn't bet)
Seat 2: paxit71 (button) folded before Flop (didn't bet)
Seat 3: marianoboni (small blind) folded before Flop
Seat 4: oddshoff (big blind) collected ($0.60)
Seat 6: AIONCMA1988 folded before Flop (didn't bet)



PokerStars Hand #166667640891:  Hold'em No Limit ($0.05/$0.10 USD) - 2017/02/23 16:04:51 ET
Table 'Eurykleia' 6-max Seat #1 is the button
Seat 1: Giyorod ($10.15 in chips) 
Seat 2: x3ultimate ($10.64 in chips) 
Seat 3: boxer821 ($20.56 in chips) 
Seat 4: 6ePeMeHHa9 ($17.02 in chips) 
Seat 5: fishhook5 ($10 in chips) 
Seat 6: afca128 ($6.42 in chips) 
x3ultimate: posts small blind $0.05
boxer821: posts big blind $0.10
*** HOLE CARDS ***
6ePeMeHHa9: folds 
fishhook5: raises $0.19 to $0.29
afca128: folds 
Giyorod: folds 
x3ultimate: folds 
boxer821: folds 
Uncalled bet ($0.19) returned to fishhook5
fishhook5 collected $0.25 from pot
*** SUMMARY ***
Total pot $0.25 | Rake $0 
Seat 1: Giyorod (button) folded before Flop (didn't bet)
Seat 2: x3ultimate (small blind) folded before Flop
Seat 3: boxer821 (big blind) folded before Flop
Seat 4: 6ePeMeHHa9 folded before Flop (didn't bet)
Seat 5: fishhook5 collected ($0.25)
Seat 6: afca128 folded before Flop (didn't bet)



PokerStars Hand #166667640933:  Hold'em No Limit ($0.05/$0.10 USD) - 2017/02/23 16:04:51 ET
Table 'Torrence II' 6-max Seat #3 is the button
Seat 1: Starbooks ($6.14 in chips) 
Seat 2: scorpionfish ($16.10 in chips) 
Seat 3: coolisses111 ($9.65 in chips) 
Seat 4: Zooplack ($10 in chips) 
Seat 5: Kow6oy ($12.33 in chips) 
Zooplack: posts small blind $0.05
Kow6oy: posts big blind $0.10
mhonielsen: sits out 
*** HOLE CARDS ***
Starbooks: folds 
scorpionfish: folds 
coolisses111: raises $0.20 to $0.30
Zooplack: folds 
Kow6oy: folds 
Uncalled bet ($0.20) returned to coolisses111
coolisses111 collected $0.25 from pot
*** SUMMARY ***
Total pot $0.25 | Rake $0 
Seat 1: Starbooks folded before Flop (didn't bet)
Seat 2: scorpionfish folded before Flop (didn't bet)
Seat 3: coolisses111 (button) collected ($0.25)
Seat 4: Zooplack (small blind) folded before Flop
Seat 5: Kow6oy (big blind) folded before Flop



PokerStars Hand #166667642175:  Hold'em No Limit ($0.05/$0.10 USD) - 2017/02/23 16:04:53 ET
Table 'Tyndareus II' 6-max Seat #3 is the button
Seat 1: Makc1705 ($3.65 in chips) 
Seat 2: Therodorus ($11.37 in chips) 
Seat 3: McCleans ($10.26 in chips) 
Seat 4: gaHy_HaXeP ($12.31 in chips) 
Seat 5: vtalian ($10 in chips) 
Seat 6: sexy_seagull ($10.30 in chips) 
gaHy_HaXeP: posts small blind $0.05
vtalian: posts big blind $0.10
*** HOLE CARDS ***
sexy_seagull: folds 
Makc1705: folds 
Therodorus: folds 
McCleans: raises $0.15 to $0.25
gaHy_HaXeP: calls $0.20
vtalian: folds 
*** FLOP *** [4s 7c 8d]
gaHy_HaXeP: checks 
McCleans: bets $0.40
gaHy_HaXeP: calls $0.40
*** TURN *** [4s 7c 8d] [4d]
Therodorus leaves the table
gaHy_HaXeP: checks 
fishhook5 joins the table at seat #2 
McCleans: bets $1.05
gaHy_HaXeP: calls $1.05
*** RIVER *** [4s 7c 8d 4d] [Kd]
gaHy_HaXeP: checks 
McCleans: bets $3
gaHy_HaXeP: folds 
Uncalled bet ($3) returned to McCleans
McCleans collected $3.34 from pot
*** SUMMARY ***
Total pot $3.50 | Rake $0.16 
Board [4s 7c 8d 4d Kd]
Seat 1: Makc1705 folded before Flop (didn't bet)
Seat 2: Therodorus folded before Flop (didn't bet)
Seat 3: McCleans (button) collected ($3.34)
Seat 4: gaHy_HaXeP (small blind) folded on the River
Seat 5: vtalian (big blind) folded before Flop
Seat 6: sexy_seagull folded before Flop (didn't bet)



PokerStars Hand #166667642331:  Hold'em No Limit ($0.05/$0.10 USD) - 2017/02/23 16:04:53 ET
Table 'Hajek III' 6-max Seat #5 is the button
Seat 1: MBen10 ($10.65 in chips) 
Seat 2: fortieth ($10.19 in chips) 
Seat 3: fedorka rus ($10.61 in chips) 
Seat 4: NvR.m1nD ($13.39 in chips) 
Seat 5: Croplayer1 ($14.75 in chips) 
MBen10: posts small blind $0.05
fortieth: posts big blind $0.10
*** HOLE CARDS ***
fedorka rus: raises $0.20 to $0.30
NvR.m1nD: folds 
Croplayer1: folds 
MBen10: folds 
fortieth: folds 
Uncalled bet ($0.20) returned to fedorka rus
fedorka rus collected $0.25 from pot
*** SUMMARY ***
Total pot $0.25 | Rake $0 
Seat 1: MBen10 (small blind) folded before Flop
Seat 2: fortieth (big blind) folded before Flop
Seat 3: fedorka rus collected ($0.25)
Seat 4: NvR.m1nD folded before Flop (didn't bet)
Seat 5: Croplayer1 (button) folded before Flop (didn't bet)



PokerStars Hand #166667642543:  Hold'em No Limit ($0.05/$0.10 USD) - 2017/02/23 16:04:53 ET
Table 'Iduberga II' 6-max Seat #6 is the button
Seat 1: mhonielsen ($10.66 in chips) 
Seat 2: popypaleta ($12.95 in chips) 
Seat 3: scorpionfish ($11.58 in chips) 
Seat 4: Peter0087 ($9.88 in chips) 
Seat 5: Pokeaster ($10.47 in chips) 
Seat 6: tblocos ($12.36 in chips) 
mhonielsen: posts small blind $0.05
popypaleta: posts big blind $0.10
*** HOLE CARDS ***
scorpionfish: folds 
Peter0087: folds 
Pokeaster: folds 
tblocos: calls $0.10
mhonielsen: calls $0.05
popypaleta: checks 
*** FLOP *** [8d 9d 8h]
mhonielsen: checks 
popypaleta: checks 
tblocos: checks 
*** TURN *** [8d 9d 8h] [Qs]
mhonielsen: bets $0.23
popypaleta: folds 
tblocos: calls $0.23
*** RIVER *** [8d 9d 8h Qs] [2d]
mhonielsen: bets $0.42
tblocos: folds 
Uncalled bet ($0.42) returned to mhonielsen
mhonielsen collected $0.73 from pot
*** SUMMARY ***
Total pot $0.76 | Rake $0.03 
Board [8d 9d 8h Qs 2d]
Seat 1: mhonielsen (small blind) collected ($0.73)
Seat 2: popypaleta (big blind) folded on the Turn
Seat 3: scorpionfish folded before Flop (didn't bet)
Seat 4: Peter0087 folded before Flop (didn't bet)
Seat 5: Pokeaster folded before Flop (didn't bet)
Seat 6: tblocos (button) folded on the River



PokerStars Hand #166667642849:  Hold'em No Limit ($0.05/$0.10 USD) - 2017/02/23 16:04:53 ET
Table 'Grietje' 6-max Seat #4 is the button
Seat 2: Feverhead ($12.97 in chips) 
Seat 4: MihaGr ($10.10 in chips) 
Seat 5: iThreeBarrel ($10 in chips) 
Seat 6: Prometheu$8 ($21.70 in chips) 
iThreeBarrel: posts small blind $0.05
Prometheu$8: posts big blind $0.10
dragonste89: sits out 
*** HOLE CARDS ***
Feverhead: raises $0.15 to $0.25
MihaGr: raises $0.75 to $1
iThreeBarrel: folds 
Prometheu$8: folds 
Feverhead: folds 
Uncalled bet ($0.75) returned to MihaGr
MihaGr collected $0.65 from pot
*** SUMMARY ***
Total pot $0.65 | Rake $0 
Seat 2: Feverhead folded before Flop
Seat 4: MihaGr (button) collected ($0.65)
Seat 5: iThreeBarrel (small blind) folded before Flop
Seat 6: Prometheu$8 (big blind) folded before Flop



PokerStars Hand #166667643098:  Hold'em No Limit ($0.05/$0.10 USD) - 2017/02/23 16:04:54 ET
Table 'Manto II' 6-max Seat #3 is the button
Seat 1: MihaGr ($10 in chips) 
Seat 2: voledy ($10 in chips) 
Seat 3: Komap511 ($10.42 in chips) 
Seat 4: dr.goofy ($10.32 in chips) 
Seat 5: ArcticBearDK ($32.69 in chips) 
Seat 6: pancernik21 ($16.20 in chips) 
dr.goofy: posts small blind $0.05
ArcticBearDK: posts big blind $0.10
*** HOLE CARDS ***
pancernik21: raises $0.20 to $0.30
MihaGr: folds 
voledy: folds 
Komap511: folds 
dr.goofy: folds 
ArcticBearDK: folds 
Uncalled bet ($0.20) returned to pancernik21
pancernik21 collected $0.25 from pot
*** SUMMARY ***
Total pot $0.25 | Rake $0 
Seat 1: MihaGr folded before Flop (didn't bet)
Seat 2: voledy folded before Flop (didn't bet)
Seat 3: Komap511 (button) folded before Flop (didn't bet)
Seat 4: dr.goofy (small blind) folded before Flop
Seat 5: ArcticBearDK (big blind) folded before Flop
Seat 6: pancernik21 collected ($0.25)



PokerStars Hand #166667643485:  Hold'em No Limit ($0.05/$0.10 USD) - 2017/02/23 16:04:54 ET
Table 'Tyndareus III' 6-max Seat #3 is the button
Seat 1: MBen10 ($10.15 in chips) 
Seat 2: MihaGr ($10 in chips) 
Seat 3: XaXaTyH4uK ($10.60 in chips) 
Seat 5: yodzik ($5 in chips) 
yodzik: posts small blind $0.05
Elinaattor: is sitting out 
MBen10: posts big blind $0.10
*** HOLE CARDS ***
tequila_joop joins the table at seat #4 
MihaGr: raises $0.20 to $0.30
XaXaTyH4uK: calls $0.30
yodzik: folds 
Elinaattor leaves the table
MBen10: folds 
*** FLOP *** [Jc Th 6c]
MihaGr: bets $0.48
XaXaTyH4uK: folds 
Uncalled bet ($0.48) returned to MihaGr
MihaGr collected $0.72 from pot
*** SUMMARY ***
Total pot $0.75 | Rake $0.03 
Board [Jc Th 6c]
Seat 1: MBen10 (big blind) folded before Flop
Seat 2: MihaGr collected ($0.72)
Seat 3: XaXaTyH4uK (button) folded on the Flop
Seat 5: yodzik (small blind) folded before Flop



PokerStars Hand #166667643656:  Hold'em No Limit ($0.05/$0.10 USD) - 2017/02/23 16:04:54 ET
Table 'Antinous' 6-max Seat #1 is the button
Seat 1: Andrei ProFF ($15.68 in chips) 
Seat 2: Nr847 ($13.65 in chips) 
Seat 3: dittoro ($10 in chips) 
Seat 4: Pekaml ($15.42 in chips) 
Seat 5: Covetsoles ($3.58 in chips) 
Seat 6: coolisses111 ($10.20 in chips) 
Nr847: posts small blind $0.05
dittoro: posts big blind $0.10
*** HOLE CARDS ***
Pekaml has timed out while disconnected
Pekaml: folds 
Covetsoles: folds 
coolisses111: folds 
Andrei ProFF: folds 
Nr847: folds 
Uncalled bet ($0.05) returned to dittoro
dittoro collected $0.10 from pot
*** SUMMARY ***
Total pot $0.10 | Rake $0 
Seat 1: Andrei ProFF (button) folded before Flop (didn't bet)
Seat 2: Nr847 (small blind) folded before Flop
Seat 3: dittoro (big blind) collected ($0.10)
Seat 4: Pekaml folded before Flop (didn't bet)
Seat 5: Covetsoles folded before Flop (didn't bet)
Seat 6: coolisses111 folded before Flop (didn't bet)



PokerStars Hand #166667643663:  Hold'em No Limit ($0.05/$0.10 USD) - 2017/02/23 16:04:54 ET
Table 'Emma II' 6-max Seat #4 is the button
Seat 1: LarryTheStar ($10 in chips) 
Seat 2: T9MS ($11.64 in chips) 
Seat 3: oddshoff ($9.52 in chips) 
Seat 4: Jucatorul823 ($5.82 in chips) 
Seat 5: Scanner17 ($11.41 in chips) 
Seat 6: CHRO8 ($14.82 in chips) 
Scanner17: posts small blind $0.05
CHRO8: posts big blind $0.10
*** HOLE CARDS ***
LarryTheStar: folds 
T9MS: raises $0.20 to $0.30
oddshoff: folds 
Jucatorul823: folds 
Scanner17: folds 
CHRO8: folds 
Uncalled bet ($0.20) returned to T9MS
T9MS collected $0.25 from pot
*** SUMMARY ***
Total pot $0.25 | Rake $0 
Seat 1: LarryTheStar folded before Flop (didn't bet)
Seat 2: T9MS collected ($0.25)
Seat 3: oddshoff folded before Flop (didn't bet)
Seat 4: Jucatorul823 (button) folded before Flop (didn't bet)
Seat 5: Scanner17 (small blind) folded before Flop
Seat 6: CHRO8 (big blind) folded before Flop



PokerStars Hand #166667643830:  Hold'em No Limit ($0.05/$0.10 USD) - 2017/02/23 16:04:54 ET
Table 'Gyldenia II' 6-max Seat #3 is the button
Seat 1: KokoulinV ($10.40 in chips) 
Seat 2: Bandyaev ($11.09 in chips) 
Seat 3: ex3Lero86 ($23.37 in chips) 
Seat 5: CHRO8 ($15.62 in chips) 
Seat 6: 8th wonders ($11.68 in chips) 
CHRO8: posts small blind $0.05
8th wonders: posts big blind $0.10
*** HOLE CARDS ***
KokoulinV: folds 
Bandyaev: folds 
ex3Lero86: raises $0.13 to $0.23
CHRO8: folds 
8th wonders: folds 
Uncalled bet ($0.13) returned to ex3Lero86
ex3Lero86 collected $0.25 from pot
*** SUMMARY ***
Total pot $0.25 | Rake $0 
Seat 1: KokoulinV folded before Flop (didn't bet)
Seat 2: Bandyaev folded before Flop (didn't bet)
Seat 3: ex3Lero86 (button) collected ($0.25)
Seat 5: CHRO8 (small blind) folded before Flop
Seat 6: 8th wonders (big blind) folded before Flop



PokerStars Hand #166667643857:  Hold'em No Limit ($0.05/$0.10 USD) - 2017/02/23 16:04:54 ET
Table 'Peiroos III' 6-max Seat #1 is the button
Seat 1: tequila_joop ($10 in chips) 
Seat 3: nabatov.m ($6.94 in chips) 
Seat 4: pivanki11 ($10.58 in chips) 
Seat 5: ChuikaPridi ($10 in chips) 
Seat 6: CHRO8 ($9.67 in chips) 
nabatov.m: posts small blind $0.05
pivanki11: posts big blind $0.10
tequila_joop: posts the ante $0.02
nabatov.m: posts the ante $0.02
pivanki11: posts the ante $0.02
ChuikaPridi: posts the ante $0.02
CHRO8: posts the ante $0.02
*** HOLE CARDS ***
ChuikaPridi: folds 
CHRO8: folds 
tequila_joop: raises $0.20 to $0.30
nabatov.m: folds 
pivanki11: raises $0.50 to $0.80
tequila_joop: folds 
Uncalled bet ($0.50) returned to pivanki11
pivanki11 collected $0.75 from pot
*** SUMMARY ***
Total pot $0.75 | Rake $0 
Seat 1: tequila_joop (button) folded before Flop
Seat 3: nabatov.m (small blind) folded before Flop
Seat 4: pivanki11 (big blind) collected ($0.75)
Seat 5: ChuikaPridi folded before Flop (didn't bet)
Seat 6: CHRO8 folded before Flop (didn't bet)



PokerStars Hand #166667643882:  Hold'em No Limit ($0.05/$0.10 USD) - 2017/02/23 16:04:54 ET
Table 'Eurydome II' 6-max Seat #5 is the button
Seat 1: rusu_rapid ($11.83 in chips) 
Seat 2: Elinaattor ($10.34 in chips) 
Seat 3: gaHy_HaXeP ($10 in chips) 
Seat 4: Smitty03300 ($10.32 in chips) 
Seat 5: kush-killa87 ($13.29 in chips) 
Seat 6: Jucatorul823 ($6.75 in chips) 
Jucatorul823: posts small blind $0.05
rusu_rapid: posts big blind $0.10
*** HOLE CARDS ***
Elinaattor: raises $0.25 to $0.35
gaHy_HaXeP: folds 
Smitty03300: folds 
kush-killa87: calls $0.35
Jucatorul823: folds 
rusu_rapid: folds 
*** FLOP *** [5d 3d 7c]
Elinaattor: bets $1.05
kush-killa87: calls $1.05
*** TURN *** [5d 3d 7c] [9c]
Elinaattor: checks 
kush-killa87: bets $1.40
Elinaattor: raises $7.31 to $8.71
kush-killa87: folds [7h]
Uncalled bet ($7.31) returned to Elinaattor
Elinaattor collected $5.49 from pot
*** SUMMARY ***
Total pot $5.75 | Rake $0.26 
Board [5d 3d 7c 9c]
Seat 1: rusu_rapid (big blind) folded before Flop
Seat 2: Elinaattor collected ($5.49)
Seat 3: gaHy_HaXeP folded before Flop (didn't bet)
Seat 4: Smitty03300 folded before Flop (didn't bet)
Seat 5: kush-killa87 (button) folded on the Turn
Seat 6: Jucatorul823 (small blind) folded before Flop



PokerStars Hand #166667644347:  Hold'em No Limit ($0.05/$0.10 USD) - 2017/02/23 16:04:55 ET
Table 'Eudora' 6-max Seat #2 is the button
Seat 1: archer2511 ($11.46 in chips) 
Seat 2: popypaleta ($10 in chips) 
Seat 3: Ice_Isayev ($10.05 in chips) 
Seat 4: yodzik ($5 in chips) 
Seat 5: chimera252 ($11.67 in chips) 
Ice_Isayev: posts small blind $0.05
yodzik: posts big blind $0.10
*** HOLE CARDS ***
chimera252: folds 
archer2511: folds 
popypaleta: raises $0.20 to $0.30
Ice_Isayev: folds 
yodzik: raises $0.60 to $0.90
popypaleta: folds 
Uncalled bet ($0.60) returned to yodzik
yodzik collected $0.65 from pot
*** SUMMARY ***
Total pot $0.65 | Rake $0 
Seat 1: archer2511 folded before Flop (didn't bet)
Seat 2: popypaleta (button) folded before Flop
Seat 3: Ice_Isayev (small blind) folded before Flop
Seat 4: yodzik (big blind) collected ($0.65)
Seat 5: chimera252 folded before Flop (didn't bet)



PokerStars Hand #166667644470:  Hold'em No Limit ($0.05/$0.10 USD) - 2017/02/23 16:04:55 ET
Table 'Bootes' 6-max Seat #3 is the button
Seat 1: Namhkal ($12.50 in chips) 
Seat 2: Bird et al ($19.30 in chips) 
Seat 3: KA3AXCTAHEU, ($19.48 in chips) 
Seat 4: totonove ($5.17 in chips) 
Seat 6: cherep61987 ($10.37 in chips) 
totonove: posts small blind $0.05
cherep61987: posts big blind $0.10
*** HOLE CARDS ***
Namhkal: raises $0.15 to $0.25
Bird et al: folds 
KA3AXCTAHEU,: calls $0.25
totonove: folds 
cherep61987: folds 
*** FLOP *** [9h 6c 2d]
Namhkal: bets $0.31
KA3AXCTAHEU,: folds 
Uncalled bet ($0.31) returned to Namhkal
Namhkal collected $0.62 from pot
*** SUMMARY ***
Total pot $0.65 | Rake $0.03 
Board [9h 6c 2d]
Seat 1: Namhkal collected ($0.62)
Seat 2: Bird et al folded before Flop (didn't bet)
Seat 3: KA3AXCTAHEU, (button) folded on the Flop
Seat 4: totonove (small blind) folded before Flop
Seat 6: cherep61987 (big blind) folded before Flop



PokerStars Hand #166667644991:  Hold'em No Limit ($0.05/$0.10 USD) - 2017/02/23 16:04:56 ET
Table 'Arkab' 6-max Seat #6 is the button
Seat 1: iamkakaroto ($10 in chips) 
Seat 2: aktion4ik ($12.39 in chips) 
Seat 3: sexy_seagull ($10 in chips) 
Seat 4: donkucallme ($17.34 in chips) 
Seat 5: OrionYusupov ($9.44 in chips) 
Seat 6: MihaGr ($10.63 in chips) 
iamkakaroto: posts small blind $0.05
aktion4ik: posts big blind $0.10
*** HOLE CARDS ***
sexy_seagull: folds 
donkucallme: raises $0.80 to $0.90
OrionYusupov: folds 
MihaGr: folds 
iamkakaroto: folds 
aktion4ik: folds 
Uncalled bet ($0.80) returned to donkucallme
donkucallme collected $0.25 from pot
*** SUMMARY ***
Total pot $0.25 | Rake $0 
Seat 1: iamkakaroto (small blind) folded before Flop
Seat 2: aktion4ik (big blind) folded before Flop
Seat 3: sexy_seagull folded before Flop (didn't bet)
Seat 4: donkucallme collected ($0.25)
Seat 5: OrionYusupov folded before Flop (didn't bet)
Seat 6: MihaGr (button) folded before Flop (didn't bet)



PokerStars Hand #166667645036:  Hold'em No Limit ($0.05/$0.10 USD) - 2017/02/23 16:04:56 ET
Table 'Deflotte' 6-max Seat #3 is the button
Seat 1: Zooplack ($15.79 in chips) 
Seat 2: MonteCris92 ($10.23 in chips) 
Seat 3: Croplayer1 ($10.15 in chips) 
Seat 4: 8th wonders ($10.22 in chips) 
Seat 5: Pokeaster ($11.12 in chips) 
Seat 6: Iarlei ($12 in chips) 
8th wonders: posts small blind $0.05
Pokeaster: posts big blind $0.10
*** HOLE CARDS ***
Iarlei: folds 
Zooplack: folds 
MonteCris92: folds 
Croplayer1: raises $0.10 to $0.20
8th wonders: folds 
Pokeaster: raises $0.70 to $0.90
Croplayer1: folds 
Uncalled bet ($0.70) returned to Pokeaster
Pokeaster collected $0.45 from pot
*** SUMMARY ***
Total pot $0.45 | Rake $0 
Seat 1: Zooplack folded before Flop (didn't bet)
Seat 2: MonteCris92 folded before Flop (didn't bet)
Seat 3: Croplayer1 (button) folded before Flop
Seat 4: 8th wonders (small blind) folded before Flop
Seat 5: Pokeaster (big blind) collected ($0.45)
Seat 6: Iarlei folded before Flop (didn't bet)



PokerStars Hand #166667645039:  Hold'em No Limit ($0.05/$0.10 USD) - 2017/02/23 16:04:56 ET
Table 'Kobresia II' 6-max Seat #6 is the button
Seat 1: RoJ1 ($13.71 in chips) 
Seat 2: Dcaro31 ($13.44 in chips) 
Seat 3: FRAID358 ($10.84 in chips) 
Seat 4: armstv ($10.87 in chips) 
Seat 5: Goroshkos88 ($12.32 in chips) 
Seat 6: WinninBikini ($10 in chips) 
RoJ1: posts small blind $0.05
Dcaro31: posts big blind $0.10
*** HOLE CARDS ***
FRAID358: folds 
armstv: folds 
Goroshkos88: folds 
WinninBikini: folds 
RoJ1: raises $0.15 to $0.25
Dcaro31: calls $0.15
*** FLOP *** [Qs 7d 8s]
RoJ1: checks 
Dcaro31: checks 
*** TURN *** [Qs 7d 8s] [2s]
RoJ1: checks 
Dcaro31: checks 
*** RIVER *** [Qs 7d 8s 2s] [9s]
RoJ1: checks 
Dcaro31: checks 
*** SHOW DOWN ***
RoJ1: shows [4c 4h] (a pair of Fours)
Dcaro31: mucks hand 
RoJ1 collected $0.48 from pot
*** SUMMARY ***
Total pot $0.50 | Rake $0.02 
Board [Qs 7d 8s 2s 9s]
Seat 1: RoJ1 (small blind) showed [4c 4h] and won ($0.48) with a pair of Fours
Seat 2: Dcaro31 (big blind) mucked
Seat 3: FRAID358 folded before Flop (didn't bet)
Seat 4: armstv folded before Flop (didn't bet)
Seat 5: Goroshkos88 folded before Flop (didn't bet)
Seat 6: WinninBikini (button) folded before Flop (didn't bet)



PokerStars Hand #166667645269:  Hold'em No Limit ($0.05/$0.10 USD) - 2017/02/23 16:04:56 ET
Table 'Risha II' 6-max Seat #6 is the button
Seat 1: R. Lemonte ($13.47 in chips) 
Seat 2: KA3AXCTAHEU, ($12.65 in chips) 
Seat 3: steepfell ($10 in chips) 
Seat 4: Comeback3392 ($20.66 in chips) 
Seat 5: m.c-alkatraz ($10.20 in chips) 
Seat 6: univibe68 ($10.46 in chips) 
R. Lemonte: posts small blind $0.05
KA3AXCTAHEU,: posts big blind $0.10
*** HOLE CARDS ***
steepfell: folds 
Comeback3392: folds 
m.c-alkatraz: folds 
univibe68: raises $0.10 to $0.20
R. Lemonte: folds 
KA3AXCTAHEU,: folds 
Uncalled bet ($0.10) returned to univibe68
univibe68 collected $0.25 from pot
*** SUMMARY ***
Total pot $0.25 | Rake $0 
Seat 1: R. Lemonte (small blind) folded before Flop
Seat 2: KA3AXCTAHEU, (big blind) folded before Flop
Seat 3: steepfell folded before Flop (didn't bet)
Seat 4: Comeback3392 folded before Flop (didn't bet)
Seat 5: m.c-alkatraz folded before Flop (didn't bet)
Seat 6: univibe68 (button) collected ($0.25)



PokerStars Hand #166667645307:  Hold'em No Limit ($0.05/$0.10 USD) - 2017/02/23 16:04:56 ET
Table 'Mesarthim' 6-max Seat #4 is the button
Seat 1: Mancuso2010 ($16.30 in chips) 
Seat 2: MühliJr ($10.37 in chips) 
Seat 3: Damage514 ($10.35 in chips) 
Seat 4: Strelok1974 ($10.11 in chips) 
Seat 5: Iarlei ($10.95 in chips) 
Seat 6: bdixon_5 ($8.96 in chips) 
Iarlei: posts small blind $0.05
bdixon_5: posts big blind $0.10
*** HOLE CARDS ***
Mancuso2010: raises $0.20 to $0.30
MühliJr: calls $0.30
Damage514: calls $0.30
Strelok1974: folds 
Iarlei: folds 
bdixon_5: folds 
*** FLOP *** [9h Th Ks]
Mancuso2010: checks 
MühliJr: checks 
Damage514: bets $0.50
Mancuso2010: folds 
MühliJr: calls $0.50
*** TURN *** [9h Th Ks] [3c]
MühliJr: checks 
Damage514: checks 
*** RIVER *** [9h Th Ks 3c] [3h]
MühliJr: bets $1.30
Damage514: folds 
Uncalled bet ($1.30) returned to MühliJr
MühliJr collected $1.96 from pot
*** SUMMARY ***
Total pot $2.05 | Rake $0.09 
Board [9h Th Ks 3c 3h]
Seat 1: Mancuso2010 folded on the Flop
Seat 2: MühliJr collected ($1.96)
Seat 3: Damage514 folded on the River
Seat 4: Strelok1974 (button) folded before Flop (didn't bet)
Seat 5: Iarlei (small blind) folded before Flop
Seat 6: bdixon_5 (big blind) folded before Flop



PokerStars Hand #166667645363:  Hold'em No Limit ($0.05/$0.10 USD) - 2017/02/23 16:04:56 ET
Table 'Caupolican' 6-max Seat #2 is the button
Seat 1: kingartur222 ($11.49 in chips) 
Seat 2: garigura ($18.90 in chips) 
Seat 4: mhonielsen ($15.69 in chips) 
Seat 5: Kazacha ($10.56 in chips) 
Seat 6: crazydevill ($10.77 in chips) 
mhonielsen: posts small blind $0.05
Kazacha: posts big blind $0.10
*** HOLE CARDS ***
crazydevill: folds 
kingartur222: folds 
garigura: folds 
mhonielsen: folds 
Uncalled bet ($0.05) returned to Kazacha
Kazacha collected $0.10 from pot
*** SUMMARY ***
Total pot $0.10 | Rake $0 
Seat 1: kingartur222 folded before Flop (didn't bet)
Seat 2: garigura (button) folded before Flop (didn't bet)
Seat 4: mhonielsen (small blind) folded before Flop
Seat 5: Kazacha (big blind) collected ($0.10)
Seat 6: crazydevill folded before Flop (didn't bet)



PokerStars Hand #166667645524:  Hold'em No Limit ($0.05/$0.10 USD) - 2017/02/23 16:04:56 ET
Table 'Rotraut' 6-max Seat #2 is the button
Seat 2: Newqbrown ($11.24 in chips) 
Seat 3: FlackoD ($12.17 in chips) 
Seat 5: Bird et al ($11.75 in chips) 
Seat 6: KokoulinV ($12.59 in chips) 
FlackoD: posts small blind $0.05
Bird et al: posts big blind $0.10
*** HOLE CARDS ***
KokoulinV: folds 
Newqbrown: folds 
FlackoD: folds 
Uncalled bet ($0.05) returned to Bird et al
Bird et al collected $0.10 from pot
*** SUMMARY ***
Total pot $0.10 | Rake $0 
Seat 2: Newqbrown (button) folded before Flop (didn't bet)
Seat 3: FlackoD (small blind) folded before Flop
Seat 5: Bird et al (big blind) collected ($0.10)
Seat 6: KokoulinV folded before Flop (didn't bet)



PokerStars Hand #166667646306:  Hold'em No Limit ($0.05/$0.10 USD) - 2017/02/23 16:04:57 ET
Table 'Camilla II' 6-max Seat #3 is the button
Seat 1: paxit71 ($8 in chips) 
Seat 2: Giyorod ($16.11 in chips) 
Seat 3: Andy Wolf ($10 in chips) 
Seat 4: chimera252 ($12.31 in chips) 
Seat 5: LarryTheStar ($11.34 in chips) 
Seat 6: david_sara83 ($10.15 in chips) 
chimera252: posts small blind $0.05
LarryTheStar: posts big blind $0.10
*** HOLE CARDS ***
david_sara83: folds 
paxit71: folds 
Giyorod: folds 
Andy Wolf: folds 
chimera252: raises $0.20 to $0.30
LarryTheStar: folds 
Uncalled bet ($0.20) returned to chimera252
chimera252 collected $0.20 from pot
*** SUMMARY ***
Total pot $0.20 | Rake $0 
Seat 1: paxit71 folded before Flop (didn't bet)
Seat 2: Giyorod folded before Flop (didn't bet)
Seat 3: Andy Wolf (button) folded before Flop (didn't bet)
Seat 4: chimera252 (small blind) collected ($0.20)
Seat 5: LarryTheStar (big blind) folded before Flop
Seat 6: david_sara83 folded before Flop (didn't bet)



PokerStars Hand #166667646324:  Hold'em No Limit ($0.05/$0.10 USD) - 2017/02/23 16:04:57 ET
Table 'Luanda' 6-max Seat #5 is the button
Seat 1: AM-L-SL ($4.85 in chips) 
Seat 2: Xander188 ($10 in chips) 
Seat 3: DamDatsAnAce ($10.15 in chips) 
Seat 5: st4tion ($13.03 in chips) 
Seat 6: KA3AXCTAHEU, ($11.48 in chips) 
KA3AXCTAHEU,: posts small blind $0.05
AM-L-SL: posts big blind $0.10
*** HOLE CARDS ***
Xander188: folds 
DamDatsAnAce: folds 
st4tion: folds 
KA3AXCTAHEU,: raises $0.20 to $0.30
AM-L-SL: folds 
Uncalled bet ($0.20) returned to KA3AXCTAHEU,
KA3AXCTAHEU, collected $0.20 from pot
*** SUMMARY ***
Total pot $0.20 | Rake $0 
Seat 1: AM-L-SL (big blind) folded before Flop
Seat 2: Xander188 folded before Flop (didn't bet)
Seat 3: DamDatsAnAce folded before Flop (didn't bet)
Seat 5: st4tion (button) folded before Flop (didn't bet)
Seat 6: KA3AXCTAHEU, (small blind) collected ($0.20)



PokerStars Hand #166667646362:  Hold'em No Limit ($0.05/$0.10 USD) - 2017/02/23 16:04:57 ET
Table 'Samitchell III' 6-max Seat #2 is the button
Seat 1: dr.goofy ($10.02 in chips) 
Seat 2: scorpionfish ($10.32 in chips) 
Seat 5: steepfell ($10 in chips) 
Seat 6: fedorka rus ($12.96 in chips) 
steepfell: posts small blind $0.05
fedorka rus: posts big blind $0.10
*** HOLE CARDS ***
dr.goofy: folds 
scorpionfish: raises $0.20 to $0.30
steepfell: folds 
fedorka rus: calls $0.20
*** FLOP *** [Kc 6h Ts]
fedorka rus: checks 
scorpionfish: bets $0.30
Vanne11 joins the table at seat #3 
DEraser joins the table at seat #4 
fedorka rus: calls $0.30
*** TURN *** [Kc 6h Ts] [6d]
fedorka rus: checks 
scorpionfish: checks 
*** RIVER *** [Kc 6h Ts 6d] [Jd]
fedorka rus: checks 
scorpionfish: bets $0.80
fedorka rus: folds 
Uncalled bet ($0.80) returned to scorpionfish
scorpionfish collected $1.19 from pot
*** SUMMARY ***
Total pot $1.25 | Rake $0.06 
Board [Kc 6h Ts 6d Jd]
Seat 1: dr.goofy folded before Flop (didn't bet)
Seat 2: scorpionfish (button) collected ($1.19)
Seat 5: steepfell (small blind) folded before Flop
Seat 6: fedorka rus (big blind) folded on the River



PokerStars Hand #166667646828:  Hold'em No Limit ($0.05/$0.10 USD) - 2017/02/23 16:04:58 ET
Table 'Tirela' 6-max Seat #6 is the button
Seat 1: Smitty03300 ($10 in chips) 
Seat 2: Andrei ProFF ($17.79 in chips) 
Seat 3: aim444 ($15.77 in chips) 
Seat 4: ArcticBearDK ($10.01 in chips) 
Seat 5: KRZuff ($11.29 in chips) 
Seat 6: coolisses111 ($9.95 in chips) 
Smitty03300: posts small blind $0.05
Andrei ProFF: posts big blind $0.10
*** HOLE CARDS ***
aim444: folds 
ArcticBearDK: folds 
KRZuff: raises $0.20 to $0.30
coolisses111: folds 
Smitty03300: folds 
Andrei ProFF: folds 
Uncalled bet ($0.20) returned to KRZuff
KRZuff collected $0.25 from pot
*** SUMMARY ***
Total pot $0.25 | Rake $0 
Seat 1: Smitty03300 (small blind) folded before Flop
Seat 2: Andrei ProFF (big blind) folded before Flop
Seat 3: aim444 folded before Flop (didn't bet)
Seat 4: ArcticBearDK folded before Flop (didn't bet)
Seat 5: KRZuff collected ($0.25)
Seat 6: coolisses111 (button) folded before Flop (didn't bet)



PokerStars Hand #166667646977:  Hold'em No Limit ($0.05/$0.10 USD) - 2017/02/23 16:04:58 ET
Table 'Nauheima II' 6-max Seat #5 is the button
Seat 2: Peter0087 ($9.82 in chips) 
Seat 3: KokoulinV ($13.29 in chips) 
Seat 4: Innerwuss ($10.47 in chips) 
Seat 5: Kow6oy ($10.30 in chips) 
Seat 6: bonyo71 ($5.09 in chips) 
bonyo71: posts small blind $0.05
Peter0087: posts big blind $0.10
*** HOLE CARDS ***
KokoulinV: folds 
Innerwuss: raises $0.15 to $0.25
Kow6oy: calls $0.25
bonyo71: folds 
Peter0087: raises $1.15 to $1.40
Innerwuss: folds 
Kow6oy: folds 
Uncalled bet ($1.15) returned to Peter0087
Peter0087 collected $0.80 from pot
*** SUMMARY ***
Total pot $0.80 | Rake $0 
Seat 2: Peter0087 (big blind) collected ($0.80)
Seat 3: KokoulinV folded before Flop (didn't bet)
Seat 4: Innerwuss folded before Flop
Seat 5: Kow6oy (button) folded before Flop
Seat 6: bonyo71 (small blind) folded before Flop



PokerStars Hand #166667646989:  Hold'em No Limit ($0.05/$0.10 USD) - 2017/02/23 16:04:58 ET
Table 'Kanda' 6-max Seat #6 is the button
Seat 1: Andy Wolf ($11.17 in chips) 
Seat 2: Pelotín ($5.30 in chips) 
Seat 4: Orlangoor ($10.19 in chips) 
Seat 5: Dimka4 ($10 in chips) 
Seat 6: oddshoff ($9.06 in chips) 
Andy Wolf: posts small blind $0.05
Pelotín: posts big blind $0.10
XaXaTyH4uK: sits out 
*** HOLE CARDS ***
Orlangoor: folds 
Dimka4: folds 
oddshoff: raises $0.10 to $0.20
Andy Wolf: folds 
Pelotín: folds 
Uncalled bet ($0.10) returned to oddshoff
oddshoff collected $0.25 from pot
*** SUMMARY ***
Total pot $0.25 | Rake $0 
Seat 1: Andy Wolf (small blind) folded before Flop
Seat 2: Pelotín (big blind) folded before Flop
Seat 4: Orlangoor folded before Flop (didn't bet)
Seat 5: Dimka4 folded before Flop (didn't bet)
Seat 6: oddshoff (button) collected ($0.25)



PokerStars Hand #166667647353:  Hold'em No Limit ($0.05/$0.10 USD) - 2017/02/23 16:04:58 ET
Table 'Marghanna II' 6-max Seat #4 is the button
Seat 2: Namhkal ($11.41 in chips) 
Seat 3: Innerwuss ($11.42 in chips) 
Seat 4: D3NyA ($12.22 in chips) 
Seat 5: ofl21189 ($7.88 in chips) 
Seat 6: VAD21 ($13.11 in chips) 
ofl21189: posts small blind $0.05
VAD21: posts big blind $0.10
Goroshkos88: sits out 
*** HOLE CARDS ***
Namhkal: folds 
Innerwuss: raises $0.15 to $0.25
D3NyA: folds 
ofl21189: calls $0.20
VAD21: folds 
*** FLOP *** [3c Ac 3h]
ofl21189: checks 
Innerwuss: checks 
*** TURN *** [3c Ac 3h] [7d]
ofl21189: bets $0.50
Innerwuss: calls $0.50
*** RIVER *** [3c Ac 3h 7d] [9s]
ofl21189: bets $0.50
Innerwuss: calls $0.50
*** SHOW DOWN ***
ofl21189: shows [Td Qd] (a pair of Threes)
Innerwuss: shows [Kh Ah] (two pair, Aces and Threes)
Innerwuss collected $2.48 from pot
*** SUMMARY ***
Total pot $2.60 | Rake $0.12 
Board [3c Ac 3h 7d 9s]
Seat 2: Namhkal folded before Flop (didn't bet)
Seat 3: Innerwuss showed [Kh Ah] and won ($2.48) with two pair, Aces and Threes
Seat 4: D3NyA (button) folded before Flop (didn't bet)
Seat 5: ofl21189 (small blind) showed [Td Qd] and lost with a pair of Threes
Seat 6: VAD21 (big blind) folded before Flop



PokerStars Hand #166667647421:  Hold'em No Limit ($0.05/$0.10 USD) - 2017/02/23 16:04:58 ET
Table 'Oongaq' 6-max Seat #6 is the button
Seat 1: Dmitrij218 ($13.50 in chips) 
Seat 2: homelessdan ($18.55 in chips) 
Seat 3: iDecMate ($10 in chips) 
Seat 4: Bird et al ($10 in chips) 
Seat 5: Dizzler1991 ($5.58 in chips) 
Seat 6: boxer821 ($10 in chips) 
Dmitrij218: posts small blind $0.05
homelessdan: posts big blind $0.10
*** HOLE CARDS ***
iDecMate: folds 
Bird et al: raises $0.21 to $0.31
Dizzler1991: folds 
boxer821: folds 
Dmitrij218: folds 
homelessdan: folds 
Uncalled bet ($0.21) returned to Bird et al
Bird et al collected $0.25 from pot
*** SUMMARY ***
Total pot $0.25 | Rake $0 
Seat 1: Dmitrij218 (small blind) folded before Flop
Seat 2: homelessdan (big blind) folded before Flop
Seat 3: iDecMate folded before Flop (didn't bet)
Seat 4: Bird et al collected ($0.25)
Seat 5: Dizzler1991 folded before Flop (didn't bet)
Seat 6: boxer821 (button) folded before Flop (didn't bet)



PokerStars Hand #166667647561:  Hold'em No Limit ($0.05/$0.10 USD) - 2017/02/23 16:04:58 ET
Table 'Wil' 6-max Seat #6 is the button
Seat 1: jwhelan94 ($22.59 in chips) 
Seat 2: Vrinni ($21.60 in chips) 
Seat 3: Namhkal ($10 in chips) 
Seat 4: x3ultimate ($10.70 in chips) 
Seat 5: Feverhead ($14.06 in chips) 
Seat 6: Comeback3392 ($14.03 in chips) 
jwhelan94: posts small blind $0.05
Vrinni: posts big blind $0.10
*** HOLE CARDS ***
Namhkal: folds 
x3ultimate: folds 
Feverhead: folds 
Comeback3392: raises $0.15 to $0.25
jwhelan94: raises $0.45 to $0.70
Vrinni: folds 
Comeback3392: folds 
Uncalled bet ($0.45) returned to jwhelan94
jwhelan94 collected $0.60 from pot
*** SUMMARY ***
Total pot $0.60 | Rake $0 
Seat 1: jwhelan94 (small blind) collected ($0.60)
Seat 2: Vrinni (big blind) folded before Flop
Seat 3: Namhkal folded before Flop (didn't bet)
Seat 4: x3ultimate folded before Flop (didn't bet)
Seat 5: Feverhead folded before Flop (didn't bet)
Seat 6: Comeback3392 (button) folded before Flop



PokerStars Hand #166667647607:  Hold'em No Limit ($0.05/$0.10 USD) - 2017/02/23 16:04:58 ET
Table 'Apollonia' 6-max Seat #5 is the button
Seat 1: ex3Lero86 ($10.11 in chips) 
Seat 2: ibara000 ($18.58 in chips) 
Seat 4: Goroshkos88 ($17.72 in chips) 
Seat 5: EphemeralBen ($22 in chips) 
Seat 6: Namhkal ($10.30 in chips) 
Namhkal: posts small blind $0.05
ex3Lero86: posts big blind $0.10
*** HOLE CARDS ***
ibara000: folds 
Goroshkos88: folds 
EphemeralBen: folds 
Namhkal: folds 
Uncalled bet ($0.05) returned to ex3Lero86
ex3Lero86 collected $0.10 from pot
*** SUMMARY ***
Total pot $0.10 | Rake $0 
Seat 1: ex3Lero86 (big blind) collected ($0.10)
Seat 2: ibara000 folded before Flop (didn't bet)
Seat 4: Goroshkos88 folded before Flop (didn't bet)
Seat 5: EphemeralBen (button) folded before Flop (didn't bet)
Seat 6: Namhkal (small blind) folded before Flop



PokerStars Hand #166667647861:  Hold'em No Limit ($0.05/$0.10 USD) - 2017/02/23 16:04:59 ET
Table 'Siebohme' 6-max Seat #6 is the button
Seat 1: kusa4ki ($11.43 in chips) 
Seat 2: el toro 1507 ($11.53 in chips) 
Seat 3: ex3Lero86 ($10.56 in chips) 
Seat 4: Innerwuss ($10.15 in chips) 
Seat 5: Kazacha ($10 in chips) 
Seat 6: townerz1991 ($10.53 in chips) 
kusa4ki: posts small blind $0.05
el toro 1507: posts big blind $0.10
*** HOLE CARDS ***
ex3Lero86: folds 
Innerwuss: folds 
Kazacha: folds 
townerz1991: folds 
kusa4ki: folds 
Uncalled bet ($0.05) returned to el toro 1507
el toro 1507 collected $0.10 from pot
*** SUMMARY ***
Total pot $0.10 | Rake $0 
Seat 1: kusa4ki (small blind) folded before Flop
Seat 2: el toro 1507 (big blind) collected ($0.10)
Seat 3: ex3Lero86 folded before Flop (didn't bet)
Seat 4: Innerwuss folded before Flop (didn't bet)
Seat 5: Kazacha folded before Flop (didn't bet)
Seat 6: townerz1991 (button) folded before Flop (didn't bet)



PokerStars Hand #166667648119:  Hold'em No Limit ($0.05/$0.10 USD) - 2017/02/23 16:04:59 ET
Table 'Senta II' 6-max Seat #5 is the button
Seat 2: NvR.m1nD ($11.30 in chips) 
Seat 3: Aescul@pius ($20.55 in chips) 
Seat 4: fedorka rus ($21.24 in chips) 
Seat 5: Algarah ($6.82 in chips) 
Seat 6: T9MS ($11.67 in chips) 
T9MS: posts small blind $0.05
NvR.m1nD: posts big blind $0.10
*** HOLE CARDS ***
Aescul@pius: raises $0.30 to $0.40
fedorka rus: folds 
Algarah: folds 
T9MS: folds 
NvR.m1nD: folds 
Uncalled bet ($0.30) returned to Aescul@pius
Aescul@pius collected $0.25 from pot
*** SUMMARY ***
Total pot $0.25 | Rake $0 
Seat 2: NvR.m1nD (big blind) folded before Flop
Seat 3: Aescul@pius collected ($0.25)
Seat 4: fedorka rus folded before Flop (didn't bet)
Seat 5: Algarah (button) folded before Flop (didn't bet)
Seat 6: T9MS (small blind) folded before Flop



PokerStars Hand #166667648164:  Hold'em No Limit ($0.05/$0.10 USD) - 2017/02/23 16:04:59 ET
Table 'Syringa' 6-max Seat #1 is the button
Seat 1: bdixon_5 ($7.80 in chips) 
Seat 2: Goroshkos88 ($10.46 in chips) 
Seat 3: Yspenyanin ($13.52 in chips) 
Seat 5: Andrei ProFF ($13.61 in chips) 
Seat 6: ibara000 ($16.28 in chips) 
Goroshkos88: posts small blind $0.05
Yspenyanin: posts big blind $0.10
*** HOLE CARDS ***
Andrei ProFF: folds 
ibara000: folds 
bdixon_5: folds 
Goroshkos88: folds 
Uncalled bet ($0.05) returned to Yspenyanin
Yspenyanin collected $0.10 from pot
*** SUMMARY ***
Total pot $0.10 | Rake $0 
Seat 1: bdixon_5 (button) folded before Flop (didn't bet)
Seat 2: Goroshkos88 (small blind) folded before Flop
Seat 3: Yspenyanin (big blind) collected ($0.10)
Seat 5: Andrei ProFF folded before Flop (didn't bet)
Seat 6: ibara000 folded before Flop (didn't bet)



PokerStars Hand #166667648291:  Hold'em No Limit ($0.05/$0.10 USD) - 2017/02/23 16:04:59 ET
Table 'Pulcova II' 6-max Seat #2 is the button
Seat 1: sexy_seagull ($13.40 in chips) 
Seat 2: Kazacha ($10 in chips) 
Seat 3: Lao Tsy ($14.18 in chips) 
Seat 4: VioXion ($10.25 in chips) 
Seat 5: mdelfin0 ($10 in chips) 
Seat 6: Ice_Isayev ($10.65 in chips) 
Lao Tsy: posts small blind $0.05
VioXion: posts big blind $0.10
*** HOLE CARDS ***
mdelfin0: folds 
Ice_Isayev: folds 
sexy_seagull: folds 
Kazacha: folds 
Lao Tsy: folds 
Uncalled bet ($0.05) returned to VioXion
VioXion collected $0.10 from pot
*** SUMMARY ***
Total pot $0.10 | Rake $0 
Seat 1: sexy_seagull folded before Flop (didn't bet)
Seat 2: Kazacha (button) folded before Flop (didn't bet)
Seat 3: Lao Tsy (small blind) folded before Flop
Seat 4: VioXion (big blind) collected ($0.10)
Seat 5: mdelfin0 folded before Flop (didn't bet)
Seat 6: Ice_Isayev folded before Flop (didn't bet)



PokerStars Hand #166667648768:  Hold'em No Limit ($0.05/$0.10 USD) - 2017/02/23 16:05:00 ET
Table 'Wabash' 6-max Seat #5 is the button
Seat 1: pivanki11 ($10 in chips) 
Seat 2: ex3Lero86 ($32.63 in chips) 
Seat 3: sszabi28 ($4.56 in chips) 
Seat 4: Nr847 ($10 in chips) 
Seat 5: popypaleta ($10 in chips) 
Seat 6: weez3r ($10.57 in chips) 
weez3r: posts small blind $0.05
pivanki11: posts big blind $0.10
*** HOLE CARDS ***
ex3Lero86: folds 
sszabi28: folds 
Nr847: folds 
popypaleta: folds 
weez3r: folds 
Uncalled bet ($0.05) returned to pivanki11
pivanki11 collected $0.10 from pot
*** SUMMARY ***
Total pot $0.10 | Rake $0 
Seat 1: pivanki11 (big blind) collected ($0.10)
Seat 2: ex3Lero86 folded before Flop (didn't bet)
Seat 3: sszabi28 folded before Flop (didn't bet)
Seat 4: Nr847 folded before Flop (didn't bet)
Seat 5: popypaleta (button) folded before Flop (didn't bet)
Seat 6: weez3r (small blind) folded before Flop



PokerStars Hand #166667649003:  Hold'em No Limit ($0.05/$0.10 USD) - 2017/02/23 16:05:00 ET
Table 'Nemo III' 6-max Seat #5 is the button
Seat 1: Kow6oy ($10 in chips) 
Seat 2: Bandyaev ($11.74 in chips) 
Seat 4: vtalian ($9.70 in chips) 
Seat 5: Joker51_wtf! ($11.43 in chips) 
Kow6oy: posts small blind $0.05
Bandyaev: posts big blind $0.10
Dimka4: sits out 
*** HOLE CARDS ***
vtalian: folds 
Joker51_wtf!: folds 
Kow6oy: folds 
Uncalled bet ($0.05) returned to Bandyaev
Bandyaev collected $0.10 from pot
*** SUMMARY ***
Total pot $0.10 | Rake $0 
Seat 1: Kow6oy (small blind) folded before Flop
Seat 2: Bandyaev (big blind) collected ($0.10)
Seat 4: vtalian folded before Flop (didn't bet)
Seat 5: Joker51_wtf! (button) folded before Flop (didn't bet)



PokerStars Hand #166667649236:  Hold'em No Limit ($0.05/$0.10 USD) - 2017/02/23 16:05:00 ET
Table 'Izar' 6-max Seat #2 is the button
Seat 1: bambolejro ($10.39 in chips) 
Seat 2: mvp0013 ($10.98 in chips) 
Seat 3: Yspenyanin ($11.17 in chips) 
Seat 4: Matee92 ($6.16 in chips) 
Seat 5: fishhook5 ($11.45 in chips) 
Seat 6: yodzik ($5 in chips) 
Yspenyanin: posts small blind $0.05
Matee92: posts big blind $0.10
*** HOLE CARDS ***
fishhook5: folds 
yodzik: folds 
bambolejro: folds 
mvp0013: folds 
Yspenyanin: raises $0.15 to $0.25
Matee92: folds 
Uncalled bet ($0.15) returned to Yspenyanin
Yspenyanin collected $0.20 from pot
*** SUMMARY ***
Total pot $0.20 | Rake $0 
Seat 1: bambolejro folded before Flop (didn't bet)
Seat 2: mvp0013 (button) folded before Flop (didn't bet)
Seat 3: Yspenyanin (small blind) collected ($0.20)
Seat 4: Matee92 (big blind) folded before Flop
Seat 5: fishhook5 folded before Flop (didn't bet)
Seat 6: yodzik folded before Flop (didn't bet)



PokerStars Hand #166667649249:  Hold'em No Limit ($0.05/$0.10 USD) - 2017/02/23 16:05:00 ET
Table 'Pirola III' 6-max Seat #5 is the button
Seat 1: bdixon_5 ($9.47 in chips) 
Seat 2: gaHy_HaXeP ($10 in chips) 
Seat 3: kingartur222 ($10.82 in chips) 
Seat 4: McCleans ($10.72 in chips) 
Seat 5: tequila_joop ($10.25 in chips) 
Seat 6: T9MS ($10 in chips) 
T9MS: posts small blind $0.05
bdixon_5: posts big blind $0.10
*** HOLE CARDS ***
gaHy_HaXeP: folds 
kingartur222: folds 
McCleans: folds 
tequila_joop: raises $0.20 to $0.30
T9MS: folds 
bdixon_5: folds 
Uncalled bet ($0.20) returned to tequila_joop
tequila_joop collected $0.25 from pot
*** SUMMARY ***
Total pot $0.25 | Rake $0 
Seat 1: bdixon_5 (big blind) folded before Flop
Seat 2: gaHy_HaXeP folded before Flop (didn't bet)
Seat 3: kingartur222 folded before Flop (didn't bet)
Seat 4: McCleans folded before Flop (didn't bet)
Seat 5: tequila_joop (button) collected ($0.25)
Seat 6: T9MS (small blind) folded before Flop



PokerStars Hand #166667649308:  Hold'em No Limit ($0.05/$0.10 USD) - 2017/02/23 16:05:00 ET
Table 'Isberga' 6-max Seat #1 is the button
Seat 1: Feverhead ($18.17 in chips) 
Seat 2: GESPERIA ($10 in chips) 
Seat 4: THIMUCHIN ($11.04 in chips) 
Seat 5: YoungGriff86 ($19.02 in chips) 
Seat 6: Goroshkos88 ($21.23 in chips) 
GESPERIA: posts small blind $0.05
THIMUCHIN: posts big blind $0.10
*** HOLE CARDS ***
YoungGriff86: folds 
Goroshkos88: folds 
Feverhead: folds 
GESPERIA: raises $0.20 to $0.30
THIMUCHIN: calls $0.20
*** FLOP *** [2s Qs 8s]
GESPERIA: bets $0.40
THIMUCHIN: folds 
Uncalled bet ($0.40) returned to GESPERIA
GESPERIA collected $0.57 from pot
*** SUMMARY ***
Total pot $0.60 | Rake $0.03 
Board [2s Qs 8s]
Seat 1: Feverhead (button) folded before Flop (didn't bet)
Seat 2: GESPERIA (small blind) collected ($0.57)
Seat 4: THIMUCHIN (big blind) folded on the Flop
Seat 5: YoungGriff86 folded before Flop (didn't bet)
Seat 6: Goroshkos88 folded before Flop (didn't bet)



PokerStars Hand #166667649476:  Hold'em No Limit ($0.05/$0.10 USD) - 2017/02/23 16:05:00 ET
Table 'Klotho II' 6-max Seat #3 is the button
Seat 1: Alexey74516 ($7.96 in chips) 
Seat 2: kickereens ($10.05 in chips) 
Seat 3: Zooplack ($10.58 in chips) 
Seat 4: Lucky HoBBiT ($10.01 in chips) 
Seat 5: david_sara83 ($16.06 in chips) 
Seat 6: D3NyA ($11.57 in chips) 
Lucky HoBBiT: posts small blind $0.05
david_sara83: posts big blind $0.10
*** HOLE CARDS ***
D3NyA: folds 
Alexey74516: folds 
Alexey74516 leaves the table
kickereens: folds 
Zooplack: folds 
Lucky HoBBiT: folds 
Uncalled bet ($0.05) returned to david_sara83
david_sara83 collected $0.10 from pot
*** SUMMARY ***
Total pot $0.10 | Rake $0 
Seat 1: Alexey74516 folded before Flop (didn't bet)
Seat 2: kickereens folded before Flop (didn't bet)
Seat 3: Zooplack (button) folded before Flop (didn't bet)
Seat 4: Lucky HoBBiT (small blind) folded before Flop
Seat 5: david_sara83 (big blind) collected ($0.10)
Seat 6: D3NyA folded before Flop (didn't bet)



PokerStars Hand #166667649569:  Hold'em No Limit ($0.05/$0.10 USD) - 2017/02/23 16:05:01 ET
Table 'Girtab II' 6-max Seat #6 is the button
Seat 1: marianoboni ($10.55 in chips) 
Seat 2: Pokeaster ($14.17 in chips) 
Seat 3: chimera252 ($10 in chips) 
Seat 4: Hyd SK ($27.03 in chips) 
Seat 6: DamDatsAnAce ($10 in chips) 
marianoboni: posts small blind $0.05
Pokeaster: posts big blind $0.10
*** HOLE CARDS ***
chimera252: folds 
Hyd SK: folds 
DamDatsAnAce: folds 
marianoboni: raises $0.24 to $0.34
Pokeaster: calls $0.24
*** FLOP *** [7d Ts Kh]
marianoboni: checks 
Pokeaster: checks 
*** TURN *** [7d Ts Kh] [Jc]
marianoboni: bets $0.49
Pokeaster: calls $0.49
*** RIVER *** [7d Ts Kh Jc] [2c]
marianoboni: bets $1.20
Pokeaster: folds 
Uncalled bet ($1.20) returned to marianoboni
marianoboni collected $1.59 from pot
*** SUMMARY ***
Total pot $1.66 | Rake $0.07 
Board [7d Ts Kh Jc 2c]
Seat 1: marianoboni (small blind) collected ($1.59)
Seat 2: Pokeaster (big blind) folded on the River
Seat 3: chimera252 folded before Flop (didn't bet)
Seat 4: Hyd SK folded before Flop (didn't bet)
Seat 6: DamDatsAnAce (button) folded before Flop (didn't bet)



PokerStars Hand #166667649596:  Hold'em No Limit ($0.05/$0.10 USD) - 2017/02/23 16:05:01 ET
Table 'Lampetia III' 6-max Seat #4 is the button
Seat 1: gaHy_HaXeP ($10.55 in chips) 
Seat 2: DamDatsAnAce ($10 in chips) 
Seat 3: Therodorus ($10 in chips) 
Seat 4: IAntikI ($11.41 in chips) 
Seat 5: robson1235 ($19.78 in chips) 
Seat 6: bdixon_5 ($9.35 in chips) 
robson1235: posts small blind $0.05
bdixon_5: posts big blind $0.10
*** HOLE CARDS ***
gaHy_HaXeP: raises $0.20 to $0.30
DamDatsAnAce: folds 
Therodorus: folds 
IAntikI: folds 
robson1235: folds 
bdixon_5: folds 
Uncalled bet ($0.20) returned to gaHy_HaXeP
gaHy_HaXeP collected $0.25 from pot
*** SUMMARY ***
Total pot $0.25 | Rake $0 
Seat 1: gaHy_HaXeP collected ($0.25)
Seat 2: DamDatsAnAce folded before Flop (didn't bet)
Seat 3: Therodorus folded before Flop (didn't bet)
Seat 4: IAntikI (button) folded before Flop (didn't bet)
Seat 5: robson1235 (small blind) folded before Flop
Seat 6: bdixon_5 (big blind) folded before Flop



PokerStars Hand #166667649742:  Hold'em No Limit ($0.05/$0.10 USD) - 2017/02/23 16:05:01 ET
Table 'Arduina' 6-max Seat #5 is the button
Seat 1: tauronex ($10 in chips) 
Seat 2: Andy Wolf ($14.45 in chips) 
Seat 3: Dcaro31 ($13.11 in chips) 
Seat 4: ChuikaPridi ($29.23 in chips) 
Seat 5: ettedallas ($7.22 in chips) 
Seat 6: dierri ($9.30 in chips) 
dierri: posts small blind $0.05
tauronex: posts big blind $0.10
*** HOLE CARDS ***
Andy Wolf: folds 
Dcaro31: folds 
ChuikaPridi: folds 
ettedallas: calls $0.10
dierri: folds 
tauronex: checks 
*** FLOP *** [9d 4s 8h]
tauronex: checks 
ettedallas: bets $0.20
tauronex: folds 
Uncalled bet ($0.20) returned to ettedallas
ettedallas collected $0.24 from pot
*** SUMMARY ***
Total pot $0.25 | Rake $0.01 
Board [9d 4s 8h]
Seat 1: tauronex (big blind) folded on the Flop
Seat 2: Andy Wolf folded before Flop (didn't bet)
Seat 3: Dcaro31 folded before Flop (didn't bet)
Seat 4: ChuikaPridi folded before Flop (didn't bet)
Seat 5: ettedallas (button) collected ($0.24)
Seat 6: dierri (small blind) folded before Flop



PokerStars Hand #166667649777:  Hold'em No Limit ($0.05/$0.10 USD) - 2017/02/23 16:05:01 ET
Table 'Persephone' 6-max Seat #2 is the button
Seat 2: AM-L-SL ($5.35 in chips) 
Seat 3: DasoII ($4.90 in chips) 
Seat 4: 2G28 ($10 in chips) 
Seat 6: popypaleta ($14.24 in chips) 
DasoII: posts small blind $0.05
2G28: posts big blind $0.10
ab260414: sits out 
dragonste89: sits out 
*** HOLE CARDS ***
popypaleta: folds 
AM-L-SL: raises $0.10 to $0.20
DasoII: folds 
2G28: folds 
Uncalled bet ($0.10) returned to AM-L-SL
AM-L-SL collected $0.25 from pot
*** SUMMARY ***
Total pot $0.25 | Rake $0 
Seat 2: AM-L-SL (button) collected ($0.25)
Seat 3: DasoII (small blind) folded before Flop
Seat 4: 2G28 (big blind) folded before Flop
Seat 6: popypaleta folded before Flop (didn't bet)



PokerStars Hand #166667649840:  Hold'em No Limit ($0.05/$0.10 USD) - 2017/02/23 16:05:01 ET
Table 'Alnasl' 6-max Seat #3 is the button
Seat 1: KA3AXCTAHEU, ($11.07 in chips) 
Seat 3: david_sara83 ($22.69 in chips) 
Seat 4: oddshoff ($9.88 in chips) 
Seat 6: Zooplack ($13.43 in chips) 
oddshoff: posts small blind $0.05
steepfell: is sitting out 
Zooplack: posts big blind $0.10
saddur: sits out 
*** HOLE CARDS ***
KA3AXCTAHEU,: folds 
david_sara83: folds 
oddshoff: folds 
Uncalled bet ($0.05) returned to Zooplack
Zooplack collected $0.10 from pot
*** SUMMARY ***
Total pot $0.10 | Rake $0 
Seat 1: KA3AXCTAHEU, folded before Flop (didn't bet)
Seat 3: david_sara83 (button) folded before Flop (didn't bet)
Seat 4: oddshoff (small blind) folded before Flop
Seat 6: Zooplack (big blind) collected ($0.10)



PokerStars Hand #166667649928:  Hold'em No Limit ($0.05/$0.10 USD) - 2017/02/23 16:05:01 ET
Table 'Kraz II' 6-max Seat #4 is the button
Seat 1: bdixon_5 ($9.70 in chips) 
Seat 3: Eddys Edge ($10 in chips) 
Seat 4: WinninBikini ($12.28 in chips) 
Seat 5: Joker51_wtf! ($10 in chips) 
Seat 6: tr41n3r12 ($10.15 in chips) 
Joker51_wtf!: posts small blind $0.05
tr41n3r12: posts big blind $0.10
shellyld: sits out 
*** HOLE CARDS ***
bdixon_5: folds 
Eddys Edge: folds 
WinninBikini: raises $0.12 to $0.22
Joker51_wtf!: folds 
tr41n3r12: folds 
Uncalled bet ($0.12) returned to WinninBikini
WinninBikini collected $0.25 from pot
*** SUMMARY ***
Total pot $0.25 | Rake $0 
Seat 1: bdixon_5 folded before Flop (didn't bet)
Seat 3: Eddys Edge folded before Flop (didn't bet)
Seat 4: WinninBikini (button) collected ($0.25)
Seat 5: Joker51_wtf! (small blind) folded before Flop
Seat 6: tr41n3r12 (big blind) folded before Flop



PokerStars Hand #166667650159:  Hold'em No Limit ($0.05/$0.10 USD) - 2017/02/23 16:05:01 ET
Table 'Vesta II' 6-max Seat #3 is the button
Seat 1: Yabidooo ($13.16 in chips) 
Seat 2: Dimka4 ($10.15 in chips) 
Seat 3: Pokeaster ($12.63 in chips) 
Seat 4: Dcaro31 ($10.32 in chips) 
Seat 6: XaXaTyH4uK ($10 in chips) 
Dcaro31: posts small blind $0.05
Andy Wolf: is sitting out 
XaXaTyH4uK: posts big blind $0.10
*** HOLE CARDS ***
Yabidooo: folds 
Dimka4: folds 
Pokeaster: raises $0.15 to $0.25
Dcaro31: folds 
XaXaTyH4uK: raises $0.75 to $1
Pokeaster: folds 
Uncalled bet ($0.75) returned to XaXaTyH4uK
XaXaTyH4uK collected $0.55 from pot
*** SUMMARY ***
Total pot $0.55 | Rake $0 
Seat 1: Yabidooo folded before Flop (didn't bet)
Seat 2: Dimka4 folded before Flop (didn't bet)
Seat 3: Pokeaster (button) folded before Flop
Seat 4: Dcaro31 (small blind) folded before Flop
Seat 6: XaXaTyH4uK (big blind) collected ($0.55)



PokerStars Hand #166667650442:  Hold'em No Limit ($0.05/$0.10 USD) - 2017/02/23 16:05:02 ET
Table 'Lehigh' 6-max Seat #5 is the button
Seat 1: kowe4ka565 ($8.31 in chips) 
Seat 3: Therodorus ($12.79 in chips) 
Seat 4: Chodemuncher ($10 in chips) 
Seat 5: Xander188 ($10 in chips) 
Seat 6: CallByValue ($9.90 in chips) 
CallByValue: posts small blind $0.05
kowe4ka565: posts big blind $0.10
Sbozzz: sits out 
*** HOLE CARDS ***
Therodorus: folds 
Chodemuncher: folds 
Xander188: folds 
CallByValue: folds 
Uncalled bet ($0.05) returned to kowe4ka565
kowe4ka565 collected $0.10 from pot
*** SUMMARY ***
Total pot $0.10 | Rake $0 
Seat 1: kowe4ka565 (big blind) collected ($0.10)
Seat 3: Therodorus folded before Flop (didn't bet)
Seat 4: Chodemuncher folded before Flop (didn't bet)
Seat 5: Xander188 (button) folded before Flop (didn't bet)
Seat 6: CallByValue (small blind) folded before Flop



PokerStars Hand #166667650446:  Hold'em No Limit ($0.05/$0.10 USD) - 2017/02/23 16:05:02 ET
Table 'Ophelia' 6-max Seat #4 is the button
Seat 1: ralfi37 ($9.26 in chips) 
Seat 2: popypaleta ($16.63 in chips) 
Seat 3: mvp0013 ($11.45 in chips) 
Seat 4: Cluckh ($12.44 in chips) 
Seat 5: truck1234 ($13.91 in chips) 
Seat 6: Yabidooo ($11.28 in chips) 
truck1234: posts small blind $0.05
Yabidooo: posts big blind $0.10
*** HOLE CARDS ***
ralfi37: raises $0.20 to $0.30
popypaleta: folds 
mvp0013: folds 
Cluckh: calls $0.30
truck1234: folds 
Yabidooo: folds 
*** FLOP *** [9h Kc 7s]
ralfi37: checks 
Cluckh: checks 
*** TURN *** [9h Kc 7s] [Qc]
ralfi37: bets $0.50
Cluckh: folds 
Uncalled bet ($0.50) returned to ralfi37
ralfi37 collected $0.72 from pot
*** SUMMARY ***
Total pot $0.75 | Rake $0.03 
Board [9h Kc 7s Qc]
Seat 1: ralfi37 collected ($0.72)
Seat 2: popypaleta folded before Flop (didn't bet)
Seat 3: mvp0013 folded before Flop (didn't bet)
Seat 4: Cluckh (button) folded on the Turn
Seat 5: truck1234 (small blind) folded before Flop
Seat 6: Yabidooo (big blind) folded before Flop



PokerStars Hand #166667650855:  Hold'em No Limit ($0.05/$0.10 USD) - 2017/02/23 16:05:02 ET
Table 'Serpens' 6-max Seat #4 is the button
Seat 1: Namhkal ($10.30 in chips) 
Seat 2: KA3AXCTAHEU, ($19.20 in chips) 
Seat 3: homelessdan ($29.44 in chips) 
Seat 4: Ragazzi3 ($6.74 in chips) 
Seat 5: XwinX25 ($11.71 in chips) 
Seat 6: Croplayer1 ($10.15 in chips) 
XwinX25: posts small blind $0.05
Croplayer1: posts big blind $0.10
*** HOLE CARDS ***
Namhkal: folds 
KA3AXCTAHEU,: folds 
homelessdan: folds 
Ragazzi3: folds 
XwinX25: raises $0.15 to $0.25
Croplayer1: folds 
Uncalled bet ($0.15) returned to XwinX25
XwinX25 collected $0.20 from pot
*** SUMMARY ***
Total pot $0.20 | Rake $0 
Seat 1: Namhkal folded before Flop (didn't bet)
Seat 2: KA3AXCTAHEU, folded before Flop (didn't bet)
Seat 3: homelessdan folded before Flop (didn't bet)
Seat 4: Ragazzi3 (button) folded before Flop (didn't bet)
Seat 5: XwinX25 (small blind) collected ($0.20)
Seat 6: Croplayer1 (big blind) folded before Flop



PokerStars Hand #166667650942:  Hold'em No Limit ($0.05/$0.10 USD) - 2017/02/23 16:05:02 ET
Table 'Epimetheus' 6-max Seat #2 is the button
Seat 1: 6ePeMeHHa9 ($10.29 in chips) 
Seat 2: patrick19111 ($15.51 in chips) 
Seat 3: dineldidi ($9.74 in chips) 
Seat 5: afca128 ($23.83 in chips) 
Seat 6: voledy ($10.60 in chips) 
dineldidi: posts small blind $0.05
afca128: posts big blind $0.10
*** HOLE CARDS ***
voledy: folds 
6ePeMeHHa9: folds 
patrick19111: folds 
dineldidi: raises $0.20 to $0.30
afca128: folds 
Uncalled bet ($0.20) returned to dineldidi
dineldidi collected $0.20 from pot
*** SUMMARY ***
Total pot $0.20 | Rake $0 
Seat 1: 6ePeMeHHa9 folded before Flop (didn't bet)
Seat 2: patrick19111 (button) folded before Flop (didn't bet)
Seat 3: dineldidi (small blind) collected ($0.20)
Seat 5: afca128 (big blind) folded before Flop
Seat 6: voledy folded before Flop (didn't bet)



PokerStars Hand #166667651919:  Hold'em No Limit ($0.05/$0.10 USD) - 2017/02/23 16:05:03 ET
Table 'Tristan III' 6-max Seat #5 is the button
Seat 1: CHRO8 ($18.23 in chips) 
Seat 2: Hyd SK ($14.03 in chips) 
Seat 3: fedorka rus ($25.62 in chips) 
Seat 4: Feverhead ($11.53 in chips) 
Seat 5: david_sara83 ($10.61 in chips) 
fredrik10528 will be allowed to play after the button
CHRO8: posts small blind $0.05
Hyd SK: posts big blind $0.10
*** HOLE CARDS ***
fedorka rus: raises $0.20 to $0.30
Feverhead: folds 
david_sara83: folds 
CHRO8: folds 
Hyd SK: folds 
Uncalled bet ($0.20) returned to fedorka rus
fedorka rus collected $0.25 from pot
*** SUMMARY ***
Total pot $0.25 | Rake $0 
Seat 1: CHRO8 (small blind) folded before Flop
Seat 2: Hyd SK (big blind) folded before Flop
Seat 3: fedorka rus collected ($0.25)
Seat 4: Feverhead folded before Flop (didn't bet)
Seat 5: david_sara83 (button) folded before Flop (didn't bet)



PokerStars Hand #166667651925:  Hold'em No Limit ($0.05/$0.10 USD) - 2017/02/23 16:05:03 ET
Table 'Nuki' 6-max Seat #6 is the button
Seat 1: bdixon_5 ($7.85 in chips) 
Seat 2: ArcticBearDK ($19.23 in chips) 
Seat 3: david_sara83 ($13.94 in chips) 
Seat 4: GESPERIA ($28.26 in chips) 
Seat 6: Zooplack ($25.12 in chips) 
bdixon_5: posts small blind $0.05
ArcticBearDK: posts big blind $0.10
*** HOLE CARDS ***
david_sara83: folds 
GESPERIA: raises $0.20 to $0.30
Zooplack: folds 
bdixon_5: folds 
ArcticBearDK: calls $0.20
*** FLOP *** [Qh Qs 5s]
ArcticBearDK: checks 
GESPERIA: bets $0.41
ArcticBearDK: folds 
Uncalled bet ($0.41) returned to GESPERIA
GESPERIA collected $0.62 from pot
*** SUMMARY ***
Total pot $0.65 | Rake $0.03 
Board [Qh Qs 5s]
Seat 1: bdixon_5 (small blind) folded before Flop
Seat 2: ArcticBearDK (big blind) folded on the Flop
Seat 3: david_sara83 folded before Flop (didn't bet)
Seat 4: GESPERIA collected ($0.62)
Seat 6: Zooplack (button) folded before Flop (didn't bet)



PokerStars Hand #166667652123:  Hold'em No Limit ($0.05/$0.10 USD) - 2017/02/23 16:05:03 ET
Table 'Ruvuma' 6-max Seat #3 is the button
Seat 1: FRAID358 ($14.15 in chips) 
Seat 2: Fab_1512 ($12.62 in chips) 
Seat 3: Spud014 ($10 in chips) 
Seat 4: DamDatsAnAce ($10.05 in chips) 
Seat 5: sexy_seagull ($10 in chips) 
Seat 6: Elinaattor ($9.60 in chips) 
DamDatsAnAce: posts small blind $0.05
sexy_seagull: posts big blind $0.10
*** HOLE CARDS ***
Elinaattor: raises $0.15 to $0.25
FRAID358: folds 
Fab_1512: folds 
Spud014: folds 
DamDatsAnAce: folds 
sexy_seagull: calls $0.15
*** FLOP *** [6s 7s 9c]
sexy_seagull: checks 
Elinaattor: checks 
*** TURN *** [6s 7s 9c] [7d]
sexy_seagull: bets $0.36
Elinaattor: folds 
Uncalled bet ($0.36) returned to sexy_seagull
sexy_seagull collected $0.53 from pot
*** SUMMARY ***
Total pot $0.55 | Rake $0.02 
Board [6s 7s 9c 7d]
Seat 1: FRAID358 folded before Flop (didn't bet)
Seat 2: Fab_1512 folded before Flop (didn't bet)
Seat 3: Spud014 (button) folded before Flop (didn't bet)
Seat 4: DamDatsAnAce (small blind) folded before Flop
Seat 5: sexy_seagull (big blind) collected ($0.53)
Seat 6: Elinaattor folded on the Turn



PokerStars Hand #166667652148:  Hold'em No Limit ($0.05/$0.10 USD) - 2017/02/23 16:05:03 ET
Table 'Nymphe II' 6-max Seat #3 is the button
Seat 1: jacktayra ($4.21 in chips) 
Seat 2: Newqbrown ($10.90 in chips) 
Seat 3: THIMUCHIN ($14.06 in chips) 
Seat 4: coolisses111 ($18.05 in chips) 
Seat 5: Yspenyanin ($10.94 in chips) 
Seat 6: Xander188 ($18.08 in chips) 
coolisses111: posts small blind $0.05
Yspenyanin: posts big blind $0.10
*** HOLE CARDS ***
Xander188: folds 
jacktayra: calls $0.10
Newqbrown: folds 
THIMUCHIN: raises $0.25 to $0.35
coolisses111: folds 
Yspenyanin: folds 
jacktayra: calls $0.25
*** FLOP *** [2h 7s Qd]
jacktayra: checks 
THIMUCHIN: bets $0.45
jacktayra: calls $0.45
*** TURN *** [2h 7s Qd] [8h]
jacktayra: checks 
THIMUCHIN: bets $1.55
jacktayra: calls $1.55
*** RIVER *** [2h 7s Qd 8h] [Ac]
jacktayra: bets $0.30
THIMUCHIN: raises $1.73 to $2.03
jacktayra: folds 
Uncalled bet ($1.73) returned to THIMUCHIN
THIMUCHIN collected $5.20 from pot
*** SUMMARY ***
Total pot $5.45 | Rake $0.25 
Board [2h 7s Qd 8h Ac]
Seat 1: jacktayra folded on the River
Seat 2: Newqbrown folded before Flop (didn't bet)
Seat 3: THIMUCHIN (button) collected ($5.20)
Seat 4: coolisses111 (small blind) folded before Flop
Seat 5: Yspenyanin (big blind) folded before Flop
Seat 6: Xander188 folded before Flop (didn't bet)



PokerStars Hand #166667652496:  Hold'em No Limit ($0.05/$0.10 USD) - 2017/02/23 16:05:04 ET
Table 'Rosalia' 6-max Seat #1 is the button
Seat 1: Hyd SK ($10 in chips) 
Seat 2: Bandyaev ($11.74 in chips) 
Seat 3: Andy Wolf ($12.18 in chips) 
Seat 4: THIMUCHIN ($10.15 in chips) 
Seat 5: miron762 ($18.25 in chips) 
Seat 6: facewald ($16.78 in chips) 
Bandyaev: posts small blind $0.05
Andy Wolf: posts big blind $0.10
*** HOLE CARDS ***
THIMUCHIN: folds 
miron762: calls $0.10
facewald: folds 
Hyd SK: raises $0.25 to $0.35
Bandyaev: folds 
Andy Wolf: folds 
miron762: calls $0.25
*** FLOP *** [4c 2c 7d]
miron762: bets $0.40
Hyd SK: folds 
Uncalled bet ($0.40) returned to miron762
miron762 collected $0.81 from pot
*** SUMMARY ***
Total pot $0.85 | Rake $0.04 
Board [4c 2c 7d]
Seat 1: Hyd SK (button) folded on the Flop
Seat 2: Bandyaev (small blind) folded before Flop
Seat 3: Andy Wolf (big blind) folded before Flop
Seat 4: THIMUCHIN folded before Flop (didn't bet)
Seat 5: miron762 collected ($0.81)
Seat 6: facewald folded before Flop (didn't bet)



PokerStars Hand #166667652908:  Hold'em No Limit ($0.05/$0.10 USD) - 2017/02/23 16:05:04 ET
Table 'Nata II' 6-max Seat #1 is the button
Seat 1: luisantrs ($7.21 in chips) 
Seat 2: CHRO8 ($15.75 in chips) 
Seat 3: 8th wonders ($10 in chips) 
Seat 4: Comeback3392 ($10 in chips) 
Seat 5: RoJ1 ($12.08 in chips) 
Seat 6: IAntikI ($11.36 in chips) 
CHRO8: posts small blind $0.05
8th wonders: posts big blind $0.10
*** HOLE CARDS ***
Comeback3392: folds 
RoJ1: folds 
IAntikI: raises $0.20 to $0.30
luisantrs: calls $0.30
CHRO8: folds 
8th wonders: folds 
*** FLOP *** [2h Kc 5h]
IAntikI: bets $0.45
luisantrs: calls $0.45
*** TURN *** [2h Kc 5h] [Ks]
IAntikI: bets $1
luisantrs: calls $1
*** RIVER *** [2h Kc 5h Ks] [6h]
IAntikI: checks 
luisantrs: bets $3.49
IAntikI: folds 
Uncalled bet ($3.49) returned to luisantrs
luisantrs collected $3.49 from pot
*** SUMMARY ***
Total pot $3.65 | Rake $0.16 
Board [2h Kc 5h Ks 6h]
Seat 1: luisantrs (button) collected ($3.49)
Seat 2: CHRO8 (small blind) folded before Flop
Seat 3: 8th wonders (big blind) folded before Flop
Seat 4: Comeback3392 folded before Flop (didn't bet)
Seat 5: RoJ1 folded before Flop (didn't bet)
Seat 6: IAntikI folded on the River



PokerStars Hand #166667652957:  Hold'em No Limit ($0.05/$0.10 USD) - 2017/02/23 16:05:04 ET
Table 'Fechtig III' 6-max Seat #2 is the button
Seat 1: Scanner17 ($12.24 in chips) 
Seat 2: GV82 ($16.08 in chips) 
Seat 3: eniksenik ($10 in chips) 
Seat 4: Kow6oy ($10 in chips) 
Seat 5: ksandr_hom ($10.10 in chips) 
Seat 6: Glatzemandse ($18.04 in chips) 
eniksenik: posts small blind $0.05
Kow6oy: posts big blind $0.10
*** HOLE CARDS ***
ksandr_hom: raises $0.20 to $0.30
Glatzemandse: folds 
Scanner17: folds 
GV82: folds 
eniksenik: folds 
Kow6oy: folds 
Uncalled bet ($0.20) returned to ksandr_hom
ksandr_hom collected $0.25 from pot
*** SUMMARY ***
Total pot $0.25 | Rake $0 
Seat 1: Scanner17 folded before Flop (didn't bet)
Seat 2: GV82 (button) folded before Flop (didn't bet)
Seat 3: eniksenik (small blind) folded before Flop
Seat 4: Kow6oy (big blind) folded before Flop
Seat 5: ksandr_hom collected ($0.25)
Seat 6: Glatzemandse folded before Flop (didn't bet)



PokerStars Hand #166667653301:  Hold'em No Limit ($0.05/$0.10 USD) - 2017/02/23 16:05:05 ET
Table 'Sinon II' 6-max Seat #2 is the button
Seat 1: Aescul@pius ($10 in chips) 
Seat 2: ÄissesHai ($17.15 in chips) 
Seat 3: crazydevill ($10.68 in chips) 
Seat 4: Bandyaev ($15.48 in chips) 
Seat 5: ab260414 ($11.06 in chips) 
Seat 6: hartmut2012 ($5.28 in chips) 
crazydevill: posts small blind $0.05
Bandyaev: posts big blind $0.10
*** HOLE CARDS ***
ab260414: folds 
hartmut2012 has timed out
hartmut2012: folds 
Aescul@pius: raises $0.15 to $0.25
ÄissesHai: calls $0.25
crazydevill: folds 
Bandyaev: folds 
*** FLOP *** [Qd 5c 2s]
Aescul@pius: bets $0.40
ÄissesHai: folds 
Uncalled bet ($0.40) returned to Aescul@pius
Aescul@pius collected $0.62 from pot
*** SUMMARY ***
Total pot $0.65 | Rake $0.03 
Board [Qd 5c 2s]
Seat 1: Aescul@pius collected ($0.62)
Seat 2: ÄissesHai (button) folded on the Flop
Seat 3: crazydevill (small blind) folded before Flop
Seat 4: Bandyaev (big blind) folded before Flop
Seat 5: ab260414 folded before Flop (didn't bet)
Seat 6: hartmut2012 folded before Flop (didn't bet)



PokerStars Hand #166667653307:  Hold'em No Limit ($0.05/$0.10 USD) - 2017/02/23 16:05:05 ET
Table 'Juliet II' 6-max Seat #5 is the button
Seat 1: alexpolevaja ($11.32 in chips) 
Seat 2: KA3AXCTAHEU, ($15.08 in chips) 
Seat 3: patrick19111 ($11.57 in chips) 
Seat 4: x3ultimate ($10.55 in chips) 
Seat 5: Dcaro31 ($18.82 in chips) 
Seat 6: BookWorm78 ($33 in chips) 
BookWorm78: posts small blind $0.05
alexpolevaja: posts big blind $0.10
*** HOLE CARDS ***
KA3AXCTAHEU,: folds 
patrick19111: folds 
x3ultimate: folds 
Dcaro31: raises $0.20 to $0.30
BookWorm78: folds 
alexpolevaja: folds 
Uncalled bet ($0.20) returned to Dcaro31
Dcaro31 collected $0.25 from pot
*** SUMMARY ***
Total pot $0.25 | Rake $0 
Seat 1: alexpolevaja (big blind) folded before Flop
Seat 2: KA3AXCTAHEU, folded before Flop (didn't bet)
Seat 3: patrick19111 folded before Flop (didn't bet)
Seat 4: x3ultimate folded before Flop (didn't bet)
Seat 5: Dcaro31 (button) collected ($0.25)
Seat 6: BookWorm78 (small blind) folded before Flop



PokerStars Hand #166667653322:  Hold'em No Limit ($0.05/$0.10 USD) - 2017/02/23 16:05:05 ET
Table 'Giclas' 6-max Seat #3 is the button
Seat 1: david_sara83 ($10 in chips) 
Seat 2: Crafty23@PS ($10.71 in chips) 
Seat 3: fidas1972 ($9.91 in chips) 
Seat 4: Eddys Edge ($10 in chips) 
Seat 5: dedea1989 ($25.20 in chips) 
Seat 6: eniksenik ($14.63 in chips) 
Eddys Edge: posts small blind $0.05
dedea1989: posts big blind $0.10
*** HOLE CARDS ***
eniksenik: folds 
david_sara83: folds 
Crafty23@PS: raises $0.20 to $0.30
fidas1972: calls $0.30
Eddys Edge: calls $0.25
dedea1989: calls $0.20
*** FLOP *** [7s 2d Ks]
Eddys Edge: bets $0.95
dedea1989: folds 
Crafty23@PS: folds 
fidas1972: calls $0.95
*** TURN *** [7s 2d Ks] [Qd]
Eddys Edge: bets $2.45
fidas1972: calls $2.45
*** RIVER *** [7s 2d Ks Qd] [7d]
Eddys Edge: bets $6.30 and is all-in
fidas1972: folds 
Uncalled bet ($6.30) returned to Eddys Edge
Eddys Edge collected $7.64 from pot
*** SUMMARY ***
Total pot $8 | Rake $0.36 
Board [7s 2d Ks Qd 7d]
Seat 1: david_sara83 folded before Flop (didn't bet)
Seat 2: Crafty23@PS folded on the Flop
Seat 3: fidas1972 (button) folded on the River
Seat 4: Eddys Edge (small blind) collected ($7.64)
Seat 5: dedea1989 (big blind) folded on the Flop
Seat 6: eniksenik folded before Flop (didn't bet)



PokerStars Hand #166667653327:  Hold'em No Limit ($0.05/$0.10 USD) - 2017/02/23 16:05:05 ET
Table 'Brendelia II' 6-max Seat #3 is the button
Seat 2: Crimsonr ($4.97 in chips) 
Seat 3: ValdemorS ($19 in chips) 
Seat 6: luckyPositiv ($10.24 in chips) 
luckyPositiv: posts small blind $0.05
Crimsonr: posts big blind $0.10
Crimsonr: posts the ante $0.02
ValdemorS: posts the ante $0.02
luckyPositiv: posts the ante $0.02
*** HOLE CARDS ***
ValdemorS: folds 
luckyPositiv: folds 
Uncalled bet ($0.05) returned to Crimsonr
Crimsonr collected $0.16 from pot
*** SUMMARY ***
Total pot $0.16 | Rake $0 
Seat 2: Crimsonr (big blind) collected ($0.16)
Seat 3: ValdemorS (button) folded before Flop (didn't bet)
Seat 6: luckyPositiv (small blind) folded before Flop



PokerStars Hand #166667653465:  Hold'em No Limit ($0.05/$0.10 USD) - 2017/02/23 16:05:05 ET
Table 'Euryalos II' 6-max Seat #5 is the button
Seat 1: acekid403 ($9.90 in chips) 
Seat 2: silsilviu ($7.05 in chips) 
Seat 3: Hyd SK ($10.65 in chips) 
Seat 4: popypaleta ($15.47 in chips) 
Seat 5: horang2 ($8.25 in chips) 
Seat 6: MihaGr ($10.05 in chips) 
MihaGr: posts small blind $0.05
acekid403: posts big blind $0.10
*** HOLE CARDS ***
silsilviu: folds 
Hyd SK: folds 
popypaleta: raises $0.20 to $0.30
horang2: folds 
MihaGr: folds 
acekid403: folds 
Uncalled bet ($0.20) returned to popypaleta
popypaleta collected $0.25 from pot
*** SUMMARY ***
Total pot $0.25 | Rake $0 
Seat 1: acekid403 (big blind) folded before Flop
Seat 2: silsilviu folded before Flop (didn't bet)
Seat 3: Hyd SK folded before Flop (didn't bet)
Seat 4: popypaleta collected ($0.25)
Seat 5: horang2 (button) folded before Flop (didn't bet)
Seat 6: MihaGr (small blind) folded before Flop



PokerStars Hand #166667653742:  Hold'em No Limit ($0.05/$0.10 USD) - 2017/02/23 16:05:05 ET
Table 'Lederle' 6-max Seat #5 is the button
Seat 2: truck1234 ($16 in chips) 
Seat 3: Kazacha ($10.15 in chips) 
Seat 4: Pokeaster ($13.76 in chips) 
Seat 5: 8th wonders ($14.33 in chips) 
Seat 6: pokekrk ($10 in chips) 
pokekrk: posts small blind $0.05
truck1234: posts big blind $0.10
*** HOLE CARDS ***
Kazacha: folds 
Pokeaster: folds 
8th wonders: folds 
pokekrk: raises $0.15 to $0.25
truck1234: folds 
Uncalled bet ($0.15) returned to pokekrk
pokekrk collected $0.20 from pot
*** SUMMARY ***
Total pot $0.20 | Rake $0 
Seat 2: truck1234 (big blind) folded before Flop
Seat 3: Kazacha folded before Flop (didn't bet)
Seat 4: Pokeaster folded before Flop (didn't bet)
Seat 5: 8th wonders (button) folded before Flop (didn't bet)
Seat 6: pokekrk (small blind) collected ($0.20)



PokerStars Hand #166667653744:  Hold'em No Limit ($0.05/$0.10 USD) - 2017/02/23 16:05:05 ET
Table 'California II' 6-max Seat #4 is the button
Seat 1: fedorka rus ($10 in chips) 
Seat 2: homelessdan ($10.15 in chips) 
Seat 3: Bird et al ($10.20 in chips) 
Seat 4: pokekrk ($11.96 in chips) 
Seat 6: chiko4040 ($8.01 in chips) 
chiko4040: posts small blind $0.05
fedorka rus: posts big blind $0.10
*** HOLE CARDS ***
homelessdan: folds 
Bird et al: folds 
pokekrk: folds 
chiko4040: folds 
Uncalled bet ($0.05) returned to fedorka rus
fedorka rus collected $0.10 from pot
*** SUMMARY ***
Total pot $0.10 | Rake $0 
Seat 1: fedorka rus (big blind) collected ($0.10)
Seat 2: homelessdan folded before Flop (didn't bet)
Seat 3: Bird et al folded before Flop (didn't bet)
Seat 4: pokekrk (button) folded before Flop (didn't bet)
Seat 6: chiko4040 (small blind) folded before Flop



PokerStars Hand #166667653974:  Hold'em No Limit ($0.05/$0.10 USD) - 2017/02/23 16:05:05 ET
Table 'Alnasl II' 6-max Seat #1 is the button
Seat 1: dragonste89 ($13 in chips) 
Seat 2: Therodorus ($11.81 in chips) 
Seat 3: ICBM-RS26 ($8.28 in chips) 
Seat 4: Eddys Edge ($10 in chips) 
Seat 5: mdelfin0 ($12.31 in chips) 
Seat 6: Bommer78 ($4.76 in chips) 
Therodorus: posts small blind $0.05
ICBM-RS26: posts big blind $0.10
*** HOLE CARDS ***
Eddys Edge: folds 
mdelfin0: raises $0.20 to $0.30
Bommer78: folds 
dragonste89: folds 
Therodorus: folds 
ICBM-RS26: folds 
Uncalled bet ($0.20) returned to mdelfin0
mdelfin0 collected $0.25 from pot
*** SUMMARY ***
Total pot $0.25 | Rake $0 
Seat 1: dragonste89 (button) folded before Flop (didn't bet)
Seat 2: Therodorus (small blind) folded before Flop
Seat 3: ICBM-RS26 (big blind) folded before Flop
Seat 4: Eddys Edge folded before Flop (didn't bet)
Seat 5: mdelfin0 collected ($0.25)
Seat 6: Bommer78 folded before Flop (didn't bet)



PokerStars Hand #166667653982:  Hold'em No Limit ($0.05/$0.10 USD) - 2017/02/23 16:05:05 ET
Table 'Ebella II' 6-max Seat #6 is the button
Seat 1: gaHy_HaXeP ($10 in chips) 
Seat 2: Therodorus ($10 in chips) 
Seat 3: Torften2 ($15.88 in chips) 
Seat 4: ValdemorS ($11.50 in chips) 
Seat 5: Bird et al ($10 in chips) 
Seat 6: Joker51_wtf! ($11.24 in chips) 
gaHy_HaXeP: posts small blind $0.05
Therodorus: posts big blind $0.10
*** HOLE CARDS ***
Torften2: calls $0.10
ValdemorS: folds 
Bird et al: folds 
Joker51_wtf!: folds 
gaHy_HaXeP: folds 
Therodorus: raises $0.45 to $0.55
Torften2: raises $15.33 to $15.88 and is all-in
Therodorus: folds 
Uncalled bet ($15.33) returned to Torften2
Torften2 collected $1.15 from pot
*** SUMMARY ***
Total pot $1.15 | Rake $0 
Seat 1: gaHy_HaXeP (small blind) folded before Flop
Seat 2: Therodorus (big blind) folded before Flop
Seat 3: Torften2 collected ($1.15)
Seat 4: ValdemorS folded before Flop (didn't bet)
Seat 5: Bird et al folded before Flop (didn't bet)
Seat 6: Joker51_wtf! (button) folded before Flop (didn't bet)



PokerStars Hand #166667654289:  Hold'em No Limit ($0.05/$0.10 USD) - 2017/02/23 16:05:06 ET
Table 'Hamal II' 6-max Seat #2 is the button
Seat 1: saxoalto2011 ($7.79 in chips) 
Seat 2: pancernik21 ($10 in chips) 
Seat 3: Cluckh ($11.29 in chips) 
Seat 4: ArcticBearDK ($10.81 in chips) 
Seat 5: eniksenik ($10.89 in chips) 
Seat 6: LarryTheStar ($11.54 in chips) 
Cluckh: posts small blind $0.05
ArcticBearDK: posts big blind $0.10
*** HOLE CARDS ***
eniksenik: folds 
LarryTheStar: folds 
saxoalto2011: folds 
pancernik21: raises $0.20 to $0.30
Cluckh: folds 
ArcticBearDK: folds 
Uncalled bet ($0.20) returned to pancernik21
pancernik21 collected $0.25 from pot
*** SUMMARY ***
Total pot $0.25 | Rake $0 
Seat 1: saxoalto2011 folded before Flop (didn't bet)
Seat 2: pancernik21 (button) collected ($0.25)
Seat 3: Cluckh (small blind) folded before Flop
Seat 4: ArcticBearDK (big blind) folded before Flop
Seat 5: eniksenik folded before Flop (didn't bet)
Seat 6: LarryTheStar folded before Flop (didn't bet)



PokerStars Hand #166667654399:  Hold'em No Limit ($0.05/$0.10 USD) - 2017/02/23 16:05:06 ET
Table 'Postrema' 6-max Seat #5 is the button
Seat 1: CHRO8 ($13.27 in chips) 
Seat 2: pancernik21 ($12.76 in chips) 
Seat 3: edcc19 ($2.81 in chips) 
Seat 4: ChuikaPridi ($13.93 in chips) 
Seat 5: Comeback3392 ($12.05 in chips) 
Seat 6: Scanner17 ($10 in chips) 
Scanner17: posts small blind $0.05
CHRO8: posts big blind $0.10
*** HOLE CARDS ***
pancernik21: folds 
edcc19: folds 
ChuikaPridi: raises $0.20 to $0.30
Comeback3392: folds 
Scanner17: folds 
CHRO8: raises $0.65 to $0.95
ChuikaPridi: folds 
Uncalled bet ($0.65) returned to CHRO8
CHRO8 collected $0.65 from pot
*** SUMMARY ***
Total pot $0.65 | Rake $0 
Seat 1: CHRO8 (big blind) collected ($0.65)
Seat 2: pancernik21 folded before Flop (didn't bet)
Seat 3: edcc19 folded before Flop (didn't bet)
Seat 4: ChuikaPridi folded before Flop
Seat 5: Comeback3392 (button) folded before Flop (didn't bet)
Seat 6: Scanner17 (small blind) folded before Flop



PokerStars Hand #166667654716:  Hold'em No Limit ($0.05/$0.10 USD) - 2017/02/23 16:05:06 ET
Table 'Hyakutake' 6-max Seat #5 is the button
Seat 1: Asilvagoat ($12.47 in chips) 
Seat 2: boxer821 ($10.79 in chips) 
Seat 3: lenboysprite ($5.94 in chips) 
Seat 4: eniksenik ($13.65 in chips) 
Seat 5: RoJ1 ($11.44 in chips) 
Seat 6: maxiv608 ($13.32 in chips) 
maxiv608: posts small blind $0.05
Asilvagoat: posts big blind $0.10
*** HOLE CARDS ***
boxer821: folds 
lenboysprite: folds 
eniksenik: raises $0.20 to $0.30
RoJ1: folds 
maxiv608: folds 
Asilvagoat: folds 
Uncalled bet ($0.20) returned to eniksenik
eniksenik collected $0.25 from pot
*** SUMMARY ***
Total pot $0.25 | Rake $0 
Seat 1: Asilvagoat (big blind) folded before Flop
Seat 2: boxer821 folded before Flop (didn't bet)
Seat 3: lenboysprite folded before Flop (didn't bet)
Seat 4: eniksenik collected ($0.25)
Seat 5: RoJ1 (button) folded before Flop (didn't bet)
Seat 6: maxiv608 (small blind) folded before Flop



PokerStars Hand #166667654766:  Hold'em No Limit ($0.05/$0.10 USD) - 2017/02/23 16:05:06 ET
Table 'Sham' 6-max Seat #6 is the button
Seat 1: pancernik21 ($10 in chips) 
Seat 2: ex3Lero86 ($10.45 in chips) 
Seat 3: weez3r ($22.68 in chips) 
Seat 4: VAD21 ($14.36 in chips) 
Seat 5: T9MS ($10.28 in chips) 
Seat 6: bdixon_5 ($8 in chips) 
pancernik21: posts small blind $0.05
ex3Lero86: posts big blind $0.10
*** HOLE CARDS ***
weez3r: folds 
VAD21: folds 
T9MS: folds 
bdixon_5: raises $0.20 to $0.30
pancernik21: folds 
ex3Lero86: folds 
Uncalled bet ($0.20) returned to bdixon_5
bdixon_5 collected $0.25 from pot
*** SUMMARY ***
Total pot $0.25 | Rake $0 
Seat 1: pancernik21 (small blind) folded before Flop
Seat 2: ex3Lero86 (big blind) folded before Flop
Seat 3: weez3r folded before Flop (didn't bet)
Seat 4: VAD21 folded before Flop (didn't bet)
Seat 5: T9MS folded before Flop (didn't bet)
Seat 6: bdixon_5 (button) collected ($0.25)



PokerStars Hand #166667654922:  Hold'em No Limit ($0.05/$0.10 USD) - 2017/02/23 16:05:06 ET
Table 'Krethon' 6-max Seat #1 is the button
Seat 1: boxer821 ($10.92 in chips) 
Seat 2: manashov ($12.11 in chips) 
Seat 3: D3NyA ($10 in chips) 
Seat 4: chimera252 ($14.79 in chips) 
Seat 5: popypaleta ($10.10 in chips) 
manashov: posts small blind $0.05
D3NyA: posts big blind $0.10
*** HOLE CARDS ***
chimera252: raises $0.20 to $0.30
popypaleta: folds 
boxer821: folds 
manashov: folds 
D3NyA: folds 
Uncalled bet ($0.20) returned to chimera252
chimera252 collected $0.25 from pot
*** SUMMARY ***
Total pot $0.25 | Rake $0 
Seat 1: boxer821 (button) folded before Flop (didn't bet)
Seat 2: manashov (small blind) folded before Flop
Seat 3: D3NyA (big blind) folded before Flop
Seat 4: chimera252 collected ($0.25)
Seat 5: popypaleta folded before Flop (didn't bet)



PokerStars Hand #166667655069:  Hold'em No Limit ($0.05/$0.10 USD) - 2017/02/23 16:05:07 ET
Table 'Markab II' 6-max Seat #2 is the button
Seat 1: david_sara83 ($10.67 in chips) 
Seat 2: truck1234 ($11.05 in chips) 
Seat 3: sexy_seagull ($10.05 in chips) 
Seat 4: Crafty23@PS ($11.69 in chips) 
Seat 5: Rodik002 ($19.17 in chips) 
Seat 6: Comeback3392 ($10 in chips) 
sexy_seagull: posts small blind $0.05
Crafty23@PS: posts big blind $0.10
*** HOLE CARDS ***
Rodik002: raises $0.20 to $0.30
Comeback3392: folds 
david_sara83: folds 
truck1234: folds 
sexy_seagull: folds 
Crafty23@PS: folds 
Uncalled bet ($0.20) returned to Rodik002
Rodik002 collected $0.25 from pot
*** SUMMARY ***
Total pot $0.25 | Rake $0 
Seat 1: david_sara83 folded before Flop (didn't bet)
Seat 2: truck1234 (button) folded before Flop (didn't bet)
Seat 3: sexy_seagull (small blind) folded before Flop
Seat 4: Crafty23@PS (big blind) folded before Flop
Seat 5: Rodik002 collected ($0.25)
Seat 6: Comeback3392 folded before Flop (didn't bet)



PokerStars Hand #166667655130:  Hold'em No Limit ($0.05/$0.10 USD) - 2017/02/23 16:05:07 ET
Table 'Kunigunde II' 6-max Seat #4 is the button
Seat 1: facewald ($9.94 in chips) 
Seat 3: pancernik21 ($14.93 in chips) 
Seat 4: david_sara83 ($12.83 in chips) 
Seat 5: mdelfin0 ($11.49 in chips) 
Seat 6: Zooplack ($10 in chips) 
mdelfin0: posts small blind $0.05
Zooplack: posts big blind $0.10
eniksenik: sits out 
*** HOLE CARDS ***
facewald: raises $0.19 to $0.29
pancernik21: raises $0.61 to $0.90
david_sara83: folds 
mdelfin0: folds 
Zooplack: folds 
facewald: calls $0.61
*** FLOP *** [Ts 6d 9c]
facewald: checks 
pancernik21: checks 
*** TURN *** [Ts 6d 9c] [Kh]
facewald: checks 
pancernik21: bets $1
facewald: calls $1
*** RIVER *** [Ts 6d 9c Kh] [Ac]
facewald: bets $2.10
pancernik21: calls $2.10
*** SHOW DOWN ***
facewald: shows [Kd Jd] (a pair of Kings)
pancernik21: shows [Jh As] (a pair of Aces)
pancernik21 collected $7.78 from pot
*** SUMMARY ***
Total pot $8.15 | Rake $0.37 
Board [Ts 6d 9c Kh Ac]
Seat 1: facewald showed [Kd Jd] and lost with a pair of Kings
Seat 3: pancernik21 showed [Jh As] and won ($7.78) with a pair of Aces
Seat 4: david_sara83 (button) folded before Flop (didn't bet)
Seat 5: mdelfin0 (small blind) folded before Flop
Seat 6: Zooplack (big blind) folded before Flop



PokerStars Hand #166667655145:  Hold'em No Limit ($0.05/$0.10 USD) - 2017/02/23 16:05:07 ET
Table 'Nekkar' 6-max Seat #5 is the button
Seat 2: Bird et al ($11.17 in chips) 
Seat 3: Zemz_Ru ($15.05 in chips) 
Seat 4: kingartur222 ($13.34 in chips) 
Seat 5: Vrinni ($11.55 in chips) 
Seat 6: Eddys Edge ($10.53 in chips) 
Eddys Edge: posts small blind $0.05
Bird et al: posts big blind $0.10
*** HOLE CARDS ***
Zemz_Ru: folds 
kingartur222: folds 
Vrinni: raises $0.15 to $0.25
Eddys Edge: folds 
Bird et al: folds 
Uncalled bet ($0.15) returned to Vrinni
Vrinni collected $0.25 from pot
*** SUMMARY ***
Total pot $0.25 | Rake $0 
Seat 2: Bird et al (big blind) folded before Flop
Seat 3: Zemz_Ru folded before Flop (didn't bet)
Seat 4: kingartur222 folded before Flop (didn't bet)
Seat 5: Vrinni (button) collected ($0.25)
Seat 6: Eddys Edge (small blind) folded before Flop



PokerStars Hand #166667655173:  Hold'em No Limit ($0.05/$0.10 USD) - 2017/02/23 16:05:07 ET
Table 'Apollonia' 6-max Seat #6 is the button
Seat 1: ex3Lero86 ($10.16 in chips) 
Seat 2: ibara000 ($18.58 in chips) 
Seat 4: Goroshkos88 ($17.72 in chips) 
Seat 5: EphemeralBen ($22 in chips) 
Seat 6: Namhkal ($10.25 in chips) 
ex3Lero86: posts small blind $0.05
ibara000: posts big blind $0.10
*** HOLE CARDS ***
Goroshkos88: folds 
EphemeralBen: raises $0.20 to $0.30
Namhkal: calls $0.30
steepfell joins the table at seat #3 
ex3Lero86: folds 
ibara000: folds 
*** FLOP *** [Qs 9d 4s]
EphemeralBen: bets $0.40
Namhkal: folds 
Uncalled bet ($0.40) returned to EphemeralBen
EphemeralBen collected $0.72 from pot
*** SUMMARY ***
Total pot $0.75 | Rake $0.03 
Board [Qs 9d 4s]
Seat 1: ex3Lero86 (small blind) folded before Flop
Seat 2: ibara000 (big blind) folded before Flop
Seat 4: Goroshkos88 folded before Flop (didn't bet)
Seat 5: EphemeralBen collected ($0.72)
Seat 6: Namhkal (button) folded on the Flop



PokerStars Hand #166667655578:  Hold'em No Limit ($0.05/$0.10 USD) - 2017/02/23 16:05:07 ET
Table 'Selinur' 6-max Seat #6 is the button
Seat 1: KA3AXCTAHEU, ($10 in chips) 
Seat 2: hoedje72 ($8.34 in chips) 
Seat 3: bambolejro ($11.07 in chips) 
Seat 4: freezing666 ($11.63 in chips) 
Seat 5: IAntikI ($10.37 in chips) 
Seat 6: homelessdan ($17.47 in chips) 
KA3AXCTAHEU,: posts small blind $0.05
hoedje72: posts big blind $0.10
*** HOLE CARDS ***
bambolejro: folds 
freezing666: folds 
IAntikI: raises $0.20 to $0.30
homelessdan: calls $0.30
KA3AXCTAHEU,: folds 
hoedje72: calls $0.20
*** FLOP *** [5c 4s 9c]
hoedje72: checks 
IAntikI: checks 
homelessdan: bets $0.50
hoedje72: folds 
IAntikI: folds 
Uncalled bet ($0.50) returned to homelessdan
homelessdan collected $0.91 from pot
*** SUMMARY ***
Total pot $0.95 | Rake $0.04 
Board [5c 4s 9c]
Seat 1: KA3AXCTAHEU, (small blind) folded before Flop
Seat 2: hoedje72 (big blind) folded on the Flop
Seat 3: bambolejro folded before Flop (didn't bet)
Seat 4: freezing666 folded before Flop (didn't bet)
Seat 5: IAntikI folded on the Flop
Seat 6: homelessdan (button) collected ($0.91)



PokerStars Hand #166667655946:  Hold'em No Limit ($0.05/$0.10 USD) - 2017/02/23 16:05:08 ET
Table 'Lagrula' 6-max Seat #5 is the button
Seat 1: Ice_Isayev ($10 in chips) 
Seat 3: micke667 ($15.82 in chips) 
Seat 4: Calimero2408 ($6.47 in chips) 
Seat 5: Iarlei ($10 in chips) 
Seat 6: Spud014 ($11.35 in chips) 
Spud014: posts small blind $0.05
Ice_Isayev: posts big blind $0.10
KRZuff: sits out 
*** HOLE CARDS ***
micke667: calls $0.10
Calimero2408: calls $0.10
Iarlei: calls $0.10
Spud014: raises $0.30 to $0.40
Ice_Isayev: folds 
micke667: calls $0.30
Calimero2408: calls $0.30
Iarlei: calls $0.30
*** FLOP *** [5s 2d 4s]
Spud014: bets $1.07
micke667: folds 
Calimero2408: calls $1.07
Iarlei: folds 
*** TURN *** [5s 2d 4s] [9h]
Spud014: bets $2.44
Calimero2408: calls $2.44
*** RIVER *** [5s 2d 4s 9h] [7h]
Spud014: checks 
Calimero2408: checks 
*** SHOW DOWN ***
Spud014: shows [7d 6d] (a pair of Sevens)
Calimero2408: shows [Ah Ad] (a pair of Aces)
Calimero2408 collected $8.33 from pot
*** SUMMARY ***
Total pot $8.72 | Rake $0.39 
Board [5s 2d 4s 9h 7h]
Seat 1: Ice_Isayev (big blind) folded before Flop
Seat 3: micke667 folded on the Flop
Seat 4: Calimero2408 showed [Ah Ad] and won ($8.33) with a pair of Aces
Seat 5: Iarlei (button) folded on the Flop
Seat 6: Spud014 (small blind) showed [7d 6d] and lost with a pair of Sevens



PokerStars Hand #166667656009:  Hold'em No Limit ($0.05/$0.10 USD) - 2017/02/23 16:05:08 ET
Table 'Hajek III' 6-max Seat #1 is the button
Seat 1: MBen10 ($10.60 in chips) 
Seat 2: fortieth ($10.09 in chips) 
Seat 3: fedorka rus ($10.76 in chips) 
Seat 4: NvR.m1nD ($13.39 in chips) 
Seat 5: Croplayer1 ($14.75 in chips) 
fortieth: posts small blind $0.05
fedorka rus: posts big blind $0.10
*** HOLE CARDS ***
NvR.m1nD: folds 
Croplayer1: raises $0.20 to $0.30
MBen10: folds 
fortieth: folds 
fedorka rus: folds 
Uncalled bet ($0.20) returned to Croplayer1
Croplayer1 collected $0.25 from pot
*** SUMMARY ***
Total pot $0.25 | Rake $0 
Seat 1: MBen10 (button) folded before Flop (didn't bet)
Seat 2: fortieth (small blind) folded before Flop
Seat 3: fedorka rus (big blind) folded before Flop
Seat 4: NvR.m1nD folded before Flop (didn't bet)
Seat 5: Croplayer1 collected ($0.25)



PokerStars Hand #166667656041:  Hold'em No Limit ($0.05/$0.10 USD) - 2017/02/23 16:05:08 ET
Table 'Marbachia II' 6-max Seat #6 is the button
Seat 1: AC Evergreen ($10.05 in chips) 
Seat 2: Yabidooo ($11.89 in chips) 
Seat 4: BahiaMinhaP ($10 in chips) 
Seat 5: MihaGr ($10 in chips) 
Seat 6: DamDatsAnAce ($10 in chips) 
AC Evergreen: posts small blind $0.05
Yabidooo: posts big blind $0.10
MisterX413: sits out 
*** HOLE CARDS ***
BahiaMinhaP: folds 
MihaGr: folds 
DamDatsAnAce: raises $0.15 to $0.25
AC Evergreen: folds 
Yabidooo: folds 
Uncalled bet ($0.15) returned to DamDatsAnAce
DamDatsAnAce collected $0.25 from pot
*** SUMMARY ***
Total pot $0.25 | Rake $0 
Seat 1: AC Evergreen (small blind) folded before Flop
Seat 2: Yabidooo (big blind) folded before Flop
Seat 4: BahiaMinhaP folded before Flop (didn't bet)
Seat 5: MihaGr folded before Flop (didn't bet)
Seat 6: DamDatsAnAce (button) collected ($0.25)



PokerStars Hand #166667656380:  Hold'em No Limit ($0.05/$0.10 USD) - 2017/02/23 16:05:08 ET
Table 'Nemo III' 6-max Seat #1 is the button
Seat 1: Kow6oy ($10 in chips) 
Seat 2: Bandyaev ($11.79 in chips) 
Seat 3: Dimka4 ($10 in chips) 
Seat 4: vtalian ($9.70 in chips) 
Seat 5: Joker51_wtf! ($11.43 in chips) 
Bandyaev: posts small blind $0.05
Dimka4: posts big blind $0.10
*** HOLE CARDS ***
maxiv608 joins the table at seat #6 
vtalian: folds 
Joker51_wtf!: folds 
Kow6oy: folds 
Bandyaev: folds 
Uncalled bet ($0.05) returned to Dimka4
Dimka4 collected $0.10 from pot
*** SUMMARY ***
Total pot $0.10 | Rake $0 
Seat 1: Kow6oy (button) folded before Flop (didn't bet)
Seat 2: Bandyaev (small blind) folded before Flop
Seat 3: Dimka4 (big blind) collected ($0.10)
Seat 4: vtalian folded before Flop (didn't bet)
Seat 5: Joker51_wtf! folded before Flop (didn't bet)



PokerStars Hand #166667656429:  Hold'em No Limit ($0.05/$0.10 USD) - 2017/02/23 16:05:08 ET
Table 'Rostia' 6-max Seat #6 is the button
Seat 1: paxit71 ($7.93 in chips) 
Seat 2: david_sara83 ($19.21 in chips) 
Seat 4: Hyd SK ($11.68 in chips) 
Seat 5: silsilviu ($7.05 in chips) 
Seat 6: Giyorod ($10.70 in chips) 
paxit71: posts small blind $0.05
david_sara83: posts big blind $0.10
iThreeBarrel: sits out 
*** HOLE CARDS ***
Hyd SK: folds 
silsilviu: raises $0.20 to $0.30
Giyorod: folds 
paxit71: folds 
david_sara83: calls $0.20
*** FLOP *** [Ts As 5d]
david_sara83: checks 
silsilviu: bets $0.41
david_sara83: folds 
Uncalled bet ($0.41) returned to silsilviu
silsilviu collected $0.62 from pot
*** SUMMARY ***
Total pot $0.65 | Rake $0.03 
Board [Ts As 5d]
Seat 1: paxit71 (small blind) folded before Flop
Seat 2: david_sara83 (big blind) folded on the Flop
Seat 4: Hyd SK folded before Flop (didn't bet)
Seat 5: silsilviu collected ($0.62)
Seat 6: Giyorod (button) folded before Flop (didn't bet)



PokerStars Hand #166667656688:  Hold'em No Limit ($0.05/$0.10 USD) - 2017/02/23 16:05:08 ET
Table 'Reginhild' 6-max Seat #3 is the button
Seat 1: iamkakaroto ($11.40 in chips) 
Seat 2: Kow6oy ($10 in chips) 
Seat 3: ARCHITECT83 ($6.39 in chips) 
Seat 4: Raymondo21 ($23.26 in chips) 
Seat 5: XCarlos610 ($29.93 in chips) 
Seat 6: eniksenik ($10 in chips) 
Raymondo21: posts small blind $0.05
XCarlos610: posts big blind $0.10
*** HOLE CARDS ***
eniksenik: raises $0.20 to $0.30
iamkakaroto: folds 
Kow6oy: folds 
ARCHITECT83: folds 
Raymondo21: calls $0.25
XCarlos610: folds 
*** FLOP *** [8h 4h 6s]
Raymondo21: bets $0.30
eniksenik: folds 
Uncalled bet ($0.30) returned to Raymondo21
Raymondo21 collected $0.67 from pot
*** SUMMARY ***
Total pot $0.70 | Rake $0.03 
Board [8h 4h 6s]
Seat 1: iamkakaroto folded before Flop (didn't bet)
Seat 2: Kow6oy folded before Flop (didn't bet)
Seat 3: ARCHITECT83 (button) folded before Flop (didn't bet)
Seat 4: Raymondo21 (small blind) collected ($0.67)
Seat 5: XCarlos610 (big blind) folded before Flop
Seat 6: eniksenik folded on the Flop



PokerStars Hand #166667656743:  Hold'em No Limit ($0.05/$0.10 USD) - 2017/02/23 16:05:08 ET
Table 'Heka II' 6-max Seat #1 is the button
Seat 1: Mamm0nism ($14.22 in chips) 
Seat 2: oddshoff ($11.47 in chips) 
Seat 3: MühliJr ($10.30 in chips) 
Seat 4: theNot0r1ous ($10.45 in chips) 
Seat 5: ArcticBearDK ($12.53 in chips) 
Seat 6: MonteCris92 ($10 in chips) 
oddshoff: posts small blind $0.05
MühliJr: posts big blind $0.10
*** HOLE CARDS ***
theNot0r1ous: folds 
ArcticBearDK: folds 
MonteCris92: folds 
Mamm0nism: raises $0.20 to $0.30
oddshoff: folds 
MühliJr: calls $0.20
*** FLOP *** [Qc Ah Ac]
MühliJr: checks 
Mamm0nism: bets $0.40
MühliJr: calls $0.40
*** TURN *** [Qc Ah Ac] [5c]
MühliJr: checks 
Mamm0nism: checks 
*** RIVER *** [Qc Ah Ac 5c] [Js]
MühliJr: checks 
Mamm0nism: bets $1.10
MühliJr: calls $1.10
*** SHOW DOWN ***
Mamm0nism: shows [Ts Ad] (three of a kind, Aces)
MühliJr: mucks hand 
Mamm0nism collected $3.49 from pot
*** SUMMARY ***
Total pot $3.65 | Rake $0.16 
Board [Qc Ah Ac 5c Js]
Seat 1: Mamm0nism (button) showed [Ts Ad] and won ($3.49) with three of a kind, Aces
Seat 2: oddshoff (small blind) folded before Flop
Seat 3: MühliJr (big blind) mucked
Seat 4: theNot0r1ous folded before Flop (didn't bet)
Seat 5: ArcticBearDK folded before Flop (didn't bet)
Seat 6: MonteCris92 folded before Flop (didn't bet)



PokerStars Hand #166667656889:  Hold'em No Limit ($0.05/$0.10 USD) - 2017/02/23 16:05:09 ET
Table 'Tomyris II' 6-max Seat #4 is the button
Seat 1: ArcticBearDK ($21.98 in chips) 
Seat 2: Yspenyanin ($12.39 in chips) 
Seat 3: robertsabb ($12.53 in chips) 
Seat 4: Dcaro31 ($10 in chips) 
Seat 5: 6ePeMeHHa9 ($10 in chips) 
Seat 6: StackSmakka ($11.59 in chips) 
6ePeMeHHa9: posts small blind $0.05
StackSmakka: posts big blind $0.10
*** HOLE CARDS ***
ArcticBearDK: folds 
Yspenyanin: folds 
robertsabb: calls $0.10
Dcaro31: folds 
6ePeMeHHa9: raises $0.30 to $0.40
StackSmakka: folds 
robertsabb: calls $0.30
*** FLOP *** [Ts 5h 4d]
6ePeMeHHa9: bets $0.65
robertsabb: folds 
Uncalled bet ($0.65) returned to 6ePeMeHHa9
6ePeMeHHa9 collected $0.86 from pot
*** SUMMARY ***
Total pot $0.90 | Rake $0.04 
Board [Ts 5h 4d]
Seat 1: ArcticBearDK folded before Flop (didn't bet)
Seat 2: Yspenyanin folded before Flop (didn't bet)
Seat 3: robertsabb folded on the Flop
Seat 4: Dcaro31 (button) folded before Flop (didn't bet)
Seat 5: 6ePeMeHHa9 (small blind) collected ($0.86)
Seat 6: StackSmakka (big blind) folded before Flop



PokerStars Hand #166667656981:  Hold'em No Limit ($0.05/$0.10 USD) - 2017/02/23 16:05:09 ET
Table 'Peiroos' 6-max Seat #2 is the button
Seat 1: ksandr_hom ($10 in chips) 
Seat 2: Nr847 ($10 in chips) 
Seat 3: atlx0711 ($26.67 in chips) 
Seat 4: Peter0087 ($10 in chips) 
Seat 5: sergio-cb164 ($9.10 in chips) 
Seat 6: DevonMiles88 ($4.91 in chips) 
atlx0711: posts small blind $0.05
Peter0087: posts big blind $0.10
*** HOLE CARDS ***
sergio-cb164: calls $0.10
DevonMiles88: calls $0.10
ksandr_hom: folds 
Nr847: folds 
atlx0711: raises $0.20 to $0.30
Peter0087: folds 
sergio-cb164: calls $0.20
DevonMiles88: calls $0.20
*** FLOP *** [Ah 5s 8s]
atlx0711: checks 
sergio-cb164: checks 
DevonMiles88: bets $0.90
atlx0711: folds 
sergio-cb164: folds 
Uncalled bet ($0.90) returned to DevonMiles88
DevonMiles88 collected $0.96 from pot
*** SUMMARY ***
Total pot $1 | Rake $0.04 
Board [Ah 5s 8s]
Seat 1: ksandr_hom folded before Flop (didn't bet)
Seat 2: Nr847 (button) folded before Flop (didn't bet)
Seat 3: atlx0711 (small blind) folded on the Flop
Seat 4: Peter0087 (big blind) folded before Flop
Seat 5: sergio-cb164 folded on the Flop
Seat 6: DevonMiles88 collected ($0.96)



PokerStars Hand #166667657051:  Hold'em No Limit ($0.05/$0.10 USD) - 2017/02/23 16:05:09 ET
Table 'Cassini' 6-max Seat #5 is the button
Seat 1: Pokeaster ($10.77 in chips) 
Seat 2: mhonielsen ($12.56 in chips) 
Seat 4: fortieth ($13.57 in chips) 
Seat 5: johkom ($7.55 in chips) 
Seat 6: JahSoldier69 ($10.22 in chips) 
JahSoldier69: posts small blind $0.05
Pokeaster: posts big blind $0.10
*** HOLE CARDS ***
mhonielsen: folds 
fortieth: folds 
johkom: folds 
JahSoldier69: folds 
Uncalled bet ($0.05) returned to Pokeaster
Pokeaster collected $0.10 from pot
*** SUMMARY ***
Total pot $0.10 | Rake $0 
Seat 1: Pokeaster (big blind) collected ($0.10)
Seat 2: mhonielsen folded before Flop (didn't bet)
Seat 4: fortieth folded before Flop (didn't bet)
Seat 5: johkom (button) folded before Flop (didn't bet)
Seat 6: JahSoldier69 (small blind) folded before Flop



PokerStars Hand #166667657111:  Hold'em No Limit ($0.05/$0.10 USD) - 2017/02/23 16:05:09 ET
Table 'Tyche III' 6-max Seat #5 is the button
Seat 1: milt65 ($10.31 in chips) 
Seat 3: ChuikaPridi ($10 in chips) 
Seat 4: Kazacha ($10 in chips) 
Seat 5: chimera252 ($12.90 in chips) 
Seat 6: Ice_Isayev ($10.05 in chips) 
Ice_Isayev: posts small blind $0.05
milt65: posts big blind $0.10
*** HOLE CARDS ***
ChuikaPridi: raises $0.20 to $0.30
Kazacha: folds 
chimera252: folds 
Ice_Isayev: folds 
milt65: calls $0.20
*** FLOP *** [Ac 5c 7s]
milt65: checks 
ChuikaPridi: bets $0.40
milt65: calls $0.40
*** TURN *** [Ac 5c 7s] [5d]
milt65: checks 
ChuikaPridi: bets $0.90
milt65: calls $0.90
*** RIVER *** [Ac 5c 7s 5d] [Ah]
milt65: bets $1.24
ChuikaPridi: raises $1.56 to $2.80
milt65: calls $1.56
*** SHOW DOWN ***
ChuikaPridi: shows [Ad Qs] (a full house, Aces full of Fives)
milt65: shows [As Jd] (a full house, Aces full of Fives)
milt65 collected $4.23 from pot
ChuikaPridi collected $4.22 from pot
*** SUMMARY ***
Total pot $8.85 | Rake $0.40 
Board [Ac 5c 7s 5d Ah]
Seat 1: milt65 (big blind) showed [As Jd] and won ($4.23) with a full house, Aces full of Fives
Seat 3: ChuikaPridi showed [Ad Qs] and won ($4.22) with a full house, Aces full of Fives
Seat 4: Kazacha folded before Flop (didn't bet)
Seat 5: chimera252 (button) folded before Flop (didn't bet)
Seat 6: Ice_Isayev (small blind) folded before Flop



PokerStars Hand #166667657206:  Hold'em No Limit ($0.05/$0.10 USD) - 2017/02/23 16:05:09 ET
Table 'Lobelia II' 6-max Seat #1 is the button
Seat 1: facewald ($21.07 in chips) 
Seat 2: Dcaro31 ($17.26 in chips) 
Seat 3: oddshoff ($19.40 in chips) 
Seat 5: Feverhead ($20.43 in chips) 
Seat 6: NvR.m1nD ($10.27 in chips) 
Dcaro31: posts small blind $0.05
oddshoff: posts big blind $0.10
*** HOLE CARDS ***
Feverhead: folds 
NvR.m1nD: folds 
facewald: raises $0.19 to $0.29
Dcaro31: folds 
oddshoff: folds 
Uncalled bet ($0.19) returned to facewald
facewald collected $0.25 from pot
*** SUMMARY ***
Total pot $0.25 | Rake $0 
Seat 1: facewald (button) collected ($0.25)
Seat 2: Dcaro31 (small blind) folded before Flop
Seat 3: oddshoff (big blind) folded before Flop
Seat 5: Feverhead folded before Flop (didn't bet)
Seat 6: NvR.m1nD folded before Flop (didn't bet)



PokerStars Hand #166667657335:  Hold'em No Limit ($0.05/$0.10 USD) - 2017/02/23 16:05:09 ET
Table 'Caupolican II' 6-max Seat #3 is the button
Seat 1: Strelok1974 ($10 in chips) 
Seat 2: MBen10 ($22.07 in chips) 
Seat 3: fedorka rus ($11.98 in chips) 
Seat 4: GESPERIA ($21.47 in chips) 
Seat 5: ArcticBearDK ($14.44 in chips) 
Seat 6: pancernik21 ($13.30 in chips) 
GESPERIA: posts small blind $0.05
ArcticBearDK: posts big blind $0.10
*** HOLE CARDS ***
pancernik21: folds 
Strelok1974: folds 
MBen10: folds 
fedorka rus: raises $0.10 to $0.20
GESPERIA: folds 
ArcticBearDK: folds 
Uncalled bet ($0.10) returned to fedorka rus
fedorka rus collected $0.25 from pot
*** SUMMARY ***
Total pot $0.25 | Rake $0 
Seat 1: Strelok1974 folded before Flop (didn't bet)
Seat 2: MBen10 folded before Flop (didn't bet)
Seat 3: fedorka rus (button) collected ($0.25)
Seat 4: GESPERIA (small blind) folded before Flop
Seat 5: ArcticBearDK (big blind) folded before Flop
Seat 6: pancernik21 folded before Flop (didn't bet)



PokerStars Hand #166667657678:  Hold'em No Limit ($0.05/$0.10 USD) - 2017/02/23 16:05:09 ET
Table 'Syringa II' 6-max Seat #2 is the button
Seat 1: GiveTwoMe ($13.87 in chips) 
Seat 2: Cluckh ($10.14 in chips) 
Seat 3: gaHy_HaXeP ($10.63 in chips) 
Seat 4: MBen10 ($10 in chips) 
Seat 5: Mishapok196 ($7.50 in chips) 
Seat 6: WinninBikini ($10.37 in chips) 
gaHy_HaXeP: posts small blind $0.05
MBen10: posts big blind $0.10
*** HOLE CARDS ***
Mishapok196: calls $0.10
WinninBikini: raises $0.40 to $0.50
GiveTwoMe: raises $1 to $1.50
Cluckh: folds 
gaHy_HaXeP: folds 
MBen10: folds 
Mishapok196: folds 
WinninBikini: calls $1
*** FLOP *** [4c 3c 3s]
WinninBikini: checks 
GiveTwoMe: bets $1.55
WinninBikini: folds 
Uncalled bet ($1.55) returned to GiveTwoMe
GiveTwoMe collected $3.10 from pot
*** SUMMARY ***
Total pot $3.25 | Rake $0.15 
Board [4c 3c 3s]
Seat 1: GiveTwoMe collected ($3.10)
Seat 2: Cluckh (button) folded before Flop (didn't bet)
Seat 3: gaHy_HaXeP (small blind) folded before Flop
Seat 4: MBen10 (big blind) folded before Flop
Seat 5: Mishapok196 folded before Flop
Seat 6: WinninBikini folded on the Flop



PokerStars Hand #166667657875:  Hold'em No Limit ($0.05/$0.10 USD) - 2017/02/23 16:05:10 ET
Table 'Aisakos II' 6-max Seat #5 is the button
Seat 1: Crafty23@PS ($10.30 in chips) 
Seat 2: svaika24 ($17.08 in chips) 
Seat 3: iamkakaroto ($10.54 in chips) 
Seat 4: T9MS ($10 in chips) 
Seat 5: KokoulinV ($12.25 in chips) 
Seat 6: LarryTheStar ($10.05 in chips) 
LarryTheStar: posts small blind $0.05
Crafty23@PS: posts big blind $0.10
*** HOLE CARDS ***
svaika24: folds 
iamkakaroto: folds 
T9MS: folds 
KokoulinV: raises $0.10 to $0.20
LarryTheStar: folds 
Crafty23@PS: raises $0.70 to $0.90
KokoulinV: folds 
Uncalled bet ($0.70) returned to Crafty23@PS
Crafty23@PS collected $0.45 from pot
*** SUMMARY ***
Total pot $0.45 | Rake $0 
Seat 1: Crafty23@PS (big blind) collected ($0.45)
Seat 2: svaika24 folded before Flop (didn't bet)
Seat 3: iamkakaroto folded before Flop (didn't bet)
Seat 4: T9MS folded before Flop (didn't bet)
Seat 5: KokoulinV (button) folded before Flop
Seat 6: LarryTheStar (small blind) folded before Flop



PokerStars Hand #166667657923:  Hold'em No Limit ($0.05/$0.10 USD) - 2017/02/23 16:05:10 ET
Table 'Esperanto II' 6-max Seat #4 is the button
Seat 1: kurasd ($11.10 in chips) 
Seat 2: MihaGr ($10.04 in chips) 
Seat 3: Namhkal ($12.10 in chips) 
Seat 4: Andrei ProFF ($10.45 in chips) 
Seat 5: FRAID358 ($9.90 in chips) 
Seat 6: ArcticBearDK ($12.73 in chips) 
FRAID358: posts small blind $0.05
ArcticBearDK: posts big blind $0.10
*** HOLE CARDS ***
kurasd: folds 
MihaGr: folds 
Namhkal: folds 
Andrei ProFF: raises $0.15 to $0.25
FRAID358: folds 
ArcticBearDK: raises $0.75 to $1
Andrei ProFF: folds 
Uncalled bet ($0.75) returned to ArcticBearDK
ArcticBearDK collected $0.55 from pot
*** SUMMARY ***
Total pot $0.55 | Rake $0 
Seat 1: kurasd folded before Flop (didn't bet)
Seat 2: MihaGr folded before Flop (didn't bet)
Seat 3: Namhkal folded before Flop (didn't bet)
Seat 4: Andrei ProFF (button) folded before Flop
Seat 5: FRAID358 (small blind) folded before Flop
Seat 6: ArcticBearDK (big blind) collected ($0.55)



PokerStars Hand #166667657976:  Hold'em No Limit ($0.05/$0.10 USD) - 2017/02/23 16:05:10 ET
Table 'Aegle' 6-max Seat #1 is the button
Seat 1: phatts76 ($3.90 in chips) 
Seat 2: yodzik ($5 in chips) 
Seat 3: DrejAtom ($12.74 in chips) 
Seat 4: ab260414 ($10.37 in chips) 
Seat 5: KokoulinV ($10.98 in chips) 
Seat 6: CHRO8 ($20.44 in chips) 
yodzik: posts small blind $0.05
DrejAtom: posts big blind $0.10
*** HOLE CARDS ***
ab260414: folds 
KokoulinV: raises $0.15 to $0.25
CHRO8: folds 
phatts76: folds 
yodzik: folds 
DrejAtom: calls $0.15
*** FLOP *** [8d Ts 7c]
DrejAtom: checks 
KokoulinV: bets $0.35
DrejAtom: folds 
Uncalled bet ($0.35) returned to KokoulinV
KokoulinV collected $0.53 from pot
*** SUMMARY ***
Total pot $0.55 | Rake $0.02 
Board [8d Ts 7c]
Seat 1: phatts76 (button) folded before Flop (didn't bet)
Seat 2: yodzik (small blind) folded before Flop
Seat 3: DrejAtom (big blind) folded on the Flop
Seat 4: ab260414 folded before Flop (didn't bet)
Seat 5: KokoulinV collected ($0.53)
Seat 6: CHRO8 folded before Flop (didn't bet)



PokerStars Hand #166667658011:  Hold'em No Limit ($0.05/$0.10 USD) - 2017/02/23 16:05:10 ET
Table 'Thia' 6-max Seat #1 is the button
Seat 1: Eddys Edge ($10.37 in chips) 
Seat 2: sugrob86 ($19.40 in chips) 
Seat 3: northug18 ($9.39 in chips) 
Seat 4: Bandyaev ($10.35 in chips) 
Seat 5: ab260414 ($10.57 in chips) 
Seat 6: ex3Lero86 ($15.45 in chips) 
sugrob86: posts small blind $0.05
northug18: posts big blind $0.10
*** HOLE CARDS ***
Bandyaev: folds 
ab260414: folds 
ex3Lero86: folds 
Eddys Edge: raises $0.10 to $0.20
sugrob86: folds 
northug18: calls $0.10
*** FLOP *** [Ah 4d Tc]
northug18: checks 
Eddys Edge: checks 
*** TURN *** [Ah 4d Tc] [Kd]
northug18: checks 
Eddys Edge: bets $0.30
northug18: calls $0.30
*** RIVER *** [Ah 4d Tc Kd] [2c]
northug18: checks 
Eddys Edge: bets $0.50
northug18: folds 
Uncalled bet ($0.50) returned to Eddys Edge
Eddys Edge collected $1 from pot
*** SUMMARY ***
Total pot $1.05 | Rake $0.05 
Board [Ah 4d Tc Kd 2c]
Seat 1: Eddys Edge (button) collected ($1)
Seat 2: sugrob86 (small blind) folded before Flop
Seat 3: northug18 (big blind) folded on the River
Seat 4: Bandyaev folded before Flop (didn't bet)
Seat 5: ab260414 folded before Flop (didn't bet)
Seat 6: ex3Lero86 folded before Flop (didn't bet)



PokerStars Hand #166667658303:  Hold'em No Limit ($0.05/$0.10 USD) - 2017/02/23 16:05:10 ET
Table 'Emma II' 6-max Seat #5 is the button
Seat 1: LarryTheStar ($10 in chips) 
Seat 2: T9MS ($11.79 in chips) 
Seat 3: oddshoff ($9.52 in chips) 
Seat 4: Jucatorul823 ($5.82 in chips) 
Seat 5: Scanner17 ($11.36 in chips) 
Seat 6: CHRO8 ($14.72 in chips) 
CHRO8: posts small blind $0.05
LarryTheStar: posts big blind $0.10
*** HOLE CARDS ***
T9MS: folds 
oddshoff: folds 
Jucatorul823: raises $0.20 to $0.30
Scanner17: calls $0.30
CHRO8: folds 
LarryTheStar: folds 
*** FLOP *** [8c 4s Kc]
Jucatorul823: bets $0.50
Scanner17: folds 
Uncalled bet ($0.50) returned to Jucatorul823
Jucatorul823 collected $0.72 from pot
*** SUMMARY ***
Total pot $0.75 | Rake $0.03 
Board [8c 4s Kc]
Seat 1: LarryTheStar (big blind) folded before Flop
Seat 2: T9MS folded before Flop (didn't bet)
Seat 3: oddshoff folded before Flop (didn't bet)
Seat 4: Jucatorul823 collected ($0.72)
Seat 5: Scanner17 (button) folded on the Flop
Seat 6: CHRO8 (small blind) folded before Flop



PokerStars Hand #166667658365:  Hold'em No Limit ($0.05/$0.10 USD) - 2017/02/23 16:05:10 ET
Table 'Grietje' 6-max Seat #5 is the button
Seat 1: dragonste89 ($10 in chips) 
Seat 2: Feverhead ($12.72 in chips) 
Seat 4: MihaGr ($10.50 in chips) 
Seat 5: iThreeBarrel ($10 in chips) 
Seat 6: Prometheu$8 ($21.60 in chips) 
Prometheu$8: posts small blind $0.05
dragonste89: posts big blind $0.10
*** HOLE CARDS ***
GitoValdivia joins the table at seat #3 
Feverhead: folds 
MihaGr: folds 
iThreeBarrel: raises $0.15 to $0.25
Prometheu$8: folds 
dragonste89: folds 
Uncalled bet ($0.15) returned to iThreeBarrel
iThreeBarrel collected $0.25 from pot
*** SUMMARY ***
Total pot $0.25 | Rake $0 
Seat 1: dragonste89 (big blind) folded before Flop
Seat 2: Feverhead folded before Flop (didn't bet)
Seat 4: MihaGr folded before Flop (didn't bet)
Seat 5: iThreeBarrel (button) collected ($0.25)
Seat 6: Prometheu$8 (small blind) folded before Flop



PokerStars Hand #166667658366:  Hold'em No Limit ($0.05/$0.10 USD) - 2017/02/23 16:05:10 ET
Table 'Phereclos II' 6-max Seat #1 is the button
Seat 1: Croplayer1 ($10 in chips) 
Seat 2: Kazacha ($10.18 in chips) 
Seat 4: DamDatsAnAce ($10.53 in chips) 
Seat 6: mhonielsen ($16.30 in chips) 
Kazacha: posts small blind $0.05
kickereens: is sitting out 
kickereens leaves the table
DamDatsAnAce: posts big blind $0.10
crazydevill: sits out 
*** HOLE CARDS ***
mhonielsen: folds 
BJamesB2014 joins the table at seat #3 
Croplayer1: folds 
Kazacha: folds 
Uncalled bet ($0.05) returned to DamDatsAnAce
DamDatsAnAce collected $0.10 from pot
*** SUMMARY ***
Total pot $0.10 | Rake $0 
Seat 1: Croplayer1 (button) folded before Flop (didn't bet)
Seat 2: Kazacha (small blind) folded before Flop
Seat 4: DamDatsAnAce (big blind) collected ($0.10)
Seat 6: mhonielsen folded before Flop (didn't bet)



PokerStars Hand #166667658536:  Hold'em No Limit ($0.05/$0.10 USD) - 2017/02/23 16:05:10 ET
Table 'Pompeja III' 6-max Seat #3 is the button
Seat 1: Iarlei ($12.04 in chips) 
Seat 2: steepfell ($10 in chips) 
Seat 3: Yspenyanin ($11.85 in chips) 
Seat 4: Cluckh ($13.77 in chips) 
Seat 5: Spud014 ($12.14 in chips) 
Seat 6: mega spasser ($4.95 in chips) 
Cluckh: posts small blind $0.05
Spud014: posts big blind $0.10
*** HOLE CARDS ***
mega spasser: folds 
Iarlei: folds 
steepfell: folds 
Yspenyanin: folds 
Cluckh: raises $0.20 to $0.30
Spud014: folds 
Uncalled bet ($0.20) returned to Cluckh
Cluckh collected $0.20 from pot
*** SUMMARY ***
Total pot $0.20 | Rake $0 
Seat 1: Iarlei folded before Flop (didn't bet)
Seat 2: steepfell folded before Flop (didn't bet)
Seat 3: Yspenyanin (button) folded before Flop (didn't bet)
Seat 4: Cluckh (small blind) collected ($0.20)
Seat 5: Spud014 (big blind) folded before Flop
Seat 6: mega spasser folded before Flop (didn't bet)



PokerStars Hand #166667658585:  Hold'em No Limit ($0.05/$0.10 USD) - 2017/02/23 16:05:10 ET
Table 'Armenia' 6-max Seat #3 is the button
Seat 1: tr41n3r12 ($12.02 in chips) 
Seat 2: Yabidooo ($11.72 in chips) 
Seat 3: XwinX25 ($10 in chips) 
Seat 5: boxer821 ($12.33 in chips) 
Seat 6: mega spasser ($6.36 in chips) 
boxer821: posts small blind $0.05
mega spasser: posts big blind $0.10
*** HOLE CARDS ***
tr41n3r12: folds 
Yabidooo: folds 
XwinX25: raises $0.15 to $0.25
boxer821: folds 
mega spasser: folds 
Uncalled bet ($0.15) returned to XwinX25
XwinX25 collected $0.25 from pot
*** SUMMARY ***
Total pot $0.25 | Rake $0 
Seat 1: tr41n3r12 folded before Flop (didn't bet)
Seat 2: Yabidooo folded before Flop (didn't bet)
Seat 3: XwinX25 (button) collected ($0.25)
Seat 5: boxer821 (small blind) folded before Flop
Seat 6: mega spasser (big blind) folded before Flop



PokerStars Hand #166667658604:  Hold'em No Limit ($0.05/$0.10 USD) - 2017/02/23 16:05:10 ET
Table 'Wesselink II' 6-max Seat #1 is the button
Seat 1: vladcol ($5.07 in chips) 
Seat 2: KRZuff ($10 in chips) 
Seat 3: Wargolandros ($9.07 in chips) 
Seat 4: BahiaMinhaP ($10.98 in chips) 
Seat 6: bambolejro ($10.32 in chips) 
KRZuff: posts small blind $0.05
Wargolandros: posts big blind $0.10
*** HOLE CARDS ***
BahiaMinhaP: folds 
bambolejro: folds 
vladcol: calls $0.10
KRZuff: folds 
Wargolandros: checks 
*** FLOP *** [Qs Th 3h]
Wargolandros: checks 
vladcol: checks 
*** TURN *** [Qs Th 3h] [5s]
Wargolandros: checks 
vladcol: bets $0.20
Wargolandros: folds 
Uncalled bet ($0.20) returned to vladcol
vladcol collected $0.24 from pot
*** SUMMARY ***
Total pot $0.25 | Rake $0.01 
Board [Qs Th 3h 5s]
Seat 1: vladcol (button) collected ($0.24)
Seat 2: KRZuff (small blind) folded before Flop
Seat 3: Wargolandros (big blind) folded on the Turn
Seat 4: BahiaMinhaP folded before Flop (didn't bet)
Seat 6: bambolejro folded before Flop (didn't bet)



PokerStars Hand #166667658765:  Hold'em No Limit ($0.05/$0.10 USD) - 2017/02/23 16:05:11 ET
Table 'Stroobantia' 6-max Seat #3 is the button
Seat 1: mam9zyc ($8.59 in chips) 
Seat 2: XwinX25 ($10 in chips) 
Seat 3: Namhkal ($10 in chips) 
Seat 4: Yspenyanin ($10.03 in chips) 
Seat 5: boxer821 ($11.39 in chips) 
Seat 6: KokoulinV ($15.82 in chips) 
Yspenyanin: posts small blind $0.05
boxer821: posts big blind $0.10
*** HOLE CARDS ***
KokoulinV: folds 
mam9zyc: folds 
XwinX25: raises $0.20 to $0.30
Namhkal: folds 
Yspenyanin: folds 
boxer821: folds 
Uncalled bet ($0.20) returned to XwinX25
XwinX25 collected $0.25 from pot
*** SUMMARY ***
Total pot $0.25 | Rake $0 
Seat 1: mam9zyc folded before Flop (didn't bet)
Seat 2: XwinX25 collected ($0.25)
Seat 3: Namhkal (button) folded before Flop (didn't bet)
Seat 4: Yspenyanin (small blind) folded before Flop
Seat 5: boxer821 (big blind) folded before Flop
Seat 6: KokoulinV folded before Flop (didn't bet)



PokerStars Hand #166667658882:  Hold'em No Limit ($0.05/$0.10 USD) - 2017/02/23 16:05:11 ET
Table 'Brendelia II' 6-max Seat #6 is the button
Seat 2: Crimsonr ($5.06 in chips) 
Seat 3: ValdemorS ($18.98 in chips) 
Seat 6: luckyPositiv ($10.17 in chips) 
Crimsonr: posts small blind $0.05
ValdemorS: posts big blind $0.10
Crimsonr: posts the ante $0.02
ValdemorS: posts the ante $0.02
luckyPositiv: posts the ante $0.02
*** HOLE CARDS ***
luckyPositiv: folds 
Crimsonr: raises $0.30 to $0.40
ValdemorS: folds 
Uncalled bet ($0.30) returned to Crimsonr
Crimsonr collected $0.26 from pot
*** SUMMARY ***
Total pot $0.26 | Rake $0 
Seat 2: Crimsonr (small blind) collected ($0.26)
Seat 3: ValdemorS (big blind) folded before Flop
Seat 6: luckyPositiv (button) folded before Flop (didn't bet)



PokerStars Hand #166667659161:  Hold'em No Limit ($0.05/$0.10 USD) - 2017/02/23 16:05:11 ET
Table 'Nephthys II' 6-max Seat #1 is the button
Seat 1: DamDatsAnAce ($10 in chips) 
Seat 3: Newqbrown ($22.16 in chips) 
Seat 4: MihaGr ($10 in chips) 
Seat 5: kingartur222 ($8.76 in chips) 
Seat 6: CHRO8 ($14.34 in chips) 
Newqbrown: posts small blind $0.05
MihaGr: posts big blind $0.10
*** HOLE CARDS ***
kingartur222: folds 
CHRO8: folds 
DamDatsAnAce: raises $0.15 to $0.25
Newqbrown: calls $0.20
MihaGr: folds 
*** FLOP *** [7c 8s 7s]
Newqbrown: checks 
DamDatsAnAce: bets $0.35
steepfell joins the table at seat #2 
Newqbrown: calls $0.35
*** TURN *** [7c 8s 7s] [6h]
steepfell leaves the table
Newqbrown: checks 
DamDatsAnAce: bets $0.80
Newqbrown: calls $0.80
*** RIVER *** [7c 8s 7s 6h] [Qc]
Newqbrown: checks 
DamDatsAnAce: checks 
Ju$tD0it joins the table at seat #2 
*** SHOW DOWN ***
Newqbrown: shows [5c 6s] (two pair, Sevens and Sixes)
DamDatsAnAce: shows [8h Ks] (two pair, Eights and Sevens)
DamDatsAnAce collected $2.77 from pot
*** SUMMARY ***
Total pot $2.90 | Rake $0.13 
Board [7c 8s 7s 6h Qc]
Seat 1: DamDatsAnAce (button) showed [8h Ks] and won ($2.77) with two pair, Eights and Sevens
Seat 3: Newqbrown (small blind) showed [5c 6s] and lost with two pair, Sevens and Sixes
Seat 4: MihaGr (big blind) folded before Flop
Seat 5: kingartur222 folded before Flop (didn't bet)
Seat 6: CHRO8 folded before Flop (didn't bet)



PokerStars Hand #166667659591:  Hold'em No Limit ($0.05/$0.10 USD) - 2017/02/23 16:05:11 ET
Table 'Atalante' 6-max Seat #3 is the button
Seat 1: OceanBlue100 ($5.09 in chips) 
Seat 2: CiisCi ($19.77 in chips) 
Seat 3: Kow6oy ($10 in chips) 
Seat 4: Dcaro31 ($24.97 in chips) 
Seat 5: eniksenik ($10.44 in chips) 
Seat 6: FlopsterGB ($30.38 in chips) 
Dcaro31: posts small blind $0.05
eniksenik: posts big blind $0.10
*** HOLE CARDS ***
FlopsterGB: folds 
OceanBlue100: folds 
CiisCi: raises $0.15 to $0.25
Kow6oy: folds 
Dcaro31: folds 
eniksenik: calls $0.15
*** FLOP *** [7s 6d 5s]
eniksenik: checks 
CiisCi: bets $0.35
eniksenik: folds 
Uncalled bet ($0.35) returned to CiisCi
CiisCi collected $0.53 from pot
*** SUMMARY ***
Total pot $0.55 | Rake $0.02 
Board [7s 6d 5s]
Seat 1: OceanBlue100 folded before Flop (didn't bet)
Seat 2: CiisCi collected ($0.53)
Seat 3: Kow6oy (button) folded before Flop (didn't bet)
Seat 4: Dcaro31 (small blind) folded before Flop
Seat 5: eniksenik (big blind) folded on the Flop
Seat 6: FlopsterGB folded before Flop (didn't bet)



PokerStars Hand #166667659651:  Hold'em No Limit ($0.05/$0.10 USD) - 2017/02/23 16:05:12 ET
Table 'Klotho II' 6-max Seat #4 is the button
Seat 2: kickereens ($10.05 in chips) 
Seat 3: Zooplack ($10.58 in chips) 
Seat 4: Lucky HoBBiT ($10 in chips) 
Seat 5: david_sara83 ($16.11 in chips) 
Seat 6: D3NyA ($11.57 in chips) 
david_sara83: posts small blind $0.05
D3NyA: posts big blind $0.10
*** HOLE CARDS ***
kickereens: folds 
Zooplack: raises $0.15 to $0.25
KRZuff joins the table at seat #1 
Lucky HoBBiT: calls $0.25
david_sara83: folds 
D3NyA: folds 
*** FLOP *** [Ad 7d 8d]
Zooplack: bets $0.37
KRZuff leaves the table
Lucky HoBBiT: calls $0.37
*** TURN *** [Ad 7d 8d] [Td]
Kow6oy joins the table at seat #1 
Kow6oy leaves the table
Zooplack: checks 
Asilvagoat joins the table at seat #1 
Asilvagoat leaves the table
Lucky HoBBiT: bets $0.74
Zooplack: folds 
Uncalled bet ($0.74) returned to Lucky HoBBiT
Lucky HoBBiT collected $1.33 from pot
*** SUMMARY ***
Total pot $1.39 | Rake $0.06 
Board [Ad 7d 8d Td]
Seat 2: kickereens folded before Flop (didn't bet)
Seat 3: Zooplack folded on the Turn
Seat 4: Lucky HoBBiT (button) collected ($1.33)
Seat 5: david_sara83 (small blind) folded before Flop
Seat 6: D3NyA (big blind) folded before Flop



PokerStars Hand #166667659738:  Hold'em No Limit ($0.05/$0.10 USD) - 2017/02/23 16:05:12 ET
Table 'Gyldenia II' 6-max Seat #5 is the button
Seat 1: KokoulinV ($10.40 in chips) 
Seat 2: Bandyaev ($11.09 in chips) 
Seat 3: ex3Lero86 ($23.52 in chips) 
Seat 5: CHRO8 ($15.57 in chips) 
Seat 6: 8th wonders ($11.58 in chips) 
8th wonders: posts small blind $0.05
KokoulinV: posts big blind $0.10
*** HOLE CARDS ***
Bandyaev: folds 
ex3Lero86: raises $0.15 to $0.25
CHRO8: folds 
8th wonders: folds 
KokoulinV: folds 
Uncalled bet ($0.15) returned to ex3Lero86
ex3Lero86 collected $0.25 from pot
*** SUMMARY ***
Total pot $0.25 | Rake $0 
Seat 1: KokoulinV (big blind) folded before Flop
Seat 2: Bandyaev folded before Flop (didn't bet)
Seat 3: ex3Lero86 collected ($0.25)
Seat 5: CHRO8 (button) folded before Flop (didn't bet)
Seat 6: 8th wonders (small blind) folded before Flop



PokerStars Hand #166667659907:  Hold'em No Limit ($0.05/$0.10 USD) - 2017/02/23 16:05:12 ET
Table 'Arkab' 6-max Seat #1 is the button
Seat 1: iamkakaroto ($10 in chips) 
Seat 2: aktion4ik ($12.29 in chips) 
Seat 3: sexy_seagull ($10 in chips) 
Seat 4: donkucallme ($17.49 in chips) 
Seat 5: OrionYusupov ($9.44 in chips) 
Seat 6: MihaGr ($10.63 in chips) 
aktion4ik: posts small blind $0.05
sexy_seagull: posts big blind $0.10
*** HOLE CARDS ***
donkucallme: folds 
OrionYusupov: folds 
MihaGr: raises $0.20 to $0.30
iamkakaroto: folds 
aktion4ik: folds 
sexy_seagull: folds 
Uncalled bet ($0.20) returned to MihaGr
MihaGr collected $0.25 from pot
*** SUMMARY ***
Total pot $0.25 | Rake $0 
Seat 1: iamkakaroto (button) folded before Flop (didn't bet)
Seat 2: aktion4ik (small blind) folded before Flop
Seat 3: sexy_seagull (big blind) folded before Flop
Seat 4: donkucallme folded before Flop (didn't bet)
Seat 5: OrionYusupov folded before Flop (didn't bet)
Seat 6: MihaGr collected ($0.25)



PokerStars Hand #166667660143:  Hold'em No Limit ($0.05/$0.10 USD) - 2017/02/23 16:05:12 ET
Table 'Deflotte' 6-max Seat #4 is the button
Seat 1: Zooplack ($15.79 in chips) 
Seat 2: MonteCris92 ($10.23 in chips) 
Seat 3: Croplayer1 ($10 in chips) 
Seat 4: 8th wonders ($10.17 in chips) 
Seat 5: Pokeaster ($11.37 in chips) 
Seat 6: Iarlei ($12 in chips) 
Pokeaster: posts small blind $0.05
Iarlei: posts big blind $0.10
*** HOLE CARDS ***
Zooplack: folds 
MonteCris92: folds 
Croplayer1: raises $0.15 to $0.25
8th wonders: folds 
Pokeaster: folds 
Iarlei: folds 
Uncalled bet ($0.15) returned to Croplayer1
Croplayer1 collected $0.25 from pot
*** SUMMARY ***
Total pot $0.25 | Rake $0 
Seat 1: Zooplack folded before Flop (didn't bet)
Seat 2: MonteCris92 folded before Flop (didn't bet)
Seat 3: Croplayer1 collected ($0.25)
Seat 4: 8th wonders (button) folded before Flop (didn't bet)
Seat 5: Pokeaster (small blind) folded before Flop
Seat 6: Iarlei (big blind) folded before Flop



PokerStars Hand #166667660197:  Hold'em No Limit ($0.05/$0.10 USD) - 2017/02/23 16:05:12 ET
Table 'Siebohme II' 6-max Seat #2 is the button
Seat 1: homelessdan ($17.82 in chips) 
Seat 2: townerz1991 ($14.17 in chips) 
Seat 3: D3NyA ($10.23 in chips) 
Seat 4: POT_TRADER ($12.29 in chips) 
Seat 5: NvR.m1nD ($10.37 in chips) 
Seat 6: Fozzy690 ($10.14 in chips) 
D3NyA: posts small blind $0.05
POT_TRADER: posts big blind $0.10
*** HOLE CARDS ***
NvR.m1nD: folds 
Fozzy690: folds 
homelessdan: raises $0.20 to $0.30
townerz1991: folds 
D3NyA: folds 
POT_TRADER: folds 
Uncalled bet ($0.20) returned to homelessdan
homelessdan collected $0.25 from pot
*** SUMMARY ***
Total pot $0.25 | Rake $0 
Seat 1: homelessdan collected ($0.25)
Seat 2: townerz1991 (button) folded before Flop (didn't bet)
Seat 3: D3NyA (small blind) folded before Flop
Seat 4: POT_TRADER (big blind) folded before Flop
Seat 5: NvR.m1nD folded before Flop (didn't bet)
Seat 6: Fozzy690 folded before Flop (didn't bet)



PokerStars Hand #166667660222:  Hold'em No Limit ($0.05/$0.10 USD) - 2017/02/23 16:05:12 ET
Table 'Vaisala' 6-max Seat #2 is the button
Seat 2: XaXaTyH4uK ($12.14 in chips) 
Seat 3: x3ultimate ($10.15 in chips) 
Seat 4: sexy_seagull ($11.53 in chips) 
Seat 5: AIONCMA1988 ($3.80 in chips) 
Seat 6: Aleksey K228 ($15.28 in chips) 
x3ultimate: posts small blind $0.05
sexy_seagull: posts big blind $0.10
*** HOLE CARDS ***
AIONCMA1988: folds 
Aleksey K228: raises $0.20 to $0.30
XaXaTyH4uK: folds 
x3ultimate: folds 
sexy_seagull: folds 
Uncalled bet ($0.20) returned to Aleksey K228
Aleksey K228 collected $0.25 from pot
*** SUMMARY ***
Total pot $0.25 | Rake $0 
Seat 2: XaXaTyH4uK (button) folded before Flop (didn't bet)
Seat 3: x3ultimate (small blind) folded before Flop
Seat 4: sexy_seagull (big blind) folded before Flop
Seat 5: AIONCMA1988 folded before Flop (didn't bet)
Seat 6: Aleksey K228 collected ($0.25)



PokerStars Hand #166667660274:  Hold'em No Limit ($0.05/$0.10 USD) - 2017/02/23 16:05:12 ET
Table 'Manto II' 6-max Seat #4 is the button
Seat 1: MihaGr ($10 in chips) 
Seat 2: voledy ($10 in chips) 
Seat 3: Komap511 ($10.42 in chips) 
Seat 4: dr.goofy ($10.27 in chips) 
Seat 5: ArcticBearDK ($32.59 in chips) 
Seat 6: pancernik21 ($16.35 in chips) 
ArcticBearDK: posts small blind $0.05
pancernik21: posts big blind $0.10
*** HOLE CARDS ***
MihaGr: folds 
voledy: folds 
Komap511: raises $0.20 to $0.30
dr.goofy: calls $0.30
ArcticBearDK: folds 
pancernik21: folds 
*** FLOP *** [5s 6s 9c]
Komap511: bets $0.40
dr.goofy: calls $0.40
*** TURN *** [5s 6s 9c] [5h]
Komap511: bets $1.10
dr.goofy: calls $1.10
*** RIVER *** [5s 6s 9c 5h] [Qs]
Komap511: bets $3.20
dr.goofy: calls $3.20
*** SHOW DOWN ***
Komap511: shows [3h 8h] (a pair of Fives)
dr.goofy: shows [9s Ts] (a flush, Queen high)
dr.goofy collected $9.69 from pot
*** SUMMARY ***
Total pot $10.15 | Rake $0.46 
Board [5s 6s 9c 5h Qs]
Seat 1: MihaGr folded before Flop (didn't bet)
Seat 2: voledy folded before Flop (didn't bet)
Seat 3: Komap511 showed [3h 8h] and lost with a pair of Fives
Seat 4: dr.goofy (button) showed [9s Ts] and won ($9.69) with a flush, Queen high
Seat 5: ArcticBearDK (small blind) folded before Flop
Seat 6: pancernik21 (big blind) folded before Flop



PokerStars Hand #166667660316:  Hold'em No Limit ($0.05/$0.10 USD) - 2017/02/23 16:05:12 ET
Table 'Torrence II' 6-max Seat #4 is the button
Seat 1: Starbooks ($6.14 in chips) 
Seat 2: scorpionfish ($16.10 in chips) 
Seat 3: coolisses111 ($9.80 in chips) 
Seat 4: Zooplack ($10 in chips) 
Seat 5: Kow6oy ($12.23 in chips) 
Seat 6: mhonielsen ($10 in chips) 
Kow6oy: posts small blind $0.05
mhonielsen: posts big blind $0.10
*** HOLE CARDS ***
Starbooks: calls $0.10
scorpionfish: raises $0.20 to $0.30
coolisses111: folds 
Zooplack: calls $0.30
Kow6oy: folds 
mhonielsen: folds 
Starbooks: calls $0.20
*** FLOP *** [2h 7c As]
Starbooks: checks 
scorpionfish: checks 
Zooplack: checks 
*** TURN *** [2h 7c As] [Kc]
Starbooks: bets $0.20
scorpionfish: folds 
Zooplack: folds 
Uncalled bet ($0.20) returned to Starbooks
Starbooks collected $1 from pot
*** SUMMARY ***
Total pot $1.05 | Rake $0.05 
Board [2h 7c As Kc]
Seat 1: Starbooks collected ($1)
Seat 2: scorpionfish folded on the Turn
Seat 3: coolisses111 folded before Flop (didn't bet)
Seat 4: Zooplack (button) folded on the Turn
Seat 5: Kow6oy (small blind) folded before Flop
Seat 6: mhonielsen (big blind) folded before Flop



PokerStars Hand #166667660707:  Hold'em No Limit ($0.05/$0.10 USD) - 2017/02/23 16:05:13 ET
Table 'Syringa' 6-max Seat #2 is the button
Seat 1: bdixon_5 ($7.80 in chips) 
Seat 2: Goroshkos88 ($10.41 in chips) 
Seat 3: Yspenyanin ($13.57 in chips) 
Seat 5: Andrei ProFF ($13.61 in chips) 
Seat 6: ibara000 ($16.28 in chips) 
Yspenyanin: posts small blind $0.05
Andrei ProFF: posts big blind $0.10
*** HOLE CARDS ***
ibara000: folds 
bdixon_5: folds 
Goroshkos88: folds 
Yspenyanin: folds 
Uncalled bet ($0.05) returned to Andrei ProFF
Andrei ProFF collected $0.10 from pot
*** SUMMARY ***
Total pot $0.10 | Rake $0 
Seat 1: bdixon_5 folded before Flop (didn't bet)
Seat 2: Goroshkos88 (button) folded before Flop (didn't bet)
Seat 3: Yspenyanin (small blind) folded before Flop
Seat 5: Andrei ProFF (big blind) collected ($0.10)
Seat 6: ibara000 folded before Flop (didn't bet)



PokerStars Hand #166667660728:  Hold'em No Limit ($0.05/$0.10 USD) - 2017/02/23 16:05:13 ET
Table 'Luanda' 6-max Seat #6 is the button
Seat 1: AM-L-SL ($4.75 in chips) 
Seat 2: Xander188 ($10 in chips) 
Seat 3: DamDatsAnAce ($10.15 in chips) 
Seat 5: st4tion ($13.03 in chips) 
Seat 6: KA3AXCTAHEU, ($11.58 in chips) 
AM-L-SL: posts small blind $0.05
Xander188: posts big blind $0.10
*** HOLE CARDS ***
DamDatsAnAce: folds 
st4tion: folds 
KA3AXCTAHEU,: folds 
AM-L-SL: calls $0.05
Xander188: checks 
*** FLOP *** [9d 2s 9c]
AM-L-SL: checks 
Xander188: checks 
*** TURN *** [9d 2s 9c] [7h]
AM-L-SL: checks 
Xander188: checks 
*** RIVER *** [9d 2s 9c 7h] [3s]
AM-L-SL: checks 
Xander188: checks 
*** SHOW DOWN ***
AM-L-SL: shows [Kh Td] (a pair of Nines)
Xander188: shows [5h As] (a pair of Nines - Ace kicker)
Xander188 collected $0.19 from pot
*** SUMMARY ***
Total pot $0.20 | Rake $0.01 
Board [9d 2s 9c 7h 3s]
Seat 1: AM-L-SL (small blind) showed [Kh Td] and lost with a pair of Nines
Seat 2: Xander188 (big blind) showed [5h As] and won ($0.19) with a pair of Nines
Seat 3: DamDatsAnAce folded before Flop (didn't bet)
Seat 5: st4tion folded before Flop (didn't bet)
Seat 6: KA3AXCTAHEU, (button) folded before Flop (didn't bet)



PokerStars Hand #166667660965:  Hold'em No Limit ($0.05/$0.10 USD) - 2017/02/23 16:05:13 ET
Table 'Pirola' 6-max Seat #4 is the button
Seat 1: Rodik002 ($10.28 in chips) 
Seat 2: lmlmlmlm90 ($18.54 in chips) 
Seat 3: XaXaTyH4uK ($10.76 in chips) 
Seat 4: barons89 ($12.06 in chips) 
Seat 5: Iarlei ($14.29 in chips) 
Seat 6: Hyd SK ($10 in chips) 
Iarlei: posts small blind $0.05
Hyd SK: posts big blind $0.10
*** HOLE CARDS ***
Rodik002: folds 
lmlmlmlm90: folds 
XaXaTyH4uK: raises $0.20 to $0.30
barons89: folds 
Iarlei: folds 
Hyd SK: calls $0.20
*** FLOP *** [Kd 4d 5c]
Hyd SK: checks 
XaXaTyH4uK: bets $0.42
Hyd SK: folds 
Uncalled bet ($0.42) returned to XaXaTyH4uK
XaXaTyH4uK collected $0.62 from pot
*** SUMMARY ***
Total pot $0.65 | Rake $0.03 
Board [Kd 4d 5c]
Seat 1: Rodik002 folded before Flop (didn't bet)
Seat 2: lmlmlmlm90 folded before Flop (didn't bet)
Seat 3: XaXaTyH4uK collected ($0.62)
Seat 4: barons89 (button) folded before Flop (didn't bet)
Seat 5: Iarlei (small blind) folded before Flop
Seat 6: Hyd SK (big blind) folded on the Flop



PokerStars Hand #166667661165:  Hold'em No Limit ($0.05/$0.10 USD) - 2017/02/23 16:05:13 ET
Table 'Crommelin II' 6-max Seat #4 is the button
Seat 1: THIMUCHIN ($11.62 in chips) 
Seat 2: Bird et al ($10 in chips) 
Seat 3: Strelok1974 ($21.80 in chips) 
Seat 4: Pequeño Clau ($13.12 in chips) 
Seat 5: Action_Gibi ($17.18 in chips) 
Action_Gibi: posts small blind $0.05
THIMUCHIN: posts big blind $0.10
*** HOLE CARDS ***
Bird et al: folds 
Strelok1974: folds 
Pequeño Clau: folds 
Action_Gibi: folds 
Uncalled bet ($0.05) returned to THIMUCHIN
THIMUCHIN collected $0.10 from pot
*** SUMMARY ***
Total pot $0.10 | Rake $0 
Seat 1: THIMUCHIN (big blind) collected ($0.10)
Seat 2: Bird et al folded before Flop (didn't bet)
Seat 3: Strelok1974 folded before Flop (didn't bet)
Seat 4: Pequeño Clau (button) folded before Flop (didn't bet)
Seat 5: Action_Gibi (small blind) folded before Flop



PokerStars Hand #166667661378:  Hold'em No Limit ($0.05/$0.10 USD) - 2017/02/23 16:05:13 ET
Table 'Hestia' 6-max Seat #5 is the button
Seat 2: Kow6oy ($10 in chips) 
Seat 3: MBen10 ($13.77 in chips) 
Seat 4: Lucky HoBBiT ($10 in chips) 
Seat 5: CiisCi ($16.45 in chips) 
Seat 6: Smitty03300 ($10 in chips) 
Smitty03300: posts small blind $0.05
Kow6oy: posts big blind $0.10
*** HOLE CARDS ***
MBen10: folds 
Lucky HoBBiT: folds 
CiisCi: folds 
Smitty03300: folds 
Uncalled bet ($0.05) returned to Kow6oy
Kow6oy collected $0.10 from pot
*** SUMMARY ***
Total pot $0.10 | Rake $0 
Seat 2: Kow6oy (big blind) collected ($0.10)
Seat 3: MBen10 folded before Flop (didn't bet)
Seat 4: Lucky HoBBiT folded before Flop (didn't bet)
Seat 5: CiisCi (button) folded before Flop (didn't bet)
Seat 6: Smitty03300 (small blind) folded before Flop



PokerStars Hand #166667661626:  Hold'em No Limit ($0.05/$0.10 USD) - 2017/02/23 16:05:14 ET
Table 'Clavel' 6-max Seat #6 is the button
Seat 1: KRZuff ($14.41 in chips) 
Seat 2: Namhkal ($10 in chips) 
Seat 4: Dcaro31 ($11.98 in chips) 
Seat 5: Vrinni ($10.14 in chips) 
Seat 6: Gra_anD77 ($4.56 in chips) 
KRZuff: posts small blind $0.05
Namhkal: posts big blind $0.10
*** HOLE CARDS ***
Dcaro31: folds 
Vrinni: folds 
Gra_anD77: calls $0.10
KRZuff: folds 
Namhkal: checks 
*** FLOP *** [Ts Jd 2h]
Namhkal: checks 
Gra_anD77: checks 
*** TURN *** [Ts Jd 2h] [Ah]
Namhkal: checks 
Gra_anD77: bets $0.10
Namhkal: folds 
Uncalled bet ($0.10) returned to Gra_anD77
Gra_anD77 collected $0.24 from pot
*** SUMMARY ***
Total pot $0.25 | Rake $0.01 
Board [Ts Jd 2h Ah]
Seat 1: KRZuff (small blind) folded before Flop
Seat 2: Namhkal (big blind) folded on the Turn
Seat 4: Dcaro31 folded before Flop (didn't bet)
Seat 5: Vrinni folded before Flop (didn't bet)
Seat 6: Gra_anD77 (button) collected ($0.24)



PokerStars Hand #166667661688:  Hold'em No Limit ($0.05/$0.10 USD) - 2017/02/23 16:05:14 ET
Table 'Hunnia' 6-max Seat #6 is the button
Seat 1: univibe68 ($21.93 in chips) 
Seat 2: mhonielsen ($10 in chips) 
Seat 3: 6ePeMeHHa9 ($10.71 in chips) 
Seat 4: Jalida3 ($10.55 in chips) 
Seat 5: Smarkon ($14.93 in chips) 
Seat 6: ChuikaPridi ($10 in chips) 
univibe68: posts small blind $0.05
mhonielsen: posts big blind $0.10
*** HOLE CARDS ***
6ePeMeHHa9: folds 
Jalida3: calls $0.10
Smarkon: folds 
ChuikaPridi: folds 
univibe68: folds 
mhonielsen: checks 
*** FLOP *** [5d 7h 2h]
mhonielsen: checks 
Jalida3: bets $0.24
mhonielsen: folds 
Uncalled bet ($0.24) returned to Jalida3
Jalida3 collected $0.24 from pot
*** SUMMARY ***
Total pot $0.25 | Rake $0.01 
Board [5d 7h 2h]
Seat 1: univibe68 (small blind) folded before Flop
Seat 2: mhonielsen (big blind) folded on the Flop
Seat 3: 6ePeMeHHa9 folded before Flop (didn't bet)
Seat 4: Jalida3 collected ($0.24)
Seat 5: Smarkon folded before Flop (didn't bet)
Seat 6: ChuikaPridi (button) folded before Flop (didn't bet)



PokerStars Hand #166667662139:  Hold'em No Limit ($0.05/$0.10 USD) - 2017/02/23 16:05:14 ET
Table 'Huberta II' 6-max Seat #2 is the button
Seat 1: tr41n3r12 ($10.33 in chips) 
Seat 2: Ice_Isayev ($12.08 in chips) 
Seat 3: patrick19111 ($10.65 in chips) 
Seat 4: VAD21 ($12.11 in chips) 
Seat 5: Feverhead ($26.93 in chips) 
patrick19111: posts small blind $0.05
VAD21: posts big blind $0.10
yodzik: sits out 
*** HOLE CARDS ***
Feverhead: raises $0.20 to $0.30
tr41n3r12: calls $0.30
Ice_Isayev: folds 
patrick19111: folds 
VAD21: folds 
*** FLOP *** [2d 5c 6d]
Feverhead: bets $0.50
tr41n3r12: calls $0.50
*** TURN *** [2d 5c 6d] [Kh]
Feverhead: bets $1.11
tr41n3r12: folds 
Uncalled bet ($1.11) returned to Feverhead
Feverhead collected $1.67 from pot
*** SUMMARY ***
Total pot $1.75 | Rake $0.08 
Board [2d 5c 6d Kh]
Seat 1: tr41n3r12 folded on the Turn
Seat 2: Ice_Isayev (button) folded before Flop (didn't bet)
Seat 3: patrick19111 (small blind) folded before Flop
Seat 4: VAD21 (big blind) folded before Flop
Seat 5: Feverhead collected ($1.67)



PokerStars Hand #166667662140:  Hold'em No Limit ($0.05/$0.10 USD) - 2017/02/23 16:05:14 ET
Table 'Thoas' 6-max Seat #3 is the button
Seat 2: themacer24 ($8.52 in chips) 
Seat 3: iamkakaroto ($10 in chips) 
Seat 4: Morris_Chair ($17.86 in chips) 
Seat 5: Kow6oy ($10.32 in chips) 
Seat 6: takis nik ($10 in chips) 
Morris_Chair: posts small blind $0.05
Kow6oy: posts big blind $0.10
*** HOLE CARDS ***
takis nik: folds 
themacer24: folds 
iamkakaroto: raises $0.15 to $0.25
Morris_Chair: calls $0.20
Kow6oy: folds 
*** FLOP *** [Js Ad Jd]
Morris_Chair: checks 
iamkakaroto: bets $0.37
Morris_Chair: calls $0.37
*** TURN *** [Js Ad Jd] [2c]
Morris_Chair: checks 
iamkakaroto: checks 
*** RIVER *** [Js Ad Jd 2c] [6d]
Morris_Chair: bets $1
iamkakaroto: folds 
Uncalled bet ($1) returned to Morris_Chair
Morris_Chair collected $1.28 from pot
*** SUMMARY ***
Total pot $1.34 | Rake $0.06 
Board [Js Ad Jd 2c 6d]
Seat 2: themacer24 folded before Flop (didn't bet)
Seat 3: iamkakaroto (button) folded on the River
Seat 4: Morris_Chair (small blind) collected ($1.28)
Seat 5: Kow6oy (big blind) folded before Flop
Seat 6: takis nik folded before Flop (didn't bet)



PokerStars Hand #166667662381:  Hold'em No Limit ($0.05/$0.10 USD) - 2017/02/23 16:05:14 ET
Table 'Caprera III' 6-max Seat #5 is the button
Seat 1: Vrinni ($18.73 in chips) 
Seat 2: hg123454321 ($9.69 in chips) 
Seat 5: fedorka rus ($49.53 in chips) 
Seat 6: GESPERIA ($18.38 in chips) 
GESPERIA: posts small blind $0.05
Vrinni: posts big blind $0.10
*** HOLE CARDS ***
hg123454321: raises $0.10 to $0.20
fedorka rus: folds 
GESPERIA: calls $0.15
Vrinni: folds 
*** FLOP *** [5s 4c 7c]
GESPERIA: checks 
hg123454321: bets $0.30
GESPERIA: calls $0.30
*** TURN *** [5s 4c 7c] [Qh]
GESPERIA: bets $0.69
hg123454321: calls $0.69
*** RIVER *** [5s 4c 7c Qh] [Kc]
GESPERIA: checks 
hg123454321: checks 
*** SHOW DOWN ***
GESPERIA: shows [Jc Kd] (a pair of Kings)
hg123454321: shows [Qs 7s] (two pair, Queens and Sevens)
hg123454321 collected $2.37 from pot
*** SUMMARY ***
Total pot $2.48 | Rake $0.11 
Board [5s 4c 7c Qh Kc]
Seat 1: Vrinni (big blind) folded before Flop
Seat 2: hg123454321 showed [Qs 7s] and won ($2.37) with two pair, Queens and Sevens
Seat 5: fedorka rus (button) folded before Flop (didn't bet)
Seat 6: GESPERIA (small blind) showed [Jc Kd] and lost with a pair of Kings



PokerStars Hand #166667662382:  Hold'em No Limit ($0.05/$0.10 USD) - 2017/02/23 16:05:14 ET
Table 'Laetitia II' 6-max Seat #3 is the button
Seat 1: Cluckh ($10.96 in chips) 
Seat 2: manashov ($10.22 in chips) 
Seat 3: 6ePeMeHHa9 ($10.14 in chips) 
Seat 4: Feverhead ($16.71 in chips) 
Seat 5: D3NyA ($16.63 in chips) 
Seat 6: Dima91360 ($4.90 in chips) 
Feverhead: posts small blind $0.05
D3NyA: posts big blind $0.10
*** HOLE CARDS ***
Dima91360: calls $0.10
Cluckh: folds 
manashov: raises $0.30 to $0.40
6ePeMeHHa9: folds 
Feverhead: folds 
D3NyA: folds 
Dima91360: calls $0.30
*** FLOP *** [5s 4s 6s]
Dima91360: checks 
manashov: bets $0.50
Dima91360: calls $0.50
*** TURN *** [5s 4s 6s] [3c]
Dima91360: checks 
manashov: checks 
*** RIVER *** [5s 4s 6s 3c] [6h]
Dima91360: bets $0.30
manashov: calls $0.30
*** SHOW DOWN ***
Dima91360: shows [Ah 5d] (two pair, Sixes and Fives)
manashov: mucks hand 
Dima91360 collected $2.44 from pot
*** SUMMARY ***
Total pot $2.55 | Rake $0.11 
Board [5s 4s 6s 3c 6h]
Seat 1: Cluckh folded before Flop (didn't bet)
Seat 2: manashov mucked
Seat 3: 6ePeMeHHa9 (button) folded before Flop (didn't bet)
Seat 4: Feverhead (small blind) folded before Flop
Seat 5: D3NyA (big blind) folded before Flop
Seat 6: Dima91360 showed [Ah 5d] and won ($2.44) with two pair, Sixes and Fives



PokerStars Hand #166667662483:  Hold'em No Limit ($0.05/$0.10 USD) - 2017/02/23 16:05:15 ET
Table 'Senta II' 6-max Seat #6 is the button
Seat 2: NvR.m1nD ($11.20 in chips) 
Seat 3: Aescul@pius ($20.70 in chips) 
Seat 4: fedorka rus ($21.24 in chips) 
Seat 5: Algarah ($6.82 in chips) 
Seat 6: T9MS ($11.62 in chips) 
NvR.m1nD: posts small blind $0.05
Aescul@pius: posts big blind $0.10
*** HOLE CARDS ***
fedorka rus: raises $0.20 to $0.30
Algarah: calls $0.30
T9MS: calls $0.30
NvR.m1nD: calls $0.25
Aescul@pius: folds 
*** FLOP *** [3d As Th]
NvR.m1nD: checks 
fedorka rus: checks 
Algarah: checks 
T9MS: checks 
*** TURN *** [3d As Th] [7s]
NvR.m1nD: bets $0.52
fedorka rus: folds 
Algarah: folds 
T9MS: folds 
Uncalled bet ($0.52) returned to NvR.m1nD
NvR.m1nD collected $1.24 from pot
*** SUMMARY ***
Total pot $1.30 | Rake $0.06 
Board [3d As Th 7s]
Seat 2: NvR.m1nD (small blind) collected ($1.24)
Seat 3: Aescul@pius (big blind) folded before Flop
Seat 4: fedorka rus folded on the Turn
Seat 5: Algarah folded on the Turn
Seat 6: T9MS (button) folded on the Turn



PokerStars Hand #166667662704:  Hold'em No Limit ($0.05/$0.10 USD) - 2017/02/23 16:05:15 ET
Table 'Antielus II' 6-max Seat #5 is the button
Seat 1: Dcaro31 ($17.30 in chips) 
Seat 2: Orlangoor ($10.15 in chips) 
Seat 3: mcyi3at2 ($12.16 in chips) 
Seat 4: XwinX25 ($10 in chips) 
Seat 5: Hyd SK ($11.89 in chips) 
Seat 6: GiveTwoMe ($12.30 in chips) 
GiveTwoMe: posts small blind $0.05
Dcaro31: posts big blind $0.10
*** HOLE CARDS ***
Orlangoor: folds 
mcyi3at2: folds 
XwinX25: raises $0.20 to $0.30
Hyd SK: raises $0.70 to $1
GiveTwoMe: folds 
Dcaro31: calls $0.90
XwinX25: folds 
*** FLOP *** [4c 2c 7s]
Dcaro31: checks 
Hyd SK: checks 
*** TURN *** [4c 2c 7s] [As]
Dcaro31: checks 
Hyd SK: checks 
*** RIVER *** [4c 2c 7s As] [6s]
Dcaro31: checks 
Hyd SK: checks 
*** SHOW DOWN ***
Dcaro31: shows [Js Jd] (a pair of Jacks)
Hyd SK: mucks hand 
Dcaro31 collected $2.24 from pot
*** SUMMARY ***
Total pot $2.35 | Rake $0.11 
Board [4c 2c 7s As 6s]
Seat 1: Dcaro31 (big blind) showed [Js Jd] and won ($2.24) with a pair of Jacks
Seat 2: Orlangoor folded before Flop (didn't bet)
Seat 3: mcyi3at2 folded before Flop (didn't bet)
Seat 4: XwinX25 folded before Flop
Seat 5: Hyd SK (button) mucked
Seat 6: GiveTwoMe (small blind) folded before Flop



PokerStars Hand #166667663003:  Hold'em No Limit ($0.05/$0.10 USD) - 2017/02/23 16:05:15 ET
Table 'Wabash' 6-max Seat #6 is the button
Seat 1: pivanki11 ($10.05 in chips) 
Seat 2: ex3Lero86 ($32.63 in chips) 
Seat 3: sszabi28 ($4.56 in chips) 
Seat 4: Nr847 ($10 in chips) 
Seat 5: popypaleta ($10 in chips) 
Seat 6: weez3r ($10.52 in chips) 
pivanki11: posts small blind $0.05
ex3Lero86: posts big blind $0.10
*** HOLE CARDS ***
sszabi28: calls $0.10
Nr847: folds 
popypaleta: raises $0.40 to $0.50
weez3r: folds 
pivanki11: folds 
ex3Lero86: folds 
sszabi28: calls $0.40
*** FLOP *** [8c Ac Ah]
sszabi28: bets $0.30
popypaleta: raises $0.85 to $1.15
sszabi28: calls $0.85
*** TURN *** [8c Ac Ah] [Jh]
sszabi28: bets $2.91 and is all-in
popypaleta: calls $2.91
*** RIVER *** [8c Ac Ah Jh] [Qh]
*** SHOW DOWN ***
sszabi28: shows [3c 2c] (a pair of Aces)
popypaleta: shows [Jc Tc] (two pair, Aces and Jacks)
popypaleta collected $8.85 from pot
*** SUMMARY ***
Total pot $9.27 | Rake $0.42 
Board [8c Ac Ah Jh Qh]
Seat 1: pivanki11 (small blind) folded before Flop
Seat 2: ex3Lero86 (big blind) folded before Flop
Seat 3: sszabi28 showed [3c 2c] and lost with a pair of Aces
Seat 4: Nr847 folded before Flop (didn't bet)
Seat 5: popypaleta showed [Jc Tc] and won ($8.85) with two pair, Aces and Jacks
Seat 6: weez3r (button) folded before Flop (didn't bet)



PokerStars Hand #166667663021:  Hold'em No Limit ($0.05/$0.10 USD) - 2017/02/23 16:05:15 ET
Table 'Kochera' 6-max Seat #3 is the button
Seat 1: chimera252 ($11.82 in chips) 
Seat 2: bartabs2 ($10.54 in chips) 
Seat 3: KA3AXCTAHEU, ($10 in chips) 
Seat 4: johkom ($5.36 in chips) 
Seat 5: univibe68 ($11.85 in chips) 
Seat 6: oddshoff ($9.63 in chips) 
johkom: posts small blind $0.05
univibe68: posts big blind $0.10
*** HOLE CARDS ***
oddshoff: folds 
chimera252: folds 
bartabs2: folds 
KA3AXCTAHEU,: raises $0.15 to $0.25
johkom: calls $0.20
univibe68: folds 
*** FLOP *** [7s 7h 4d]
johkom: checks 
KA3AXCTAHEU,: checks 
*** TURN *** [7s 7h 4d] [Ts]
johkom: bets $0.29
KA3AXCTAHEU,: calls $0.29
*** RIVER *** [7s 7h 4d Ts] [Jh]
johkom: bets $0.57
KA3AXCTAHEU,: folds 
Uncalled bet ($0.57) returned to johkom
johkom collected $1.13 from pot
*** SUMMARY ***
Total pot $1.18 | Rake $0.05 
Board [7s 7h 4d Ts Jh]
Seat 1: chimera252 folded before Flop (didn't bet)
Seat 2: bartabs2 folded before Flop (didn't bet)
Seat 3: KA3AXCTAHEU, (button) folded on the River
Seat 4: johkom (small blind) collected ($1.13)
Seat 5: univibe68 (big blind) folded before Flop
Seat 6: oddshoff folded before Flop (didn't bet)



PokerStars Hand #166667663063:  Hold'em No Limit ($0.05/$0.10 USD) - 2017/02/23 16:05:15 ET
Table 'Duhr II' 6-max Seat #6 is the button
Seat 1: Lucky HoBBiT ($10 in chips) 
Seat 2: Feverhead ($37.89 in chips) 
Seat 3: Innerwuss ($23.18 in chips) 
Seat 4: CHRO8 ($9.85 in chips) 
Seat 6: townerz1991 ($10 in chips) 
Lucky HoBBiT: posts small blind $0.05
Feverhead: posts big blind $0.10
Dimka4: sits out 
*** HOLE CARDS ***
Innerwuss: folds 
CHRO8: raises $0.20 to $0.30
townerz1991: raises $0.65 to $0.95
Lucky HoBBiT: folds 
Feverhead: folds 
CHRO8: calls $0.65
*** FLOP *** [2s 5c 3c]
CHRO8: checks 
townerz1991: bets $0.75
CHRO8: folds 
Uncalled bet ($0.75) returned to townerz1991
townerz1991 collected $1.96 from pot
*** SUMMARY ***
Total pot $2.05 | Rake $0.09 
Board [2s 5c 3c]
Seat 1: Lucky HoBBiT (small blind) folded before Flop
Seat 2: Feverhead (big blind) folded before Flop
Seat 3: Innerwuss folded before Flop (didn't bet)
Seat 4: CHRO8 folded on the Flop
Seat 6: townerz1991 (button) collected ($1.96)



PokerStars Hand #166667663106:  Hold'em No Limit ($0.05/$0.10 USD) - 2017/02/23 16:05:15 ET
Table 'Alnasl' 6-max Seat #4 is the button
Seat 1: KA3AXCTAHEU, ($11.07 in chips) 
Seat 2: saddur ($10 in chips) 
Seat 3: david_sara83 ($22.69 in chips) 
Seat 4: oddshoff ($9.83 in chips) 
Seat 6: Zooplack ($13.48 in chips) 
Zooplack: posts small blind $0.05
KA3AXCTAHEU,: posts big blind $0.10
saddur: posts big blind $0.10
*** HOLE CARDS ***
WinninBikini joins the table at seat #5 
saddur: checks 
WinninBikini leaves the table
david_sara83: folds 
oddshoff: folds 
6ePeMeHHa9 joins the table at seat #5 
Zooplack: folds 
KA3AXCTAHEU,: checks 
*** FLOP *** [3s 2d 8d]
KA3AXCTAHEU,: checks 
saddur: bets $0.10
KA3AXCTAHEU,: folds 
Uncalled bet ($0.10) returned to saddur
saddur collected $0.24 from pot
*** SUMMARY ***
Total pot $0.25 | Rake $0.01 
Board [3s 2d 8d]
Seat 1: KA3AXCTAHEU, (big blind) folded on the Flop
Seat 2: saddur collected ($0.24)
Seat 3: david_sara83 folded before Flop (didn't bet)
Seat 4: oddshoff (button) folded before Flop (didn't bet)
Seat 6: Zooplack (small blind) folded before Flop



PokerStars Hand #166667663344:  Hold'em No Limit ($0.05/$0.10 USD) - 2017/02/23 16:05:15 ET
Table 'Eurykleia' 6-max Seat #2 is the button
Seat 1: Giyorod ($10.15 in chips) 
Seat 2: x3ultimate ($10.59 in chips) 
Seat 3: boxer821 ($20.46 in chips) 
Seat 4: 6ePeMeHHa9 ($17.02 in chips) 
Seat 5: fishhook5 ($10.15 in chips) 
Seat 6: afca128 ($6.42 in chips) 
boxer821: posts small blind $0.05
6ePeMeHHa9: posts big blind $0.10
*** HOLE CARDS ***
fishhook5: folds 
afca128: folds 
Giyorod: folds 
x3ultimate: raises $0.15 to $0.25
boxer821: folds 
6ePeMeHHa9: folds 
Uncalled bet ($0.15) returned to x3ultimate
x3ultimate collected $0.25 from pot
*** SUMMARY ***
Total pot $0.25 | Rake $0 
Seat 1: Giyorod folded before Flop (didn't bet)
Seat 2: x3ultimate (button) collected ($0.25)
Seat 3: boxer821 (small blind) folded before Flop
Seat 4: 6ePeMeHHa9 (big blind) folded before Flop
Seat 5: fishhook5 folded before Flop (didn't bet)
Seat 6: afca128 folded before Flop (didn't bet)



PokerStars Hand #166667663466:  Hold'em No Limit ($0.05/$0.10 USD) - 2017/02/23 16:05:16 ET
Table 'Crocus' 6-max Seat #6 is the button
Seat 1: truck1234 ($25.05 in chips) 
Seat 2: garigura ($11.19 in chips) 
Seat 3: Limpa Meza ($0.78 in chips) 
Seat 4: patrick19111 ($12.26 in chips) 
Seat 5: Golsuorsi ($10 in chips) 
Seat 6: Rodik002 ($10 in chips) 
truck1234: posts small blind $0.05
garigura: posts big blind $0.10
*** HOLE CARDS ***
Limpa Meza: folds 
patrick19111: folds 
Golsuorsi: folds 
Rodik002: raises $0.10 to $0.20
truck1234: folds 
garigura: calls $0.10
*** FLOP *** [5h 9s 8h]
garigura: checks 
Rodik002: bets $0.30
garigura: folds 
Uncalled bet ($0.30) returned to Rodik002
Rodik002 collected $0.43 from pot
*** SUMMARY ***
Total pot $0.45 | Rake $0.02 
Board [5h 9s 8h]
Seat 1: truck1234 (small blind) folded before Flop
Seat 2: garigura (big blind) folded on the Flop
Seat 3: Limpa Meza folded before Flop (didn't bet)
Seat 4: patrick19111 folded before Flop (didn't bet)
Seat 5: Golsuorsi folded before Flop (didn't bet)
Seat 6: Rodik002 (button) collected ($0.43)



PokerStars Hand #166667663515:  Hold'em No Limit ($0.05/$0.10 USD) - 2017/02/23 16:05:16 ET
Table 'Bengt' 6-max Seat #2 is the button
Seat 1: Lucky HoBBiT ($12.35 in chips) 
Seat 2: ChefRocco ($21.11 in chips) 
Seat 3: nantes15 ($13.28 in chips) 
Seat 4: 8th wonders ($10 in chips) 
Seat 5: RoJ1 ($10.31 in chips) 
Seat 6: Goroshkos88 ($10.28 in chips) 
nantes15: posts small blind $0.05
8th wonders: posts big blind $0.10
*** HOLE CARDS ***
RoJ1: folds 
Goroshkos88: folds 
Lucky HoBBiT: folds 
ChefRocco: calls $0.10
nantes15: folds 
8th wonders: checks 
*** FLOP *** [Ts 7s 5d]
8th wonders: checks 
ChefRocco: checks 
*** TURN *** [Ts 7s 5d] [Jd]
8th wonders: checks 
ChefRocco: checks 
*** RIVER *** [Ts 7s 5d Jd] [7d]
8th wonders: checks 
ChefRocco: checks 
*** SHOW DOWN ***
8th wonders: shows [Tc 2c] (two pair, Tens and Sevens)
ChefRocco: mucks hand 
8th wonders collected $0.24 from pot
*** SUMMARY ***
Total pot $0.25 | Rake $0.01 
Board [Ts 7s 5d Jd 7d]
Seat 1: Lucky HoBBiT folded before Flop (didn't bet)
Seat 2: ChefRocco (button) mucked
Seat 3: nantes15 (small blind) folded before Flop
Seat 4: 8th wonders (big blind) showed [Tc 2c] and won ($0.24) with two pair, Tens and Sevens
Seat 5: RoJ1 folded before Flop (didn't bet)
Seat 6: Goroshkos88 folded before Flop (didn't bet)



PokerStars Hand #166667663613:  Hold'em No Limit ($0.05/$0.10 USD) - 2017/02/23 16:05:16 ET
Table 'Stroobantia II' 6-max Seat #2 is the button
Seat 1: XBrosh ($8.09 in chips) 
Seat 2: IAntikI ($10 in chips) 
Seat 3: 8th wonders ($10.73 in chips) 
Seat 5: Zooplack ($12.48 in chips) 
Seat 6: CHRO8 ($12.97 in chips) 
8th wonders: posts small blind $0.05
Xander188: is sitting out 
Zooplack: posts big blind $0.10
*** HOLE CARDS ***
Xander188 leaves the table
CHRO8: folds 
XBrosh: calls $0.10
Punzzzer joins the table at seat #4 
IAntikI: folds 
8th wonders: raises $0.30 to $0.40
Zooplack: folds 
XBrosh: calls $0.30
*** FLOP *** [6c 2d Td]
8th wonders: bets $0.50
XBrosh: folds 
Uncalled bet ($0.50) returned to 8th wonders
8th wonders collected $0.86 from pot
*** SUMMARY ***
Total pot $0.90 | Rake $0.04 
Board [6c 2d Td]
Seat 1: XBrosh folded on the Flop
Seat 2: IAntikI (button) folded before Flop (didn't bet)
Seat 3: 8th wonders (small blind) collected ($0.86)
Seat 5: Zooplack (big blind) folded before Flop
Seat 6: CHRO8 folded before Flop (didn't bet)



PokerStars Hand #166667664290:  Hold'em No Limit ($0.05/$0.10 USD) - 2017/02/23 16:05:16 ET
Table 'Rotraut' 6-max Seat #3 is the button
Seat 2: Newqbrown ($11.24 in chips) 
Seat 3: FlackoD ($12.12 in chips) 
Seat 5: Bird et al ($11.80 in chips) 
Seat 6: KokoulinV ($12.59 in chips) 
Bird et al: posts small blind $0.05
KokoulinV: posts big blind $0.10
*** HOLE CARDS ***
Newqbrown: raises $0.20 to $0.30
FlackoD: raises $0.60 to $0.90
Bird et al: folds 
KokoulinV: folds 
Newqbrown: calls $0.60
*** FLOP *** [4h 3s Jd]
Newqbrown: checks 
FlackoD: checks 
*** TURN *** [4h 3s Jd] [7h]
Newqbrown: checks 
FlackoD: checks 
*** RIVER *** [4h 3s Jd 7h] [3c]
Newqbrown: checks 
FlackoD: checks 
*** SHOW DOWN ***
Newqbrown: shows [4c 6c] (two pair, Fours and Threes)
FlackoD: mucks hand 
Newqbrown collected $1.86 from pot
*** SUMMARY ***
Total pot $1.95 | Rake $0.09 
Board [4h 3s Jd 7h 3c]
Seat 2: Newqbrown showed [4c 6c] and won ($1.86) with two pair, Fours and Threes
Seat 3: FlackoD (button) mucked
Seat 5: Bird et al (small blind) folded before Flop
Seat 6: KokoulinV (big blind) folded before Flop



PokerStars Hand #166667664586:  Hold'em No Limit ($0.05/$0.10 USD) - 2017/02/23 16:05:17 ET
Table 'Lehigh' 6-max Seat #6 is the button
Seat 1: kowe4ka565 ($8.36 in chips) 
Seat 2: Sbozzz ($10 in chips) 
Seat 3: Therodorus ($12.79 in chips) 
Seat 4: Chodemuncher ($10 in chips) 
Seat 5: Xander188 ($10 in chips) 
Seat 6: CallByValue ($9.85 in chips) 
kowe4ka565: posts small blind $0.05
Sbozzz: posts big blind $0.10
*** HOLE CARDS ***
Therodorus: folds 
Chodemuncher: raises $0.20 to $0.30
Xander188: folds 
CallByValue: calls $0.30
kowe4ka565: calls $0.25
Sbozzz: calls $0.20
*** FLOP *** [9c As Ac]
kowe4ka565: checks 
Sbozzz: checks 
Chodemuncher: bets $0.60
CallByValue: calls $0.60
kowe4ka565: folds 
Sbozzz: calls $0.60
*** TURN *** [9c As Ac] [Ks]
Sbozzz: checks 
Chodemuncher: checks 
CallByValue: bets $1.43
Sbozzz: calls $1.43
Chodemuncher: folds 
*** RIVER *** [9c As Ac Ks] [8c]
Sbozzz: checks 
CallByValue: checks 
*** SHOW DOWN ***
Sbozzz: shows [Ah Kc] (a full house, Aces full of Kings)
CallByValue: mucks hand 
Sbozzz collected $5.60 from pot
*** SUMMARY ***
Total pot $5.86 | Rake $0.26 
Board [9c As Ac Ks 8c]
Seat 1: kowe4ka565 (small blind) folded on the Flop
Seat 2: Sbozzz (big blind) showed [Ah Kc] and won ($5.60) with a full house, Aces full of Kings
Seat 3: Therodorus folded before Flop (didn't bet)
Seat 4: Chodemuncher folded on the Turn
Seat 5: Xander188 folded before Flop (didn't bet)
Seat 6: CallByValue (button) mucked



PokerStars Hand #166667665002:  Hold'em No Limit ($0.05/$0.10 USD) - 2017/02/23 16:05:17 ET
Table 'Izar' 6-max Seat #3 is the button
Seat 1: bambolejro ($10.39 in chips) 
Seat 2: mvp0013 ($10.98 in chips) 
Seat 3: Yspenyanin ($11.27 in chips) 
Seat 4: Matee92 ($6.06 in chips) 
Seat 5: fishhook5 ($11.45 in chips) 
Seat 6: yodzik ($5 in chips) 
Matee92: posts small blind $0.05
fishhook5: posts big blind $0.10
*** HOLE CARDS ***
yodzik: raises $0.20 to $0.30
bambolejro: folds 
mvp0013: folds 
Yspenyanin: folds 
Matee92: folds 
fishhook5: folds 
Uncalled bet ($0.20) returned to yodzik
yodzik collected $0.25 from pot
*** SUMMARY ***
Total pot $0.25 | Rake $0 
Seat 1: bambolejro folded before Flop (didn't bet)
Seat 2: mvp0013 folded before Flop (didn't bet)
Seat 3: Yspenyanin (button) folded before Flop (didn't bet)
Seat 4: Matee92 (small blind) folded before Flop
Seat 5: fishhook5 (big blind) folded before Flop
Seat 6: yodzik collected ($0.25)



PokerStars Hand #166667665349:  Hold'em No Limit ($0.05/$0.10 USD) - 2017/02/23 16:05:18 ET
Table 'Kanda' 6-max Seat #1 is the button
Seat 1: Andy Wolf ($11.12 in chips) 
Seat 2: Pelotín ($5.20 in chips) 
Seat 3: XaXaTyH4uK ($10 in chips) 
Seat 4: Orlangoor ($10.19 in chips) 
Seat 5: Dimka4 ($10 in chips) 
Seat 6: oddshoff ($9.21 in chips) 
Pelotín: posts small blind $0.05
XaXaTyH4uK: posts big blind $0.10
*** HOLE CARDS ***
Orlangoor: folds 
Dimka4: folds 
oddshoff: folds 
Andy Wolf: raises $0.20 to $0.30
Pelotín: folds 
XaXaTyH4uK: folds 
Uncalled bet ($0.20) returned to Andy Wolf
Andy Wolf collected $0.25 from pot
*** SUMMARY ***
Total pot $0.25 | Rake $0 
Seat 1: Andy Wolf (button) collected ($0.25)
Seat 2: Pelotín (small blind) folded before Flop
Seat 3: XaXaTyH4uK (big blind) folded before Flop
Seat 4: Orlangoor folded before Flop (didn't bet)
Seat 5: Dimka4 folded before Flop (didn't bet)
Seat 6: oddshoff folded before Flop (didn't bet)



PokerStars Hand #166667666256:  Hold'em No Limit ($0.05/$0.10 USD) - 2017/02/23 16:05:19 ET
Table 'Antinous' 6-max Seat #2 is the button
Seat 1: Andrei ProFF ($15.68 in chips) 
Seat 2: Nr847 ($13.60 in chips) 
Seat 3: dittoro ($10.05 in chips) 
Seat 5: Covetsoles ($3.58 in chips) 
Seat 6: coolisses111 ($10.20 in chips) 
dittoro: posts small blind $0.05
Covetsoles: posts big blind $0.10
*** HOLE CARDS ***
coolisses111: folds 
Andrei ProFF: folds 
Nr847: folds 
dittoro: folds 
Uncalled bet ($0.05) returned to Covetsoles
Covetsoles collected $0.10 from pot
*** SUMMARY ***
Total pot $0.10 | Rake $0 
Seat 1: Andrei ProFF folded before Flop (didn't bet)
Seat 2: Nr847 (button) folded before Flop (didn't bet)
Seat 3: dittoro (small blind) folded before Flop
Seat 5: Covetsoles (big blind) collected ($0.10)
Seat 6: coolisses111 folded before Flop (didn't bet)



PokerStars Hand #166667666428:  Hold'em No Limit ($0.05/$0.10 USD) - 2017/02/23 16:05:19 ET
Table 'Siebohme' 6-max Seat #1 is the button
Seat 1: kusa4ki ($11.38 in chips) 
Seat 2: el toro 1507 ($11.58 in chips) 
Seat 3: ex3Lero86 ($10.56 in chips) 
Seat 4: Innerwuss ($10.15 in chips) 
Seat 5: Kazacha ($10 in chips) 
Seat 6: townerz1991 ($10.53 in chips) 
el toro 1507: posts small blind $0.05
ex3Lero86: posts big blind $0.10
*** HOLE CARDS ***
Innerwuss: folds 
Kazacha: folds 
townerz1991: folds 
kusa4ki: raises $0.20 to $0.30
el toro 1507: folds 
ex3Lero86: folds 
Uncalled bet ($0.20) returned to kusa4ki
kusa4ki collected $0.25 from pot
*** SUMMARY ***
Total pot $0.25 | Rake $0 
Seat 1: kusa4ki (button) collected ($0.25)
Seat 2: el toro 1507 (small blind) folded before Flop
Seat 3: ex3Lero86 (big blind) folded before Flop
Seat 4: Innerwuss folded before Flop (didn't bet)
Seat 5: Kazacha folded before Flop (didn't bet)
Seat 6: townerz1991 folded before Flop (didn't bet)



PokerStars Hand #166667666688:  Hold'em No Limit ($0.05/$0.10 USD) - 2017/02/23 16:05:19 ET
Table 'Goto II' 6-max Seat #2 is the button
Seat 1: FRAID358 ($12.76 in chips) 
Seat 2: 6ePeMeHHa9 ($11.82 in chips) 
Seat 3: Goroshkos88 ($10.49 in chips) 
Seat 4: KRZuff ($13.04 in chips) 
Seat 5: RoJ1 ($14.50 in chips) 
Seat 6: ermananb93 ($11.79 in chips) 
Goroshkos88: posts small blind $0.05
KRZuff: posts big blind $0.10
*** HOLE CARDS ***
RoJ1: folds 
ermananb93: calls $0.10
FRAID358: raises $0.20 to $0.30
6ePeMeHHa9: folds 
Goroshkos88: folds 
KRZuff: raises $1 to $1.30
ermananb93: folds 
FRAID358: folds 
Uncalled bet ($1) returned to KRZuff
KRZuff collected $0.75 from pot
*** SUMMARY ***
Total pot $0.75 | Rake $0 
Seat 1: FRAID358 folded before Flop
Seat 2: 6ePeMeHHa9 (button) folded before Flop (didn't bet)
Seat 3: Goroshkos88 (small blind) folded before Flop
Seat 4: KRZuff (big blind) collected ($0.75)
Seat 5: RoJ1 folded before Flop (didn't bet)
Seat 6: ermananb93 folded before Flop



PokerStars Hand #166667666711:  Hold'em No Limit ($0.05/$0.10 USD) - 2017/02/23 16:05:19 ET
Table 'Persephone' 6-max Seat #3 is the button
Seat 2: AM-L-SL ($5.50 in chips) 
Seat 3: DasoII ($4.85 in chips) 
Seat 4: 2G28 ($10 in chips) 
Seat 5: ab260414 ($10 in chips) 
Seat 6: popypaleta ($14.24 in chips) 
2G28: posts small blind $0.05
ab260414: posts big blind $0.10
dragonste89: sits out 
*** HOLE CARDS ***
popypaleta: raises $0.20 to $0.30
AM-L-SL: folds 
DasoII: folds 
2G28: folds 
ab260414: folds 
Uncalled bet ($0.20) returned to popypaleta
popypaleta collected $0.25 from pot
*** SUMMARY ***
Total pot $0.25 | Rake $0 
Seat 2: AM-L-SL folded before Flop (didn't bet)
Seat 3: DasoII (button) folded before Flop (didn't bet)
Seat 4: 2G28 (small blind) folded before Flop
Seat 5: ab260414 (big blind) folded before Flop
Seat 6: popypaleta collected ($0.25)



PokerStars Hand #166667666903:  Hold'em No Limit ($0.05/$0.10 USD) - 2017/02/23 16:05:19 ET
Table 'Lampetia' 6-max Seat #2 is the button
Seat 1: WinninBikini ($10.29 in chips) 
Seat 2: ex3Lero86 ($10 in chips) 
Seat 3: Ice_Isayev ($19.94 in chips) 
Seat 4: Rodik002 ($10 in chips) 
Seat 5: luisantrs ($9.33 in chips) 
Seat 6: Scanner17 ($12.44 in chips) 
Ice_Isayev: posts small blind $0.05
Rodik002: posts big blind $0.10
*** HOLE CARDS ***
luisantrs: folds 
Scanner17: folds 
WinninBikini: folds 
ex3Lero86: raises $0.15 to $0.25
Ice_Isayev: folds 
Rodik002: folds 
Uncalled bet ($0.15) returned to ex3Lero86
ex3Lero86 collected $0.25 from pot
*** SUMMARY ***
Total pot $0.25 | Rake $0 
Seat 1: WinninBikini folded before Flop (didn't bet)
Seat 2: ex3Lero86 (button) collected ($0.25)
Seat 3: Ice_Isayev (small blind) folded before Flop
Seat 4: Rodik002 (big blind) folded before Flop
Seat 5: luisantrs folded before Flop (didn't bet)
Seat 6: Scanner17 folded before Flop (didn't bet)



PokerStars Hand #166667667011:  Hold'em No Limit ($0.05/$0.10 USD) - 2017/02/23 16:05:19 ET
Table 'Lorbach' 6-max Seat #4 is the button
Seat 1: LarryTheStar ($14.68 in chips) 
Seat 3: ArcticBearDK ($10 in chips) 
Seat 4: McCleans ($10 in chips) 
Seat 5: Cluckh ($14.52 in chips) 
Seat 6: Worlz ($15.73 in chips) 
Cluckh: posts small blind $0.05
Worlz: posts big blind $0.10
*** HOLE CARDS ***
LarryTheStar: folds 
ArcticBearDK: folds 
McCleans: folds 
Cluckh: folds 
Uncalled bet ($0.05) returned to Worlz
Worlz collected $0.10 from pot
*** SUMMARY ***
Total pot $0.10 | Rake $0 
Seat 1: LarryTheStar folded before Flop (didn't bet)
Seat 3: ArcticBearDK folded before Flop (didn't bet)
Seat 4: McCleans (button) folded before Flop (didn't bet)
Seat 5: Cluckh (small blind) folded before Flop
Seat 6: Worlz (big blind) collected ($0.10)



PokerStars Hand #166667667416:  Hold'em No Limit ($0.05/$0.10 USD) - 2017/02/23 16:05:20 ET
Table 'Tyndareus III' 6-max Seat #5 is the button
Seat 1: MBen10 ($10.05 in chips) 
Seat 2: MihaGr ($10.42 in chips) 
Seat 3: XaXaTyH4uK ($10.30 in chips) 
Seat 5: yodzik ($5 in chips) 
MBen10: posts small blind $0.05
MihaGr: posts big blind $0.10
tequila_joop: sits out 
*** HOLE CARDS ***
XaXaTyH4uK: folds 
yodzik: folds 
MBen10: folds 
Uncalled bet ($0.05) returned to MihaGr
Hb-309 joins the table at seat #6 
MihaGr collected $0.10 from pot
*** SUMMARY ***
Total pot $0.10 | Rake $0 
Seat 1: MBen10 (small blind) folded before Flop
Seat 2: MihaGr (big blind) collected ($0.10)
Seat 3: XaXaTyH4uK folded before Flop (didn't bet)
Seat 5: yodzik (button) folded before Flop (didn't bet)



PokerStars Hand #166667667469:  Hold'em No Limit ($0.05/$0.10 USD) - 2017/02/23 16:05:20 ET
Table 'Oongaq' 6-max Seat #1 is the button
Seat 1: Dmitrij218 ($13.45 in chips) 
Seat 2: homelessdan ($18.45 in chips) 
Seat 3: iDecMate ($10 in chips) 
Seat 4: Bird et al ($10.15 in chips) 
Seat 5: Dizzler1991 ($5.58 in chips) 
Seat 6: boxer821 ($10 in chips) 
homelessdan: posts small blind $0.05
iDecMate: posts big blind $0.10
*** HOLE CARDS ***
Bird et al: folds 
Dizzler1991: folds 
boxer821: folds 
Dmitrij218: calls $0.10
homelessdan: folds 
iDecMate: checks 
*** FLOP *** [4d 4c Jc]
iDecMate: bets $0.16
Dmitrij218: folds 
Uncalled bet ($0.16) returned to iDecMate
iDecMate collected $0.24 from pot
*** SUMMARY ***
Total pot $0.25 | Rake $0.01 
Board [4d 4c Jc]
Seat 1: Dmitrij218 (button) folded on the Flop
Seat 2: homelessdan (small blind) folded before Flop
Seat 3: iDecMate (big blind) collected ($0.24)
Seat 4: Bird et al folded before Flop (didn't bet)
Seat 5: Dizzler1991 folded before Flop (didn't bet)
Seat 6: boxer821 folded before Flop (didn't bet)



PokerStars Hand #166667667547:  Hold'em No Limit ($0.05/$0.10 USD) - 2017/02/23 16:05:20 ET
Table 'Serpens' 6-max Seat #5 is the button
Seat 1: Namhkal ($10.30 in chips) 
Seat 2: KA3AXCTAHEU, ($19.20 in chips) 
Seat 3: homelessdan ($29.44 in chips) 
Seat 4: Ragazzi3 ($10 in chips) 
Seat 5: XwinX25 ($11.81 in chips) 
Seat 6: Croplayer1 ($10.05 in chips) 
Croplayer1: posts small blind $0.05
Namhkal: posts big blind $0.10
*** HOLE CARDS ***
KA3AXCTAHEU,: raises $0.15 to $0.25
homelessdan: folds 
Ragazzi3: folds 
XwinX25: folds 
Croplayer1: folds 
Namhkal: folds 
Uncalled bet ($0.15) returned to KA3AXCTAHEU,
KA3AXCTAHEU, collected $0.25 from pot
*** SUMMARY ***
Total pot $0.25 | Rake $0 
Seat 1: Namhkal (big blind) folded before Flop
Seat 2: KA3AXCTAHEU, collected ($0.25)
Seat 3: homelessdan folded before Flop (didn't bet)
Seat 4: Ragazzi3 folded before Flop (didn't bet)
Seat 5: XwinX25 (button) folded before Flop (didn't bet)
Seat 6: Croplayer1 (small blind) folded before Flop



PokerStars Hand #166667667679:  Hold'em No Limit ($0.05/$0.10 USD) - 2017/02/23 16:05:20 ET
Table 'Vesta II' 6-max Seat #4 is the button
Seat 1: Yabidooo ($13.16 in chips) 
Seat 2: Dimka4 ($10.15 in chips) 
Seat 3: Pokeaster ($12.38 in chips) 
Seat 4: Dcaro31 ($10.27 in chips) 
Seat 6: XaXaTyH4uK ($10.30 in chips) 
XaXaTyH4uK: posts small blind $0.05
Yabidooo: posts big blind $0.10
*** HOLE CARDS ***
Dimka4: folds 
ChuikaPridi joins the table at seat #5 
Pokeaster: folds 
Dcaro31: raises $0.20 to $0.30
XaXaTyH4uK: raises $0.70 to $1
Yabidooo: folds 
Dcaro31: calls $0.70
*** FLOP *** [Jc Kd Qs]
XaXaTyH4uK: bets $1.20
Dcaro31: folds 
Uncalled bet ($1.20) returned to XaXaTyH4uK
XaXaTyH4uK collected $2.01 from pot
*** SUMMARY ***
Total pot $2.10 | Rake $0.09 
Board [Jc Kd Qs]
Seat 1: Yabidooo (big blind) folded before Flop
Seat 2: Dimka4 folded before Flop (didn't bet)
Seat 3: Pokeaster folded before Flop (didn't bet)
Seat 4: Dcaro31 (button) folded on the Flop
Seat 6: XaXaTyH4uK (small blind) collected ($2.01)



PokerStars Hand #166667667793:  Hold'em No Limit ($0.05/$0.10 USD) - 2017/02/23 16:05:20 ET
Table 'Lacroute' 6-max Seat #2 is the button
Seat 1: johnnyPieper ($4.27 in chips) 
Seat 2: Andy Wolf ($10 in chips) 
Seat 3: Croplayer1 ($14.80 in chips) 
Seat 4: st4tion ($17.52 in chips) 
Seat 5: steepfell ($11.29 in chips) 
Seat 6: IAntikI ($10 in chips) 
Croplayer1: posts small blind $0.05
st4tion: posts big blind $0.10
*** HOLE CARDS ***
steepfell: folds 
IAntikI: raises $0.20 to $0.30
johnnyPieper: calls $0.30
Andy Wolf: folds 
Croplayer1: folds 
st4tion: folds 
*** FLOP *** [9c Kh 9d]
IAntikI: bets $0.50
johnnyPieper: folds 
Uncalled bet ($0.50) returned to IAntikI
IAntikI collected $0.72 from pot
*** SUMMARY ***
Total pot $0.75 | Rake $0.03 
Board [9c Kh 9d]
Seat 1: johnnyPieper folded on the Flop
Seat 2: Andy Wolf (button) folded before Flop (didn't bet)
Seat 3: Croplayer1 (small blind) folded before Flop
Seat 4: st4tion (big blind) folded before Flop
Seat 5: steepfell folded before Flop (didn't bet)
Seat 6: IAntikI collected ($0.72)



PokerStars Hand #166667668020:  Hold'em No Limit ($0.05/$0.10 USD) - 2017/02/23 16:05:21 ET
Table 'Camilla II' 6-max Seat #4 is the button
Seat 1: paxit71 ($8 in chips) 
Seat 2: Giyorod ($16.11 in chips) 
Seat 3: Andy Wolf ($10 in chips) 
Seat 4: chimera252 ($12.41 in chips) 
Seat 5: LarryTheStar ($11.24 in chips) 
Seat 6: david_sara83 ($10.15 in chips) 
LarryTheStar: posts small blind $0.05
david_sara83: posts big blind $0.10
*** HOLE CARDS ***
paxit71: raises $0.40 to $0.50
Giyorod: folds 
Andy Wolf: folds 
chimera252: folds 
LarryTheStar: folds 
david_sara83: folds 
Uncalled bet ($0.40) returned to paxit71
paxit71 collected $0.25 from pot
*** SUMMARY ***
Total pot $0.25 | Rake $0 
Seat 1: paxit71 collected ($0.25)
Seat 2: Giyorod folded before Flop (didn't bet)
Seat 3: Andy Wolf folded before Flop (didn't bet)
Seat 4: chimera252 (button) folded before Flop (didn't bet)
Seat 5: LarryTheStar (small blind) folded before Flop
Seat 6: david_sara83 (big blind) folded before Flop



PokerStars Hand #166667668072:  Hold'em No Limit ($0.05/$0.10 USD) - 2017/02/23 16:05:21 ET
Table 'Lederle' 6-max Seat #6 is the button
Seat 2: truck1234 ($15.90 in chips) 
Seat 3: Kazacha ($10.15 in chips) 
Seat 4: Pokeaster ($13.76 in chips) 
Seat 5: 8th wonders ($14.33 in chips) 
Seat 6: pokekrk ($10.10 in chips) 
truck1234: posts small blind $0.05
Kazacha: posts big blind $0.10
*** HOLE CARDS ***
Pokeaster: folds 
8th wonders: folds 
pokekrk: folds 
truck1234: folds 
Uncalled bet ($0.05) returned to Kazacha
Kazacha collected $0.10 from pot
*** SUMMARY ***
Total pot $0.10 | Rake $0 
Seat 2: truck1234 (small blind) folded before Flop
Seat 3: Kazacha (big blind) collected ($0.10)
Seat 4: Pokeaster folded before Flop (didn't bet)
Seat 5: 8th wonders folded before Flop (didn't bet)
Seat 6: pokekrk (button) folded before Flop (didn't bet)



PokerStars Hand #166667668108:  Hold'em No Limit ($0.05/$0.10 USD) - 2017/02/23 16:05:21 ET
Table 'Tirela' 6-max Seat #1 is the button
Seat 1: Smitty03300 ($10 in chips) 
Seat 2: Andrei ProFF ($17.69 in chips) 
Seat 3: aim444 ($15.77 in chips) 
Seat 4: ArcticBearDK ($10.01 in chips) 
Seat 5: KRZuff ($11.44 in chips) 
Seat 6: coolisses111 ($9.95 in chips) 
Andrei ProFF: posts small blind $0.05
aim444: posts big blind $0.10
*** HOLE CARDS ***
ArcticBearDK: folds 
KRZuff: raises $0.20 to $0.30
coolisses111: folds 
Smitty03300: folds 
Andrei ProFF: folds 
aim444: calls $0.20
*** FLOP *** [Ad 8h 2d]
aim444: checks 
KRZuff: bets $0.40
aim444: folds 
Uncalled bet ($0.40) returned to KRZuff
KRZuff collected $0.62 from pot
*** SUMMARY ***
Total pot $0.65 | Rake $0.03 
Board [Ad 8h 2d]
Seat 1: Smitty03300 (button) folded before Flop (didn't bet)
Seat 2: Andrei ProFF (small blind) folded before Flop
Seat 3: aim444 (big blind) folded on the Flop
Seat 4: ArcticBearDK folded before Flop (didn't bet)
Seat 5: KRZuff collected ($0.62)
Seat 6: coolisses111 folded before Flop (didn't bet)



PokerStars Hand #166667668289:  Hold'em No Limit ($0.05/$0.10 USD) - 2017/02/23 16:05:21 ET
Table 'Pallas II' 6-max Seat #2 is the button
Seat 1: mdelfin0 ($15.73 in chips) 
Seat 2: FRAID358 ($9.95 in chips) 
Seat 3: KRZuff ($10 in chips) 
Seat 5: Yspenyanin ($19.71 in chips) 
KRZuff: posts small blind $0.05
Mr. Bluff 34: is sitting out 
Yspenyanin: posts big blind $0.10
Orlangoor: sits out 
*** HOLE CARDS ***
Orlangoor leaves the table
Mr. Bluff 34 leaves the table
Kow6oy joins the table at seat #6 
mdelfin0: raises $0.15 to $0.25
FRAID358: raises $0.65 to $0.90
Kow6oy leaves the table
MisterX413 joins the table at seat #4 
Asilvagoat joins the table at seat #6 
KRZuff: folds 
Yspenyanin: folds 
mdelfin0: folds 
Uncalled bet ($0.65) returned to FRAID358
FRAID358 collected $0.65 from pot
*** SUMMARY ***
Total pot $0.65 | Rake $0 
Seat 1: mdelfin0 folded before Flop
Seat 2: FRAID358 (button) collected ($0.65)
Seat 3: KRZuff (small blind) folded before Flop
Seat 5: Yspenyanin (big blind) folded before Flop



PokerStars Hand #166667668500:  Hold'em No Limit ($0.05/$0.10 USD) - 2017/02/23 16:05:21 ET
Table 'Walpurga' 6-max Seat #3 is the button
Seat 1: chimera252 ($12.07 in chips) 
Seat 2: paxit71 ($6.69 in chips) 
Seat 3: marianoboni ($10 in chips) 
Seat 4: oddshoff ($13.09 in chips) 
Seat 6: AIONCMA1988 ($5 in chips) 
oddshoff: posts small blind $0.05
maxt92 was removed from the table for failing to post
AIONCMA1988: posts big blind $0.10
*** HOLE CARDS ***
Fremara joins the table at seat #5 
chimera252: raises $0.20 to $0.30
paxit71: folds 
marianoboni: folds 
oddshoff: folds 
AIONCMA1988: folds 
Uncalled bet ($0.20) returned to chimera252
chimera252 collected $0.25 from pot
*** SUMMARY ***
Total pot $0.25 | Rake $0 
Seat 1: chimera252 collected ($0.25)
Seat 2: paxit71 folded before Flop (didn't bet)
Seat 3: marianoboni (button) folded before Flop (didn't bet)
Seat 4: oddshoff (small blind) folded before Flop
Seat 6: AIONCMA1988 (big blind) folded before Flop



PokerStars Hand #166667668816:  Hold'em No Limit ($0.05/$0.10 USD) - 2017/02/23 16:05:21 ET
Table 'Lampetia III' 6-max Seat #5 is the button
Seat 1: gaHy_HaXeP ($10.70 in chips) 
Seat 2: DamDatsAnAce ($10 in chips) 
Seat 3: Therodorus ($10 in chips) 
Seat 4: IAntikI ($11.41 in chips) 
Seat 5: robson1235 ($19.73 in chips) 
Seat 6: bdixon_5 ($9.25 in chips) 
bdixon_5: posts small blind $0.05
gaHy_HaXeP: posts big blind $0.10
*** HOLE CARDS ***
DamDatsAnAce: raises $0.30 to $0.40
Therodorus: folds 
Therodorus leaves the table
Orlangoor joins the table at seat #3 
IAntikI: folds 
robson1235: folds 
bdixon_5: folds 
gaHy_HaXeP: folds 
Uncalled bet ($0.30) returned to DamDatsAnAce
DamDatsAnAce collected $0.25 from pot
*** SUMMARY ***
Total pot $0.25 | Rake $0 
Seat 1: gaHy_HaXeP (big blind) folded before Flop
Seat 2: DamDatsAnAce collected ($0.25)
Seat 3: Therodorus folded before Flop (didn't bet)
Seat 4: IAntikI folded before Flop (didn't bet)
Seat 5: robson1235 (button) folded before Flop (didn't bet)
Seat 6: bdixon_5 (small blind) folded before Flop



PokerStars Hand #166667669007:  Hold'em No Limit ($0.05/$0.10 USD) - 2017/02/23 16:05:22 ET
Table 'Tomita II' 6-max Seat #3 is the button
Seat 2: mhonielsen ($10 in chips) 
Seat 3: Lucky HoBBiT ($12.63 in chips) 
Seat 4: Hyd SK ($10 in chips) 
Seat 6: saniasmir ($10 in chips) 
Hyd SK: posts small blind $0.05
YY778 was removed from the table for failing to post
saniasmir: posts big blind $0.10
*** HOLE CARDS ***
mhonielsen: folds 
Lucky HoBBiT: folds 
Hyd SK: folds 
Uncalled bet ($0.05) returned to saniasmir
saniasmir collected $0.10 from pot
*** SUMMARY ***
Total pot $0.10 | Rake $0 
Seat 2: mhonielsen folded before Flop (didn't bet)
Seat 3: Lucky HoBBiT (button) folded before Flop (didn't bet)
Seat 4: Hyd SK (small blind) folded before Flop
Seat 6: saniasmir (big blind) collected ($0.10)



PokerStars Hand #166667669064:  Hold'em No Limit ($0.05/$0.10 USD) - 2017/02/23 16:05:22 ET
Table 'Kraz II' 6-max Seat #5 is the button
Seat 1: bdixon_5 ($9.70 in chips) 
Seat 3: Eddys Edge ($10 in chips) 
Seat 4: WinninBikini ($12.43 in chips) 
Seat 5: Joker51_wtf! ($10 in chips) 
Seat 6: tr41n3r12 ($10.05 in chips) 
tr41n3r12: posts small blind $0.05
bdixon_5: posts big blind $0.10
shellyld: sits out 
*** HOLE CARDS ***
Eddys Edge: folds 
WinninBikini: folds 
Joker51_wtf!: raises $0.12 to $0.22
tr41n3r12: folds 
bdixon_5: folds 
Uncalled bet ($0.12) returned to Joker51_wtf!
Joker51_wtf! collected $0.25 from pot
*** SUMMARY ***
Total pot $0.25 | Rake $0 
Seat 1: bdixon_5 (big blind) folded before Flop
Seat 3: Eddys Edge folded before Flop (didn't bet)
Seat 4: WinninBikini folded before Flop (didn't bet)
Seat 5: Joker51_wtf! (button) collected ($0.25)
Seat 6: tr41n3r12 (small blind) folded before Flop



PokerStars Hand #166667669207:  Hold'em No Limit ($0.05/$0.10 USD) - 2017/02/23 16:05:22 ET
Table 'Pulcova II' 6-max Seat #3 is the button
Seat 1: sexy_seagull ($13.40 in chips) 
Seat 2: Kazacha ($10 in chips) 
Seat 3: Lao Tsy ($14.13 in chips) 
Seat 4: VioXion ($10.30 in chips) 
Seat 5: mdelfin0 ($10 in chips) 
Seat 6: Ice_Isayev ($10.65 in chips) 
VioXion: posts small blind $0.05
mdelfin0: posts big blind $0.10
*** HOLE CARDS ***
Ice_Isayev: folds 
sexy_seagull: folds 
Kazacha: raises $0.14 to $0.24
Lao Tsy: raises $0.66 to $0.90
VioXion: folds 
mdelfin0: folds 
Kazacha: folds 
Uncalled bet ($0.66) returned to Lao Tsy
Lao Tsy collected $0.63 from pot
*** SUMMARY ***
Total pot $0.63 | Rake $0 
Seat 1: sexy_seagull folded before Flop (didn't bet)
Seat 2: Kazacha folded before Flop
Seat 3: Lao Tsy (button) collected ($0.63)
Seat 4: VioXion (small blind) folded before Flop
Seat 5: mdelfin0 (big blind) folded before Flop
Seat 6: Ice_Isayev folded before Flop (didn't bet)



PokerStars Hand #166667669710:  Hold'em No Limit ($0.05/$0.10 USD) - 2017/02/23 16:05:22 ET
Table 'Fechtig III' 6-max Seat #3 is the button
Seat 1: Scanner17 ($12.24 in chips) 
Seat 2: GV82 ($16.08 in chips) 
Seat 3: eniksenik ($10 in chips) 
Seat 4: Kow6oy ($10 in chips) 
Seat 5: ksandr_hom ($10.25 in chips) 
Seat 6: Glatzemandse ($18.04 in chips) 
Kow6oy: posts small blind $0.05
ksandr_hom: posts big blind $0.10
*** HOLE CARDS ***
Glatzemandse: calls $0.10
Scanner17: folds 
GV82: raises $0.20 to $0.30
eniksenik: calls $0.30
Kow6oy: calls $0.25
ksandr_hom: folds 
Glatzemandse: folds 
*** FLOP *** [Js 2h 9h]
Kow6oy: checks 
GV82: bets $1.05
eniksenik: folds 
Kow6oy: folds 
Uncalled bet ($1.05) returned to GV82
GV82 collected $1.05 from pot
*** SUMMARY ***
Total pot $1.10 | Rake $0.05 
Board [Js 2h 9h]
Seat 1: Scanner17 folded before Flop (didn't bet)
Seat 2: GV82 collected ($1.05)
Seat 3: eniksenik (button) folded on the Flop
Seat 4: Kow6oy (small blind) folded on the Flop
Seat 5: ksandr_hom (big blind) folded before Flop
Seat 6: Glatzemandse folded before Flop



PokerStars Hand #166667669824:  Hold'em No Limit ($0.05/$0.10 USD) - 2017/02/23 16:05:23 ET
Table 'California II' 6-max Seat #6 is the button
Seat 1: fedorka rus ($10.05 in chips) 
Seat 2: homelessdan ($10.15 in chips) 
Seat 3: Bird et al ($10.20 in chips) 
Seat 4: pokekrk ($11.96 in chips) 
Seat 6: chiko4040 ($7.96 in chips) 
fedorka rus: posts small blind $0.05
homelessdan: posts big blind $0.10
*** HOLE CARDS ***
Bird et al: folds 
pokekrk: raises $0.15 to $0.25
chiko4040: folds 
JahSoldier69 joins the table at seat #5 
JahSoldier69 leaves the table
fedorka rus: raises $0.55 to $0.80
homelessdan: folds 
pokekrk: calls $0.55
*** FLOP *** [Td 3c 3h]
Nikolai77798 joins the table at seat #5 
fedorka rus: bets $0.70
pokekrk: calls $0.70
*** TURN *** [Td 3c 3h] [5d]
fedorka rus: bets $1.10
pokekrk: raises $1.70 to $2.80
fedorka rus: folds 
Uncalled bet ($1.70) returned to pokekrk
pokekrk collected $5.06 from pot
*** SUMMARY ***
Total pot $5.30 | Rake $0.24 
Board [Td 3c 3h 5d]
Seat 1: fedorka rus (small blind) folded on the Turn
Seat 2: homelessdan (big blind) folded before Flop
Seat 3: Bird et al folded before Flop (didn't bet)
Seat 4: pokekrk collected ($5.06)
Seat 6: chiko4040 (button) folded before Flop (didn't bet)



PokerStars Hand #166667669845:  Hold'em No Limit ($0.05/$0.10 USD) - 2017/02/23 16:05:23 ET
Table 'Risha II' 6-max Seat #1 is the button
Seat 1: R. Lemonte ($13.42 in chips) 
Seat 2: KA3AXCTAHEU, ($12.55 in chips) 
Seat 3: steepfell ($10 in chips) 
Seat 4: Comeback3392 ($20.66 in chips) 
Seat 5: m.c-alkatraz ($10.20 in chips) 
Seat 6: univibe68 ($10.61 in chips) 
KA3AXCTAHEU,: posts small blind $0.05
steepfell: posts big blind $0.10
*** HOLE CARDS ***
Comeback3392: raises $0.20 to $0.30
m.c-alkatraz: folds 
univibe68: folds 
R. Lemonte: folds 
KA3AXCTAHEU,: folds 
steepfell: folds 
Uncalled bet ($0.20) returned to Comeback3392
Comeback3392 collected $0.25 from pot
*** SUMMARY ***
Total pot $0.25 | Rake $0 
Seat 1: R. Lemonte (button) folded before Flop (didn't bet)
Seat 2: KA3AXCTAHEU, (small blind) folded before Flop
Seat 3: steepfell (big blind) folded before Flop
Seat 4: Comeback3392 collected ($0.25)
Seat 5: m.c-alkatraz folded before Flop (didn't bet)
Seat 6: univibe68 folded before Flop (didn't bet)



PokerStars Hand #166667669927:  Hold'em No Limit ($0.05/$0.10 USD) - 2017/02/23 16:05:23 ET
Table 'Syringa' 6-max Seat #3 is the button
Seat 1: bdixon_5 ($7.80 in chips) 
Seat 2: Goroshkos88 ($10.41 in chips) 
Seat 3: Yspenyanin ($13.52 in chips) 
Seat 5: Andrei ProFF ($13.66 in chips) 
Seat 6: ibara000 ($16.28 in chips) 
Andrei ProFF: posts small blind $0.05
ibara000: posts big blind $0.10
*** HOLE CARDS ***
bdixon_5: folds 
Goroshkos88: raises $0.20 to $0.30
Yspenyanin: folds 
Andrei ProFF: folds 
ibara000: folds 
Uncalled bet ($0.20) returned to Goroshkos88
Goroshkos88 collected $0.25 from pot
*** SUMMARY ***
Total pot $0.25 | Rake $0 
Seat 1: bdixon_5 folded before Flop (didn't bet)
Seat 2: Goroshkos88 collected ($0.25)
Seat 3: Yspenyanin (button) folded before Flop (didn't bet)
Seat 5: Andrei ProFF (small blind) folded before Flop
Seat 6: ibara000 (big blind) folded before Flop



PokerStars Hand #166667670136:  Hold'em No Limit ($0.05/$0.10 USD) - 2017/02/23 16:05:23 ET
Table 'Phereclos II' 6-max Seat #2 is the button
Seat 1: Croplayer1 ($10 in chips) 
Seat 2: Kazacha ($10.13 in chips) 
Seat 4: DamDatsAnAce ($10.58 in chips) 
Seat 5: crazydevill ($10 in chips) 
Seat 6: mhonielsen ($16.30 in chips) 
BJamesB2014 will be allowed to play after the button
DamDatsAnAce: posts small blind $0.05
crazydevill: posts big blind $0.10
*** HOLE CARDS ***
mhonielsen: folds 
Croplayer1: folds 
Kazacha: raises $0.14 to $0.24
DamDatsAnAce: folds 
crazydevill: calls $0.14
*** FLOP *** [Jd 9s 5d]
crazydevill: checks 
Kazacha: bets $0.40
crazydevill: folds 
Uncalled bet ($0.40) returned to Kazacha
Kazacha collected $0.51 from pot
*** SUMMARY ***
Total pot $0.53 | Rake $0.02 
Board [Jd 9s 5d]
Seat 1: Croplayer1 folded before Flop (didn't bet)
Seat 2: Kazacha (button) collected ($0.51)
Seat 4: DamDatsAnAce (small blind) folded before Flop
Seat 5: crazydevill (big blind) folded on the Flop
Seat 6: mhonielsen folded before Flop (didn't bet)



PokerStars Hand #166667670171:  Hold'em No Limit ($0.05/$0.10 USD) - 2017/02/23 16:05:23 ET
Table 'Lesath III' 6-max Seat #3 is the button
Seat 1: Gogeta26 ($6.12 in chips) 
Seat 2: WinninBikini ($10.03 in chips) 
Seat 3: Giyorod ($10 in chips) 
Seat 4: Eddys Edge ($10.56 in chips) 
Seat 5: eniksenik ($16.15 in chips) 
Seat 6: patrick19111 ($10.56 in chips) 
Eddys Edge: posts small blind $0.05
eniksenik: posts big blind $0.10
*** HOLE CARDS ***
patrick19111: folds 
Gogeta26: calls $0.10
WinninBikini: raises $0.30 to $0.40
Giyorod: folds 
Eddys Edge: folds 
eniksenik: folds 
Gogeta26: raises $0.40 to $0.80
WinninBikini: calls $0.40
*** FLOP *** [4s 9s 6s]
Gogeta26: bets $5.32 and is all-in
WinninBikini: folds 
Uncalled bet ($5.32) returned to Gogeta26
Gogeta26 collected $1.67 from pot
*** SUMMARY ***
Total pot $1.75 | Rake $0.08 
Board [4s 9s 6s]
Seat 1: Gogeta26 collected ($1.67)
Seat 2: WinninBikini folded on the Flop
Seat 3: Giyorod (button) folded before Flop (didn't bet)
Seat 4: Eddys Edge (small blind) folded before Flop
Seat 5: eniksenik (big blind) folded before Flop
Seat 6: patrick19111 folded before Flop (didn't bet)



PokerStars Hand #166667670367:  Hold'em No Limit ($0.05/$0.10 USD) - 2017/02/23 16:05:23 ET
Table 'Cassini' 6-max Seat #6 is the button
Seat 1: Pokeaster ($10.82 in chips) 
Seat 2: mhonielsen ($12.56 in chips) 
Seat 4: fortieth ($13.57 in chips) 
Seat 5: johkom ($7.55 in chips) 
Seat 6: JahSoldier69 ($10.17 in chips) 
Pokeaster: posts small blind $0.05
mhonielsen: posts big blind $0.10
*** HOLE CARDS ***
fortieth: raises $0.17 to $0.27
johkom: folds 
JahSoldier69: folds 
Pokeaster: folds 
mhonielsen: folds 
Uncalled bet ($0.17) returned to fortieth
fortieth collected $0.25 from pot
*** SUMMARY ***
Total pot $0.25 | Rake $0 
Seat 1: Pokeaster (small blind) folded before Flop
Seat 2: mhonielsen (big blind) folded before Flop
Seat 4: fortieth collected ($0.25)
Seat 5: johkom folded before Flop (didn't bet)
Seat 6: JahSoldier69 (button) folded before Flop (didn't bet)



PokerStars Hand #166667670482:  Hold'em No Limit ($0.05/$0.10 USD) - 2017/02/23 16:05:23 ET
Table 'Hyakutake' 6-max Seat #6 is the button
Seat 1: Asilvagoat ($12.37 in chips) 
Seat 2: boxer821 ($10.79 in chips) 
Seat 3: lenboysprite ($5.94 in chips) 
Seat 4: eniksenik ($13.80 in chips) 
Seat 5: RoJ1 ($11.44 in chips) 
Seat 6: maxiv608 ($13.27 in chips) 
Asilvagoat: posts small blind $0.05
boxer821: posts big blind $0.10
*** HOLE CARDS ***
lenboysprite: folds 
eniksenik: folds 
RoJ1: folds 
maxiv608: raises $0.10 to $0.20
Asilvagoat: folds 
boxer821: folds 
Uncalled bet ($0.10) returned to maxiv608
maxiv608 collected $0.25 from pot
*** SUMMARY ***
Total pot $0.25 | Rake $0 
Seat 1: Asilvagoat (small blind) folded before Flop
Seat 2: boxer821 (big blind) folded before Flop
Seat 3: lenboysprite folded before Flop (didn't bet)
Seat 4: eniksenik folded before Flop (didn't bet)
Seat 5: RoJ1 folded before Flop (didn't bet)
Seat 6: maxiv608 (button) collected ($0.25)



PokerStars Hand #166667671064:  Hold'em No Limit ($0.05/$0.10 USD) - 2017/02/23 16:05:24 ET
Table 'Sham' 6-max Seat #1 is the button
Seat 1: pancernik21 ($10 in chips) 
Seat 2: ex3Lero86 ($10.35 in chips) 
Seat 3: weez3r ($22.68 in chips) 
Seat 4: VAD21 ($14.36 in chips) 
Seat 5: T9MS ($10.28 in chips) 
Seat 6: bdixon_5 ($8.15 in chips) 
ex3Lero86: posts small blind $0.05
weez3r: posts big blind $0.10
*** HOLE CARDS ***
VAD21: folds 
T9MS: raises $0.20 to $0.30
bdixon_5: calls $0.30
pancernik21: folds 
ex3Lero86: folds 
weez3r: raises $0.95 to $1.25
T9MS: folds 
bdixon_5: raises $1.05 to $2.30
weez3r: calls $1.05
*** FLOP *** [8c Jd 9s]
weez3r: bets $5
bdixon_5: raises $0.85 to $5.85 and is all-in
weez3r: calls $0.85
*** TURN *** [8c Jd 9s] [9d]
*** RIVER *** [8c Jd 9s 9d] [6c]
*** SHOW DOWN ***
weez3r: shows [As Qs] (a pair of Nines)
bdixon_5: shows [Ah Ad] (two pair, Aces and Nines)
bdixon_5 collected $15.90 from pot
*** SUMMARY ***
Total pot $16.65 | Rake $0.75 
Board [8c Jd 9s 9d 6c]
Seat 1: pancernik21 (button) folded before Flop (didn't bet)
Seat 2: ex3Lero86 (small blind) folded before Flop
Seat 3: weez3r (big blind) showed [As Qs] and lost with a pair of Nines
Seat 4: VAD21 folded before Flop (didn't bet)
Seat 5: T9MS folded before Flop
Seat 6: bdixon_5 showed [Ah Ad] and won ($15.90) with two pair, Aces and Nines



PokerStars Hand #166667671118:  Hold'em No Limit ($0.05/$0.10 USD) - 2017/02/23 16:05:24 ET
Table 'Geisha' 6-max Seat #3 is the button
Seat 1: facewald ($34.33 in chips) 
Seat 2: voledy ($10.60 in chips) 
Seat 3: Eddys Edge ($10 in chips) 
Seat 4: jvstsayyes ($11.07 in chips) 
Seat 5: KRZuff ($14.50 in chips) 
Seat 6: Namhkal ($21.48 in chips) 
jvstsayyes: posts small blind $0.05
KRZuff: posts big blind $0.10
*** HOLE CARDS ***
Namhkal: folds 
facewald: raises $0.19 to $0.29
voledy: folds 
Eddys Edge: folds 
jvstsayyes: calls $0.24
KRZuff: calls $0.19
*** FLOP *** [6c 2c Ah]
jvstsayyes: bets $0.10
KRZuff: calls $0.10
facewald: folds 
*** TURN *** [6c 2c Ah] [Kh]
jvstsayyes: bets $0.20
KRZuff: folds 
Uncalled bet ($0.20) returned to jvstsayyes
jvstsayyes collected $1.02 from pot
*** SUMMARY ***
Total pot $1.07 | Rake $0.05 
Board [6c 2c Ah Kh]
Seat 1: facewald folded on the Flop
Seat 2: voledy folded before Flop (didn't bet)
Seat 3: Eddys Edge (button) folded before Flop (didn't bet)
Seat 4: jvstsayyes (small blind) collected ($1.02)
Seat 5: KRZuff (big blind) folded on the Turn
Seat 6: Namhkal folded before Flop (didn't bet)



PokerStars Hand #166667671119:  Hold'em No Limit ($0.05/$0.10 USD) - 2017/02/23 16:05:24 ET
Table 'Jokaste II' 6-max Seat #2 is the button
Seat 1: Hyd SK ($13.55 in chips) 
Seat 2: T9MS ($12.33 in chips) 
Seat 3: crazydevill ($9.90 in chips) 
Seat 4: FRAID358 ($15.36 in chips) 
Seat 5: Vrinni ($10.28 in chips) 
Seat 6: Adailton07 ($15.05 in chips) 
crazydevill: posts small blind $0.05
FRAID358: posts big blind $0.10
*** HOLE CARDS ***
Vrinni: folds 
Adailton07: raises $0.20 to $0.30
Hyd SK: folds 
T9MS: folds 
crazydevill: folds 
FRAID358: folds 
Uncalled bet ($0.20) returned to Adailton07
Adailton07 collected $0.25 from pot
*** SUMMARY ***
Total pot $0.25 | Rake $0 
Seat 1: Hyd SK folded before Flop (didn't bet)
Seat 2: T9MS (button) folded before Flop (didn't bet)
Seat 3: crazydevill (small blind) folded before Flop
Seat 4: FRAID358 (big blind) folded before Flop
Seat 5: Vrinni folded before Flop (didn't bet)
Seat 6: Adailton07 collected ($0.25)



PokerStars Hand #166667671166:  Hold'em No Limit ($0.05/$0.10 USD) - 2017/02/23 16:05:24 ET
Table 'Xanthippe II' 6-max Seat #2 is the button
Seat 1: ade22345 ($8.55 in chips) 
Seat 2: Bird et al ($13.51 in chips) 
Seat 3: Dcaro31 ($10.97 in chips) 
Seat 4: Barcardi14 ($5.51 in chips) 
Seat 5: yodzik ($5 in chips) 
Seat 6: Orlangoor ($10.64 in chips) 
Dcaro31: posts small blind $0.05
Barcardi14: posts big blind $0.10
*** HOLE CARDS ***
yodzik: folds 
Orlangoor: folds 
ade22345: folds 
Bird et al: folds 
Dcaro31: folds 
Uncalled bet ($0.05) returned to Barcardi14
Barcardi14 collected $0.10 from pot
*** SUMMARY ***
Total pot $0.10 | Rake $0 
Seat 1: ade22345 folded before Flop (didn't bet)
Seat 2: Bird et al (button) folded before Flop (didn't bet)
Seat 3: Dcaro31 (small blind) folded before Flop
Seat 4: Barcardi14 (big blind) collected ($0.10)
Seat 5: yodzik folded before Flop (didn't bet)
Seat 6: Orlangoor folded before Flop (didn't bet)



PokerStars Hand #166667671180:  Hold'em No Limit ($0.05/$0.10 USD) - 2017/02/23 16:05:24 ET
Table 'Anhui II' 6-max Seat #6 is the button
Seat 1: kingartur222 ($12.92 in chips) 
Seat 2: kikus334 ($12.66 in chips) 
Seat 3: lochniak556 ($26 in chips) 
Seat 4: dragonste89 ($10 in chips) 
Seat 5: Bandyaev ($10 in chips) 
Seat 6: .BaRReL.1122 ($5.05 in chips) 
kingartur222: posts small blind $0.05
kikus334: posts big blind $0.10
*** HOLE CARDS ***
lochniak556: raises $0.30 to $0.40
dragonste89: folds 
Bandyaev: folds 
.BaRReL.1122: calls $0.40
kingartur222: folds 
kikus334: calls $0.30
*** FLOP *** [2s Ad Jd]
kikus334: checks 
lochniak556: checks 
.BaRReL.1122: checks 
*** TURN *** [2s Ad Jd] [8c]
kikus334: checks 
lochniak556: bets $1.10
lochniak556 said, "pas"
.BaRReL.1122: folds 
kikus334: folds 
Uncalled bet ($1.10) returned to lochniak556
lochniak556 collected $1.19 from pot
*** SUMMARY ***
Total pot $1.25 | Rake $0.06 
Board [2s Ad Jd 8c]
Seat 1: kingartur222 (small blind) folded before Flop
Seat 2: kikus334 (big blind) folded on the Turn
Seat 3: lochniak556 collected ($1.19)
Seat 4: dragonste89 folded before Flop (didn't bet)
Seat 5: Bandyaev folded before Flop (didn't bet)
Seat 6: .BaRReL.1122 (button) folded on the Turn



PokerStars Hand #166667671262:  Hold'em No Limit ($0.05/$0.10 USD) - 2017/02/23 16:05:24 ET
Table 'Bootes' 6-max Seat #4 is the button
Seat 1: Namhkal ($12.87 in chips) 
Seat 2: Bird et al ($19.30 in chips) 
Seat 3: KA3AXCTAHEU, ($19.23 in chips) 
Seat 4: totonove ($5.12 in chips) 
Seat 6: cherep61987 ($10.27 in chips) 
cherep61987: posts small blind $0.05
Namhkal: posts big blind $0.10
*** HOLE CARDS ***
Bird et al: folds 
KA3AXCTAHEU,: folds 
totonove: calls $0.10
cherep61987: folds 
Namhkal: raises $0.30 to $0.40
totonove: folds 
Uncalled bet ($0.30) returned to Namhkal
Namhkal collected $0.25 from pot
*** SUMMARY ***
Total pot $0.25 | Rake $0 
Seat 1: Namhkal (big blind) collected ($0.25)
Seat 2: Bird et al folded before Flop (didn't bet)
Seat 3: KA3AXCTAHEU, folded before Flop (didn't bet)
Seat 4: totonove (button) folded before Flop
Seat 6: cherep61987 (small blind) folded before Flop



PokerStars Hand #166667671740:  Hold'em No Limit ($0.05/$0.10 USD) - 2017/02/23 16:05:25 ET
Table 'Grietje' 6-max Seat #6 is the button
Seat 1: dragonste89 ($10 in chips) 
Seat 2: Feverhead ($12.72 in chips) 
Seat 4: MihaGr ($10.50 in chips) 
Seat 5: iThreeBarrel ($10.15 in chips) 
Seat 6: Prometheu$8 ($21.55 in chips) 
dragonste89: posts small blind $0.05
Feverhead: posts big blind $0.10
GitoValdivia: sits out 
*** HOLE CARDS ***
MihaGr: folds 
iThreeBarrel: folds 
Prometheu$8: raises $0.25 to $0.35
dragonste89: folds 
Feverhead: folds 
Uncalled bet ($0.25) returned to Prometheu$8
Prometheu$8 collected $0.25 from pot
*** SUMMARY ***
Total pot $0.25 | Rake $0 
Seat 1: dragonste89 (small blind) folded before Flop
Seat 2: Feverhead (big blind) folded before Flop
Seat 4: MihaGr folded before Flop (didn't bet)
Seat 5: iThreeBarrel folded before Flop (didn't bet)
Seat 6: Prometheu$8 (button) collected ($0.25)



PokerStars Hand #166667671984:  Hold'em No Limit ($0.05/$0.10 USD) - 2017/02/23 16:05:25 ET
Table 'Vaisala' 6-max Seat #3 is the button
Seat 2: XaXaTyH4uK ($12.14 in chips) 
Seat 3: x3ultimate ($10.10 in chips) 
Seat 4: sexy_seagull ($11.43 in chips) 
Seat 5: AIONCMA1988 ($3.80 in chips) 
Seat 6: Aleksey K228 ($15.43 in chips) 
sexy_seagull: posts small blind $0.05
AIONCMA1988: posts big blind $0.10
*** HOLE CARDS ***
Aleksey K228: folds 
XaXaTyH4uK: folds 
x3ultimate: folds 
sexy_seagull: folds 
Uncalled bet ($0.05) returned to AIONCMA1988
AIONCMA1988 collected $0.10 from pot
*** SUMMARY ***
Total pot $0.10 | Rake $0 
Seat 2: XaXaTyH4uK folded before Flop (didn't bet)
Seat 3: x3ultimate (button) folded before Flop (didn't bet)
Seat 4: sexy_seagull (small blind) folded before Flop
Seat 5: AIONCMA1988 (big blind) collected ($0.10)
Seat 6: Aleksey K228 folded before Flop (didn't bet)



PokerStars Hand #166667672199:  Hold'em No Limit ($0.05/$0.10 USD) - 2017/02/23 16:05:25 ET
Table 'Aludra II' 6-max Seat #6 is the button
Seat 1: voledy ($10.28 in chips) 
Seat 2: JahSoldier69 ($14.20 in chips) 
Seat 4: MihaGr ($10 in chips) 
Seat 5: kingartur222 ($15.45 in chips) 
Seat 6: call me haaa ($14.64 in chips) 
voledy: posts small blind $0.05
JahSoldier69: posts big blind $0.10
*** HOLE CARDS ***
MihaGr: raises $0.20 to $0.30
kingartur222: folds 
call me haaa: calls $0.30
voledy: folds 
JahSoldier69: folds 
*** FLOP *** [8c Kc Ah]
MihaGr: checks 
steepfell joins the table at seat #3 
call me haaa: bets $0.36
steepfell leaves the table
MihaGr: calls $0.36
*** TURN *** [8c Kc Ah] [4c]
MihaGr: checks 
mbkongstad joins the table at seat #3 
call me haaa: checks 
*** RIVER *** [8c Kc Ah 4c] [Tc]
MihaGr: checks 
call me haaa: checks 
*** SHOW DOWN ***
MihaGr: shows [Qh Kh] (a pair of Kings)
call me haaa: mucks hand 
MihaGr collected $1.40 from pot
*** SUMMARY ***
Total pot $1.47 | Rake $0.07 
Board [8c Kc Ah 4c Tc]
Seat 1: voledy (small blind) folded before Flop
Seat 2: JahSoldier69 (big blind) folded before Flop
Seat 4: MihaGr showed [Qh Kh] and won ($1.40) with a pair of Kings
Seat 5: kingartur222 folded before Flop (didn't bet)
Seat 6: call me haaa (button) mucked



PokerStars Hand #166667672306:  Hold'em No Limit ($0.05/$0.10 USD) - 2017/02/23 16:05:25 ET
Table 'Nemo III' 6-max Seat #2 is the button
Seat 1: Kow6oy ($10 in chips) 
Seat 2: Bandyaev ($11.74 in chips) 
Seat 3: Dimka4 ($10.05 in chips) 
Seat 4: vtalian ($9.70 in chips) 
Seat 5: Joker51_wtf! ($11.43 in chips) 
Dimka4: posts small blind $0.05
vtalian: posts big blind $0.10
maxiv608: sits out 
*** HOLE CARDS ***
Joker51_wtf!: folds 
Kow6oy: folds 
Bandyaev: folds 
Dimka4: folds 
Uncalled bet ($0.05) returned to vtalian
vtalian collected $0.10 from pot
*** SUMMARY ***
Total pot $0.10 | Rake $0 
Seat 1: Kow6oy folded before Flop (didn't bet)
Seat 2: Bandyaev (button) folded before Flop (didn't bet)
Seat 3: Dimka4 (small blind) folded before Flop
Seat 4: vtalian (big blind) collected ($0.10)
Seat 5: Joker51_wtf! folded before Flop (didn't bet)



PokerStars Hand #166667672469:  Hold'em No Limit ($0.05/$0.10 USD) - 2017/02/23 16:05:25 ET
Table 'Cyane' 6-max Seat #6 is the button
Seat 1: KA3AXCTAHEU, ($10 in chips) 
Seat 2: sashi18 ($8.16 in chips) 
Seat 3: Mamm0nism ($13.04 in chips) 
Seat 4: truck1234 ($20.81 in chips) 
Seat 6: 8th wonders ($11.60 in chips) 
KA3AXCTAHEU,: posts small blind $0.05
sashi18: posts big blind $0.10
RoJ1: sits out 
*** HOLE CARDS ***
Mamm0nism: folds 
truck1234: folds 
8th wonders: folds 
KA3AXCTAHEU,: folds 
Uncalled bet ($0.05) returned to sashi18
sashi18 collected $0.10 from pot
*** SUMMARY ***
Total pot $0.10 | Rake $0 
Seat 1: KA3AXCTAHEU, (small blind) folded before Flop
Seat 2: sashi18 (big blind) collected ($0.10)
Seat 3: Mamm0nism folded before Flop (didn't bet)
Seat 4: truck1234 folded before Flop (didn't bet)
Seat 6: 8th wonders (button) folded before Flop (didn't bet)



PokerStars Hand #166667672494:  Hold'em No Limit ($0.05/$0.10 USD) - 2017/02/23 16:05:25 ET
Table 'Alnasl II' 6-max Seat #2 is the button
Seat 1: dragonste89 ($13 in chips) 
Seat 2: Therodorus ($11.76 in chips) 
Seat 3: ICBM-RS26 ($8.18 in chips) 
Seat 4: Eddys Edge ($10 in chips) 
Seat 5: mdelfin0 ($12.46 in chips) 
Seat 6: Bommer78 ($4.76 in chips) 
ICBM-RS26: posts small blind $0.05
Eddys Edge: posts big blind $0.10
*** HOLE CARDS ***
mdelfin0: folds 
Bommer78: folds 
dragonste89: raises $0.20 to $0.30
Therodorus: raises $0.60 to $0.90
ICBM-RS26: folds 
Eddys Edge: folds 
dragonste89: raises $1.50 to $2.40
Therodorus: folds 
Uncalled bet ($1.50) returned to dragonste89
dragonste89 collected $1.95 from pot
*** SUMMARY ***
Total pot $1.95 | Rake $0 
Seat 1: dragonste89 collected ($1.95)
Seat 2: Therodorus (button) folded before Flop
Seat 3: ICBM-RS26 (small blind) folded before Flop
Seat 4: Eddys Edge (big blind) folded before Flop
Seat 5: mdelfin0 folded before Flop (didn't bet)
Seat 6: Bommer78 folded before Flop (didn't bet)



PokerStars Hand #166667672538:  Hold'em No Limit ($0.05/$0.10 USD) - 2017/02/23 16:05:25 ET
Table 'Caupolican' 6-max Seat #4 is the button
Seat 1: kingartur222 ($11.49 in chips) 
Seat 2: garigura ($18.90 in chips) 
Seat 4: mhonielsen ($15.64 in chips) 
Seat 5: Kazacha ($10.61 in chips) 
Seat 6: crazydevill ($10.77 in chips) 
Kazacha: posts small blind $0.05
crazydevill: posts big blind $0.10
*** HOLE CARDS ***
kingartur222: folds 
garigura: folds 
mhonielsen: raises $0.15 to $0.25
Kazacha: folds 
crazydevill: folds 
Uncalled bet ($0.15) returned to mhonielsen
mhonielsen collected $0.25 from pot
*** SUMMARY ***
Total pot $0.25 | Rake $0 
Seat 1: kingartur222 folded before Flop (didn't bet)
Seat 2: garigura folded before Flop (didn't bet)
Seat 4: mhonielsen (button) collected ($0.25)
Seat 5: Kazacha (small blind) folded before Flop
Seat 6: crazydevill (big blind) folded before Flop



PokerStars Hand #166667672941:  Hold'em No Limit ($0.05/$0.10 USD) - 2017/02/23 16:05:26 ET
Table 'Pirola III' 6-max Seat #6 is the button
Seat 1: bdixon_5 ($9.37 in chips) 
Seat 3: kingartur222 ($10.82 in chips) 
Seat 4: McCleans ($10.72 in chips) 
Seat 5: tequila_joop ($10.40 in chips) 
Seat 6: T9MS ($10 in chips) 
bdixon_5: posts small blind $0.05
gaHy_HaXeP: is sitting out 
kingartur222: posts big blind $0.10
*** HOLE CARDS ***
gaHy_HaXeP leaves the table
Chodemuncher joins the table at seat #2 
McCleans: folds 
tequila_joop: raises $0.20 to $0.30
T9MS: folds 
bdixon_5: folds 
kingartur222: folds 
Uncalled bet ($0.20) returned to tequila_joop
tequila_joop collected $0.25 from pot
*** SUMMARY ***
Total pot $0.25 | Rake $0 
Seat 1: bdixon_5 (small blind) folded before Flop
Seat 3: kingartur222 (big blind) folded before Flop
Seat 4: McCleans folded before Flop (didn't bet)
Seat 5: tequila_joop collected ($0.25)
Seat 6: T9MS (button) folded before Flop (didn't bet)



PokerStars Hand #166667673631:  Hold'em No Limit ($0.05/$0.10 USD) - 2017/02/23 16:05:27 ET
Table 'Markab II' 6-max Seat #3 is the button
Seat 1: david_sara83 ($10.67 in chips) 
Seat 2: truck1234 ($11.05 in chips) 
Seat 3: sexy_seagull ($10 in chips) 
Seat 4: Crafty23@PS ($11.59 in chips) 
Seat 5: Rodik002 ($19.32 in chips) 
Seat 6: Comeback3392 ($10 in chips) 
Crafty23@PS: posts small blind $0.05
Rodik002: posts big blind $0.10
*** HOLE CARDS ***
Comeback3392: folds 
david_sara83: folds 
truck1234: folds 
sexy_seagull: folds 
Crafty23@PS: folds 
Uncalled bet ($0.05) returned to Rodik002
Rodik002 collected $0.10 from pot
*** SUMMARY ***
Total pot $0.10 | Rake $0 
Seat 1: david_sara83 folded before Flop (didn't bet)
Seat 2: truck1234 folded before Flop (didn't bet)
Seat 3: sexy_seagull (button) folded before Flop (didn't bet)
Seat 4: Crafty23@PS (small blind) folded before Flop
Seat 5: Rodik002 (big blind) collected ($0.10)
Seat 6: Comeback3392 folded before Flop (didn't bet)



PokerStars Hand #166667673713:  Hold'em No Limit ($0.05/$0.10 USD) - 2017/02/23 16:05:27 ET
Table 'Isberga' 6-max Seat #2 is the button
Seat 1: Feverhead ($18.17 in chips) 
Seat 2: GESPERIA ($10.27 in chips) 
Seat 4: THIMUCHIN ($10.74 in chips) 
Seat 5: YoungGriff86 ($19.02 in chips) 
Seat 6: Goroshkos88 ($21.23 in chips) 
THIMUCHIN: posts small blind $0.05
YoungGriff86: posts big blind $0.10
*** HOLE CARDS ***
Goroshkos88: folds 
Feverhead: raises $0.15 to $0.25
GESPERIA: folds 
THIMUCHIN: folds 
YoungGriff86: folds 
Uncalled bet ($0.15) returned to Feverhead
Feverhead collected $0.25 from pot
*** SUMMARY ***
Total pot $0.25 | Rake $0 
Seat 1: Feverhead collected ($0.25)
Seat 2: GESPERIA (button) folded before Flop (didn't bet)
Seat 4: THIMUCHIN (small blind) folded before Flop
Seat 5: YoungGriff86 (big blind) folded before Flop
Seat 6: Goroshkos88 folded before Flop (didn't bet)



PokerStars Hand #166667673901:  Hold'em No Limit ($0.05/$0.10 USD) - 2017/02/23 16:05:27 ET
Table 'Armenia' 6-max Seat #5 is the button
Seat 1: tr41n3r12 ($12.02 in chips) 
Seat 2: Yabidooo ($11.72 in chips) 
Seat 3: XwinX25 ($10.15 in chips) 
Seat 5: boxer821 ($12.28 in chips) 
Seat 6: mega spasser ($6.26 in chips) 
mega spasser: posts small blind $0.05
tr41n3r12: posts big blind $0.10
*** HOLE CARDS ***
Yabidooo: folds 
mbkongstad joins the table at seat #4 
XwinX25: folds 
boxer821: folds 
mega spasser: raises $0.20 to $0.30
tr41n3r12: calls $0.20
*** FLOP *** [Jd 4s 2h]
mega spasser: bets $0.29
tr41n3r12: folds 
Uncalled bet ($0.29) returned to mega spasser
mega spasser collected $0.57 from pot
*** SUMMARY ***
Total pot $0.60 | Rake $0.03 
Board [Jd 4s 2h]
Seat 1: tr41n3r12 (big blind) folded on the Flop
Seat 2: Yabidooo folded before Flop (didn't bet)
Seat 3: XwinX25 folded before Flop (didn't bet)
Seat 5: boxer821 (button) folded before Flop (didn't bet)
Seat 6: mega spasser (small blind) collected ($0.57)



PokerStars Hand #166667673976:  Hold'em No Limit ($0.05/$0.10 USD) - 2017/02/23 16:05:27 ET
Table 'Carina' 6-max Seat #3 is the button
Seat 1: Kupi007 ($10 in chips) 
Seat 2: kickereens ($24.59 in chips) 
Seat 3: LarryTheStar ($10.91 in chips) 
Seat 5: IAntikI ($10.20 in chips) 
Seat 6: alexweezer ($8.70 in chips) 
steepfell will be allowed to play after the button
IAntikI: posts small blind $0.05
alexweezer: posts big blind $0.10
*** HOLE CARDS ***
Kupi007: folds 
kickereens: raises $0.20 to $0.30
LarryTheStar: calls $0.30
IAntikI: folds 
alexweezer: calls $0.20
*** FLOP *** [4h 2c 6d]
alexweezer: checks 
kickereens: checks 
LarryTheStar: checks 
*** TURN *** [4h 2c 6d] [5h]
alexweezer: checks 
kickereens: checks 
LarryTheStar: bets $0.70
alexweezer: folds 
kickereens: folds 
Uncalled bet ($0.70) returned to LarryTheStar
LarryTheStar collected $0.91 from pot
*** SUMMARY ***
Total pot $0.95 | Rake $0.04 
Board [4h 2c 6d 5h]
Seat 1: Kupi007 folded before Flop (didn't bet)
Seat 2: kickereens folded on the Turn
Seat 3: LarryTheStar (button) collected ($0.91)
Seat 5: IAntikI (small blind) folded before Flop
Seat 6: alexweezer (big blind) folded on the Turn



PokerStars Hand #166667674288:  Hold'em No Limit ($0.05/$0.10 USD) - 2017/02/23 16:05:27 ET
Table 'Wilkens II' 6-max Seat #6 is the button
Seat 1: Islamiq-GuRL ($10.88 in chips) 
Seat 2: manashov ($10.75 in chips) 
Seat 3: Namhkal ($10.40 in chips) 
Seat 5: patrick19111 ($11.58 in chips) 
Seat 6: XaXaTyH4uK ($14.31 in chips) 
Islamiq-GuRL: posts small blind $0.05
manashov: posts big blind $0.10
myevc: sits out 
*** HOLE CARDS ***
Namhkal: raises $0.15 to $0.25
patrick19111: folds 
XaXaTyH4uK: folds 
Islamiq-GuRL: calls $0.20
manashov: folds 
*** FLOP *** [Ts 6d Tc]
Islamiq-GuRL: checks 
Namhkal: bets $0.29
Islamiq-GuRL: calls $0.29
*** TURN *** [Ts 6d Tc] [4c]
Islamiq-GuRL: checks 
Namhkal: checks 
*** RIVER *** [Ts 6d Tc 4c] [8s]
Islamiq-GuRL: checks 
Namhkal: checks 
*** SHOW DOWN ***
Islamiq-GuRL: shows [Jc Ah] (a pair of Tens)
Namhkal: shows [9c 9s] (two pair, Tens and Nines)
Namhkal collected $1.13 from pot
*** SUMMARY ***
Total pot $1.18 | Rake $0.05 
Board [Ts 6d Tc 4c 8s]
Seat 1: Islamiq-GuRL (small blind) showed [Jc Ah] and lost with a pair of Tens
Seat 2: manashov (big blind) folded before Flop
Seat 3: Namhkal showed [9c 9s] and won ($1.13) with two pair, Tens and Nines
Seat 5: patrick19111 folded before Flop (didn't bet)
Seat 6: XaXaTyH4uK (button) folded before Flop (didn't bet)



PokerStars Hand #166667674330:  Hold'em No Limit ($0.05/$0.10 USD) - 2017/02/23 16:05:27 ET
Table 'Wil' 6-max Seat #1 is the button
Seat 1: jwhelan94 ($22.94 in chips) 
Seat 2: Vrinni ($21.50 in chips) 
Seat 3: Namhkal ($10 in chips) 
Seat 4: x3ultimate ($10.70 in chips) 
Seat 5: Feverhead ($14.06 in chips) 
Seat 6: Comeback3392 ($13.78 in chips) 
Vrinni: posts small blind $0.05
Namhkal: posts big blind $0.10
*** HOLE CARDS ***
x3ultimate: folds 
Feverhead: folds 
Comeback3392: folds 
jwhelan94: folds 
Vrinni: raises $0.15 to $0.25
Namhkal: calls $0.15
*** FLOP *** [Jd 5s 2c]
Vrinni: bets $0.24
Namhkal: calls $0.24
*** TURN *** [Jd 5s 2c] [Ks]
Vrinni: bets $0.63
Namhkal: folds 
Uncalled bet ($0.63) returned to Vrinni
Vrinni collected $0.94 from pot
*** SUMMARY ***
Total pot $0.98 | Rake $0.04 
Board [Jd 5s 2c Ks]
Seat 1: jwhelan94 (button) folded before Flop (didn't bet)
Seat 2: Vrinni (small blind) collected ($0.94)
Seat 3: Namhkal (big blind) folded on the Turn
Seat 4: x3ultimate folded before Flop (didn't bet)
Seat 5: Feverhead folded before Flop (didn't bet)
Seat 6: Comeback3392 folded before Flop (didn't bet)



PokerStars Hand #166667674581:  Hold'em No Limit ($0.05/$0.10 USD) - 2017/02/23 16:05:28 ET
Table 'Girtab' 6-max Seat #3 is the button
Seat 1: pokekrk ($13.56 in chips) 
Seat 2: MühliJr ($10 in chips) 
Seat 3: kingartur222 ($10.45 in chips) 
Seat 4: Hyd SK ($10.91 in chips) 
Seat 5: sexy_seagull ($11.30 in chips) 
Hyd SK: posts small blind $0.05
sexy_seagull: posts big blind $0.10
*** HOLE CARDS ***
pokekrk: folds 
MühliJr: folds 
kingartur222: folds 
iluzja12 joins the table at seat #6 
Hyd SK: raises $0.25 to $0.35
sexy_seagull: calls $0.25
*** FLOP *** [5d 8d 7h]
Hyd SK: bets $0.44
sexy_seagull: folds 
Uncalled bet ($0.44) returned to Hyd SK
Hyd SK collected $0.67 from pot
*** SUMMARY ***
Total pot $0.70 | Rake $0.03 
Board [5d 8d 7h]
Seat 1: pokekrk folded before Flop (didn't bet)
Seat 2: MühliJr folded before Flop (didn't bet)
Seat 3: kingartur222 (button) folded before Flop (didn't bet)
Seat 4: Hyd SK (small blind) collected ($0.67)
Seat 5: sexy_seagull (big blind) folded on the Flop



PokerStars Hand #166667675054:  Hold'em No Limit ($0.05/$0.10 USD) - 2017/02/23 16:05:28 ET
Table 'Crommelin II' 6-max Seat #5 is the button
Seat 1: THIMUCHIN ($11.67 in chips) 
Seat 2: Bird et al ($10 in chips) 
Seat 3: Strelok1974 ($21.80 in chips) 
Seat 4: Pequeño Clau ($13.12 in chips) 
Seat 5: Action_Gibi ($17.13 in chips) 
THIMUCHIN: posts small blind $0.05
Bird et al: posts big blind $0.10
*** HOLE CARDS ***
Strelok1974: folds 
Pequeño Clau: folds 
Action_Gibi: folds 
THIMUCHIN: folds 
Uncalled bet ($0.05) returned to Bird et al
Bird et al collected $0.10 from pot
*** SUMMARY ***
Total pot $0.10 | Rake $0 
Seat 1: THIMUCHIN (small blind) folded before Flop
Seat 2: Bird et al (big blind) collected ($0.10)
Seat 3: Strelok1974 folded before Flop (didn't bet)
Seat 4: Pequeño Clau folded before Flop (didn't bet)
Seat 5: Action_Gibi (button) folded before Flop (didn't bet)



PokerStars Hand #166667675089:  Hold'em No Limit ($0.05/$0.10 USD) - 2017/02/23 16:05:28 ET
Table 'Persephone' 6-max Seat #4 is the button
Seat 2: AM-L-SL ($5.50 in chips) 
Seat 3: DasoII ($4.85 in chips) 
Seat 4: 2G28 ($10 in chips) 
Seat 5: ab260414 ($10 in chips) 
Seat 6: popypaleta ($14.39 in chips) 
ab260414: posts small blind $0.05
popypaleta: posts big blind $0.10
dragonste89: sits out 
*** HOLE CARDS ***
AM-L-SL: folds 
DasoII: folds 
2G28: folds 
ab260414: folds 
Uncalled bet ($0.05) returned to popypaleta
popypaleta collected $0.10 from pot
*** SUMMARY ***
Total pot $0.10 | Rake $0 
Seat 2: AM-L-SL folded before Flop (didn't bet)
Seat 3: DasoII folded before Flop (didn't bet)
Seat 4: 2G28 (button) folded before Flop (didn't bet)
Seat 5: ab260414 (small blind) folded before Flop
Seat 6: popypaleta (big blind) collected ($0.10)



PokerStars Hand #166667675267:  Hold'em No Limit ($0.05/$0.10 USD) - 2017/02/23 16:05:28 ET
Table 'Brendelia II' 6-max Seat #2 is the button
Seat 2: Crimsonr ($5.20 in chips) 
Seat 3: ValdemorS ($18.86 in chips) 
Seat 6: luckyPositiv ($10.15 in chips) 
ValdemorS: posts small blind $0.05
luckyPositiv: posts big blind $0.10
Crimsonr: posts the ante $0.02
ValdemorS: posts the ante $0.02
luckyPositiv: posts the ante $0.02
*** HOLE CARDS ***
Crimsonr: folds 
ValdemorS: folds 
Uncalled bet ($0.05) returned to luckyPositiv
luckyPositiv collected $0.16 from pot
*** SUMMARY ***
Total pot $0.16 | Rake $0 
Seat 2: Crimsonr (button) folded before Flop (didn't bet)
Seat 3: ValdemorS (small blind) folded before Flop
Seat 6: luckyPositiv (big blind) collected ($0.16)



PokerStars Hand #166667675311:  Hold'em No Limit ($0.05/$0.10 USD) - 2017/02/23 16:05:28 ET
Table 'Aisakos II' 6-max Seat #6 is the button
Seat 1: Crafty23@PS ($10.55 in chips) 
Seat 2: svaika24 ($17.08 in chips) 
Seat 3: iamkakaroto ($10.54 in chips) 
Seat 4: T9MS ($10 in chips) 
Seat 5: KokoulinV ($12.05 in chips) 
Seat 6: LarryTheStar ($10 in chips) 
Crafty23@PS: posts small blind $0.05
svaika24: posts big blind $0.10
*** HOLE CARDS ***
iamkakaroto: folds 
T9MS: folds 
KokoulinV: folds 
LarryTheStar: raises $0.10 to $0.20
Crafty23@PS: folds 
svaika24: calls $0.10
*** FLOP *** [2c 9s 2h]
svaika24: checks 
LarryTheStar: checks 
*** TURN *** [2c 9s 2h] [5s]
svaika24: checks 
LarryTheStar: bets $0.30
svaika24: folds 
Uncalled bet ($0.30) returned to LarryTheStar
LarryTheStar collected $0.43 from pot
*** SUMMARY ***
Total pot $0.45 | Rake $0.02 
Board [2c 9s 2h 5s]
Seat 1: Crafty23@PS (small blind) folded before Flop
Seat 2: svaika24 (big blind) folded on the Turn
Seat 3: iamkakaroto folded before Flop (didn't bet)
Seat 4: T9MS folded before Flop (didn't bet)
Seat 5: KokoulinV folded before Flop (didn't bet)
Seat 6: LarryTheStar (button) collected ($0.43)



PokerStars Hand #166667675421:  Hold'em No Limit ($0.05/$0.10 USD) - 2017/02/23 16:05:29 ET
Table 'Lobelia II' 6-max Seat #2 is the button
Seat 1: facewald ($21.22 in chips) 
Seat 2: Dcaro31 ($17.21 in chips) 
Seat 3: oddshoff ($19.30 in chips) 
Seat 5: Feverhead ($20.43 in chips) 
Seat 6: NvR.m1nD ($10.27 in chips) 
oddshoff: posts small blind $0.05
Feverhead: posts big blind $0.10
*** HOLE CARDS ***
NvR.m1nD: raises $0.15 to $0.25
facewald: folds 
Dcaro31: raises $0.65 to $0.90
oddshoff: folds 
Feverhead: folds 
NvR.m1nD: folds 
Uncalled bet ($0.65) returned to Dcaro31
Dcaro31 collected $0.65 from pot
*** SUMMARY ***
Total pot $0.65 | Rake $0 
Seat 1: facewald folded before Flop (didn't bet)
Seat 2: Dcaro31 (button) collected ($0.65)
Seat 3: oddshoff (small blind) folded before Flop
Seat 5: Feverhead (big blind) folded before Flop
Seat 6: NvR.m1nD folded before Flop



PokerStars Hand #166667675584:  Hold'em No Limit ($0.05/$0.10 USD) - 2017/02/23 16:05:29 ET
Table 'Stroobantia' 6-max Seat #4 is the button
Seat 1: mam9zyc ($8.59 in chips) 
Seat 2: XwinX25 ($10.15 in chips) 
Seat 3: Namhkal ($10 in chips) 
Seat 4: Yspenyanin ($10 in chips) 
Seat 5: boxer821 ($11.29 in chips) 
Seat 6: KokoulinV ($15.82 in chips) 
boxer821: posts small blind $0.05
KokoulinV: posts big blind $0.10
*** HOLE CARDS ***
mam9zyc: folds 
XwinX25: raises $0.20 to $0.30
Namhkal: folds 
Yspenyanin: folds 
boxer821: folds 
KokoulinV: folds 
Uncalled bet ($0.20) returned to XwinX25
XwinX25 collected $0.25 from pot
*** SUMMARY ***
Total pot $0.25 | Rake $0 
Seat 1: mam9zyc folded before Flop (didn't bet)
Seat 2: XwinX25 collected ($0.25)
Seat 3: Namhkal folded before Flop (didn't bet)
Seat 4: Yspenyanin (button) folded before Flop (didn't bet)
Seat 5: boxer821 (small blind) folded before Flop
Seat 6: KokoulinV (big blind) folded before Flop



PokerStars Hand #166667675617:  Hold'em No Limit ($0.05/$0.10 USD) - 2017/02/23 16:05:29 ET
Table 'Lorbach' 6-max Seat #5 is the button
Seat 1: LarryTheStar ($14.68 in chips) 
Seat 3: ArcticBearDK ($10 in chips) 
Seat 4: McCleans ($10 in chips) 
Seat 5: Cluckh ($14.47 in chips) 
Seat 6: Worlz ($15.78 in chips) 
Worlz: posts small blind $0.05
LarryTheStar: posts big blind $0.10
*** HOLE CARDS ***
ArcticBearDK: raises $0.15 to $0.25
McCleans: folds 
Cluckh: folds 
Worlz: folds 
LarryTheStar: folds 
Uncalled bet ($0.15) returned to ArcticBearDK
ArcticBearDK collected $0.25 from pot
*** SUMMARY ***
Total pot $0.25 | Rake $0 
Seat 1: LarryTheStar (big blind) folded before Flop
Seat 3: ArcticBearDK collected ($0.25)
Seat 4: McCleans folded before Flop (didn't bet)
Seat 5: Cluckh (button) folded before Flop (didn't bet)
Seat 6: Worlz (small blind) folded before Flop



PokerStars Hand #166667675793:  Hold'em No Limit ($0.05/$0.10 USD) - 2017/02/23 16:05:29 ET
Table 'Landi II' 6-max Seat #5 is the button
Seat 1: dersiemer ($11.94 in chips) 
Seat 2: Aescul@pius ($10.95 in chips) 
Seat 3: dr.goofy ($21.44 in chips) 
Seat 4: alesi13 ($6.40 in chips) 
Seat 5: Bird et al ($10.10 in chips) 
dersiemer: posts small blind $0.05
Aescul@pius: posts big blind $0.10
*** HOLE CARDS ***
dr.goofy: folds 
alesi13: folds 
Bird et al: folds 
dersiemer: calls $0.05
Aescul@pius: checks 
*** FLOP *** [Kc Kd 6s]
dersiemer: bets $0.10
Aescul@pius: folds 
Uncalled bet ($0.10) returned to dersiemer
dersiemer collected $0.19 from pot
*** SUMMARY ***
Total pot $0.20 | Rake $0.01 
Board [Kc Kd 6s]
Seat 1: dersiemer (small blind) collected ($0.19)
Seat 2: Aescul@pius (big blind) folded on the Flop
Seat 3: dr.goofy folded before Flop (didn't bet)
Seat 4: alesi13 folded before Flop (didn't bet)
Seat 5: Bird et al (button) folded before Flop (didn't bet)



PokerStars Hand #166667675860:  Hold'em No Limit ($0.05/$0.10 USD) - 2017/02/23 16:05:29 ET
Table 'Azelfafage' 6-max Seat #1 is the button
Seat 1: Sbozzz ($15.61 in chips) 
Seat 2: tr41n3r12 ($10.20 in chips) 
Seat 3: todor1711 ($20.47 in chips) 
Seat 4: fedorka rus ($10 in chips) 
Seat 5: 8th wonders ($12.58 in chips) 
Seat 6: KA3AXCTAHEU, ($10.46 in chips) 
tr41n3r12: posts small blind $0.05
todor1711: posts big blind $0.10
*** HOLE CARDS ***
fedorka rus: folds 
8th wonders: folds 
KA3AXCTAHEU,: folds 
Sbozzz: folds 
tr41n3r12: folds 
Uncalled bet ($0.05) returned to todor1711
todor1711 collected $0.10 from pot
*** SUMMARY ***
Total pot $0.10 | Rake $0 
Seat 1: Sbozzz (button) folded before Flop (didn't bet)
Seat 2: tr41n3r12 (small blind) folded before Flop
Seat 3: todor1711 (big blind) collected ($0.10)
Seat 4: fedorka rus folded before Flop (didn't bet)
Seat 5: 8th wonders folded before Flop (didn't bet)
Seat 6: KA3AXCTAHEU, folded before Flop (didn't bet)



PokerStars Hand #166667676111:  Hold'em No Limit ($0.05/$0.10 USD) - 2017/02/23 16:05:29 ET
Table 'Pompeja III' 6-max Seat #4 is the button
Seat 1: Iarlei ($12.04 in chips) 
Seat 2: steepfell ($10 in chips) 
Seat 3: Yspenyanin ($11.85 in chips) 
Seat 4: Cluckh ($13.87 in chips) 
Seat 5: Spud014 ($12.04 in chips) 
Seat 6: mega spasser ($4.95 in chips) 
Spud014: posts small blind $0.05
mega spasser: posts big blind $0.10
*** HOLE CARDS ***
Iarlei: raises $0.20 to $0.30
steepfell: folds 
Yspenyanin: folds 
Cluckh: folds 
Spud014: folds 
mega spasser: folds 
Uncalled bet ($0.20) returned to Iarlei
Iarlei collected $0.25 from pot
*** SUMMARY ***
Total pot $0.25 | Rake $0 
Seat 1: Iarlei collected ($0.25)
Seat 2: steepfell folded before Flop (didn't bet)
Seat 3: Yspenyanin folded before Flop (didn't bet)
Seat 4: Cluckh (button) folded before Flop (didn't bet)
Seat 5: Spud014 (small blind) folded before Flop
Seat 6: mega spasser (big blind) folded before Flop



PokerStars Hand #166667676270:  Hold'em No Limit ($0.05/$0.10 USD) - 2017/02/23 16:05:29 ET
Table 'Hamal II' 6-max Seat #3 is the button
Seat 1: saxoalto2011 ($7.79 in chips) 
Seat 2: pancernik21 ($10.15 in chips) 
Seat 3: Cluckh ($11.24 in chips) 
Seat 4: ArcticBearDK ($10.71 in chips) 
Seat 5: eniksenik ($10.89 in chips) 
Seat 6: LarryTheStar ($11.54 in chips) 
ArcticBearDK: posts small blind $0.05
eniksenik: posts big blind $0.10
*** HOLE CARDS ***
LarryTheStar: raises $0.20 to $0.30
saxoalto2011: folds 
pancernik21: folds 
Cluckh: folds 
ArcticBearDK: folds 
eniksenik: folds 
Uncalled bet ($0.20) returned to LarryTheStar
LarryTheStar collected $0.25 from pot
*** SUMMARY ***
Total pot $0.25 | Rake $0 
Seat 1: saxoalto2011 folded before Flop (didn't bet)
Seat 2: pancernik21 folded before Flop (didn't bet)
Seat 3: Cluckh (button) folded before Flop (didn't bet)
Seat 4: ArcticBearDK (small blind) folded before Flop
Seat 5: eniksenik (big blind) folded before Flop
Seat 6: LarryTheStar collected ($0.25)



PokerStars Hand #166667676272:  Hold'em No Limit ($0.05/$0.10 USD) - 2017/02/23 16:05:29 ET
Table 'Eudora' 6-max Seat #3 is the button
Seat 1: archer2511 ($11.46 in chips) 
Seat 2: popypaleta ($10 in chips) 
Seat 3: Ice_Isayev ($10 in chips) 
Seat 4: yodzik ($5.35 in chips) 
Seat 5: chimera252 ($11.67 in chips) 
yodzik: posts small blind $0.05
chimera252: posts big blind $0.10
*** HOLE CARDS ***
archer2511: raises $0.20 to $0.30
popypaleta: folds 
Ice_Isayev: folds 
yodzik: folds 
chimera252: folds 
Uncalled bet ($0.20) returned to archer2511
archer2511 collected $0.25 from pot
*** SUMMARY ***
Total pot $0.25 | Rake $0 
Seat 1: archer2511 collected ($0.25)
Seat 2: popypaleta folded before Flop (didn't bet)
Seat 3: Ice_Isayev (button) folded before Flop (didn't bet)
Seat 4: yodzik (small blind) folded before Flop
Seat 5: chimera252 (big blind) folded before Flop



PokerStars Hand #166667676406:  Hold'em No Limit ($0.05/$0.10 USD) - 2017/02/23 16:05:30 ET
Table 'Antinous' 6-max Seat #3 is the button
Seat 1: Andrei ProFF ($15.68 in chips) 
Seat 2: Nr847 ($13.60 in chips) 
Seat 3: dittoro ($10 in chips) 
Seat 5: Covetsoles ($3.63 in chips) 
Seat 6: coolisses111 ($10.20 in chips) 
Covetsoles: posts small blind $0.05
coolisses111: posts big blind $0.10
*** HOLE CARDS ***
Andrei ProFF: folds 
Nr847: folds 
dittoro: raises $0.20 to $0.30
Covetsoles: folds 
coolisses111: folds 
Uncalled bet ($0.20) returned to dittoro
dittoro collected $0.25 from pot
*** SUMMARY ***
Total pot $0.25 | Rake $0 
Seat 1: Andrei ProFF folded before Flop (didn't bet)
Seat 2: Nr847 folded before Flop (didn't bet)
Seat 3: dittoro (button) collected ($0.25)
Seat 5: Covetsoles (small blind) folded before Flop
Seat 6: coolisses111 (big blind) folded before Flop



PokerStars Hand #166667676502:  Hold'em No Limit ($0.05/$0.10 USD) - 2017/02/23 16:05:30 ET
Table 'Brambilla II' 6-max Seat #5 is the button
Seat 1: Rodik002 ($12.87 in chips) 
Seat 2: dwonder75 ($13.79 in chips) 
Seat 3: BORIS_ENEV ($14.47 in chips) 
Seat 4: david_sara83 ($11.82 in chips) 
Seat 5: FRAID358 ($10.15 in chips) 
Seat 6: boxer821 ($10.38 in chips) 
boxer821: posts small blind $0.05
Rodik002: posts big blind $0.10
*** HOLE CARDS ***
dwonder75: raises $0.20 to $0.30
BORIS_ENEV: folds 
david_sara83: folds 
FRAID358: folds 
boxer821: calls $0.25
Rodik002: calls $0.20
*** FLOP *** [5d 6h Kh]
boxer821: checks 
Rodik002: checks 
dwonder75: bets $0.50
boxer821: folds 
Rodik002: folds 
Uncalled bet ($0.50) returned to dwonder75
dwonder75 collected $0.86 from pot
*** SUMMARY ***
Total pot $0.90 | Rake $0.04 
Board [5d 6h Kh]
Seat 1: Rodik002 (big blind) folded on the Flop
Seat 2: dwonder75 collected ($0.86)
Seat 3: BORIS_ENEV folded before Flop (didn't bet)
Seat 4: david_sara83 folded before Flop (didn't bet)
Seat 5: FRAID358 (button) folded before Flop (didn't bet)
Seat 6: boxer821 (small blind) folded on the Flop



PokerStars Hand #166667676517:  Hold'em No Limit ($0.05/$0.10 USD) - 2017/02/23 16:05:30 ET
Table 'Euryalos II' 6-max Seat #6 is the button
Seat 1: acekid403 ($9.80 in chips) 
Seat 2: silsilviu ($7.05 in chips) 
Seat 3: Hyd SK ($10.65 in chips) 
Seat 4: popypaleta ($15.62 in chips) 
Seat 5: horang2 ($8.25 in chips) 
Seat 6: MihaGr ($10 in chips) 
acekid403: posts small blind $0.05
silsilviu: posts big blind $0.10
*** HOLE CARDS ***
Hyd SK: folds 
popypaleta: folds 
horang2: folds 
MihaGr: raises $0.20 to $0.30
acekid403: calls $0.25
silsilviu: folds 
*** FLOP *** [6s 5h Kh]
acekid403: checks 
MihaGr: bets $0.45
acekid403: folds 
Uncalled bet ($0.45) returned to MihaGr
MihaGr collected $0.67 from pot
*** SUMMARY ***
Total pot $0.70 | Rake $0.03 
Board [6s 5h Kh]
Seat 1: acekid403 (small blind) folded on the Flop
Seat 2: silsilviu (big blind) folded before Flop
Seat 3: Hyd SK folded before Flop (didn't bet)
Seat 4: popypaleta folded before Flop (didn't bet)
Seat 5: horang2 folded before Flop (didn't bet)
Seat 6: MihaGr (button) collected ($0.67)



PokerStars Hand #166667676565:  Hold'em No Limit ($0.05/$0.10 USD) - 2017/02/23 16:05:30 ET
Table 'Reginhild' 6-max Seat #4 is the button
Seat 1: iamkakaroto ($11.40 in chips) 
Seat 2: Kow6oy ($10 in chips) 
Seat 3: ARCHITECT83 ($6.39 in chips) 
Seat 4: Raymondo21 ($23.63 in chips) 
Seat 5: XCarlos610 ($29.83 in chips) 
Seat 6: eniksenik ($10 in chips) 
XCarlos610: posts small blind $0.05
eniksenik: posts big blind $0.10
*** HOLE CARDS ***
iamkakaroto: folds 
Kow6oy: raises $0.25 to $0.35
ARCHITECT83: folds 
Raymondo21: folds 
XCarlos610: folds 
eniksenik: folds 
Uncalled bet ($0.25) returned to Kow6oy
Kow6oy collected $0.25 from pot
*** SUMMARY ***
Total pot $0.25 | Rake $0 
Seat 1: iamkakaroto folded before Flop (didn't bet)
Seat 2: Kow6oy collected ($0.25)
Seat 3: ARCHITECT83 folded before Flop (didn't bet)
Seat 4: Raymondo21 (button) folded before Flop (didn't bet)
Seat 5: XCarlos610 (small blind) folded before Flop
Seat 6: eniksenik (big blind) folded before Flop



PokerStars Hand #166667676685:  Hold'em No Limit ($0.05/$0.10 USD) - 2017/02/23 16:05:30 ET
Table 'Unitas II' 6-max Seat #6 is the button
Seat 1: Peter0087 ($9.75 in chips) 
Seat 2: steepfell ($10 in chips) 
Seat 4: truck1234 ($10.94 in chips) 
Seat 5: chimera252 ($24.63 in chips) 
Seat 6: paxit71 ($9.58 in chips) 
Peter0087: posts small blind $0.05
steepfell: posts big blind $0.10
*** HOLE CARDS ***
truck1234: folds 
chimera252: folds 
paxit71: raises $0.10 to $0.20
Peter0087: folds 
steepfell: folds 
Uncalled bet ($0.10) returned to paxit71
paxit71 collected $0.25 from pot
*** SUMMARY ***
Total pot $0.25 | Rake $0 
Seat 1: Peter0087 (small blind) folded before Flop
Seat 2: steepfell (big blind) folded before Flop
Seat 4: truck1234 folded before Flop (didn't bet)
Seat 5: chimera252 folded before Flop (didn't bet)
Seat 6: paxit71 (button) collected ($0.25)



PokerStars Hand #166667676820:  Hold'em No Limit ($0.05/$0.10 USD) - 2017/02/23 16:05:30 ET
Table 'Nuki' 6-max Seat #1 is the button
Seat 1: bdixon_5 ($7.80 in chips) 
Seat 2: ArcticBearDK ($18.93 in chips) 
Seat 3: david_sara83 ($13.94 in chips) 
Seat 4: GESPERIA ($28.58 in chips) 
Seat 6: Zooplack ($25.12 in chips) 
ArcticBearDK: posts small blind $0.05
david_sara83: posts big blind $0.10
*** HOLE CARDS ***
GESPERIA: folds 
Zooplack: raises $0.15 to $0.25
bdixon_5: folds 
ArcticBearDK: folds 
david_sara83: calls $0.15
*** FLOP *** [Js 3h As]
david_sara83: checks 
Zooplack: bets $0.32
david_sara83: calls $0.32
*** TURN *** [Js 3h As] [4d]
david_sara83: checks 
Zooplack: bets $0.86
david_sara83: calls $0.86
*** RIVER *** [Js 3h As 4d] [5d]
david_sara83: checks 
Zooplack: checks 
*** SHOW DOWN ***
david_sara83: shows [Ad 5h] (two pair, Aces and Fives)
Zooplack: shows [Ah Jh] (two pair, Aces and Jacks)
Zooplack collected $2.78 from pot
*** SUMMARY ***
Total pot $2.91 | Rake $0.13 
Board [Js 3h As 4d 5d]
Seat 1: bdixon_5 (button) folded before Flop (didn't bet)
Seat 2: ArcticBearDK (small blind) folded before Flop
Seat 3: david_sara83 (big blind) showed [Ad 5h] and lost with two pair, Aces and Fives
Seat 4: GESPERIA folded before Flop (didn't bet)
Seat 6: Zooplack showed [Ah Jh] and won ($2.78) with two pair, Aces and Jacks



PokerStars Hand #166667677068:  Hold'em No Limit ($0.05/$0.10 USD) - 2017/02/23 16:05:30 ET
Table 'Gyldenia II' 6-max Seat #6 is the button
Seat 1: KokoulinV ($10.30 in chips) 
Seat 2: Bandyaev ($11.09 in chips) 
Seat 3: ex3Lero86 ($23.67 in chips) 
Seat 5: CHRO8 ($15.57 in chips) 
Seat 6: 8th wonders ($11.53 in chips) 
KokoulinV: posts small blind $0.05
Bandyaev: posts big blind $0.10
*** HOLE CARDS ***
ex3Lero86: folds 
ex3Lero86 leaves the table
CHRO8: raises $0.20 to $0.30
8th wonders: folds 
KokoulinV: folds 
Bandyaev: folds 
Uncalled bet ($0.20) returned to CHRO8
CHRO8 collected $0.25 from pot
*** SUMMARY ***
Total pot $0.25 | Rake $0 
Seat 1: KokoulinV (small blind) folded before Flop
Seat 2: Bandyaev (big blind) folded before Flop
Seat 3: ex3Lero86 folded before Flop (didn't bet)
Seat 5: CHRO8 collected ($0.25)
Seat 6: 8th wonders (button) folded before Flop (didn't bet)



PokerStars Hand #166667677187:  Hold'em No Limit ($0.05/$0.10 USD) - 2017/02/23 16:05:30 ET
Table 'Hestia' 6-max Seat #6 is the button
Seat 2: Kow6oy ($10.05 in chips) 
Seat 3: MBen10 ($13.77 in chips) 
Seat 4: Lucky HoBBiT ($10 in chips) 
Seat 5: CiisCi ($16.45 in chips) 
Seat 6: Smitty03300 ($10 in chips) 
Kow6oy: posts small blind $0.05
MBen10: posts big blind $0.10
*** HOLE CARDS ***
Lucky HoBBiT: folds 
CiisCi: folds 
Smitty03300: folds 
Kow6oy: raises $0.20 to $0.30
MBen10: calls $0.20
*** FLOP *** [3h Jh Th]
Kow6oy: checks 
MBen10: checks 
*** TURN *** [3h Jh Th] [As]
Kow6oy: bets $0.43
MBen10: folds 
Uncalled bet ($0.43) returned to Kow6oy
Kow6oy collected $0.57 from pot
*** SUMMARY ***
Total pot $0.60 | Rake $0.03 
Board [3h Jh Th As]
Seat 2: Kow6oy (small blind) collected ($0.57)
Seat 3: MBen10 (big blind) folded on the Turn
Seat 4: Lucky HoBBiT folded before Flop (didn't bet)
Seat 5: CiisCi folded before Flop (didn't bet)
Seat 6: Smitty03300 (button) folded before Flop (didn't bet)



PokerStars Hand #166667677237:  Hold'em No Limit ($0.05/$0.10 USD) - 2017/02/23 16:05:31 ET
Table 'Peiroos III' 6-max Seat #3 is the button
Seat 1: tequila_joop ($10 in chips) 
Seat 3: nabatov.m ($6.87 in chips) 
Seat 4: pivanki11 ($11.01 in chips) 
Seat 5: ChuikaPridi ($10 in chips) 
Seat 6: CHRO8 ($9.65 in chips) 
pivanki11: posts small blind $0.05
ChuikaPridi: posts big blind $0.10
tequila_joop: posts the ante $0.02
nabatov.m: posts the ante $0.02
pivanki11: posts the ante $0.02
ChuikaPridi: posts the ante $0.02
CHRO8: posts the ante $0.02
*** HOLE CARDS ***
CHRO8: calls $0.10
tequila_joop: folds 
nabatov.m: raises $0.10 to $0.20
pivanki11: folds 
ChuikaPridi: folds 
CHRO8: calls $0.10
*** FLOP *** [6d 2d Jh]
CHRO8: checks 
nabatov.m: bets $0.31
CHRO8: folds 
Uncalled bet ($0.31) returned to nabatov.m
nabatov.m collected $0.62 from pot
*** SUMMARY ***
Total pot $0.65 | Rake $0.03 
Board [6d 2d Jh]
Seat 1: tequila_joop folded before Flop (didn't bet)
Seat 3: nabatov.m (button) collected ($0.62)
Seat 4: pivanki11 (small blind) folded before Flop
Seat 5: ChuikaPridi (big blind) folded before Flop
Seat 6: CHRO8 folded on the Flop



PokerStars Hand #166667677391:  Hold'em No Limit ($0.05/$0.10 USD) - 2017/02/23 16:05:31 ET
Table 'Esperanto II' 6-max Seat #5 is the button
Seat 1: kurasd ($11.10 in chips) 
Seat 2: MihaGr ($10.04 in chips) 
Seat 3: Namhkal ($12.10 in chips) 
Seat 4: Andrei ProFF ($10.20 in chips) 
Seat 5: FRAID358 ($9.85 in chips) 
Seat 6: ArcticBearDK ($13.03 in chips) 
ArcticBearDK: posts small blind $0.05
kurasd: posts big blind $0.10
*** HOLE CARDS ***
MihaGr: folds 
Namhkal: folds 
Andrei ProFF: folds 
FRAID358: folds 
ArcticBearDK: raises $0.30 to $0.40
kurasd: folds 
Uncalled bet ($0.30) returned to ArcticBearDK
ArcticBearDK collected $0.20 from pot
*** SUMMARY ***
Total pot $0.20 | Rake $0 
Seat 1: kurasd (big blind) folded before Flop
Seat 2: MihaGr folded before Flop (didn't bet)
Seat 3: Namhkal folded before Flop (didn't bet)
Seat 4: Andrei ProFF folded before Flop (didn't bet)
Seat 5: FRAID358 (button) folded before Flop (didn't bet)
Seat 6: ArcticBearDK (small blind) collected ($0.20)



PokerStars Hand #166667677900:  Hold'em No Limit ($0.05/$0.10 USD) - 2017/02/23 16:05:31 ET
Table 'Epimetheus' 6-max Seat #3 is the button
Seat 1: 6ePeMeHHa9 ($10.29 in chips) 
Seat 2: patrick19111 ($15.51 in chips) 
Seat 3: dineldidi ($9.84 in chips) 
Seat 5: afca128 ($23.73 in chips) 
Seat 6: voledy ($10.60 in chips) 
afca128: posts small blind $0.05
voledy: posts big blind $0.10
*** HOLE CARDS ***
6ePeMeHHa9: folds 
patrick19111: folds 
dineldidi: folds 
iluzja12 leaves the table
Namhkal joins the table at seat #4 
afca128: folds 
Uncalled bet ($0.05) returned to voledy
voledy collected $0.10 from pot
*** SUMMARY ***
Total pot $0.10 | Rake $0 
Seat 1: 6ePeMeHHa9 folded before Flop (didn't bet)
Seat 2: patrick19111 folded before Flop (didn't bet)
Seat 3: dineldidi (button) folded before Flop (didn't bet)
Seat 5: afca128 (small blind) folded before Flop
Seat 6: voledy (big blind) collected ($0.10)



PokerStars Hand #166667677950:  Hold'em No Limit ($0.05/$0.10 USD) - 2017/02/23 16:05:31 ET
Table 'Tristan III' 6-max Seat #1 is the button
Seat 1: CHRO8 ($18.18 in chips) 
Seat 2: Hyd SK ($13.93 in chips) 
Seat 3: fedorka rus ($25.77 in chips) 
Seat 4: Feverhead ($11.53 in chips) 
Seat 5: david_sara83 ($10.61 in chips) 
Seat 6: fredrik10528 ($10 in chips) 
Hyd SK: posts small blind $0.05
fedorka rus: posts big blind $0.10
fredrik10528: posts big blind $0.10
*** HOLE CARDS ***
Feverhead: folds 
david_sara83: raises $0.30 to $0.40
fredrik10528: folds 
CHRO8: folds 
Hyd SK: folds 
fedorka rus: calls $0.30
*** FLOP *** [As Th 5h]
fedorka rus: checks 
david_sara83: bets $0.49
fedorka rus: calls $0.49
*** TURN *** [As Th 5h] [Qs]
fedorka rus: checks 
david_sara83: checks 
*** RIVER *** [As Th 5h Qs] [8h]
fedorka rus: bets $0.60
david_sara83: folds 
Uncalled bet ($0.60) returned to fedorka rus
fedorka rus collected $1.84 from pot
*** SUMMARY ***
Total pot $1.93 | Rake $0.09 
Board [As Th 5h Qs 8h]
Seat 1: CHRO8 (button) folded before Flop (didn't bet)
Seat 2: Hyd SK (small blind) folded before Flop
Seat 3: fedorka rus (big blind) collected ($1.84)
Seat 4: Feverhead folded before Flop (didn't bet)
Seat 5: david_sara83 folded on the River
Seat 6: fredrik10528 folded before Flop



PokerStars Hand #166667678167:  Hold'em No Limit ($0.05/$0.10 USD) - 2017/02/23 16:05:32 ET
Table 'Izar' 6-max Seat #4 is the button
Seat 1: bambolejro ($10.39 in chips) 
Seat 2: mvp0013 ($10.98 in chips) 
Seat 3: Yspenyanin ($11.27 in chips) 
Seat 4: Matee92 ($6.01 in chips) 
Seat 5: fishhook5 ($11.35 in chips) 
Seat 6: yodzik ($5.15 in chips) 
fishhook5: posts small blind $0.05
yodzik: posts big blind $0.10
*** HOLE CARDS ***
bambolejro: folds 
mvp0013: raises $0.20 to $0.30
Yspenyanin: folds 
Matee92: folds 
fishhook5: folds 
yodzik: raises $0.60 to $0.90
mvp0013: calls $0.60
*** FLOP *** [Td Ks 4d]
yodzik: checks 
mvp0013: checks 
*** TURN *** [Td Ks 4d] [4s]
yodzik: bets $1
mvp0013: raises $1 to $2
yodzik: calls $1
*** RIVER *** [Td Ks 4d 4s] [6d]
yodzik: checks 
mvp0013: checks 
*** SHOW DOWN ***
yodzik: shows [Jc Js] (two pair, Jacks and Fours)
mvp0013: mucks hand 
yodzik collected $5.59 from pot
*** SUMMARY ***
Total pot $5.85 | Rake $0.26 
Board [Td Ks 4d 4s 6d]
Seat 1: bambolejro folded before Flop (didn't bet)
Seat 2: mvp0013 mucked
Seat 3: Yspenyanin folded before Flop (didn't bet)
Seat 4: Matee92 (button) folded before Flop (didn't bet)
Seat 5: fishhook5 (small blind) folded before Flop
Seat 6: yodzik (big blind) showed [Jc Js] and won ($5.59) with two pair, Jacks and Fours



PokerStars Hand #166667678225:  Hold'em No Limit ($0.05/$0.10 USD) - 2017/02/23 16:05:32 ET
Table 'Krethon' 6-max Seat #2 is the button
Seat 1: boxer821 ($10.92 in chips) 
Seat 2: manashov ($12.06 in chips) 
Seat 3: D3NyA ($10 in chips) 
Seat 4: chimera252 ($14.94 in chips) 
Seat 5: popypaleta ($10.10 in chips) 
D3NyA: posts small blind $0.05
chimera252: posts big blind $0.10
*** HOLE CARDS ***
popypaleta: folds 
boxer821: folds 
manashov: raises $0.10 to $0.20
D3NyA: folds 
chimera252: folds 
Uncalled bet ($0.10) returned to manashov
manashov collected $0.25 from pot
*** SUMMARY ***
Total pot $0.25 | Rake $0 
Seat 1: boxer821 folded before Flop (didn't bet)
Seat 2: manashov (button) collected ($0.25)
Seat 3: D3NyA (small blind) folded before Flop
Seat 4: chimera252 (big blind) folded before Flop
Seat 5: popypaleta folded before Flop (didn't bet)



PokerStars Hand #166667679267:  Hold'em No Limit ($0.05/$0.10 USD) - 2017/02/23 16:05:33 ET
Table 'Hercynia III' 6-max Seat #3 is the button
Seat 1: Bird et al ($14.58 in chips) 
Seat 2: Action_Gibi ($7.75 in chips) 
Seat 3: Dcaro31 ($20.17 in chips) 
Seat 5: THIMUCHIN ($15.27 in chips) 
Seat 6: bdixon_5 ($11.04 in chips) 
THIMUCHIN: posts small blind $0.05
bdixon_5: posts big blind $0.10
*** HOLE CARDS ***
Bird et al: folds 
Action_Gibi: raises $0.20 to $0.30
Dcaro31: folds 
THIMUCHIN: folds 
bdixon_5: calls $0.20
*** FLOP *** [7h 9c 2h]
bdixon_5: checks 
Action_Gibi: bets $0.31
bdixon_5: calls $0.31
*** TURN *** [7h 9c 2h] [As]
bdixon_5: checks 
Action_Gibi: checks 
*** RIVER *** [7h 9c 2h As] [8d]
bdixon_5: bets $0.80
Action_Gibi: folds 
Uncalled bet ($0.80) returned to bdixon_5
bdixon_5 collected $1.21 from pot
*** SUMMARY ***
Total pot $1.27 | Rake $0.06 
Board [7h 9c 2h As 8d]
Seat 1: Bird et al folded before Flop (didn't bet)
Seat 2: Action_Gibi folded on the River
Seat 3: Dcaro31 (button) folded before Flop (didn't bet)
Seat 5: THIMUCHIN (small blind) folded before Flop
Seat 6: bdixon_5 (big blind) collected ($1.21)



PokerStars Hand #166667679630:  Hold'em No Limit ($0.05/$0.10 USD) - 2017/02/23 16:05:33 ET
Table 'Atropos' 6-max Seat #6 is the button
Seat 1: ScorpionF39 ($1.97 in chips) 
Seat 2: yodzik ($5 in chips) 
Seat 3: NvR.m1nD ($10 in chips) 
Seat 4: iDecMate ($11.12 in chips) 
Seat 5: KokoulinV ($12.09 in chips) 
Seat 6: Iarlei ($12.43 in chips) 
ScorpionF39: posts small blind $0.05
yodzik: posts big blind $0.10
*** HOLE CARDS ***
NvR.m1nD: folds 
iDecMate: folds 
KokoulinV: folds 
Iarlei: raises $0.15 to $0.25
ScorpionF39: folds 
yodzik: folds 
Uncalled bet ($0.15) returned to Iarlei
Iarlei collected $0.25 from pot
*** SUMMARY ***
Total pot $0.25 | Rake $0 
Seat 1: ScorpionF39 (small blind) folded before Flop
Seat 2: yodzik (big blind) folded before Flop
Seat 3: NvR.m1nD folded before Flop (didn't bet)
Seat 4: iDecMate folded before Flop (didn't bet)
Seat 5: KokoulinV folded before Flop (didn't bet)
Seat 6: Iarlei (button) collected ($0.25)



PokerStars Hand #166667679825:  Hold'em No Limit ($0.05/$0.10 USD) - 2017/02/23 16:05:33 ET
Table 'Marbachia II' 6-max Seat #1 is the button
Seat 1: AC Evergreen ($10 in chips) 
Seat 2: Yabidooo ($11.79 in chips) 
Seat 3: MisterX413 ($10 in chips) 
Seat 4: BahiaMinhaP ($10 in chips) 
Seat 5: MihaGr ($10 in chips) 
Seat 6: DamDatsAnAce ($10.15 in chips) 
Yabidooo: posts small blind $0.05
MisterX413: posts big blind $0.10
*** HOLE CARDS ***
BahiaMinhaP: folds 
MihaGr: folds 
DamDatsAnAce: folds 
AC Evergreen: folds 
Yabidooo: calls $0.05
MisterX413: checks 
*** FLOP *** [Qc 3s 6s]
Yabidooo: checks 
MisterX413: checks 
*** TURN *** [Qc 3s 6s] [5s]
Yabidooo: checks 
MisterX413 has timed out
MisterX413: checks 
*** RIVER *** [Qc 3s 6s 5s] [9c]
Yabidooo: checks 
MisterX413 has timed out
MisterX413: checks 
*** SHOW DOWN ***
Yabidooo: shows [4h Kh] (high card King)
MisterX413: shows [Ks 5h] (a pair of Fives)
MisterX413 collected $0.19 from pot
*** SUMMARY ***
Total pot $0.20 | Rake $0.01 
Board [Qc 3s 6s 5s 9c]
Seat 1: AC Evergreen (button) folded before Flop (didn't bet)
Seat 2: Yabidooo (small blind) showed [4h Kh] and lost with high card King
Seat 3: MisterX413 (big blind) showed [Ks 5h] and won ($0.19) with a pair of Fives
Seat 4: BahiaMinhaP folded before Flop (didn't bet)
Seat 5: MihaGr folded before Flop (didn't bet)
Seat 6: DamDatsAnAce folded before Flop (didn't bet)



PokerStars Hand #166667679875:  Hold'em No Limit ($0.05/$0.10 USD) - 2017/02/23 16:05:33 ET
Table 'Brendelia II' 6-max Seat #3 is the button
Seat 2: Crimsonr ($5.18 in chips) 
Seat 3: ValdemorS ($18.79 in chips) 
Seat 6: luckyPositiv ($10.24 in chips) 
luckyPositiv: posts small blind $0.05
Crimsonr: posts big blind $0.10
Crimsonr: posts the ante $0.02
ValdemorS: posts the ante $0.02
luckyPositiv: posts the ante $0.02
*** HOLE CARDS ***
ValdemorS: raises $0.20 to $0.30
luckyPositiv: folds 
Crimsonr: folds 
Uncalled bet ($0.20) returned to ValdemorS
ValdemorS collected $0.31 from pot
*** SUMMARY ***
Total pot $0.31 | Rake $0 
Seat 2: Crimsonr (big blind) folded before Flop
Seat 3: ValdemorS (button) collected ($0.31)
Seat 6: luckyPositiv (small blind) folded before Flop



PokerStars Hand #166667680401:  Hold'em No Limit ($0.05/$0.10 USD) - 2017/02/23 16:05:34 ET
Table 'Nekkar' 6-max Seat #6 is the button
Seat 2: Bird et al ($11.07 in chips) 
Seat 3: Zemz_Ru ($15.05 in chips) 
Seat 4: kingartur222 ($13.34 in chips) 
Seat 5: Vrinni ($11.70 in chips) 
Seat 6: Eddys Edge ($10.48 in chips) 
Bird et al: posts small blind $0.05
Zemz_Ru: posts big blind $0.10
*** HOLE CARDS ***
kingartur222: folds 
Vrinni: folds 
Eddys Edge: folds 
Bird et al: folds 
Uncalled bet ($0.05) returned to Zemz_Ru
Zemz_Ru collected $0.10 from pot
*** SUMMARY ***
Total pot $0.10 | Rake $0 
Seat 2: Bird et al (small blind) folded before Flop
Seat 3: Zemz_Ru (big blind) collected ($0.10)
Seat 4: kingartur222 folded before Flop (didn't bet)
Seat 5: Vrinni folded before Flop (didn't bet)
Seat 6: Eddys Edge (button) folded before Flop (didn't bet)



PokerStars Hand #166667680818:  Hold'em No Limit ($0.05/$0.10 USD) - 2017/02/23 16:05:34 ET
Table 'Apollonia' 6-max Seat #1 is the button
Seat 1: ex3Lero86 ($10.11 in chips) 
Seat 2: ibara000 ($18.48 in chips) 
Seat 3: steepfell ($10 in chips) 
Seat 4: Goroshkos88 ($17.72 in chips) 
Seat 5: EphemeralBen ($22.42 in chips) 
Seat 6: Namhkal ($10 in chips) 
ibara000: posts small blind $0.05
steepfell: posts big blind $0.10
*** HOLE CARDS ***
Goroshkos88: raises $0.20 to $0.30
EphemeralBen: folds 
Namhkal: folds 
ex3Lero86: folds 
ibara000: folds 
steepfell: folds 
Uncalled bet ($0.20) returned to Goroshkos88
Goroshkos88 collected $0.25 from pot
*** SUMMARY ***
Total pot $0.25 | Rake $0 
Seat 1: ex3Lero86 (button) folded before Flop (didn't bet)
Seat 2: ibara000 (small blind) folded before Flop
Seat 3: steepfell (big blind) folded before Flop
Seat 4: Goroshkos88 collected ($0.25)
Seat 5: EphemeralBen folded before Flop (didn't bet)
Seat 6: Namhkal folded before Flop (didn't bet)



PokerStars Hand #166667680821:  Hold'em No Limit ($0.05/$0.10 USD) - 2017/02/23 16:05:34 ET
Table 'Tomita II' 6-max Seat #4 is the button
Seat 2: mhonielsen ($10 in chips) 
Seat 3: Lucky HoBBiT ($12.63 in chips) 
Seat 4: Hyd SK ($10 in chips) 
Seat 6: saniasmir ($10.05 in chips) 
saniasmir: posts small blind $0.05
mhonielsen: posts big blind $0.10
*** HOLE CARDS ***
Lucky HoBBiT: folds 
Hyd SK: raises $0.15 to $0.25
ex3Lero86 joins the table at seat #5 
saniasmir: folds 
mhonielsen: calls $0.15
*** FLOP *** [Tc 3s 8c]
mhonielsen: checks 
Hyd SK: bets $0.35
mhonielsen: calls $0.35
*** TURN *** [Tc 3s 8c] [Kh]
mhonielsen: checks 
Hyd SK: bets $0.79
mhonielsen: calls $0.79
*** RIVER *** [Tc 3s 8c Kh] [4s]
mhonielsen: checks 
Hyd SK: checks 
*** SHOW DOWN ***
mhonielsen: shows [Ts Qs] (a pair of Tens)
Hyd SK: shows [Td Ad] (a pair of Tens - Ace kicker)
Hyd SK collected $2.70 from pot
*** SUMMARY ***
Total pot $2.83 | Rake $0.13 
Board [Tc 3s 8c Kh 4s]
Seat 2: mhonielsen (big blind) showed [Ts Qs] and lost with a pair of Tens
Seat 3: Lucky HoBBiT folded before Flop (didn't bet)
Seat 4: Hyd SK (button) showed [Td Ad] and won ($2.70) with a pair of Tens
Seat 6: saniasmir (small blind) folded before Flop



PokerStars Hand #166667680938:  Hold'em No Limit ($0.05/$0.10 USD) - 2017/02/23 16:05:35 ET
Table 'Nemo III' 6-max Seat #3 is the button
Seat 1: Kow6oy ($10 in chips) 
Seat 2: Bandyaev ($11.74 in chips) 
Seat 3: Dimka4 ($10 in chips) 
Seat 4: vtalian ($9.75 in chips) 
Seat 5: Joker51_wtf! ($11.43 in chips) 
vtalian: posts small blind $0.05
Joker51_wtf!: posts big blind $0.10
maxiv608: sits out 
*** HOLE CARDS ***
Kow6oy: folds 
Bandyaev: raises $0.20 to $0.30
Dimka4: calls $0.30
vtalian: folds 
Joker51_wtf!: folds 
*** FLOP *** [Kh Jh 5c]
Bandyaev: bets $0.55
Dimka4: folds 
Uncalled bet ($0.55) returned to Bandyaev
Bandyaev collected $0.72 from pot
*** SUMMARY ***
Total pot $0.75 | Rake $0.03 
Board [Kh Jh 5c]
Seat 1: Kow6oy folded before Flop (didn't bet)
Seat 2: Bandyaev collected ($0.72)
Seat 3: Dimka4 (button) folded on the Flop
Seat 4: vtalian (small blind) folded before Flop
Seat 5: Joker51_wtf! (big blind) folded before Flop



PokerStars Hand #166667681347:  Hold'em No Limit ($0.05/$0.10 USD) - 2017/02/23 16:05:35 ET
Table 'Arkab' 6-max Seat #2 is the button
Seat 1: iamkakaroto ($10 in chips) 
Seat 2: aktion4ik ($12.24 in chips) 
Seat 3: sexy_seagull ($10 in chips) 
Seat 4: donkucallme ($17.49 in chips) 
Seat 5: OrionYusupov ($9.44 in chips) 
Seat 6: MihaGr ($10.78 in chips) 
sexy_seagull: posts small blind $0.05
donkucallme: posts big blind $0.10
*** HOLE CARDS ***
OrionYusupov: folds 
MihaGr: folds 
iamkakaroto: raises $0.20 to $0.30
aktion4ik: folds 
sexy_seagull: folds 
donkucallme: calls $0.20
*** FLOP *** [Th 8h 3c]
donkucallme: bets $1.10
iamkakaroto: calls $1.10
*** TURN *** [Th 8h 3c] [3h]
donkucallme: bets $3.70
iamkakaroto: calls $3.70
*** RIVER *** [Th 8h 3c 3h] [8d]
donkucallme: bets $3.70
iamkakaroto: calls $3.70
*** SHOW DOWN ***
donkucallme: shows [Kh 2h] (a flush, King high)
iamkakaroto: mucks hand 
donkucallme collected $16.86 from pot
*** SUMMARY ***
Total pot $17.65 | Rake $0.79 
Board [Th 8h 3c 3h 8d]
Seat 1: iamkakaroto mucked
Seat 2: aktion4ik (button) folded before Flop (didn't bet)
Seat 3: sexy_seagull (small blind) folded before Flop
Seat 4: donkucallme (big blind) showed [Kh 2h] and won ($16.86) with a flush, King high
Seat 5: OrionYusupov folded before Flop (didn't bet)
Seat 6: MihaGr folded before Flop (didn't bet)



PokerStars Hand #166667681358:  Hold'em No Limit ($0.05/$0.10 USD) - 2017/02/23 16:05:35 ET
Table 'Hajek III' 6-max Seat #2 is the button
Seat 1: MBen10 ($10.60 in chips) 
Seat 2: fortieth ($10.04 in chips) 
Seat 3: fedorka rus ($10.66 in chips) 
Seat 4: NvR.m1nD ($13.39 in chips) 
Seat 5: Croplayer1 ($14.90 in chips) 
fedorka rus: posts small blind $0.05
NvR.m1nD: posts big blind $0.10
*** HOLE CARDS ***
Croplayer1: folds 
MBen10: folds 
fortieth: raises $0.20 to $0.30
fedorka rus: folds 
NvR.m1nD: folds 
Uncalled bet ($0.20) returned to fortieth
fortieth collected $0.25 from pot
*** SUMMARY ***
Total pot $0.25 | Rake $0 
Seat 1: MBen10 folded before Flop (didn't bet)
Seat 2: fortieth (button) collected ($0.25)
Seat 3: fedorka rus (small blind) folded before Flop
Seat 4: NvR.m1nD (big blind) folded before Flop
Seat 5: Croplayer1 folded before Flop (didn't bet)



PokerStars Hand #166667681471:  Hold'em No Limit ($0.05/$0.10 USD) - 2017/02/23 16:05:35 ET
Table 'Gaika' 6-max Seat #3 is the button
Seat 1: oddshoff ($15.53 in chips) 
Seat 2: NvR.m1nD ($22.05 in chips) 
Seat 3: david_sara83 ($10.17 in chips) 
Seat 4: fortieth ($11.40 in chips) 
Seat 5: fedorka rus ($10.65 in chips) 
Seat 6: dr.goofy ($10 in chips) 
fortieth: posts small blind $0.05
fedorka rus: posts big blind $0.10
*** HOLE CARDS ***
dr.goofy: folds 
oddshoff: folds 
NvR.m1nD: folds 
david_sara83: folds 
fortieth: folds 
Uncalled bet ($0.05) returned to fedorka rus
fedorka rus collected $0.10 from pot
*** SUMMARY ***
Total pot $0.10 | Rake $0 
Seat 1: oddshoff folded before Flop (didn't bet)
Seat 2: NvR.m1nD folded before Flop (didn't bet)
Seat 3: david_sara83 (button) folded before Flop (didn't bet)
Seat 4: fortieth (small blind) folded before Flop
Seat 5: fedorka rus (big blind) collected ($0.10)
Seat 6: dr.goofy folded before Flop (didn't bet)



PokerStars Hand #166667681538:  Hold'em No Limit ($0.05/$0.10 USD) - 2017/02/23 16:05:35 ET
Table 'Martha' 6-max Seat #1 is the button
Seat 1: Peter0087 ($10.44 in chips) 
Seat 2: pauli95 ($9.29 in chips) 
Seat 3: Hyd SK ($12.16 in chips) 
Seat 4: dittoro ($10 in chips) 
Seat 5: MihaGr ($10 in chips) 
Seat 6: 8th wonders ($10 in chips) 
pauli95: posts small blind $0.05
Hyd SK: posts big blind $0.10
*** HOLE CARDS ***
dittoro: folds 
MihaGr: folds 
8th wonders: folds 
Peter0087: folds 
pauli95: calls $0.05
Hyd SK: checks 
*** FLOP *** [5d 5s 2c]
pauli95: checks 
Hyd SK: bets $0.13
pauli95: folds 
Uncalled bet ($0.13) returned to Hyd SK
Hyd SK collected $0.19 from pot
*** SUMMARY ***
Total pot $0.20 | Rake $0.01 
Board [5d 5s 2c]
Seat 1: Peter0087 (button) folded before Flop (didn't bet)
Seat 2: pauli95 (small blind) folded on the Flop
Seat 3: Hyd SK (big blind) collected ($0.19)
Seat 4: dittoro folded before Flop (didn't bet)
Seat 5: MihaGr folded before Flop (didn't bet)
Seat 6: 8th wonders folded before Flop (didn't bet)



PokerStars Hand #166667681610:  Hold'em No Limit ($0.05/$0.10 USD) - 2017/02/23 16:05:35 ET
Table 'Xanthippe II' 6-max Seat #3 is the button
Seat 1: ade22345 ($8.55 in chips) 
Seat 2: Bird et al ($13.51 in chips) 
Seat 3: Dcaro31 ($10.92 in chips) 
Seat 4: Barcardi14 ($5.56 in chips) 
Seat 5: yodzik ($5 in chips) 
Seat 6: Orlangoor ($10.64 in chips) 
Barcardi14: posts small blind $0.05
yodzik: posts big blind $0.10
*** HOLE CARDS ***
Orlangoor: folds 
ade22345: raises $0.50 to $0.60
Bird et al: calls $0.60
Dcaro31: folds 
Barcardi14: raises $4.96 to $5.56 and is all-in
yodzik: calls $4.90 and is all-in
ade22345: calls $4.96
Bird et al: folds 
*** FLOP *** [Kd Th Qs]
*** TURN *** [Kd Th Qs] [Kc]
*** RIVER *** [Kd Th Qs Kc] [3h]
*** SHOW DOWN ***
Barcardi14: shows [5c Jc] (a pair of Kings)
ade22345: shows [Td Js] (two pair, Kings and Tens)
ade22345 collected $1.07 from side pot
yodzik: shows [Qd Qh] (a full house, Queens full of Kings)
yodzik collected $14.90 from main pot
*** SUMMARY ***
Total pot $16.72 Main pot $14.90. Side pot $1.07. | Rake $0.75 
Board [Kd Th Qs Kc 3h]
Seat 1: ade22345 showed [Td Js] and won ($1.07) with two pair, Kings and Tens
Seat 2: Bird et al folded before Flop
Seat 3: Dcaro31 (button) folded before Flop (didn't bet)
Seat 4: Barcardi14 (small blind) showed [5c Jc] and lost with a pair of Kings
Seat 5: yodzik (big blind) showed [Qd Qh] and won ($14.90) with a full house, Queens full of Kings
Seat 6: Orlangoor folded before Flop (didn't bet)



PokerStars Hand #166667681860:  Hold'em No Limit ($0.05/$0.10 USD) - 2017/02/23 16:05:36 ET
Table 'Juliet II' 6-max Seat #6 is the button
Seat 1: alexpolevaja ($11.22 in chips) 
Seat 2: KA3AXCTAHEU, ($15.08 in chips) 
Seat 3: patrick19111 ($11.57 in chips) 
Seat 4: x3ultimate ($10.55 in chips) 
Seat 5: Dcaro31 ($18.97 in chips) 
Seat 6: BookWorm78 ($32.95 in chips) 
alexpolevaja: posts small blind $0.05
KA3AXCTAHEU,: posts big blind $0.10
*** HOLE CARDS ***
patrick19111: folds 
x3ultimate: folds 
Dcaro31: raises $0.20 to $0.30
BookWorm78: folds 
alexpolevaja: folds 
KA3AXCTAHEU,: folds 
Uncalled bet ($0.20) returned to Dcaro31
Dcaro31 collected $0.25 from pot
*** SUMMARY ***
Total pot $0.25 | Rake $0 
Seat 1: alexpolevaja (small blind) folded before Flop
Seat 2: KA3AXCTAHEU, (big blind) folded before Flop
Seat 3: patrick19111 folded before Flop (didn't bet)
Seat 4: x3ultimate folded before Flop (didn't bet)
Seat 5: Dcaro31 collected ($0.25)
Seat 6: BookWorm78 (button) folded before Flop (didn't bet)



PokerStars Hand #166667681968:  Hold'em No Limit ($0.05/$0.10 USD) - 2017/02/23 16:05:36 ET
Table 'Tyndareus III' 6-max Seat #1 is the button
Seat 1: MBen10 ($10 in chips) 
Seat 2: MihaGr ($10.47 in chips) 
Seat 3: XaXaTyH4uK ($10.30 in chips) 
Seat 5: yodzik ($5 in chips) 
Seat 6: Hb-309 ($10 in chips) 
MihaGr: posts small blind $0.05
XaXaTyH4uK: posts big blind $0.10
tequila_joop: sits out 
Hb-309: posts big blind $0.10
*** HOLE CARDS ***
yodzik: folds 
Hb-309: checks 
MBen10: raises $0.30 to $0.40
MihaGr: folds 
XaXaTyH4uK: raises $0.80 to $1.20
Hb-309: folds 
MBen10: calls $0.80
*** FLOP *** [2c 4d Jc]
XaXaTyH4uK: bets $1.30
MBen10: raises $2.70 to $4
XaXaTyH4uK: raises $5.10 to $9.10 and is all-in
MBen10: calls $4.80 and is all-in
Uncalled bet ($0.30) returned to XaXaTyH4uK
*** FIRST TURN *** [2c 4d Jc] [7h]
*** FIRST RIVER *** [2c 4d Jc 7h] [Qs]
*** SECOND TURN *** [2c 4d Jc] [8d]
*** SECOND RIVER *** [2c 4d Jc 8d] [6s]
*** FIRST SHOW DOWN ***
XaXaTyH4uK: shows [Kd Jd] (a pair of Jacks)
MBen10: shows [Qd Qh] (three of a kind, Queens)
MBen10 collected $9.62 from pot
*** SECOND SHOW DOWN ***
XaXaTyH4uK: shows [Kd Jd] (a pair of Jacks)
MBen10: shows [Qd Qh] (a pair of Queens)
MBen10 collected $9.62 from pot
*** SUMMARY ***
Total pot $20.15 | Rake $0.91 
Hand was run twice
FIRST Board [2c 4d Jc 7h Qs]
SECOND Board [2c 4d Jc 8d 6s]
Seat 1: MBen10 (button) showed [Qd Qh] and won ($9.62) with three of a kind, Queens, and won ($9.62) with a pair of Queens
Seat 2: MihaGr (small blind) folded before Flop
Seat 3: XaXaTyH4uK (big blind) showed [Kd Jd] and lost with a pair of Jacks, and lost with a pair of Jacks
Seat 5: yodzik folded before Flop (didn't bet)
Seat 6: Hb-309 folded before Flop



PokerStars Hand #166667682240:  Hold'em No Limit ($0.05/$0.10 USD) - 2017/02/23 16:05:36 ET
Table 'Vaisala' 6-max Seat #4 is the button
Seat 2: XaXaTyH4uK ($12.14 in chips) 
Seat 3: x3ultimate ($10.10 in chips) 
Seat 4: sexy_seagull ($11.38 in chips) 
Seat 5: AIONCMA1988 ($3.85 in chips) 
Seat 6: Aleksey K228 ($15.43 in chips) 
AIONCMA1988: posts small blind $0.05
Aleksey K228: posts big blind $0.10
*** HOLE CARDS ***
XaXaTyH4uK: folds 
x3ultimate: folds 
sexy_seagull: folds 
AIONCMA1988: raises $0.10 to $0.20
Aleksey K228: calls $0.10
*** FLOP *** [5h Ah 9d]
AIONCMA1988: checks 
Aleksey K228: bets $0.30
AIONCMA1988: raises $0.30 to $0.60
Aleksey K228: folds 
Uncalled bet ($0.30) returned to AIONCMA1988
AIONCMA1988 collected $0.96 from pot
*** SUMMARY ***
Total pot $1 | Rake $0.04 
Board [5h Ah 9d]
Seat 2: XaXaTyH4uK folded before Flop (didn't bet)
Seat 3: x3ultimate folded before Flop (didn't bet)
Seat 4: sexy_seagull (button) folded before Flop (didn't bet)
Seat 5: AIONCMA1988 (small blind) collected ($0.96)
Seat 6: Aleksey K228 (big blind) folded on the Flop



PokerStars Hand #166667682556:  Hold'em No Limit ($0.05/$0.10 USD) - 2017/02/23 16:05:36 ET
Table 'Syringa' 6-max Seat #5 is the button
Seat 1: bdixon_5 ($7.80 in chips) 
Seat 2: Goroshkos88 ($10.56 in chips) 
Seat 3: Yspenyanin ($13.52 in chips) 
Seat 5: Andrei ProFF ($13.61 in chips) 
Seat 6: ibara000 ($16.18 in chips) 
ibara000: posts small blind $0.05
bdixon_5: posts big blind $0.10
tangler19: sits out 
*** HOLE CARDS ***
Goroshkos88: folds 
Yspenyanin: folds 
Andrei ProFF: folds 
ibara000: raises $0.16 to $0.26
bdixon_5: folds 
Uncalled bet ($0.16) returned to ibara000
ibara000 collected $0.20 from pot
*** SUMMARY ***
Total pot $0.20 | Rake $0 
Seat 1: bdixon_5 (big blind) folded before Flop
Seat 2: Goroshkos88 folded before Flop (didn't bet)
Seat 3: Yspenyanin folded before Flop (didn't bet)
Seat 5: Andrei ProFF (button) folded before Flop (didn't bet)
Seat 6: ibara000 (small blind) collected ($0.20)



PokerStars Hand #166667682811:  Hold'em No Limit ($0.05/$0.10 USD) - 2017/02/23 16:05:37 ET
Table 'Nikko II' 6-max Seat #1 is the button
Seat 1: bdixon_5 ($10.37 in chips) 
Seat 2: popypaleta ($10 in chips) 
Seat 3: Hyd SK ($12.16 in chips) 
Seat 4: Peter0087 ($9.19 in chips) 
Seat 5: Aescul@pius ($12.18 in chips) 
Seat 6: JahSoldier69 ($10 in chips) 
popypaleta: posts small blind $0.05
Hyd SK: posts big blind $0.10
*** HOLE CARDS ***
Peter0087: folds 
Aescul@pius: folds 
JahSoldier69: folds 
bdixon_5: folds 
popypaleta: raises $0.20 to $0.30
Hyd SK: folds 
Uncalled bet ($0.20) returned to popypaleta
popypaleta collected $0.20 from pot
*** SUMMARY ***
Total pot $0.20 | Rake $0 
Seat 1: bdixon_5 (button) folded before Flop (didn't bet)
Seat 2: popypaleta (small blind) collected ($0.20)
Seat 3: Hyd SK (big blind) folded before Flop
Seat 4: Peter0087 folded before Flop (didn't bet)
Seat 5: Aescul@pius folded before Flop (didn't bet)
Seat 6: JahSoldier69 folded before Flop (didn't bet)



PokerStars Hand #166667683017:  Hold'em No Limit ($0.05/$0.10 USD) - 2017/02/23 16:05:37 ET
Table 'Lampetia III' 6-max Seat #6 is the button
Seat 1: gaHy_HaXeP ($10.60 in chips) 
Seat 2: DamDatsAnAce ($10.15 in chips) 
Seat 4: IAntikI ($11.41 in chips) 
Seat 5: robson1235 ($19.73 in chips) 
Seat 6: bdixon_5 ($9.20 in chips) 
gaHy_HaXeP: posts small blind $0.05
DamDatsAnAce: posts big blind $0.10
*** HOLE CARDS ***
Orlangoor leaves the table
Kow6oy joins the table at seat #3 
IAntikI: folds 
robson1235: raises $0.20 to $0.30
bdixon_5: folds 
gaHy_HaXeP: folds 
DamDatsAnAce: folds 
Uncalled bet ($0.20) returned to robson1235
robson1235 collected $0.25 from pot
*** SUMMARY ***
Total pot $0.25 | Rake $0 
Seat 1: gaHy_HaXeP (small blind) folded before Flop
Seat 2: DamDatsAnAce (big blind) folded before Flop
Seat 4: IAntikI folded before Flop (didn't bet)
Seat 5: robson1235 collected ($0.25)
Seat 6: bdixon_5 (button) folded before Flop (didn't bet)



PokerStars Hand #166667683094:  Hold'em No Limit ($0.05/$0.10 USD) - 2017/02/23 16:05:37 ET
Table 'Wingolfia II' 6-max Seat #1 is the button
Seat 1: BahiaMinhaP ($10.32 in chips) 
Seat 2: NvR.m1nD ($10.30 in chips) 
Seat 3: truck1234 ($10.51 in chips) 
Seat 4: zlobslob ($18.02 in chips) 
Seat 5: tr41n3r12 ($11.43 in chips) 
Seat 6: EphemeralBen ($11.69 in chips) 
NvR.m1nD: posts small blind $0.05
truck1234: posts big blind $0.10
*** HOLE CARDS ***
zlobslob: folds 
tr41n3r12: folds 
EphemeralBen: raises $0.20 to $0.30
BahiaMinhaP: folds 
NvR.m1nD: folds 
truck1234: folds 
Uncalled bet ($0.20) returned to EphemeralBen
EphemeralBen collected $0.25 from pot
*** SUMMARY ***
Total pot $0.25 | Rake $0 
Seat 1: BahiaMinhaP (button) folded before Flop (didn't bet)
Seat 2: NvR.m1nD (small blind) folded before Flop
Seat 3: truck1234 (big blind) folded before Flop
Seat 4: zlobslob folded before Flop (didn't bet)
Seat 5: tr41n3r12 folded before Flop (didn't bet)
Seat 6: EphemeralBen collected ($0.25)



PokerStars Hand #166667683109:  Hold'em No Limit ($0.05/$0.10 USD) - 2017/02/23 16:05:37 ET
Table 'Walpurga' 6-max Seat #4 is the button
Seat 1: chimera252 ($12.22 in chips) 
Seat 2: paxit71 ($6.69 in chips) 
Seat 3: marianoboni ($10 in chips) 
Seat 4: oddshoff ($13.04 in chips) 
Seat 6: AIONCMA1988 ($4.90 in chips) 
Fremara will be allowed to play after the button
AIONCMA1988: posts small blind $0.05
chimera252: posts big blind $0.10
*** HOLE CARDS ***
paxit71: raises $0.20 to $0.30
marianoboni: folds 
oddshoff: folds 
AIONCMA1988: calls $0.25
chimera252: folds 
*** FLOP *** [4c 9h 4d]
AIONCMA1988: checks 
paxit71: checks 
*** TURN *** [4c 9h 4d] [6s]
AIONCMA1988: bets $0.34
paxit71: calls $0.34
*** RIVER *** [4c 9h 4d 6s] [6c]
AIONCMA1988: bets $0.66
paxit71: folds 
Uncalled bet ($0.66) returned to AIONCMA1988
AIONCMA1988 collected $1.32 from pot
*** SUMMARY ***
Total pot $1.38 | Rake $0.06 
Board [4c 9h 4d 6s 6c]
Seat 1: chimera252 (big blind) folded before Flop
Seat 2: paxit71 folded on the River
Seat 3: marianoboni folded before Flop (didn't bet)
Seat 4: oddshoff (button) folded before Flop (didn't bet)
Seat 6: AIONCMA1988 (small blind) collected ($1.32)



PokerStars Hand #166667683123:  Hold'em No Limit ($0.05/$0.10 USD) - 2017/02/23 16:05:37 ET
Table 'Aconcagua' 6-max Seat #5 is the button
Seat 1: MLPlayer16 ($10 in chips) 
Seat 3: burtila1989 ($10.07 in chips) 
Seat 4: pivanki11 ($10.07 in chips) 
Seat 5: frazaunch ($6.60 in chips) 
Seat 6: coolisses111 ($8.64 in chips) 
coolisses111: posts small blind $0.05
MLPlayer16: posts big blind $0.10
Kupi007: sits out 
MLPlayer16: posts the ante $0.02
burtila1989: posts the ante $0.02
pivanki11: posts the ante $0.02
frazaunch: posts the ante $0.02
coolisses111: posts the ante $0.02
*** HOLE CARDS ***
burtila1989: raises $0.20 to $0.30
pivanki11: folds 
frazaunch: calls $0.30
coolisses111: raises $0.90 to $1.20
MLPlayer16: folds 
burtila1989: raises $0.90 to $2.10
frazaunch: folds 
coolisses111: calls $0.90
*** FLOP *** [8d 5c 8c]
coolisses111: checks 
burtila1989: bets $0.80
coolisses111: calls $0.80
*** TURN *** [8d 5c 8c] [Ks]
coolisses111: checks 
burtila1989: bets $0.20
coolisses111: calls $0.20
*** RIVER *** [8d 5c 8c Ks] [3d]
coolisses111: checks 
burtila1989: checks 
*** SHOW DOWN ***
coolisses111: shows [Js Jc] (two pair, Jacks and Eights)
burtila1989: mucks hand 
coolisses111 collected $6.40 from pot
*** SUMMARY ***
Total pot $6.70 | Rake $0.30 
Board [8d 5c 8c Ks 3d]
Seat 1: MLPlayer16 (big blind) folded before Flop
Seat 3: burtila1989 mucked
Seat 4: pivanki11 folded before Flop (didn't bet)
Seat 5: frazaunch (button) folded before Flop
Seat 6: coolisses111 (small blind) showed [Js Jc] and won ($6.40) with two pair, Jacks and Eights



PokerStars Hand #166667683927:  Hold'em No Limit ($0.05/$0.10 USD) - 2017/02/23 16:05:38 ET
Table 'Nauheima II' 6-max Seat #6 is the button
Seat 2: Peter0087 ($10.37 in chips) 
Seat 3: KokoulinV ($13.29 in chips) 
Seat 4: Innerwuss ($10.22 in chips) 
Seat 5: Kow6oy ($10.05 in chips) 
Seat 6: bonyo71 ($5.04 in chips) 
Peter0087: posts small blind $0.05
KokoulinV: posts big blind $0.10
*** HOLE CARDS ***
Innerwuss: folds 
Kow6oy: folds 
bonyo71: folds 
Peter0087: raises $0.20 to $0.30
KokoulinV: folds 
Uncalled bet ($0.20) returned to Peter0087
Peter0087 collected $0.20 from pot
*** SUMMARY ***
Total pot $0.20 | Rake $0 
Seat 2: Peter0087 (small blind) collected ($0.20)
Seat 3: KokoulinV (big blind) folded before Flop
Seat 4: Innerwuss folded before Flop (didn't bet)
Seat 5: Kow6oy folded before Flop (didn't bet)
Seat 6: bonyo71 (button) folded before Flop (didn't bet)



PokerStars Hand #166667684470:  Hold'em No Limit ($0.05/$0.10 USD) - 2017/02/23 16:05:38 ET
Table 'Rosalia' 6-max Seat #2 is the button
Seat 1: Hyd SK ($10 in chips) 
Seat 2: Bandyaev ($11.69 in chips) 
Seat 3: Andy Wolf ($12.08 in chips) 
Seat 4: THIMUCHIN ($10.15 in chips) 
Seat 5: miron762 ($18.71 in chips) 
Seat 6: facewald ($16.78 in chips) 
Andy Wolf: posts small blind $0.05
THIMUCHIN: posts big blind $0.10
*** HOLE CARDS ***
miron762: calls $0.10
facewald: folds 
Hyd SK: folds 
Bandyaev: folds 
Andy Wolf: calls $0.05
THIMUCHIN: checks 
*** FLOP *** [Th Ad Qs]
Andy Wolf: checks 
THIMUCHIN: checks 
miron762: bets $0.60
Andy Wolf: folds 
THIMUCHIN: folds 
Uncalled bet ($0.60) returned to miron762
miron762 collected $0.29 from pot
*** SUMMARY ***
Total pot $0.30 | Rake $0.01 
Board [Th Ad Qs]
Seat 1: Hyd SK folded before Flop (didn't bet)
Seat 2: Bandyaev (button) folded before Flop (didn't bet)
Seat 3: Andy Wolf (small blind) folded on the Flop
Seat 4: THIMUCHIN (big blind) folded on the Flop
Seat 5: miron762 collected ($0.29)
Seat 6: facewald folded before Flop (didn't bet)



PokerStars Hand #166667684622:  Hold'em No Limit ($0.05/$0.10 USD) - 2017/02/23 16:05:39 ET
Table 'Tomyris II' 6-max Seat #5 is the button
Seat 1: ArcticBearDK ($21.98 in chips) 
Seat 2: Yspenyanin ($12.39 in chips) 
Seat 3: robertsabb ($12.13 in chips) 
Seat 4: Dcaro31 ($10 in chips) 
Seat 5: 6ePeMeHHa9 ($10.46 in chips) 
Seat 6: StackSmakka ($11.49 in chips) 
StackSmakka: posts small blind $0.05
ArcticBearDK: posts big blind $0.10
*** HOLE CARDS ***
Yspenyanin: folds 
robertsabb: folds 
Dcaro31: folds 
6ePeMeHHa9: raises $0.14 to $0.24
StackSmakka: calls $0.19
ArcticBearDK: folds 
*** FLOP *** [3c 8c 9s]
StackSmakka: checks 
6ePeMeHHa9: checks 
*** TURN *** [3c 8c 9s] [Ad]
StackSmakka: bets $0.39
6ePeMeHHa9: calls $0.39
*** RIVER *** [3c 8c 9s Ad] [5d]
StackSmakka: bets $0.74
6ePeMeHHa9: calls $0.74
*** SHOW DOWN ***
StackSmakka: shows [Ac Jd] (a pair of Aces)
6ePeMeHHa9: shows [Ah 5h] (two pair, Aces and Fives)
6ePeMeHHa9 collected $2.71 from pot
*** SUMMARY ***
Total pot $2.84 | Rake $0.13 
Board [3c 8c 9s Ad 5d]
Seat 1: ArcticBearDK (big blind) folded before Flop
Seat 2: Yspenyanin folded before Flop (didn't bet)
Seat 3: robertsabb folded before Flop (didn't bet)
Seat 4: Dcaro31 folded before Flop (didn't bet)
Seat 5: 6ePeMeHHa9 (button) showed [Ah 5h] and won ($2.71) with two pair, Aces and Fives
Seat 6: StackSmakka (small blind) showed [Ac Jd] and lost with a pair of Aces



PokerStars Hand #166667684792:  Hold'em No Limit ($0.05/$0.10 USD) - 2017/02/23 16:05:39 ET
Table 'Isberga' 6-max Seat #4 is the button
Seat 1: Feverhead ($18.32 in chips) 
Seat 2: GESPERIA ($10.27 in chips) 
Seat 4: THIMUCHIN ($10.69 in chips) 
Seat 5: YoungGriff86 ($18.92 in chips) 
Seat 6: Goroshkos88 ($21.23 in chips) 
YoungGriff86: posts small blind $0.05
Goroshkos88: posts big blind $0.10
*** HOLE CARDS ***
Feverhead: folds 
GESPERIA: folds 
THIMUCHIN: folds 
YoungGriff86: folds 
Uncalled bet ($0.05) returned to Goroshkos88
Goroshkos88 collected $0.10 from pot
*** SUMMARY ***
Total pot $0.10 | Rake $0 
Seat 1: Feverhead folded before Flop (didn't bet)
Seat 2: GESPERIA folded before Flop (didn't bet)
Seat 4: THIMUCHIN (button) folded before Flop (didn't bet)
Seat 5: YoungGriff86 (small blind) folded before Flop
Seat 6: Goroshkos88 (big blind) collected ($0.10)



PokerStars Hand #166667685175:  Hold'em No Limit ($0.05/$0.10 USD) - 2017/02/23 16:05:39 ET
Table 'Persephone' 6-max Seat #5 is the button
Seat 1: dragonste89 ($10 in chips) 
Seat 2: AM-L-SL ($5.50 in chips) 
Seat 3: DasoII ($4.85 in chips) 
Seat 4: 2G28 ($10 in chips) 
Seat 5: ab260414 ($10 in chips) 
Seat 6: popypaleta ($14.44 in chips) 
popypaleta: posts small blind $0.05
dragonste89: posts big blind $0.10
*** HOLE CARDS ***
AM-L-SL: folds 
DasoII: folds 
2G28: raises $0.15 to $0.25
ab260414: raises $0.65 to $0.90
popypaleta: folds 
dragonste89: folds 
2G28: calls $0.65
*** FLOP *** [Kh 6h 5h]
2G28: checks 
ab260414: bets $1.60
2G28: folds 
Uncalled bet ($1.60) returned to ab260414
ab260414 collected $1.86 from pot
*** SUMMARY ***
Total pot $1.95 | Rake $0.09 
Board [Kh 6h 5h]
Seat 1: dragonste89 (big blind) folded before Flop
Seat 2: AM-L-SL folded before Flop (didn't bet)
Seat 3: DasoII folded before Flop (didn't bet)
Seat 4: 2G28 folded on the Flop
Seat 5: ab260414 (button) collected ($1.86)
Seat 6: popypaleta (small blind) folded before Flop



PokerStars Hand #166667685976:  Hold'em No Limit ($0.05/$0.10 USD) - 2017/02/23 16:05:40 ET
Table 'Postrema' 6-max Seat #6 is the button
Seat 1: CHRO8 ($13.62 in chips) 
Seat 2: pancernik21 ($12.76 in chips) 
Seat 3: edcc19 ($2.81 in chips) 
Seat 4: ChuikaPridi ($13.63 in chips) 
Seat 5: Comeback3392 ($12.05 in chips) 
Seat 6: Scanner17 ($10 in chips) 
CHRO8: posts small blind $0.05
pancernik21: posts big blind $0.10
*** HOLE CARDS ***
edcc19: folds 
ChuikaPridi: folds 
Comeback3392: raises $0.20 to $0.30
Scanner17: folds 
CHRO8: calls $0.25
pancernik21: folds 
*** FLOP *** [Kd Qd Th]
CHRO8: checks 
Comeback3392: checks 
*** TURN *** [Kd Qd Th] [Jc]
CHRO8: checks 
Comeback3392: bets $0.45
CHRO8: folds 
Uncalled bet ($0.45) returned to Comeback3392
Comeback3392 collected $0.67 from pot
*** SUMMARY ***
Total pot $0.70 | Rake $0.03 
Board [Kd Qd Th Jc]
Seat 1: CHRO8 (small blind) folded on the Turn
Seat 2: pancernik21 (big blind) folded before Flop
Seat 3: edcc19 folded before Flop (didn't bet)
Seat 4: ChuikaPridi folded before Flop (didn't bet)
Seat 5: Comeback3392 collected ($0.67)
Seat 6: Scanner17 (button) folded before Flop (didn't bet)



PokerStars Hand #166667686081:  Hold'em No Limit ($0.05/$0.10 USD) - 2017/02/23 16:05:40 ET
Table 'Clavel' 6-max Seat #1 is the button
Seat 1: KRZuff ($14.36 in chips) 
Seat 2: Namhkal ($10 in chips) 
Seat 4: Dcaro31 ($11.98 in chips) 
Seat 5: Vrinni ($10.14 in chips) 
Seat 6: Gra_anD77 ($4.70 in chips) 
Namhkal: posts small blind $0.05
Dcaro31: posts big blind $0.10
*** HOLE CARDS ***
Vrinni: folds 
Gra_anD77: folds 
KRZuff: raises $0.15 to $0.25
Namhkal: folds 
Dcaro31: folds 
Uncalled bet ($0.15) returned to KRZuff
KRZuff collected $0.25 from pot
*** SUMMARY ***
Total pot $0.25 | Rake $0 
Seat 1: KRZuff (button) collected ($0.25)
Seat 2: Namhkal (small blind) folded before Flop
Seat 4: Dcaro31 (big blind) folded before Flop
Seat 5: Vrinni folded before Flop (didn't bet)
Seat 6: Gra_anD77 folded before Flop (didn't bet)



PokerStars Hand #166667686139:  Hold'em No Limit ($0.05/$0.10 USD) - 2017/02/23 16:05:40 ET
Table 'Pompeja III' 6-max Seat #5 is the button
Seat 1: Iarlei ($12.19 in chips) 
Seat 2: steepfell ($10 in chips) 
Seat 3: Yspenyanin ($11.85 in chips) 
Seat 4: Cluckh ($13.87 in chips) 
Seat 5: Spud014 ($11.99 in chips) 
Seat 6: mega spasser ($4.85 in chips) 
mega spasser: posts small blind $0.05
Iarlei: posts big blind $0.10
*** HOLE CARDS ***
steepfell: folds 
Yspenyanin: folds 
Cluckh: folds 
Spud014: raises $0.10 to $0.20
mega spasser: folds 
Iarlei: calls $0.10
*** FLOP *** [Jh 4c 4s]
Iarlei: checks 
Spud014: bets $0.21
Iarlei: folds 
Uncalled bet ($0.21) returned to Spud014
Spud014 collected $0.43 from pot
*** SUMMARY ***
Total pot $0.45 | Rake $0.02 
Board [Jh 4c 4s]
Seat 1: Iarlei (big blind) folded on the Flop
Seat 2: steepfell folded before Flop (didn't bet)
Seat 3: Yspenyanin folded before Flop (didn't bet)
Seat 4: Cluckh folded before Flop (didn't bet)
Seat 5: Spud014 (button) collected ($0.43)
Seat 6: mega spasser (small blind) folded before Flop



PokerStars Hand #166667686347:  Hold'em No Limit ($0.05/$0.10 USD) - 2017/02/23 16:05:40 ET
Table 'Ruvuma' 6-max Seat #4 is the button
Seat 1: FRAID358 ($14.15 in chips) 
Seat 2: Fab_1512 ($12.62 in chips) 
Seat 3: Spud014 ($10 in chips) 
Seat 4: DamDatsAnAce ($10 in chips) 
Seat 5: sexy_seagull ($10.28 in chips) 
sexy_seagull: posts small blind $0.05
Elinaattor: is sitting out 
FRAID358: posts big blind $0.10
*** HOLE CARDS ***
Fab_1512: raises $0.10 to $0.20
Spud014: folds 
DamDatsAnAce: folds 
sexy_seagull: calls $0.15
FRAID358: folds 
*** FLOP *** [Jc Qs Qd]
sexy_seagull: checks 
Fab_1512: checks 
*** TURN *** [Jc Qs Qd] [Js]
sexy_seagull: checks 
Fab_1512: checks 
*** RIVER *** [Jc Qs Qd Js] [2h]
sexy_seagull: checks 
Fab_1512: checks 
*** SHOW DOWN ***
sexy_seagull: shows [8d 8s] (two pair, Queens and Jacks)
Fab_1512: shows [3d As] (two pair, Queens and Jacks - Ace kicker)
Fab_1512 collected $0.48 from pot
*** SUMMARY ***
Total pot $0.50 | Rake $0.02 
Board [Jc Qs Qd Js 2h]
Seat 1: FRAID358 (big blind) folded before Flop
Seat 2: Fab_1512 showed [3d As] and won ($0.48) with two pair, Queens and Jacks
Seat 3: Spud014 folded before Flop (didn't bet)
Seat 4: DamDatsAnAce (button) folded before Flop (didn't bet)
Seat 5: sexy_seagull (small blind) showed [8d 8s] and lost with two pair, Queens and Jacks



PokerStars Hand #166667686965:  Hold'em No Limit ($0.05/$0.10 USD) - 2017/02/23 16:05:41 ET
Table 'Kanda' 6-max Seat #2 is the button
Seat 1: Andy Wolf ($11.27 in chips) 
Seat 2: Pelotín ($5.15 in chips) 
Seat 3: XaXaTyH4uK ($10 in chips) 
Seat 4: Orlangoor ($10.19 in chips) 
Seat 5: Dimka4 ($10 in chips) 
Seat 6: oddshoff ($9.21 in chips) 
XaXaTyH4uK: posts small blind $0.05
Orlangoor: posts big blind $0.10
*** HOLE CARDS ***
Dimka4: folds 
oddshoff: folds 
Andy Wolf: folds 
Pelotín: folds 
XaXaTyH4uK: folds 
Uncalled bet ($0.05) returned to Orlangoor
Orlangoor collected $0.10 from pot
*** SUMMARY ***
Total pot $0.10 | Rake $0 
Seat 1: Andy Wolf folded before Flop (didn't bet)
Seat 2: Pelotín (button) folded before Flop (didn't bet)
Seat 3: XaXaTyH4uK (small blind) folded before Flop
Seat 4: Orlangoor (big blind) collected ($0.10)
Seat 5: Dimka4 folded before Flop (didn't bet)
Seat 6: oddshoff folded before Flop (didn't bet)



PokerStars Hand #166667687110:  Hold'em No Limit ($0.05/$0.10 USD) - 2017/02/23 16:05:41 ET
Table 'Serpens' 6-max Seat #6 is the button
Seat 1: Namhkal ($10.20 in chips) 
Seat 2: KA3AXCTAHEU, ($19.35 in chips) 
Seat 3: homelessdan ($29.44 in chips) 
Seat 4: Ragazzi3 ($10 in chips) 
Seat 5: XwinX25 ($11.81 in chips) 
Seat 6: Croplayer1 ($10 in chips) 
Namhkal: posts small blind $0.05
KA3AXCTAHEU,: posts big blind $0.10
*** HOLE CARDS ***
homelessdan: folds 
Ragazzi3: calls $0.10
XwinX25: raises $0.30 to $0.40
Croplayer1: folds 
Namhkal: folds 
KA3AXCTAHEU,: folds 
Ragazzi3: calls $0.30
*** FLOP *** [6s 6d Th]
Ragazzi3: checks 
XwinX25: checks 
*** TURN *** [6s 6d Th] [2d]
Ragazzi3: checks 
XwinX25: checks 
*** RIVER *** [6s 6d Th 2d] [3c]
Ragazzi3: checks 
XwinX25: checks 
*** SHOW DOWN ***
Ragazzi3: shows [7h Jh] (a pair of Sixes)
XwinX25: shows [Kd 8d] (a pair of Sixes - King kicker)
XwinX25 collected $0.91 from pot
*** SUMMARY ***
Total pot $0.95 | Rake $0.04 
Board [6s 6d Th 2d 3c]
Seat 1: Namhkal (small blind) folded before Flop
Seat 2: KA3AXCTAHEU, (big blind) folded before Flop
Seat 3: homelessdan folded before Flop (didn't bet)
Seat 4: Ragazzi3 showed [7h Jh] and lost with a pair of Sixes
Seat 5: XwinX25 showed [Kd 8d] and won ($0.91) with a pair of Sixes
Seat 6: Croplayer1 (button) folded before Flop (didn't bet)



PokerStars Hand #166667687398:  Hold'em No Limit ($0.05/$0.10 USD) - 2017/02/23 16:05:42 ET
Table 'Deflotte' 6-max Seat #5 is the button
Seat 1: Zooplack ($15.79 in chips) 
Seat 2: MonteCris92 ($10.23 in chips) 
Seat 3: Croplayer1 ($10.15 in chips) 
Seat 4: 8th wonders ($10.17 in chips) 
Seat 5: Pokeaster ($11.32 in chips) 
Seat 6: Iarlei ($11.90 in chips) 
Iarlei: posts small blind $0.05
Zooplack: posts big blind $0.10
*** HOLE CARDS ***
MonteCris92: folds 
Croplayer1: folds 
8th wonders: folds 
Pokeaster: raises $0.15 to $0.25
Iarlei: folds 
Zooplack: folds 
Uncalled bet ($0.15) returned to Pokeaster
Pokeaster collected $0.25 from pot
*** SUMMARY ***
Total pot $0.25 | Rake $0 
Seat 1: Zooplack (big blind) folded before Flop
Seat 2: MonteCris92 folded before Flop (didn't bet)
Seat 3: Croplayer1 folded before Flop (didn't bet)
Seat 4: 8th wonders folded before Flop (didn't bet)
Seat 5: Pokeaster (button) collected ($0.25)
Seat 6: Iarlei (small blind) folded before Flop



PokerStars Hand #166667687400:  Hold'em No Limit ($0.05/$0.10 USD) - 2017/02/23 16:05:42 ET
Table 'Joella' 6-max Seat #1 is the button
Seat 1: Dcaro31 ($13.10 in chips) 
Seat 2: Kaelyns_Bark ($7.20 in chips) 
Seat 3: Joker51_wtf! ($11.47 in chips) 
Seat 5: Anestakis777 ($5.79 in chips) 
Seat 6: dr.goofy ($10.85 in chips) 
Kaelyns_Bark: posts small blind $0.05
Joker51_wtf!: posts big blind $0.10
*** HOLE CARDS ***
Anestakis777: calls $0.10
dr.goofy: folds 
Dcaro31: folds 
Kaelyns_Bark: folds 
Joker51_wtf!: checks 
*** FLOP *** [9c Js Ad]
Joker51_wtf!: bets $0.12
Anestakis777: raises $0.12 to $0.24
Joker51_wtf!: folds 
Uncalled bet ($0.12) returned to Anestakis777
Anestakis777 collected $0.47 from pot
*** SUMMARY ***
Total pot $0.49 | Rake $0.02 
Board [9c Js Ad]
Seat 1: Dcaro31 (button) folded before Flop (didn't bet)
Seat 2: Kaelyns_Bark (small blind) folded before Flop
Seat 3: Joker51_wtf! (big blind) folded on the Flop
Seat 5: Anestakis777 collected ($0.47)
Seat 6: dr.goofy folded before Flop (didn't bet)



PokerStars Hand #166667687465:  Hold'em No Limit ($0.05/$0.10 USD) - 2017/02/23 16:05:42 ET
Table 'Sinon II' 6-max Seat #3 is the button
Seat 1: Aescul@pius ($10.37 in chips) 
Seat 2: ÄissesHai ($16.90 in chips) 
Seat 3: crazydevill ($10.63 in chips) 
Seat 4: Bandyaev ($15.38 in chips) 
Seat 5: ab260414 ($11.06 in chips) 
Bandyaev: posts small blind $0.05
ab260414: posts big blind $0.10
*** HOLE CARDS ***
Aescul@pius: folds 
ÄissesHai: calls $0.10
crazydevill: folds 
Bandyaev: folds 
ab260414: checks 
*** FLOP *** [9h 2h Qs]
ab260414: checks 
ÄissesHai: bets $0.10
ab260414: folds 
Uncalled bet ($0.10) returned to ÄissesHai
ÄissesHai collected $0.24 from pot
*** SUMMARY ***
Total pot $0.25 | Rake $0.01 
Board [9h 2h Qs]
Seat 1: Aescul@pius folded before Flop (didn't bet)
Seat 2: ÄissesHai collected ($0.24)
Seat 3: crazydevill (button) folded before Flop (didn't bet)
Seat 4: Bandyaev (small blind) folded before Flop
Seat 5: ab260414 (big blind) folded on the Flop



PokerStars Hand #166667687471:  Hold'em No Limit ($0.05/$0.10 USD) - 2017/02/23 16:05:42 ET
Table 'Grietje' 6-max Seat #1 is the button
Seat 1: dragonste89 ($10 in chips) 
Seat 2: Feverhead ($12.62 in chips) 
Seat 3: GitoValdivia ($6.81 in chips) 
Seat 4: MihaGr ($10.50 in chips) 
Seat 5: iThreeBarrel ($10.15 in chips) 
Seat 6: Prometheu$8 ($21.70 in chips) 
Feverhead: posts small blind $0.05
GitoValdivia: posts big blind $0.10
*** HOLE CARDS ***
MihaGr: folds 
iThreeBarrel: folds 
Prometheu$8: folds 
dragonste89: raises $0.15 to $0.25
Feverhead: folds 
GitoValdivia: folds 
Uncalled bet ($0.15) returned to dragonste89
dragonste89 collected $0.25 from pot
*** SUMMARY ***
Total pot $0.25 | Rake $0 
Seat 1: dragonste89 (button) collected ($0.25)
Seat 2: Feverhead (small blind) folded before Flop
Seat 3: GitoValdivia (big blind) folded before Flop
Seat 4: MihaGr folded before Flop (didn't bet)
Seat 5: iThreeBarrel folded before Flop (didn't bet)
Seat 6: Prometheu$8 folded before Flop (didn't bet)



PokerStars Hand #166667687705:  Hold'em No Limit ($0.05/$0.10 USD) - 2017/02/23 16:05:42 ET
Table 'Caupolican II' 6-max Seat #4 is the button
Seat 1: Strelok1974 ($10 in chips) 
Seat 2: MBen10 ($22.07 in chips) 
Seat 3: fedorka rus ($12.13 in chips) 
Seat 4: GESPERIA ($21.42 in chips) 
Seat 5: ArcticBearDK ($14.34 in chips) 
Seat 6: pancernik21 ($13.30 in chips) 
ArcticBearDK: posts small blind $0.05
pancernik21: posts big blind $0.10
*** HOLE CARDS ***
Strelok1974: folds 
MBen10: raises $0.18 to $0.28
fedorka rus: folds 
GESPERIA: folds 
ArcticBearDK: raises $0.84 to $1.12
pancernik21: folds 
MBen10: calls $0.84
*** FLOP *** [Td 2c Kc]
ArcticBearDK: bets $1.20
MBen10: folds 
Uncalled bet ($1.20) returned to ArcticBearDK
ArcticBearDK collected $2.23 from pot
*** SUMMARY ***
Total pot $2.34 | Rake $0.11 
Board [Td 2c Kc]
Seat 1: Strelok1974 folded before Flop (didn't bet)
Seat 2: MBen10 folded on the Flop
Seat 3: fedorka rus folded before Flop (didn't bet)
Seat 4: GESPERIA (button) folded before Flop (didn't bet)
Seat 5: ArcticBearDK (small blind) collected ($2.23)
Seat 6: pancernik21 (big blind) folded before Flop



PokerStars Hand #166667688142:  Hold'em No Limit ($0.05/$0.10 USD) - 2017/02/23 16:05:42 ET
Table 'Siebohme II' 6-max Seat #3 is the button
Seat 1: homelessdan ($17.97 in chips) 
Seat 2: townerz1991 ($14.17 in chips) 
Seat 3: D3NyA ($10.18 in chips) 
Seat 4: POT_TRADER ($12.19 in chips) 
Seat 5: NvR.m1nD ($10.37 in chips) 
Seat 6: Fozzy690 ($10.14 in chips) 
POT_TRADER: posts small blind $0.05
NvR.m1nD: posts big blind $0.10
*** HOLE CARDS ***
Fozzy690: calls $0.10
homelessdan: folds 
townerz1991: folds 
D3NyA: folds 
POT_TRADER: folds 
NvR.m1nD: checks 
*** FLOP *** [4h Qs 9c]
NvR.m1nD: bets $0.12
Fozzy690: calls $0.12
*** TURN *** [4h Qs 9c] [Ts]
NvR.m1nD: bets $0.31
Fozzy690: folds 
Uncalled bet ($0.31) returned to NvR.m1nD
NvR.m1nD collected $0.47 from pot
*** SUMMARY ***
Total pot $0.49 | Rake $0.02 
Board [4h Qs 9c Ts]
Seat 1: homelessdan folded before Flop (didn't bet)
Seat 2: townerz1991 folded before Flop (didn't bet)
Seat 3: D3NyA (button) folded before Flop (didn't bet)
Seat 4: POT_TRADER (small blind) folded before Flop
Seat 5: NvR.m1nD (big blind) collected ($0.47)
Seat 6: Fozzy690 folded on the Turn



PokerStars Hand #166667688169:  Hold'em No Limit ($0.05/$0.10 USD) - 2017/02/23 16:05:42 ET
Table 'Markab II' 6-max Seat #4 is the button
Seat 1: david_sara83 ($10.67 in chips) 
Seat 2: truck1234 ($11.05 in chips) 
Seat 3: sexy_seagull ($10 in chips) 
Seat 4: Crafty23@PS ($11.54 in chips) 
Seat 5: Rodik002 ($19.37 in chips) 
Seat 6: Comeback3392 ($10 in chips) 
Rodik002: posts small blind $0.05
Comeback3392: posts big blind $0.10
*** HOLE CARDS ***
david_sara83: raises $0.20 to $0.30
truck1234: folds 
sexy_seagull: folds 
Crafty23@PS: folds 
Rodik002: raises $0.70 to $1
Comeback3392: folds 
david_sara83: folds 
Uncalled bet ($0.70) returned to Rodik002
Rodik002 collected $0.70 from pot
*** SUMMARY ***
Total pot $0.70 | Rake $0 
Seat 1: david_sara83 folded before Flop
Seat 2: truck1234 folded before Flop (didn't bet)
Seat 3: sexy_seagull folded before Flop (didn't bet)
Seat 4: Crafty23@PS (button) folded before Flop (didn't bet)
Seat 5: Rodik002 (small blind) collected ($0.70)
Seat 6: Comeback3392 (big blind) folded before Flop



PokerStars Hand #166667688354:  Hold'em No Limit ($0.05/$0.10 USD) - 2017/02/23 16:05:43 ET
Table 'Lederle' 6-max Seat #2 is the button
Seat 2: truck1234 ($15.85 in chips) 
Seat 3: Kazacha ($10.20 in chips) 
Seat 4: Pokeaster ($13.76 in chips) 
Seat 5: 8th wonders ($14.33 in chips) 
Seat 6: pokekrk ($10.10 in chips) 
Kazacha: posts small blind $0.05
Pokeaster: posts big blind $0.10
*** HOLE CARDS ***
8th wonders: folds 
pokekrk: folds 
truck1234: folds 
Kazacha: folds 
Uncalled bet ($0.05) returned to Pokeaster
Pokeaster collected $0.10 from pot
*** SUMMARY ***
Total pot $0.10 | Rake $0 
Seat 2: truck1234 (button) folded before Flop (didn't bet)
Seat 3: Kazacha (small blind) folded before Flop
Seat 4: Pokeaster (big blind) collected ($0.10)
Seat 5: 8th wonders folded before Flop (didn't bet)
Seat 6: pokekrk folded before Flop (didn't bet)



PokerStars Hand #166667688704:  Hold'em No Limit ($0.05/$0.10 USD) - 2017/02/23 16:05:43 ET
Table 'Halawe II' 6-max Seat #3 is the button
Seat 1: DIGOR100 ($6.87 in chips) 
Seat 3: cherep61987 ($10.79 in chips) 
Seat 4: voledy ($12.50 in chips) 
Seat 5: takis nik ($12.43 in chips) 
Seat 6: Rodik002 ($20.37 in chips) 
voledy: posts small blind $0.05
takis nik: posts big blind $0.10
*** HOLE CARDS ***
Rodik002: folds 
DIGOR100: calls $0.10
cherep61987: folds 
voledy: folds 
takis nik: checks 
*** FLOP *** [8s 8h Kh]
takis nik: checks 
DIGOR100: bets $0.24
takis nik: folds 
Uncalled bet ($0.24) returned to DIGOR100
DIGOR100 collected $0.24 from pot
*** SUMMARY ***
Total pot $0.25 | Rake $0.01 
Board [8s 8h Kh]
Seat 1: DIGOR100 collected ($0.24)
Seat 3: cherep61987 (button) folded before Flop (didn't bet)
Seat 4: voledy (small blind) folded before Flop
Seat 5: takis nik (big blind) folded on the Flop
Seat 6: Rodik002 folded before Flop (didn't bet)



PokerStars Hand #166667689433:  Hold'em No Limit ($0.05/$0.10 USD) - 2017/02/23 16:05:44 ET
Table 'Garlena III' 6-max Seat #1 is the button
Seat 1: dittoro ($10 in chips) 
Seat 2: rusu_rapid ($10 in chips) 
Seat 3: Therodorus ($10 in chips) 
rusu_rapid: posts small blind $0.05
Therodorus: posts big blind $0.10
*** HOLE CARDS ***
dittoro: folds 
rusu_rapid: folds 
Uncalled bet ($0.05) returned to Therodorus
Therodorus collected $0.10 from pot
*** SUMMARY ***
Total pot $0.10 | Rake $0 
Seat 1: dittoro (button) folded before Flop (didn't bet)
Seat 2: rusu_rapid (small blind) folded before Flop
Seat 3: Therodorus (big blind) collected ($0.10)



PokerStars Hand #166667689443:  Hold'em No Limit ($0.05/$0.10 USD) - 2017/02/23 16:05:44 ET
Table 'Crommelin II' 6-max Seat #1 is the button
Seat 1: THIMUCHIN ($11.62 in chips) 
Seat 2: Bird et al ($10.05 in chips) 
Seat 3: Strelok1974 ($21.80 in chips) 
Seat 4: Pequeño Clau ($13.12 in chips) 
Seat 5: Action_Gibi ($17.13 in chips) 
Bird et al: posts small blind $0.05
Strelok1974: posts big blind $0.10
*** HOLE CARDS ***
Action_Gibi said, "si sick player"
Pequeño Clau: folds 
Action_Gibi: folds 
THIMUCHIN: folds 
Bird et al: raises $0.20 to $0.30
Strelok1974: folds 
Uncalled bet ($0.20) returned to Bird et al
Bird et al collected $0.20 from pot
*** SUMMARY ***
Total pot $0.20 | Rake $0 
Seat 1: THIMUCHIN (button) folded before Flop (didn't bet)
Seat 2: Bird et al (small blind) collected ($0.20)
Seat 3: Strelok1974 (big blind) folded before Flop
Seat 4: Pequeño Clau folded before Flop (didn't bet)
Seat 5: Action_Gibi folded before Flop (didn't bet)



PokerStars Hand #166667689993:  Hold'em No Limit ($0.05/$0.10 USD) - 2017/02/23 16:05:44 ET
Table 'Nekkar' 6-max Seat #2 is the button
Seat 2: Bird et al ($11.02 in chips) 
Seat 3: Zemz_Ru ($15.10 in chips) 
Seat 4: kingartur222 ($13.34 in chips) 
Seat 5: Vrinni ($11.70 in chips) 
Seat 6: Eddys Edge ($10.48 in chips) 
Zemz_Ru: posts small blind $0.05
kingartur222: posts big blind $0.10
*** HOLE CARDS ***
Vrinni: folds 
Eddys Edge: folds 
Bird et al: folds 
Zemz_Ru: raises $0.20 to $0.30
kingartur222: folds 
Uncalled bet ($0.20) returned to Zemz_Ru
Zemz_Ru collected $0.20 from pot
*** SUMMARY ***
Total pot $0.20 | Rake $0 
Seat 2: Bird et al (button) folded before Flop (didn't bet)
Seat 3: Zemz_Ru (small blind) collected ($0.20)
Seat 4: kingartur222 (big blind) folded before Flop
Seat 5: Vrinni folded before Flop (didn't bet)
Seat 6: Eddys Edge folded before Flop (didn't bet)



PokerStars Hand #166667690114:  Hold'em No Limit ($0.05/$0.10 USD) - 2017/02/23 16:05:45 ET
Table 'Atalante' 6-max Seat #4 is the button
Seat 1: OceanBlue100 ($5.09 in chips) 
Seat 2: CiisCi ($20.05 in chips) 
Seat 3: Kow6oy ($10 in chips) 
Seat 4: Dcaro31 ($24.92 in chips) 
Seat 5: eniksenik ($10.19 in chips) 
Seat 6: FlopsterGB ($30.38 in chips) 
eniksenik: posts small blind $0.05
FlopsterGB: posts big blind $0.10
*** HOLE CARDS ***
OceanBlue100: folds 
CiisCi: raises $0.25 to $0.35
Kow6oy: folds 
Dcaro31: folds 
eniksenik: folds 
FlopsterGB: folds 
Uncalled bet ($0.25) returned to CiisCi
CiisCi collected $0.25 from pot
*** SUMMARY ***
Total pot $0.25 | Rake $0 
Seat 1: OceanBlue100 folded before Flop (didn't bet)
Seat 2: CiisCi collected ($0.25)
Seat 3: Kow6oy folded before Flop (didn't bet)
Seat 4: Dcaro31 (button) folded before Flop (didn't bet)
Seat 5: eniksenik (small blind) folded before Flop
Seat 6: FlopsterGB (big blind) folded before Flop



PokerStars Hand #166667690373:  Hold'em No Limit ($0.05/$0.10 USD) - 2017/02/23 16:05:45 ET
Table 'Lampetia' 6-max Seat #3 is the button
Seat 1: WinninBikini ($10.29 in chips) 
Seat 2: ex3Lero86 ($10.15 in chips) 
Seat 3: Ice_Isayev ($19.89 in chips) 
Seat 4: Rodik002 ($10 in chips) 
Seat 5: luisantrs ($9.33 in chips) 
Seat 6: Scanner17 ($12.44 in chips) 
Rodik002: posts small blind $0.05
luisantrs: posts big blind $0.10
*** HOLE CARDS ***
Scanner17: folds 
WinninBikini: folds 
ex3Lero86: raises $0.15 to $0.25
Ice_Isayev: folds 
Rodik002: folds 
luisantrs: folds 
Uncalled bet ($0.15) returned to ex3Lero86
ex3Lero86 collected $0.25 from pot
*** SUMMARY ***
Total pot $0.25 | Rake $0 
Seat 1: WinninBikini folded before Flop (didn't bet)
Seat 2: ex3Lero86 collected ($0.25)
Seat 3: Ice_Isayev (button) folded before Flop (didn't bet)
Seat 4: Rodik002 (small blind) folded before Flop
Seat 5: luisantrs (big blind) folded before Flop
Seat 6: Scanner17 folded before Flop (didn't bet)



PokerStars Hand #166667690604:  Hold'em No Limit ($0.05/$0.10 USD) - 2017/02/23 16:05:45 ET
Table 'Gyldenia II' 6-max Seat #1 is the button
Seat 1: KokoulinV ($10.25 in chips) 
Seat 2: Bandyaev ($10.99 in chips) 
Seat 5: CHRO8 ($15.72 in chips) 
Seat 6: 8th wonders ($11.53 in chips) 
Bandyaev: posts small blind $0.05
CHRO8: posts big blind $0.10
*** HOLE CARDS ***
8th wonders: folds 
KokoulinV: raises $0.10 to $0.20
Bandyaev: folds 
CHRO8: calls $0.10
*** FLOP *** [3h Qd Ac]
CHRO8: checks 
KokoulinV: bets $0.25
CHRO8: folds 
Uncalled bet ($0.25) returned to KokoulinV
KokoulinV collected $0.43 from pot
*** SUMMARY ***
Total pot $0.45 | Rake $0.02 
Board [3h Qd Ac]
Seat 1: KokoulinV (button) collected ($0.43)
Seat 2: Bandyaev (small blind) folded before Flop
Seat 5: CHRO8 (big blind) folded on the Flop
Seat 6: 8th wonders folded before Flop (didn't bet)



PokerStars Hand #166667690770:  Hold'em No Limit ($0.05/$0.10 USD) - 2017/02/23 16:05:45 ET
Table 'Gaika II' 6-max Seat #5 is the button
Seat 1: Ice_Isayev ($10 in chips) 
Seat 2: steepfell ($10.32 in chips) 
Seat 3: iDecMate ($18.73 in chips) 
Seat 4: Hyd SK ($11.67 in chips) 
Seat 5: KokoulinV ($12.56 in chips) 
Seat 6: bartabs2 ($9.27 in chips) 
bartabs2: posts small blind $0.05
Ice_Isayev: posts big blind $0.10
*** HOLE CARDS ***
steepfell: folds 
iDecMate: folds 
Hyd SK: raises $0.25 to $0.35
KokoulinV: folds 
bartabs2: calls $0.30
Ice_Isayev: folds 
*** FLOP *** [Kd 5s 5d]
bartabs2: checks 
Hyd SK: bets $0.50
bartabs2: folds 
Uncalled bet ($0.50) returned to Hyd SK
Hyd SK collected $0.76 from pot
*** SUMMARY ***
Total pot $0.80 | Rake $0.04 
Board [Kd 5s 5d]
Seat 1: Ice_Isayev (big blind) folded before Flop
Seat 2: steepfell folded before Flop (didn't bet)
Seat 3: iDecMate folded before Flop (didn't bet)
Seat 4: Hyd SK collected ($0.76)
Seat 5: KokoulinV (button) folded before Flop (didn't bet)
Seat 6: bartabs2 (small blind) folded on the Flop



PokerStars Hand #166667690776:  Hold'em No Limit ($0.05/$0.10 USD) - 2017/02/23 16:05:45 ET
Table 'Kraz II' 6-max Seat #6 is the button
Seat 1: bdixon_5 ($9.60 in chips) 
Seat 2: shellyld ($10 in chips) 
Seat 3: Eddys Edge ($10 in chips) 
Seat 4: WinninBikini ($12.43 in chips) 
Seat 5: Joker51_wtf! ($10.15 in chips) 
Seat 6: tr41n3r12 ($10 in chips) 
bdixon_5: posts small blind $0.05
shellyld: posts big blind $0.10
*** HOLE CARDS ***
Eddys Edge: folds 
WinninBikini: folds 
Joker51_wtf!: folds 
tr41n3r12: folds 
bdixon_5: folds 
Uncalled bet ($0.05) returned to shellyld
shellyld collected $0.10 from pot
*** SUMMARY ***
Total pot $0.10 | Rake $0 
Seat 1: bdixon_5 (small blind) folded before Flop
Seat 2: shellyld (big blind) collected ($0.10)
Seat 3: Eddys Edge folded before Flop (didn't bet)
Seat 4: WinninBikini folded before Flop (didn't bet)
Seat 5: Joker51_wtf! folded before Flop (didn't bet)
Seat 6: tr41n3r12 (button) folded before Flop (didn't bet)



PokerStars Hand #166667691071:  Hold'em No Limit ($0.05/$0.10 USD) - 2017/02/23 16:05:46 ET
Table 'Brendelia II' 6-max Seat #6 is the button
Seat 2: Crimsonr ($5.06 in chips) 
Seat 3: ValdemorS ($18.98 in chips) 
Seat 6: luckyPositiv ($10.17 in chips) 
Crimsonr: posts small blind $0.05
ValdemorS: posts big blind $0.10
Crimsonr: posts the ante $0.02
ValdemorS: posts the ante $0.02
luckyPositiv: posts the ante $0.02
*** HOLE CARDS ***
luckyPositiv: raises $0.40 to $0.50
Crimsonr: folds 
ValdemorS: folds 
Uncalled bet ($0.40) returned to luckyPositiv
luckyPositiv collected $0.31 from pot
*** SUMMARY ***
Total pot $0.31 | Rake $0 
Seat 2: Crimsonr (small blind) folded before Flop
Seat 3: ValdemorS (big blind) folded before Flop
Seat 6: luckyPositiv (button) collected ($0.31)



PokerStars Hand #166667691404:  Hold'em No Limit ($0.05/$0.10 USD) - 2017/02/23 16:05:46 ET
Table 'Ophelia' 6-max Seat #5 is the button
Seat 1: ralfi37 ($9.68 in chips) 
Seat 2: popypaleta ($16.63 in chips) 
Seat 3: mvp0013 ($11.45 in chips) 
Seat 4: Cluckh ($12.14 in chips) 
Seat 5: truck1234 ($13.86 in chips) 
Seat 6: Yabidooo ($11.18 in chips) 
Yabidooo: posts small blind $0.05
ralfi37: posts big blind $0.10
*** HOLE CARDS ***
popypaleta: folds 
mvp0013: raises $0.20 to $0.30
Cluckh: folds 
truck1234: folds 
Yabidooo: folds 
ralfi37: folds 
Uncalled bet ($0.20) returned to mvp0013
mvp0013 collected $0.25 from pot
*** SUMMARY ***
Total pot $0.25 | Rake $0 
Seat 1: ralfi37 (big blind) folded before Flop
Seat 2: popypaleta folded before Flop (didn't bet)
Seat 3: mvp0013 collected ($0.25)
Seat 4: Cluckh folded before Flop (didn't bet)
Seat 5: truck1234 (button) folded before Flop (didn't bet)
Seat 6: Yabidooo (small blind) folded before Flop



PokerStars Hand #166667691981:  Hold'em No Limit ($0.05/$0.10 USD) - 2017/02/23 16:05:47 ET
Table 'Cyane' 6-max Seat #1 is the button
Seat 1: KA3AXCTAHEU, ($10 in chips) 
Seat 2: sashi18 ($8.21 in chips) 
Seat 3: Mamm0nism ($13.04 in chips) 
Seat 4: truck1234 ($20.81 in chips) 
Seat 6: 8th wonders ($11.60 in chips) 
sashi18: posts small blind $0.05
Mamm0nism: posts big blind $0.10
RoJ1: sits out 
*** HOLE CARDS ***
truck1234: folds 
8th wonders: folds 
KA3AXCTAHEU,: raises $0.15 to $0.25
sashi18: folds 
Mamm0nism: folds 
Uncalled bet ($0.15) returned to KA3AXCTAHEU,
KA3AXCTAHEU, collected $0.25 from pot
*** SUMMARY ***
Total pot $0.25 | Rake $0 
Seat 1: KA3AXCTAHEU, (button) collected ($0.25)
Seat 2: sashi18 (small blind) folded before Flop
Seat 3: Mamm0nism (big blind) folded before Flop
Seat 4: truck1234 folded before Flop (didn't bet)
Seat 6: 8th wonders folded before Flop (didn't bet)



PokerStars Hand #166667692090:  Hold'em No Limit ($0.05/$0.10 USD) - 2017/02/23 16:05:47 ET
Table 'Pirola' 6-max Seat #5 is the button
Seat 1: Rodik002 ($10.28 in chips) 
Seat 2: lmlmlmlm90 ($18.54 in chips) 
Seat 3: XaXaTyH4uK ($11.08 in chips) 
Seat 4: barons89 ($12.06 in chips) 
Seat 5: Iarlei ($14.24 in chips) 
Seat 6: Hyd SK ($10 in chips) 
Hyd SK: posts small blind $0.05
Rodik002: posts big blind $0.10
*** HOLE CARDS ***
lmlmlmlm90 has timed out
lmlmlmlm90: folds 
XaXaTyH4uK: folds 
barons89: folds 
Iarlei: raises $0.15 to $0.25
Hyd SK: raises $0.75 to $1
Rodik002: folds 
Iarlei: folds 
Uncalled bet ($0.75) returned to Hyd SK
Hyd SK collected $0.60 from pot
*** SUMMARY ***
Total pot $0.60 | Rake $0 
Seat 1: Rodik002 (big blind) folded before Flop
Seat 2: lmlmlmlm90 folded before Flop (didn't bet)
Seat 3: XaXaTyH4uK folded before Flop (didn't bet)
Seat 4: barons89 folded before Flop (didn't bet)
Seat 5: Iarlei (button) folded before Flop
Seat 6: Hyd SK (small blind) collected ($0.60)



PokerStars Hand #166667692098:  Hold'em No Limit ($0.05/$0.10 USD) - 2017/02/23 16:05:47 ET
Table 'Eurykleia' 6-max Seat #3 is the button
Seat 1: Giyorod ($10.15 in chips) 
Seat 2: x3ultimate ($10.74 in chips) 
Seat 3: boxer821 ($20.41 in chips) 
Seat 4: 6ePeMeHHa9 ($16.92 in chips) 
Seat 5: fishhook5 ($10.15 in chips) 
Seat 6: afca128 ($6.42 in chips) 
6ePeMeHHa9: posts small blind $0.05
fishhook5: posts big blind $0.10
*** HOLE CARDS ***
afca128: raises $0.10 to $0.20
Giyorod: folds 
x3ultimate: folds 
boxer821: folds 
6ePeMeHHa9: folds 
fishhook5: folds 
Uncalled bet ($0.10) returned to afca128
afca128 collected $0.25 from pot
*** SUMMARY ***
Total pot $0.25 | Rake $0 
Seat 1: Giyorod folded before Flop (didn't bet)
Seat 2: x3ultimate folded before Flop (didn't bet)
Seat 3: boxer821 (button) folded before Flop (didn't bet)
Seat 4: 6ePeMeHHa9 (small blind) folded before Flop
Seat 5: fishhook5 (big blind) folded before Flop
Seat 6: afca128 collected ($0.25)



PokerStars Hand #166667692205:  Hold'em No Limit ($0.05/$0.10 USD) - 2017/02/23 16:05:47 ET
Table 'Nehalennia III' 6-max Seat #2 is the button
Seat 1: boxer821 ($12.16 in chips) 
Seat 2: fortieth ($9.19 in chips) 
Seat 3: ValdemorS ($17.93 in chips) 
Seat 4: eniksenik ($10 in chips) 
Seat 5: wulffboy ($36.98 in chips) 
Seat 6: valzeny ($22.01 in chips) 
ValdemorS: posts small blind $0.05
eniksenik: posts big blind $0.10
boxer821: posts the ante $0.02
fortieth: posts the ante $0.02
ValdemorS: posts the ante $0.02
eniksenik: posts the ante $0.02
wulffboy: posts the ante $0.02
valzeny: posts the ante $0.02
*** HOLE CARDS ***
wulffboy: calls $0.10
valzeny: calls $0.10
boxer821: raises $0.57 to $0.67
fortieth: calls $0.67
ValdemorS: folds 
eniksenik: folds 
wulffboy: folds 
valzeny: calls $0.57
*** FLOP *** [Qc 3h 9s]
valzeny: checks 
boxer821: checks 
fortieth: bets $1.20
valzeny: folds 
boxer821: folds 
Uncalled bet ($1.20) returned to fortieth
fortieth collected $2.27 from pot
*** SUMMARY ***
Total pot $2.38 | Rake $0.11 
Board [Qc 3h 9s]
Seat 1: boxer821 folded on the Flop
Seat 2: fortieth (button) collected ($2.27)
Seat 3: ValdemorS (small blind) folded before Flop
Seat 4: eniksenik (big blind) folded before Flop
Seat 5: wulffboy folded before Flop
Seat 6: valzeny folded on the Flop



PokerStars Hand #166667692312:  Hold'em No Limit ($0.05/$0.10 USD) - 2017/02/23 16:05:47 ET
Table 'Unitas II' 6-max Seat #1 is the button
Seat 1: Peter0087 ($9.70 in chips) 
Seat 2: steepfell ($10 in chips) 
Seat 4: truck1234 ($10.94 in chips) 
Seat 5: chimera252 ($24.63 in chips) 
Seat 6: paxit71 ($9.73 in chips) 
steepfell: posts small blind $0.05
truck1234: posts big blind $0.10
*** HOLE CARDS ***
chimera252: folds 
paxit71: folds 
Peter0087: folds 
steepfell: raises $0.15 to $0.25
truck1234: folds 
Uncalled bet ($0.15) returned to steepfell
steepfell collected $0.20 from pot
*** SUMMARY ***
Total pot $0.20 | Rake $0 
Seat 1: Peter0087 (button) folded before Flop (didn't bet)
Seat 2: steepfell (small blind) collected ($0.20)
Seat 4: truck1234 (big blind) folded before Flop
Seat 5: chimera252 folded before Flop (didn't bet)
Seat 6: paxit71 folded before Flop (didn't bet)



PokerStars Hand #166667692561:  Hold'em No Limit ($0.05/$0.10 USD) - 2017/02/23 16:05:47 ET
Table 'Pyrrhus III' 6-max Seat #4 is the button
Seat 1: skatejeff ($13.72 in chips) 
Seat 2: univibe68 ($20.32 in chips) 
Seat 3: coolisses111 ($9.89 in chips) 
Seat 4: ex3Lero86 ($23.13 in chips) 
Seat 6: MLPlayer16 ($19.78 in chips) 
MLPlayer16: posts small blind $0.05
skatejeff: posts big blind $0.10
skatejeff: posts the ante $0.02
univibe68: posts the ante $0.02
coolisses111: posts the ante $0.02
ex3Lero86: posts the ante $0.02
MLPlayer16: posts the ante $0.02
*** HOLE CARDS ***
univibe68: folds 
coolisses111: folds 
mAEgar leaves the table
ex3Lero86: raises $0.17 to $0.27
MLPlayer16: folds 
skatejeff: folds 
Uncalled bet ($0.17) returned to ex3Lero86
ex3Lero86 collected $0.35 from pot
*** SUMMARY ***
Total pot $0.35 | Rake $0 
Seat 1: skatejeff (big blind) folded before Flop
Seat 2: univibe68 folded before Flop (didn't bet)
Seat 3: coolisses111 folded before Flop (didn't bet)
Seat 4: ex3Lero86 (button) collected ($0.35)
Seat 6: MLPlayer16 (small blind) folded before Flop



PokerStars Hand #166667692763:  Hold'em No Limit ($0.05/$0.10 USD) - 2017/02/23 16:05:47 ET
Table 'Reginhild' 6-max Seat #5 is the button
Seat 1: iamkakaroto ($11.40 in chips) 
Seat 2: Kow6oy ($10.15 in chips) 
Seat 3: ARCHITECT83 ($6.39 in chips) 
Seat 4: Raymondo21 ($23.63 in chips) 
Seat 5: XCarlos610 ($29.78 in chips) 
Seat 6: eniksenik ($10 in chips) 
eniksenik: posts small blind $0.05
iamkakaroto: posts big blind $0.10
*** HOLE CARDS ***
Kow6oy: raises $0.25 to $0.35
ARCHITECT83: folds 
Raymondo21: folds 
XCarlos610: folds 
eniksenik: folds 
iamkakaroto: folds 
Uncalled bet ($0.25) returned to Kow6oy
Kow6oy collected $0.25 from pot
*** SUMMARY ***
Total pot $0.25 | Rake $0 
Seat 1: iamkakaroto (big blind) folded before Flop
Seat 2: Kow6oy collected ($0.25)
Seat 3: ARCHITECT83 folded before Flop (didn't bet)
Seat 4: Raymondo21 folded before Flop (didn't bet)
Seat 5: XCarlos610 (button) folded before Flop (didn't bet)
Seat 6: eniksenik (small blind) folded before Flop



PokerStars Hand #166667692820:  Hold'em No Limit ($0.05/$0.10 USD) - 2017/02/23 16:05:47 ET
Table 'Hunnia' 6-max Seat #1 is the button
Seat 1: univibe68 ($21.88 in chips) 
Seat 2: mhonielsen ($10 in chips) 
Seat 3: 6ePeMeHHa9 ($10.71 in chips) 
Seat 4: Jalida3 ($10.69 in chips) 
Seat 5: Smarkon ($14.93 in chips) 
Seat 6: ChuikaPridi ($10 in chips) 
mhonielsen: posts small blind $0.05
6ePeMeHHa9: posts big blind $0.10
*** HOLE CARDS ***
Jalida3: folds 
Smarkon: raises $0.30 to $0.40
ChuikaPridi: folds 
univibe68: calls $0.40
mhonielsen: folds 
6ePeMeHHa9: folds 
*** FLOP *** [9d 9h 6h]
Smarkon: checks 
univibe68: checks 
*** TURN *** [9d 9h 6h] [Kh]
Smarkon: bets $0.30
univibe68: folds 
Uncalled bet ($0.30) returned to Smarkon
Smarkon collected $0.91 from pot
*** SUMMARY ***
Total pot $0.95 | Rake $0.04 
Board [9d 9h 6h Kh]
Seat 1: univibe68 (button) folded on the Turn
Seat 2: mhonielsen (small blind) folded before Flop
Seat 3: 6ePeMeHHa9 (big blind) folded before Flop
Seat 4: Jalida3 folded before Flop (didn't bet)
Seat 5: Smarkon collected ($0.91)
Seat 6: ChuikaPridi folded before Flop (didn't bet)



PokerStars Hand #166667692913:  Hold'em No Limit ($0.05/$0.10 USD) - 2017/02/23 16:05:48 ET
Table 'Aegle' 6-max Seat #2 is the button
Seat 1: phatts76 ($3.90 in chips) 
Seat 2: yodzik ($5 in chips) 
Seat 3: DrejAtom ($12.49 in chips) 
Seat 4: ab260414 ($10.37 in chips) 
Seat 5: KokoulinV ($11.26 in chips) 
Seat 6: CHRO8 ($20.44 in chips) 
DrejAtom: posts small blind $0.05
ab260414: posts big blind $0.10
*** HOLE CARDS ***
KokoulinV: folds 
CHRO8: folds 
phatts76: folds 
yodzik: folds 
DrejAtom: raises $0.10 to $0.20
ab260414: folds 
Uncalled bet ($0.10) returned to DrejAtom
DrejAtom collected $0.20 from pot
*** SUMMARY ***
Total pot $0.20 | Rake $0 
Seat 1: phatts76 folded before Flop (didn't bet)
Seat 2: yodzik (button) folded before Flop (didn't bet)
Seat 3: DrejAtom (small blind) collected ($0.20)
Seat 4: ab260414 (big blind) folded before Flop
Seat 5: KokoulinV folded before Flop (didn't bet)
Seat 6: CHRO8 folded before Flop (didn't bet)



PokerStars Hand #166667693105:  Hold'em No Limit ($0.05/$0.10 USD) - 2017/02/23 16:05:48 ET
Table 'Caupolican' 6-max Seat #5 is the button
Seat 1: kingartur222 ($11.49 in chips) 
Seat 2: garigura ($18.90 in chips) 
Seat 4: mhonielsen ($15.79 in chips) 
Seat 5: Kazacha ($10.56 in chips) 
Seat 6: crazydevill ($10.67 in chips) 
crazydevill: posts small blind $0.05
kingartur222: posts big blind $0.10
*** HOLE CARDS ***
garigura: folds 
mhonielsen: folds 
Kazacha: folds 
crazydevill: folds 
Uncalled bet ($0.05) returned to kingartur222
kingartur222 collected $0.10 from pot
*** SUMMARY ***
Total pot $0.10 | Rake $0 
Seat 1: kingartur222 (big blind) collected ($0.10)
Seat 2: garigura folded before Flop (didn't bet)
Seat 4: mhonielsen folded before Flop (didn't bet)
Seat 5: Kazacha (button) folded before Flop (didn't bet)
Seat 6: crazydevill (small blind) folded before Flop



PokerStars Hand #166667693419:  Hold'em No Limit ($0.05/$0.10 USD) - 2017/02/23 16:05:48 ET
Table 'Risha II' 6-max Seat #2 is the button
Seat 1: R. Lemonte ($13.42 in chips) 
Seat 2: KA3AXCTAHEU, ($12.50 in chips) 
Seat 3: steepfell ($10 in chips) 
Seat 4: Comeback3392 ($20.81 in chips) 
Seat 5: m.c-alkatraz ($10.20 in chips) 
Seat 6: univibe68 ($10.61 in chips) 
steepfell: posts small blind $0.05
Comeback3392: posts big blind $0.10
*** HOLE CARDS ***
m.c-alkatraz: folds 
univibe68: folds 
R. Lemonte: folds 
KA3AXCTAHEU,: raises $0.10 to $0.20
steepfell: folds 
Comeback3392: folds 
Uncalled bet ($0.10) returned to KA3AXCTAHEU,
KA3AXCTAHEU, collected $0.25 from pot
*** SUMMARY ***
Total pot $0.25 | Rake $0 
Seat 1: R. Lemonte folded before Flop (didn't bet)
Seat 2: KA3AXCTAHEU, (button) collected ($0.25)
Seat 3: steepfell (small blind) folded before Flop
Seat 4: Comeback3392 (big blind) folded before Flop
Seat 5: m.c-alkatraz folded before Flop (didn't bet)
Seat 6: univibe68 folded before Flop (didn't bet)



PokerStars Hand #166667693632:  Hold'em No Limit ($0.05/$0.10 USD) - 2017/02/23 16:05:48 ET
Table 'Wesselink II' 6-max Seat #2 is the button
Seat 1: vladcol ($5.21 in chips) 
Seat 2: KRZuff ($10 in chips) 
Seat 3: Wargolandros ($8.97 in chips) 
Seat 4: BahiaMinhaP ($10.98 in chips) 
Seat 6: bambolejro ($10.32 in chips) 
Wargolandros: posts small blind $0.05
BahiaMinhaP: posts big blind $0.10
*** HOLE CARDS ***
bambolejro: raises $0.20 to $0.30
vladcol: folds 
KRZuff: folds 
Wargolandros: folds 
BahiaMinhaP: calls $0.20
*** FLOP *** [7s Ac 3c]
BahiaMinhaP: checks 
bambolejro: bets $0.42
BahiaMinhaP: folds 
Uncalled bet ($0.42) returned to bambolejro
bambolejro collected $0.62 from pot
*** SUMMARY ***
Total pot $0.65 | Rake $0.03 
Board [7s Ac 3c]
Seat 1: vladcol folded before Flop (didn't bet)
Seat 2: KRZuff (button) folded before Flop (didn't bet)
Seat 3: Wargolandros (small blind) folded before Flop
Seat 4: BahiaMinhaP (big blind) folded on the Flop
Seat 6: bambolejro collected ($0.62)



PokerStars Hand #166667693728:  Hold'em No Limit ($0.05/$0.10 USD) - 2017/02/23 16:05:48 ET
Table 'Glarona' 6-max Seat #2 is the button
Seat 1: LarryTheStar ($10.35 in chips) 
Seat 2: BookWorm78 ($10 in chips) 
Seat 3: hoedje72 ($3.76 in chips) 
Seat 4: CrippledGod ($7.14 in chips) 
Seat 5: david_sara83 ($10.25 in chips) 
Seat 6: Namhkal ($11.33 in chips) 
hoedje72: posts small blind $0.05
CrippledGod: posts big blind $0.10
*** HOLE CARDS ***
david_sara83: folds 
Namhkal: folds 
LarryTheStar: folds 
BookWorm78: folds 
hoedje72: folds 
Uncalled bet ($0.05) returned to CrippledGod
CrippledGod collected $0.10 from pot
*** SUMMARY ***
Total pot $0.10 | Rake $0 
Seat 1: LarryTheStar folded before Flop (didn't bet)
Seat 2: BookWorm78 (button) folded before Flop (didn't bet)
Seat 3: hoedje72 (small blind) folded before Flop
Seat 4: CrippledGod (big blind) collected ($0.10)
Seat 5: david_sara83 folded before Flop (didn't bet)
Seat 6: Namhkal folded before Flop (didn't bet)



PokerStars Hand #166667693739:  Hold'em No Limit ($0.05/$0.10 USD) - 2017/02/23 16:05:48 ET
Table 'Ushakaron II' 6-max Seat #4 is the button
Seat 1: Kow6oy ($10.15 in chips) 
Seat 2: Iarlei ($11.19 in chips) 
Seat 3: Rodik002 ($10.12 in chips) 
Seat 4: avintage176 ($27.71 in chips) 
Seat 5: 1limewax1 ($16.53 in chips) 
Seat 6: eniksenik ($10.86 in chips) 
1limewax1: posts small blind $0.05
eniksenik: posts big blind $0.10
*** HOLE CARDS ***
Kow6oy: folds 
Iarlei: raises $0.20 to $0.30
Rodik002: folds 
avintage176: folds 
1limewax1: calls $0.25
eniksenik: raises $1 to $1.30
Iarlei: raises $1.85 to $3.15
1limewax1: folds 
eniksenik: folds 
Uncalled bet ($1.85) returned to Iarlei
Iarlei collected $2.90 from pot
*** SUMMARY ***
Total pot $2.90 | Rake $0 
Seat 1: Kow6oy folded before Flop (didn't bet)
Seat 2: Iarlei collected ($2.90)
Seat 3: Rodik002 folded before Flop (didn't bet)
Seat 4: avintage176 (button) folded before Flop (didn't bet)
Seat 5: 1limewax1 (small blind) folded before Flop
Seat 6: eniksenik (big blind) folded before Flop



