PokerStars Hand #166667384733:  Hold'em No Limit ($0.05/$0.10 USD) - 2017/02/23 16:00:00 ET
Table 'Samitchell III' 6-max Seat #4 is the button
Seat 1: dr.goofy ($10 in chips) 
Seat 2: schili557 ($12.19 in chips) 
Seat 3: Kow6oy ($10.10 in chips) 
Seat 4: eniksenik ($10.70 in chips) 
Seat 5: boxer821 ($18.36 in chips) 
Seat 6: fedorka rus ($12.69 in chips) 
boxer821: posts small blind $0.05
fedorka rus: posts big blind $0.10
*** HOLE CARDS ***
dr.goofy: raises $0.20 to $0.30
schili557: folds 
Kow6oy: folds 
eniksenik: calls $0.30
boxer821: folds 
schili557 leaves the table
fedorka rus: folds 
*** FLOP *** [7h Ah Js]
Namhkal joins the table at seat #2 
Namhkal leaves the table
Orlangoor joins the table at seat #2 
dr.goofy: bets $0.70
eniksenik: folds 
Uncalled bet ($0.70) returned to dr.goofy
dr.goofy collected $0.72 from pot
*** SUMMARY ***
Total pot $0.75 | Rake $0.03 
Board [7h Ah Js]
Seat 1: dr.goofy collected ($0.72)
Seat 2: schili557 folded before Flop (didn't bet)
Seat 3: Kow6oy folded before Flop (didn't bet)
Seat 4: eniksenik (button) folded on the Flop
Seat 5: boxer821 (small blind) folded before Flop
Seat 6: fedorka rus (big blind) folded before Flop



PokerStars Hand #166667384904:  Hold'em No Limit ($0.05/$0.10 USD) - 2017/02/23 16:00:00 ET
Table 'Ushakaron II' 6-max Seat #3 is the button
Seat 1: Kow6oy ($10.30 in chips) 
Seat 2: Iarlei ($10.23 in chips) 
Seat 3: Rodik002 ($10 in chips) 
Seat 4: avintage176 ($27.92 in chips) 
Seat 5: 1limewax1 ($17.59 in chips) 
Seat 6: eniksenik ($10 in chips) 
avintage176: posts small blind $0.05
1limewax1 is disconnected 
1limewax1 is connected 
1limewax1: posts big blind $0.10
*** HOLE CARDS ***
eniksenik: folds 
Kow6oy: folds 
Iarlei: folds 
Rodik002: raises $0.10 to $0.20
avintage176: calls $0.15
1limewax1: calls $0.10
*** FLOP *** [7c 5s 3c]
avintage176: bets $0.40
1limewax1: folds 
Rodik002: calls $0.40
*** TURN *** [7c 5s 3c] [Tc]
avintage176: bets $0.80
Rodik002: folds 
Uncalled bet ($0.80) returned to avintage176
avintage176 collected $1.34 from pot
*** SUMMARY ***
Total pot $1.40 | Rake $0.06 
Board [7c 5s 3c Tc]
Seat 1: Kow6oy folded before Flop (didn't bet)
Seat 2: Iarlei folded before Flop (didn't bet)
Seat 3: Rodik002 (button) folded on the Turn
Seat 4: avintage176 (small blind) collected ($1.34)
Seat 5: 1limewax1 (big blind) folded on the Flop
Seat 6: eniksenik folded before Flop (didn't bet)



PokerStars Hand #166667385081:  Hold'em No Limit ($0.05/$0.10 USD) - 2017/02/23 16:00:00 ET
Table 'Crocus' 6-max Seat #5 is the button
Seat 1: truck1234 ($24.58 in chips) 
Seat 2: garigura ($11.53 in chips) 
Seat 3: Limpa Meza ($0.44 in chips) 
Seat 4: patrick19111 ($12.38 in chips) 
Seat 5: Golsuorsi ($10 in chips) 
Seat 6: Rodik002 ($10.05 in chips) 
Rodik002: posts small blind $0.05
truck1234: posts big blind $0.10
*** HOLE CARDS ***
garigura: folds 
Limpa Meza: folds 
patrick19111: folds 
Golsuorsi: raises $0.10 to $0.20
Rodik002: folds 
truck1234: calls $0.10
*** FLOP *** [6c 9c 4c]
truck1234: bets $0.30
Golsuorsi: folds 
Uncalled bet ($0.30) returned to truck1234
truck1234 collected $0.43 from pot
*** SUMMARY ***
Total pot $0.45 | Rake $0.02 
Board [6c 9c 4c]
Seat 1: truck1234 (big blind) collected ($0.43)
Seat 2: garigura folded before Flop (didn't bet)
Seat 3: Limpa Meza folded before Flop (didn't bet)
Seat 4: patrick19111 folded before Flop (didn't bet)
Seat 5: Golsuorsi (button) folded on the Flop
Seat 6: Rodik002 (small blind) folded before Flop



PokerStars Hand #166667385291:  Hold'em No Limit ($0.05/$0.10 USD) - 2017/02/23 16:00:00 ET
Table 'Oongaq' 6-max Seat #1 is the button
Seat 1: Dmitrij218 ($12.06 in chips) 
Seat 2: homelessdan ($19.10 in chips) 
Seat 3: iDecMate ($10 in chips) 
Seat 4: Bird et al ($10 in chips) 
Seat 5: Dizzler1991 ($5.07 in chips) 
Seat 6: boxer821 ($10 in chips) 
homelessdan: posts small blind $0.05
iDecMate: posts big blind $0.10
*** HOLE CARDS ***
Bird et al: folds 
Dizzler1991: calls $0.10
boxer821: folds 
Dmitrij218: calls $0.10
homelessdan: folds 
iDecMate: checks 
*** FLOP *** [5d Tc 9d]
iDecMate: bets $0.22
Dizzler1991: calls $0.22
Dmitrij218: calls $0.22
*** TURN *** [5d Tc 9d] [6h]
iDecMate: checks 
Dizzler1991: bets $0.48
Dmitrij218: calls $0.48
iDecMate: calls $0.48
*** RIVER *** [5d Tc 9d 6h] [As]
iDecMate: checks 
Dizzler1991: checks 
Dmitrij218: bets $0.20
iDecMate: folds 
Dizzler1991: folds 
Uncalled bet ($0.20) returned to Dmitrij218
Dmitrij218 collected $2.34 from pot
*** SUMMARY ***
Total pot $2.45 | Rake $0.11 
Board [5d Tc 9d 6h As]
Seat 1: Dmitrij218 (button) collected ($2.34)
Seat 2: homelessdan (small blind) folded before Flop
Seat 3: iDecMate (big blind) folded on the River
Seat 4: Bird et al folded before Flop (didn't bet)
Seat 5: Dizzler1991 folded on the River
Seat 6: boxer821 folded before Flop (didn't bet)



PokerStars Hand #166667385294:  Hold'em No Limit ($0.05/$0.10 USD) - 2017/02/23 16:00:00 ET
Table 'Bengt' 6-max Seat #4 is the button
Seat 2: ChefRocco ($19.21 in chips) 
Seat 3: nantes15 ($12.51 in chips) 
Seat 4: 8th wonders ($12.72 in chips) 
Seat 5: RoJ1 ($10.51 in chips) 
Seat 6: Goroshkos88 ($10.15 in chips) 
RoJ1: posts small blind $0.05
Goroshkos88: posts big blind $0.10
Lucky HoBBiT: sits out 
*** HOLE CARDS ***
ChefRocco: calls $0.10
nantes15: folds 
8th wonders: raises $0.40 to $0.50
RoJ1: folds 
Goroshkos88: folds 
ChefRocco: calls $0.40
*** FLOP *** [Td Js Jd]
ChefRocco: checks 
8th wonders: bets $0.60
ChefRocco: calls $0.60
*** TURN *** [Td Js Jd] [8s]
ChefRocco: bets $1.12
8th wonders: calls $1.12
*** RIVER *** [Td Js Jd 8s] [2c]
ChefRocco: bets $2.19
8th wonders: calls $2.19
*** SHOW DOWN ***
ChefRocco: shows [Qh 9s] (a straight, Eight to Queen)
8th wonders: mucks hand 
ChefRocco collected $8.57 from pot
*** SUMMARY ***
Total pot $8.97 | Rake $0.40 
Board [Td Js Jd 8s 2c]
Seat 2: ChefRocco showed [Qh 9s] and won ($8.57) with a straight, Eight to Queen
Seat 3: nantes15 folded before Flop (didn't bet)
Seat 4: 8th wonders (button) mucked
Seat 5: RoJ1 (small blind) folded before Flop
Seat 6: Goroshkos88 (big blind) folded before Flop



PokerStars Hand #166667385655:  Hold'em No Limit ($0.05/$0.10 USD) - 2017/02/23 16:00:01 ET
Table 'Mesarthim' 6-max Seat #5 is the button
Seat 1: Mancuso2010 ($17.25 in chips) 
Seat 2: MühliJr ($10.93 in chips) 
Seat 3: Damage514 ($8.06 in chips) 
Seat 4: Strelok1974 ($10 in chips) 
Seat 5: Iarlei ($11.05 in chips) 
Seat 6: bdixon_5 ($9.60 in chips) 
bdixon_5: posts small blind $0.05
Mancuso2010: posts big blind $0.10
*** HOLE CARDS ***
MühliJr: folds 
Damage514: calls $0.10
Strelok1974: folds 
Iarlei: folds 
bdixon_5: raises $0.20 to $0.30
Mancuso2010: folds 
Damage514: calls $0.20
*** FLOP *** [Jc 9h Ts]
bdixon_5: bets $0.34
Damage514: calls $0.34
*** TURN *** [Jc 9h Ts] [Kh]
bdixon_5: checks 
Damage514: bets $0.66
bdixon_5: folds 
Uncalled bet ($0.66) returned to Damage514
Damage514 collected $1.32 from pot
*** SUMMARY ***
Total pot $1.38 | Rake $0.06 
Board [Jc 9h Ts Kh]
Seat 1: Mancuso2010 (big blind) folded before Flop
Seat 2: MühliJr folded before Flop (didn't bet)
Seat 3: Damage514 collected ($1.32)
Seat 4: Strelok1974 folded before Flop (didn't bet)
Seat 5: Iarlei (button) folded before Flop (didn't bet)
Seat 6: bdixon_5 (small blind) folded on the Turn



PokerStars Hand #166667386233:  Hold'em No Limit ($0.05/$0.10 USD) - 2017/02/23 16:00:02 ET
Table 'Gyldenia II' 6-max Seat #5 is the button
Seat 1: KokoulinV ($10 in chips) 
Seat 2: Bandyaev ($10 in chips) 
Seat 3: ex3Lero86 ($23.37 in chips) 
Seat 5: CHRO8 ($17.74 in chips) 
Seat 6: 8th wonders ($10.27 in chips) 
8th wonders: posts small blind $0.05
KokoulinV: posts big blind $0.10
*** HOLE CARDS ***
Bandyaev: raises $0.20 to $0.30
ex3Lero86: folds 
CHRO8: folds 
8th wonders: calls $0.25
KokoulinV: folds 
*** FLOP *** [9s As 5c]
8th wonders: checks 
Bandyaev: checks 
*** TURN *** [9s As 5c] [Js]
8th wonders: bets $0.50
Bandyaev: folds 
Uncalled bet ($0.50) returned to 8th wonders
8th wonders collected $0.67 from pot
*** SUMMARY ***
Total pot $0.70 | Rake $0.03 
Board [9s As 5c Js]
Seat 1: KokoulinV (big blind) folded before Flop
Seat 2: Bandyaev folded on the Turn
Seat 3: ex3Lero86 folded before Flop (didn't bet)
Seat 5: CHRO8 (button) folded before Flop (didn't bet)
Seat 6: 8th wonders (small blind) collected ($0.67)



PokerStars Hand #166667386293:  Hold'em No Limit ($0.05/$0.10 USD) - 2017/02/23 16:00:02 ET
Table 'Halawe II' 6-max Seat #6 is the button
Seat 1: DIGOR100 ($6.65 in chips) 
Seat 2: Darkfrai ($10 in chips) 
Seat 3: cherep61987 ($10.72 in chips) 
Seat 4: voledy ($12.04 in chips) 
Seat 5: takis nik ($12.83 in chips) 
Seat 6: Rodik002 ($20.52 in chips) 
DIGOR100: posts small blind $0.05
Darkfrai: posts big blind $0.10
*** HOLE CARDS ***
cherep61987: raises $0.20 to $0.30
voledy: folds 
takis nik: folds 
Rodik002: folds 
DIGOR100: folds 
Darkfrai: folds 
Uncalled bet ($0.20) returned to cherep61987
cherep61987 collected $0.25 from pot
*** SUMMARY ***
Total pot $0.25 | Rake $0 
Seat 1: DIGOR100 (small blind) folded before Flop
Seat 2: Darkfrai (big blind) folded before Flop
Seat 3: cherep61987 collected ($0.25)
Seat 4: voledy folded before Flop (didn't bet)
Seat 5: takis nik folded before Flop (didn't bet)
Seat 6: Rodik002 (button) folded before Flop (didn't bet)



PokerStars Hand #166667386488:  Hold'em No Limit ($0.05/$0.10 USD) - 2017/02/23 16:00:02 ET
Table 'Nekkar' 6-max Seat #2 is the button
Seat 1: aapokerkot ($11.65 in chips) 
Seat 2: Bird et al ($10 in chips) 
Seat 3: Zemz_Ru ($16.96 in chips) 
Seat 4: kingartur222 ($12.48 in chips) 
Seat 5: Vrinni ($11.79 in chips) 
Seat 6: Eddys Edge ($10.85 in chips) 
Zemz_Ru: posts small blind $0.05
kingartur222: posts big blind $0.10
*** HOLE CARDS ***
Vrinni: folds 
Eddys Edge: folds 
aapokerkot: folds 
Bird et al: folds 
Zemz_Ru: raises $0.20 to $0.30
kingartur222: folds 
Uncalled bet ($0.20) returned to Zemz_Ru
Zemz_Ru collected $0.20 from pot
*** SUMMARY ***
Total pot $0.20 | Rake $0 
Seat 1: aapokerkot folded before Flop (didn't bet)
Seat 2: Bird et al (button) folded before Flop (didn't bet)
Seat 3: Zemz_Ru (small blind) collected ($0.20)
Seat 4: kingartur222 (big blind) folded before Flop
Seat 5: Vrinni folded before Flop (didn't bet)
Seat 6: Eddys Edge folded before Flop (didn't bet)



PokerStars Hand #166667386566:  Hold'em No Limit ($0.05/$0.10 USD) - 2017/02/23 16:00:02 ET
Table 'Deflotte' 6-max Seat #6 is the button
Seat 1: Zooplack ($15.19 in chips) 
Seat 3: Croplayer1 ($10 in chips) 
Seat 4: 8th wonders ($10 in chips) 
Seat 5: Pokeaster ($11.52 in chips) 
Seat 6: Iarlei ($11.64 in chips) 
Zooplack: posts small blind $0.05
MonteCris92 is disconnected 
MonteCris92 has timed out while disconnected
MonteCris92: is sitting out 
Croplayer1: posts big blind $0.10
*** HOLE CARDS ***
8th wonders: folds 
Pokeaster: folds 
Iarlei: raises $0.15 to $0.25
Zooplack: raises $0.50 to $0.75
Croplayer1: folds 
Iarlei: folds 
Uncalled bet ($0.50) returned to Zooplack
Zooplack collected $0.60 from pot
*** SUMMARY ***
Total pot $0.60 | Rake $0 
Seat 1: Zooplack (small blind) collected ($0.60)
Seat 3: Croplayer1 (big blind) folded before Flop
Seat 4: 8th wonders folded before Flop (didn't bet)
Seat 5: Pokeaster folded before Flop (didn't bet)
Seat 6: Iarlei (button) folded before Flop



PokerStars Hand #166667386732:  Hold'em No Limit ($0.05/$0.10 USD) - 2017/02/23 16:00:02 ET
Table 'Tomita II' 6-max Seat #1 is the button
Seat 1: HARDCORE66RU ($24.73 in chips) 
Seat 2: mhonielsen ($10 in chips) 
Seat 3: Lucky HoBBiT ($10 in chips) 
Seat 4: Hyd SK ($10 in chips) 
Seat 6: Punzzzer ($12.36 in chips) 
mhonielsen: posts small blind $0.05
Lucky HoBBiT: posts big blind $0.10
*** HOLE CARDS ***
Hyd SK: folds 
Punzzzer: folds 
HARDCORE66RU: raises $0.15 to $0.25
mhonielsen: folds 
Lucky HoBBiT: folds 
Uncalled bet ($0.15) returned to HARDCORE66RU
HARDCORE66RU collected $0.25 from pot
*** SUMMARY ***
Total pot $0.25 | Rake $0 
Seat 1: HARDCORE66RU (button) collected ($0.25)
Seat 2: mhonielsen (small blind) folded before Flop
Seat 3: Lucky HoBBiT (big blind) folded before Flop
Seat 4: Hyd SK folded before Flop (didn't bet)
Seat 6: Punzzzer folded before Flop (didn't bet)



PokerStars Hand #166667386837:  Hold'em No Limit ($0.05/$0.10 USD) - 2017/02/23 16:00:02 ET
Table 'Iduberga II' 6-max Seat #5 is the button
Seat 1: mhonielsen ($10.66 in chips) 
Seat 2: popypaleta ($12.27 in chips) 
Seat 4: Peter0087 ($10.93 in chips) 
Seat 5: Pokeaster ($10.62 in chips) 
Seat 6: tblocos ($9.95 in chips) 
tblocos: posts small blind $0.05
mhonielsen: posts big blind $0.10
scorpionfish: sits out 
*** HOLE CARDS ***
popypaleta: folds 
Peter0087: raises $0.20 to $0.30
Pokeaster: folds 
tblocos: calls $0.25
mhonielsen: calls $0.20
*** FLOP *** [Kd 2c 2d]
tblocos: checks 
mhonielsen: checks 
Peter0087: checks 
*** TURN *** [Kd 2c 2d] [3d]
tblocos: checks 
mhonielsen: bets $0.60
Peter0087: calls $0.60
tblocos: calls $0.60
*** RIVER *** [Kd 2c 2d 3d] [6d]
tblocos: checks 
mhonielsen: checks 
Peter0087: checks 
*** SHOW DOWN ***
tblocos: shows [5d 5s] (a flush, King high)
mhonielsen: mucks hand 
Peter0087: mucks hand 
tblocos collected $2.58 from pot
*** SUMMARY ***
Total pot $2.70 | Rake $0.12 
Board [Kd 2c 2d 3d 6d]
Seat 1: mhonielsen (big blind) mucked
Seat 2: popypaleta folded before Flop (didn't bet)
Seat 4: Peter0087 mucked
Seat 5: Pokeaster (button) folded before Flop (didn't bet)
Seat 6: tblocos (small blind) showed [5d 5s] and won ($2.58) with a flush, King high



PokerStars Hand #166667387174:  Hold'em No Limit ($0.05/$0.10 USD) - 2017/02/23 16:00:03 ET
Table 'Pyrrhus III' 6-max Seat #2 is the button
Seat 1: skatejeff ($17.28 in chips) 
Seat 2: univibe68 ($20.88 in chips) 
Seat 3: coolisses111 ($9.88 in chips) 
Seat 4: ex3Lero86 ($12.05 in chips) 
Seat 5: mAEgar ($4.94 in chips) 
Seat 6: MLPlayer16 ($19.37 in chips) 
coolisses111: posts small blind $0.05
ex3Lero86: posts big blind $0.10
skatejeff: posts the ante $0.02
univibe68: posts the ante $0.02
coolisses111: posts the ante $0.02
ex3Lero86: posts the ante $0.02
mAEgar: posts the ante $0.02
MLPlayer16: posts the ante $0.02
*** HOLE CARDS ***
mAEgar: raises $0.10 to $0.20
MLPlayer16: folds 
skatejeff: folds 
univibe68: folds 
coolisses111: folds 
ex3Lero86: folds 
Uncalled bet ($0.10) returned to mAEgar
mAEgar collected $0.37 from pot
*** SUMMARY ***
Total pot $0.37 | Rake $0 
Seat 1: skatejeff folded before Flop (didn't bet)
Seat 2: univibe68 (button) folded before Flop (didn't bet)
Seat 3: coolisses111 (small blind) folded before Flop
Seat 4: ex3Lero86 (big blind) folded before Flop
Seat 5: mAEgar collected ($0.37)
Seat 6: MLPlayer16 folded before Flop (didn't bet)



PokerStars Hand #166667387176:  Hold'em No Limit ($0.05/$0.10 USD) - 2017/02/23 16:00:03 ET
Table 'Ruvuma' 6-max Seat #6 is the button
Seat 1: FRAID358 ($10.30 in chips) 
Seat 2: Fab_1512 ($11.43 in chips) 
Seat 3: Spud014 ($11.41 in chips) 
Seat 4: DamDatsAnAce ($10 in chips) 
Seat 5: sexy_seagull ($10.15 in chips) 
Seat 6: Elinaattor ($11.25 in chips) 
FRAID358: posts small blind $0.05
Fab_1512: posts big blind $0.10
*** HOLE CARDS ***
Spud014: folds 
DamDatsAnAce: folds 
sexy_seagull: folds 
Elinaattor: raises $0.15 to $0.25
FRAID358: folds 
Fab_1512: calls $0.15
*** FLOP *** [4d 5s Ts]
Fab_1512: bets $0.40
Elinaattor: calls $0.40
*** TURN *** [4d 5s Ts] [3c]
Fab_1512: bets $0.80
Elinaattor: calls $0.80
*** RIVER *** [4d 5s Ts 3c] [8d]
Fab_1512: bets $0.20
Elinaattor: calls $0.20
*** SHOW DOWN ***
Fab_1512: shows [8h 8c] (three of a kind, Eights)
Elinaattor: mucks hand 
Fab_1512 collected $3.20 from pot
*** SUMMARY ***
Total pot $3.35 | Rake $0.15 
Board [4d 5s Ts 3c 8d]
Seat 1: FRAID358 (small blind) folded before Flop
Seat 2: Fab_1512 (big blind) showed [8h 8c] and won ($3.20) with three of a kind, Eights
Seat 3: Spud014 folded before Flop (didn't bet)
Seat 4: DamDatsAnAce folded before Flop (didn't bet)
Seat 5: sexy_seagull folded before Flop (didn't bet)
Seat 6: Elinaattor (button) mucked



PokerStars Hand #166667387211:  Hold'em No Limit ($0.05/$0.10 USD) - 2017/02/23 16:00:03 ET
Table 'Tyndareus III' 6-max Seat #1 is the button
Seat 1: MBen10 ($10 in chips) 
Seat 2: MihaGr ($10 in chips) 
Seat 3: XaXaTyH4uK ($10.15 in chips) 
Seat 4: Therodorus ($11.76 in chips) 
Seat 5: Chodemuncher ($10 in chips) 
Seat 6: Elinaattor ($9.52 in chips) 
MihaGr: posts small blind $0.05
XaXaTyH4uK: posts big blind $0.10
*** HOLE CARDS ***
Therodorus: folds 
Chodemuncher: folds 
Elinaattor: folds 
MBen10: folds 
MihaGr: folds 
Uncalled bet ($0.05) returned to XaXaTyH4uK
XaXaTyH4uK collected $0.10 from pot
*** SUMMARY ***
Total pot $0.10 | Rake $0 
Seat 1: MBen10 (button) folded before Flop (didn't bet)
Seat 2: MihaGr (small blind) folded before Flop
Seat 3: XaXaTyH4uK (big blind) collected ($0.10)
Seat 4: Therodorus folded before Flop (didn't bet)
Seat 5: Chodemuncher folded before Flop (didn't bet)
Seat 6: Elinaattor folded before Flop (didn't bet)



PokerStars Hand #166667387284:  Hold'em No Limit ($0.05/$0.10 USD) - 2017/02/23 16:00:03 ET
Table 'Veniakaverin' 6-max Seat #5 is the button
Seat 1: pivanki11 ($10 in chips) 
Seat 2: david_sara83 ($10 in chips) 
Seat 3: Hyd SK ($18.50 in chips) 
Seat 4: Ampped87 ($10.03 in chips) 
Seat 5: Innerwuss ($24.69 in chips) 
Seat 6: bdixon_5 ($9.75 in chips) 
bdixon_5: posts small blind $0.05
pivanki11: posts big blind $0.10
*** HOLE CARDS ***
david_sara83: raises $0.20 to $0.30
Hyd SK: folds 
Ampped87: calls $0.30
Innerwuss has timed out
Innerwuss: folds 
bdixon_5: folds 
pivanki11: raises $0.30 to $0.60
david_sara83: calls $0.30
Ampped87: calls $0.30
*** FLOP *** [8h As 7c]
pivanki11: checks 
david_sara83: checks 
Ampped87: checks 
*** TURN *** [8h As 7c] [Ah]
pivanki11: checks 
david_sara83: checks 
Ampped87: checks 
*** RIVER *** [8h As 7c Ah] [2s]
pivanki11: bets $0.90
david_sara83: folds 
Ampped87: calls $0.90
*** SHOW DOWN ***
pivanki11: shows [Ts Tc] (two pair, Aces and Tens)
Ampped87: mucks hand 
pivanki11 collected $3.49 from pot
*** SUMMARY ***
Total pot $3.65 | Rake $0.16 
Board [8h As 7c Ah 2s]
Seat 1: pivanki11 (big blind) showed [Ts Tc] and won ($3.49) with two pair, Aces and Tens
Seat 2: david_sara83 folded on the River
Seat 3: Hyd SK folded before Flop (didn't bet)
Seat 4: Ampped87 mucked
Seat 5: Innerwuss (button) folded before Flop (didn't bet)
Seat 6: bdixon_5 (small blind) folded before Flop



PokerStars Hand #166667387925:  Hold'em No Limit ($0.05/$0.10 USD) - 2017/02/23 16:00:04 ET
Table 'Hunnia' 6-max Seat #6 is the button
Seat 1: univibe68 ($19.06 in chips) 
Seat 2: mhonielsen ($10.15 in chips) 
Seat 3: crazydevill ($10.17 in chips) 
Seat 4: Jalida3 ($10.56 in chips) 
Seat 5: Smarkon ($15.23 in chips) 
Seat 6: ChuikaPridi ($9.22 in chips) 
univibe68: posts small blind $0.05
mhonielsen: posts big blind $0.10
*** HOLE CARDS ***
crazydevill: folds 
Jalida3: raises $0.20 to $0.30
Smarkon: folds 
ChuikaPridi: folds 
univibe68: folds 
mhonielsen: folds 
Uncalled bet ($0.20) returned to Jalida3
Jalida3 collected $0.25 from pot
*** SUMMARY ***
Total pot $0.25 | Rake $0 
Seat 1: univibe68 (small blind) folded before Flop
Seat 2: mhonielsen (big blind) folded before Flop
Seat 3: crazydevill folded before Flop (didn't bet)
Seat 4: Jalida3 collected ($0.25)
Seat 5: Smarkon folded before Flop (didn't bet)
Seat 6: ChuikaPridi (button) folded before Flop (didn't bet)



PokerStars Hand #166667387990:  Hold'em No Limit ($0.05/$0.10 USD) - 2017/02/23 16:00:04 ET
Table 'Crommelin II' 6-max Seat #4 is the button
Seat 1: THIMUCHIN ($10.90 in chips) 
Seat 2: Bird et al ($10.19 in chips) 
Seat 3: Strelok1974 ($21.15 in chips) 
Seat 4: Pequeño Clau ($10.15 in chips) 
Seat 5: Action_Gibi ($20.55 in chips) 
Seat 6: Darkfrai ($10.30 in chips) 
Action_Gibi: posts small blind $0.05
Darkfrai: posts big blind $0.10
*** HOLE CARDS ***
THIMUCHIN: raises $0.20 to $0.30
Bird et al: folds 
Strelok1974: folds 
Pequeño Clau: folds 
Action_Gibi: folds 
Darkfrai: calls $0.20
*** FLOP *** [9h Qc 7d]
Darkfrai: checks 
THIMUCHIN: checks 
*** TURN *** [9h Qc 7d] [Th]
Darkfrai: checks 
THIMUCHIN: bets $0.55
Darkfrai: folds 
Uncalled bet ($0.55) returned to THIMUCHIN
THIMUCHIN collected $0.62 from pot
*** SUMMARY ***
Total pot $0.65 | Rake $0.03 
Board [9h Qc 7d Th]
Seat 1: THIMUCHIN collected ($0.62)
Seat 2: Bird et al folded before Flop (didn't bet)
Seat 3: Strelok1974 folded before Flop (didn't bet)
Seat 4: Pequeño Clau (button) folded before Flop (didn't bet)
Seat 5: Action_Gibi (small blind) folded before Flop
Seat 6: Darkfrai (big blind) folded on the Turn



PokerStars Hand #166667388405:  Hold'em No Limit ($0.05/$0.10 USD) - 2017/02/23 16:00:04 ET
Table 'Lobelia II' 6-max Seat #1 is the button
Seat 1: facewald ($29.10 in chips) 
Seat 2: Dcaro31 ($18.64 in chips) 
Seat 3: oddshoff ($10.65 in chips) 
Seat 5: Feverhead ($20.68 in chips) 
Dcaro31: posts small blind $0.05
oddshoff: posts big blind $0.10
NvR.m1nD: sits out 
*** HOLE CARDS ***
Feverhead: folds 
facewald: folds 
Dcaro31: folds 
Uncalled bet ($0.05) returned to oddshoff
oddshoff collected $0.10 from pot
*** SUMMARY ***
Total pot $0.10 | Rake $0 
Seat 1: facewald (button) folded before Flop (didn't bet)
Seat 2: Dcaro31 (small blind) folded before Flop
Seat 3: oddshoff (big blind) collected ($0.10)
Seat 5: Feverhead folded before Flop (didn't bet)



PokerStars Hand #166667388507:  Hold'em No Limit ($0.05/$0.10 USD) - 2017/02/23 16:00:05 ET
Table 'Aisakos II' 6-max Seat #1 is the button
Seat 1: Crafty23@PS ($10 in chips) 
Seat 2: svaika24 ($17.68 in chips) 
Seat 3: iamkakaroto ($10.13 in chips) 
Seat 5: KokoulinV ($10.87 in chips) 
Seat 6: LarryTheStar ($10 in chips) 
svaika24: posts small blind $0.05
iamkakaroto: posts big blind $0.10
T9MS: sits out 
*** HOLE CARDS ***
KokoulinV: folds 
LarryTheStar: raises $0.20 to $0.30
Crafty23@PS: calls $0.30
svaika24: folds 
iamkakaroto: calls $0.20
*** FLOP *** [5c Jd 3d]
iamkakaroto: bets $0.60
LarryTheStar: folds 
Crafty23@PS: folds 
Uncalled bet ($0.60) returned to iamkakaroto
iamkakaroto collected $0.91 from pot
*** SUMMARY ***
Total pot $0.95 | Rake $0.04 
Board [5c Jd 3d]
Seat 1: Crafty23@PS (button) folded on the Flop
Seat 2: svaika24 (small blind) folded before Flop
Seat 3: iamkakaroto (big blind) collected ($0.91)
Seat 5: KokoulinV folded before Flop (didn't bet)
Seat 6: LarryTheStar folded on the Flop



PokerStars Hand #166667388659:  Hold'em No Limit ($0.05/$0.10 USD) - 2017/02/23 16:00:05 ET
Table 'Sheragul III' 6-max Seat #1 is the button
Seat 1: danky24 ($17.36 in chips) 
Seat 2: Bird et al ($12.01 in chips) 
Seat 4: maxiv608 ($11.09 in chips) 
Seat 5: Bandyaev ($14.81 in chips) 
Seat 6: Andrei ProFF ($10 in chips) 
Bird et al: posts small blind $0.05
maxiv608: posts big blind $0.10
*** HOLE CARDS ***
Bandyaev: folds 
Andrei ProFF: folds 
danky24: folds 
Bird et al: folds 
Uncalled bet ($0.05) returned to maxiv608
maxiv608 collected $0.10 from pot
*** SUMMARY ***
Total pot $0.10 | Rake $0 
Seat 1: danky24 (button) folded before Flop (didn't bet)
Seat 2: Bird et al (small blind) folded before Flop
Seat 4: maxiv608 (big blind) collected ($0.10)
Seat 5: Bandyaev folded before Flop (didn't bet)
Seat 6: Andrei ProFF folded before Flop (didn't bet)



PokerStars Hand #166667388693:  Hold'em No Limit ($0.05/$0.10 USD) - 2017/02/23 16:00:05 ET
Table 'Wil' 6-max Seat #1 is the button
Seat 1: jwhelan94 ($24.47 in chips) 
Seat 2: Vrinni ($22.66 in chips) 
Seat 3: Namhkal ($10 in chips) 
Seat 4: x3ultimate ($10.42 in chips) 
Seat 5: Feverhead ($11.21 in chips) 
Seat 6: Comeback3392 ($14.33 in chips) 
Vrinni: posts small blind $0.05
Namhkal: posts big blind $0.10
*** HOLE CARDS ***
x3ultimate: folds 
Feverhead: raises $0.20 to $0.30
Comeback3392: folds 
jwhelan94: folds 
Vrinni: folds 
Namhkal: folds 
Uncalled bet ($0.20) returned to Feverhead
Feverhead collected $0.25 from pot
Feverhead: doesn't show hand 
*** SUMMARY ***
Total pot $0.25 | Rake $0 
Seat 1: jwhelan94 (button) folded before Flop (didn't bet)
Seat 2: Vrinni (small blind) folded before Flop
Seat 3: Namhkal (big blind) folded before Flop
Seat 4: x3ultimate folded before Flop (didn't bet)
Seat 5: Feverhead collected ($0.25)
Seat 6: Comeback3392 folded before Flop (didn't bet)



PokerStars Hand #166667388834:  Hold'em No Limit ($0.05/$0.10 USD) - 2017/02/23 16:00:05 ET
Table 'Luanda' 6-max Seat #5 is the button
Seat 1: Kow6oy ($10.25 in chips) 
Seat 2: Xander188 ($10.30 in chips) 
Seat 4: aapokerkot ($10.38 in chips) 
Seat 5: st4tion ($11.89 in chips) 
Seat 6: KA3AXCTAHEU, ($11.06 in chips) 
KA3AXCTAHEU,: posts small blind $0.05
Kow6oy: posts big blind $0.10
DamDatsAnAce: sits out 
*** HOLE CARDS ***
Xander188: folds 
aapokerkot: folds 
st4tion: raises $0.15 to $0.25
KA3AXCTAHEU,: raises $0.60 to $0.85
Kow6oy: folds 
st4tion: folds 
Uncalled bet ($0.60) returned to KA3AXCTAHEU,
KA3AXCTAHEU, collected $0.60 from pot
*** SUMMARY ***
Total pot $0.60 | Rake $0 
Seat 1: Kow6oy (big blind) folded before Flop
Seat 2: Xander188 folded before Flop (didn't bet)
Seat 4: aapokerkot folded before Flop (didn't bet)
Seat 5: st4tion (button) folded before Flop
Seat 6: KA3AXCTAHEU, (small blind) collected ($0.60)



PokerStars Hand #166667388870:  Hold'em No Limit ($0.05/$0.10 USD) - 2017/02/23 16:00:05 ET
Table 'Siebohme II' 6-max Seat #4 is the button
Seat 1: homelessdan ($18.22 in chips) 
Seat 2: townerz1991 ($14.52 in chips) 
Seat 4: POT_TRADER ($12.14 in chips) 
Seat 5: NvR.m1nD ($10 in chips) 
NvR.m1nD: posts small blind $0.05
homelessdan: posts big blind $0.10
D3NyA: sits out 
*** HOLE CARDS ***
townerz1991: folds 
POT_TRADER: folds 
NvR.m1nD: folds 
Uncalled bet ($0.05) returned to homelessdan
homelessdan collected $0.10 from pot
*** SUMMARY ***
Total pot $0.10 | Rake $0 
Seat 1: homelessdan (big blind) collected ($0.10)
Seat 2: townerz1991 folded before Flop (didn't bet)
Seat 4: POT_TRADER (button) folded before Flop (didn't bet)
Seat 5: NvR.m1nD (small blind) folded before Flop



PokerStars Hand #166667389153:  Hold'em No Limit ($0.05/$0.10 USD) - 2017/02/23 16:00:05 ET
Table 'Lagrula' 6-max Seat #3 is the button
Seat 1: Ice_Isayev ($10 in chips) 
Seat 2: jamalungma ($10.96 in chips) 
Seat 3: micke667 ($15.91 in chips) 
Seat 4: Calimero2408 ($4.78 in chips) 
Seat 5: Iarlei ($10 in chips) 
Seat 6: Spud014 ($11.10 in chips) 
Calimero2408: posts small blind $0.05
Iarlei: posts big blind $0.10
*** HOLE CARDS ***
Spud014: folds 
Ice_Isayev: folds 
jamalungma: folds 
micke667: folds 
Calimero2408: calls $0.05
Iarlei: checks 
*** FLOP *** [7d 3h 9h]
Calimero2408: checks 
Iarlei: checks 
*** TURN *** [7d 3h 9h] [2d]
Calimero2408: bets $0.20
Iarlei: folds 
Uncalled bet ($0.20) returned to Calimero2408
Calimero2408 collected $0.19 from pot
*** SUMMARY ***
Total pot $0.20 | Rake $0.01 
Board [7d 3h 9h 2d]
Seat 1: Ice_Isayev folded before Flop (didn't bet)
Seat 2: jamalungma folded before Flop (didn't bet)
Seat 3: micke667 (button) folded before Flop (didn't bet)
Seat 4: Calimero2408 (small blind) collected ($0.19)
Seat 5: Iarlei (big blind) folded on the Turn
Seat 6: Spud014 folded before Flop (didn't bet)



PokerStars Hand #166667389209:  Hold'em No Limit ($0.05/$0.10 USD) - 2017/02/23 16:00:05 ET
Table 'Caupolican' 6-max Seat #5 is the button
Seat 1: kingartur222 ($10.23 in chips) 
Seat 2: garigura ($19.70 in chips) 
Seat 3: arturgalant ($4.77 in chips) 
Seat 4: mhonielsen ($11.46 in chips) 
Seat 5: Kazacha ($10.80 in chips) 
Seat 6: crazydevill ($10.92 in chips) 
crazydevill: posts small blind $0.05
kingartur222: posts big blind $0.10
*** HOLE CARDS ***
garigura: folds 
arturgalant: folds 
mhonielsen: folds 
Kazacha: raises $0.14 to $0.24
crazydevill: folds 
kingartur222: folds 
Uncalled bet ($0.14) returned to Kazacha
Kazacha collected $0.25 from pot
*** SUMMARY ***
Total pot $0.25 | Rake $0 
Seat 1: kingartur222 (big blind) folded before Flop
Seat 2: garigura folded before Flop (didn't bet)
Seat 3: arturgalant folded before Flop (didn't bet)
Seat 4: mhonielsen folded before Flop (didn't bet)
Seat 5: Kazacha (button) collected ($0.25)
Seat 6: crazydevill (small blind) folded before Flop



PokerStars Hand #166667389292:  Hold'em No Limit ($0.05/$0.10 USD) - 2017/02/23 16:00:05 ET
Table 'Duhr II' 6-max Seat #5 is the button
Seat 1: Lucky HoBBiT ($10 in chips) 
Seat 2: Feverhead ($37.76 in chips) 
Seat 3: Innerwuss ($12.06 in chips) 
Seat 4: CHRO8 ($14.61 in chips) 
Seat 5: Punzzzer ($10 in chips) 
Seat 6: townerz1991 ($10.99 in chips) 
townerz1991: posts small blind $0.05
Lucky HoBBiT: posts big blind $0.10
*** HOLE CARDS ***
Feverhead: folds 
Innerwuss: folds 
CHRO8: folds 
Punzzzer: raises $0.15 to $0.25
townerz1991: raises $0.75 to $1
Lucky HoBBiT is connected 
Lucky HoBBiT: folds 
Punzzzer: calls $0.75
*** FLOP *** [Th 7c Js]
townerz1991: checks 
Punzzzer: bets $1.21
townerz1991: calls $1.21
*** TURN *** [Th 7c Js] [7d]
townerz1991: checks 
Punzzzer: bets $3.24
townerz1991: folds 
Uncalled bet ($3.24) returned to Punzzzer
Punzzzer collected $4.32 from pot
*** SUMMARY ***
Total pot $4.52 | Rake $0.20 
Board [Th 7c Js 7d]
Seat 1: Lucky HoBBiT (big blind) folded before Flop
Seat 2: Feverhead folded before Flop (didn't bet)
Seat 3: Innerwuss folded before Flop (didn't bet)
Seat 4: CHRO8 folded before Flop (didn't bet)
Seat 5: Punzzzer (button) collected ($4.32)
Seat 6: townerz1991 (small blind) folded on the Turn



PokerStars Hand #166667389387:  Hold'em No Limit ($0.05/$0.10 USD) - 2017/02/23 16:00:06 ET
Table 'Eurydome II' 6-max Seat #5 is the button
Seat 2: Elinaattor ($10.49 in chips) 
Seat 3: gaHy_HaXeP ($10 in chips) 
Seat 5: kush-killa87 ($12.13 in chips) 
Seat 6: Jucatorul823 ($6.20 in chips) 
Jucatorul823: posts small blind $0.05
Elinaattor: posts big blind $0.10
*** HOLE CARDS ***
gaHy_HaXeP: raises $0.15 to $0.25
kush-killa87: calls $0.25
Jucatorul823: folds 
Elinaattor: folds 
*** FLOP *** [Ks 6d Qc]
gaHy_HaXeP: checks 
kush-killa87: checks 
*** TURN *** [Ks 6d Qc] [8d]
gaHy_HaXeP: checks 
kush-killa87: bets $0.30
gaHy_HaXeP: calls $0.30
*** RIVER *** [Ks 6d Qc 8d] [5h]
gaHy_HaXeP: checks 
kush-killa87: bets $1.20
gaHy_HaXeP: calls $1.20
*** SHOW DOWN ***
kush-killa87: shows [Qs 8s] (two pair, Queens and Eights)
gaHy_HaXeP: mucks hand 
kush-killa87 collected $3.49 from pot
*** SUMMARY ***
Total pot $3.65 | Rake $0.16 
Board [Ks 6d Qc 8d 5h]
Seat 2: Elinaattor (big blind) folded before Flop
Seat 3: gaHy_HaXeP mucked
Seat 5: kush-killa87 (button) showed [Qs 8s] and won ($3.49) with two pair, Queens and Eights
Seat 6: Jucatorul823 (small blind) folded before Flop



PokerStars Hand #166667389494:  Hold'em No Limit ($0.05/$0.10 USD) - 2017/02/23 16:00:06 ET
Table 'Joella' 6-max Seat #3 is the button
Seat 1: Dcaro31 ($13.40 in chips) 
Seat 2: Kaelyns_Bark ($10.46 in chips) 
Seat 3: Joker51_wtf! ($10.20 in chips) 
Seat 5: Anestakis777 ($4.50 in chips) 
Seat 6: dr.goofy ($10 in chips) 
Anestakis777: posts small blind $0.05
dr.goofy: posts big blind $0.10
*** HOLE CARDS ***
Dcaro31: folds 
Kaelyns_Bark: raises $0.10 to $0.20
Joker51_wtf!: folds 
Anestakis777: calls $0.15
dr.goofy: folds 
*** FLOP *** [Kd Ah 6h]
Anestakis777: bets $0.20
Kaelyns_Bark: calls $0.20
*** TURN *** [Kd Ah 6h] [4h]
Anestakis777: bets $0.50
Kaelyns_Bark: folds 
Uncalled bet ($0.50) returned to Anestakis777
Anestakis777 collected $0.86 from pot
*** SUMMARY ***
Total pot $0.90 | Rake $0.04 
Board [Kd Ah 6h 4h]
Seat 1: Dcaro31 folded before Flop (didn't bet)
Seat 2: Kaelyns_Bark folded on the Turn
Seat 3: Joker51_wtf! (button) folded before Flop (didn't bet)
Seat 5: Anestakis777 (small blind) collected ($0.86)
Seat 6: dr.goofy (big blind) folded before Flop



PokerStars Hand #166667389692:  Hold'em No Limit ($0.05/$0.10 USD) - 2017/02/23 16:00:06 ET
Table 'Girtab' 6-max Seat #5 is the button
Seat 2: MühliJr ($10 in chips) 
Seat 3: kingartur222 ($12.59 in chips) 
Seat 4: Hyd SK ($10.79 in chips) 
Seat 5: sexy_seagull ($10.87 in chips) 
Seat 6: BahiaMinhaP ($10 in chips) 
BahiaMinhaP: posts small blind $0.05
MühliJr: posts big blind $0.10
*** HOLE CARDS ***
kingartur222: folds 
Hyd SK: folds 
sexy_seagull: folds 
BahiaMinhaP: raises $0.20 to $0.30
MühliJr: calls $0.20
*** FLOP *** [4d 5c 9c]
BahiaMinhaP: bets $0.38
MühliJr: calls $0.38
*** TURN *** [4d 5c 9c] [6s]
BahiaMinhaP: bets $0.87
MühliJr: calls $0.87
*** RIVER *** [4d 5c 9c 6s] [4h]
BahiaMinhaP: checks 
MühliJr: checks 
*** SHOW DOWN ***
BahiaMinhaP: shows [Kc 8c] (a pair of Fours)
MühliJr: shows [9d 8s] (two pair, Nines and Fours)
MühliJr collected $2.96 from pot
*** SUMMARY ***
Total pot $3.10 | Rake $0.14 
Board [4d 5c 9c 6s 4h]
Seat 2: MühliJr (big blind) showed [9d 8s] and won ($2.96) with two pair, Nines and Fours
Seat 3: kingartur222 folded before Flop (didn't bet)
Seat 4: Hyd SK folded before Flop (didn't bet)
Seat 5: sexy_seagull (button) folded before Flop (didn't bet)
Seat 6: BahiaMinhaP (small blind) showed [Kc 8c] and lost with a pair of Fours



PokerStars Hand #166667389787:  Hold'em No Limit ($0.05/$0.10 USD) - 2017/02/23 16:00:06 ET
Table 'Atalante' 6-max Seat #6 is the button
Seat 1: OceanBlue100 ($5.39 in chips) 
Seat 2: CiisCi ($26.69 in chips) 
Seat 3: Kow6oy ($10 in chips) 
Seat 4: Dcaro31 ($25.22 in chips) 
Seat 5: eniksenik ($10.29 in chips) 
Seat 6: FlopsterGB ($23.55 in chips) 
OceanBlue100: posts small blind $0.05
CiisCi: posts big blind $0.10
*** HOLE CARDS ***
Kow6oy: folds 
Dcaro31: folds 
eniksenik: folds 
FlopsterGB: raises $0.20 to $0.30
OceanBlue100: calls $0.25
CiisCi: calls $0.20
*** FLOP *** [Tc 5s 2c]
OceanBlue100: checks 
CiisCi: bets $0.57
FlopsterGB: calls $0.57
OceanBlue100: folds 
*** TURN *** [Tc 5s 2c] [As]
CiisCi: bets $1.40
FlopsterGB: calls $1.40
*** RIVER *** [Tc 5s 2c As] [Ks]
CiisCi: checks 
FlopsterGB: bets $4.40
CiisCi: folds 
Uncalled bet ($4.40) returned to FlopsterGB
FlopsterGB collected $4.62 from pot
*** SUMMARY ***
Total pot $4.84 | Rake $0.22 
Board [Tc 5s 2c As Ks]
Seat 1: OceanBlue100 (small blind) folded on the Flop
Seat 2: CiisCi (big blind) folded on the River
Seat 3: Kow6oy folded before Flop (didn't bet)
Seat 4: Dcaro31 folded before Flop (didn't bet)
Seat 5: eniksenik folded before Flop (didn't bet)
Seat 6: FlopsterGB (button) collected ($4.62)



PokerStars Hand #166667389854:  Hold'em No Limit ($0.05/$0.10 USD) - 2017/02/23 16:00:06 ET
Table 'Ebella II' 6-max Seat #1 is the button
Seat 1: gaHy_HaXeP ($10 in chips) 
Seat 2: Therodorus ($10 in chips) 
Seat 3: Torften2 ($8.47 in chips) 
Seat 4: ValdemorS ($10.15 in chips) 
Seat 5: Bird et al ($10.15 in chips) 
Therodorus: posts small blind $0.05
Torften2: posts big blind $0.10
Joker51_wtf!: sits out 
*** HOLE CARDS ***
ValdemorS: raises $0.20 to $0.30
Bird et al: folds 
gaHy_HaXeP: folds 
Therodorus: folds 
Torften2: folds 
Uncalled bet ($0.20) returned to ValdemorS
ValdemorS collected $0.25 from pot
*** SUMMARY ***
Total pot $0.25 | Rake $0 
Seat 1: gaHy_HaXeP (button) folded before Flop (didn't bet)
Seat 2: Therodorus (small blind) folded before Flop
Seat 3: Torften2 (big blind) folded before Flop
Seat 4: ValdemorS collected ($0.25)
Seat 5: Bird et al folded before Flop (didn't bet)



PokerStars Hand #166667389894:  Hold'em No Limit ($0.05/$0.10 USD) - 2017/02/23 16:00:06 ET
Table 'Lesath III' 6-max Seat #5 is the button
Seat 1: Gogeta26 ($6.83 in chips) 
Seat 2: WinninBikini ($10.18 in chips) 
Seat 3: Giyorod ($10 in chips) 
Seat 4: Eddys Edge ($10 in chips) 
Seat 5: eniksenik ($15.49 in chips) 
Seat 6: patrick19111 ($10.76 in chips) 
patrick19111: posts small blind $0.05
Gogeta26: posts big blind $0.10
*** HOLE CARDS ***
WinninBikini: folds 
Giyorod: folds 
Eddys Edge: folds 
eniksenik: folds 
patrick19111: folds 
Uncalled bet ($0.05) returned to Gogeta26
Gogeta26 collected $0.10 from pot
*** SUMMARY ***
Total pot $0.10 | Rake $0 
Seat 1: Gogeta26 (big blind) collected ($0.10)
Seat 2: WinninBikini folded before Flop (didn't bet)
Seat 3: Giyorod folded before Flop (didn't bet)
Seat 4: Eddys Edge folded before Flop (didn't bet)
Seat 5: eniksenik (button) folded before Flop (didn't bet)
Seat 6: patrick19111 (small blind) folded before Flop



PokerStars Hand #166667389910:  Hold'em No Limit ($0.05/$0.10 USD) - 2017/02/23 16:00:06 ET
Table 'Peiroos' 6-max Seat #1 is the button
Seat 1: ksandr_hom ($10 in chips) 
Seat 2: Nr847 ($10 in chips) 
Seat 3: atlx0711 ($22.02 in chips) 
Seat 4: Peter0087 ($4.29 in chips) 
Seat 5: sergio-cb164 ($9.55 in chips) 
Seat 6: DevonMiles88 ($8.82 in chips) 
Nr847: posts small blind $0.05
atlx0711: posts big blind $0.10
*** HOLE CARDS ***
Peter0087: raises $0.10 to $0.20
sergio-cb164: folds 
DevonMiles88: raises $0.30 to $0.50
ksandr_hom: folds 
Nr847: folds 
atlx0711: folds 
Peter0087: calls $0.30
*** FLOP *** [8s 6s 8c]
Peter0087: checks 
DevonMiles88: bets $0.80
Peter0087: folds 
Uncalled bet ($0.80) returned to DevonMiles88
DevonMiles88 collected $1.10 from pot
*** SUMMARY ***
Total pot $1.15 | Rake $0.05 
Board [8s 6s 8c]
Seat 1: ksandr_hom (button) folded before Flop (didn't bet)
Seat 2: Nr847 (small blind) folded before Flop
Seat 3: atlx0711 (big blind) folded before Flop
Seat 4: Peter0087 folded on the Flop
Seat 5: sergio-cb164 folded before Flop (didn't bet)
Seat 6: DevonMiles88 collected ($1.10)



PokerStars Hand #166667390104:  Hold'em No Limit ($0.05/$0.10 USD) - 2017/02/23 16:00:06 ET
Table 'Lorbach' 6-max Seat #3 is the button
Seat 1: LarryTheStar ($11.27 in chips) 
Seat 2: fabadam ($12.48 in chips) 
Seat 3: ArcticBearDK ($11.05 in chips) 
Seat 4: McCleans ($10 in chips) 
Seat 5: Cluckh ($14.77 in chips) 
Seat 6: Worlz ($13.07 in chips) 
McCleans: posts small blind $0.05
Cluckh: posts big blind $0.10
*** HOLE CARDS ***
Worlz: calls $0.10
LarryTheStar: folds 
fabadam: folds 
ArcticBearDK: folds 
McCleans: calls $0.05
Cluckh: raises $0.40 to $0.50
Worlz: folds 
McCleans: folds 
Uncalled bet ($0.40) returned to Cluckh
Cluckh collected $0.30 from pot
*** SUMMARY ***
Total pot $0.30 | Rake $0 
Seat 1: LarryTheStar folded before Flop (didn't bet)
Seat 2: fabadam folded before Flop (didn't bet)
Seat 3: ArcticBearDK (button) folded before Flop (didn't bet)
Seat 4: McCleans (small blind) folded before Flop
Seat 5: Cluckh (big blind) collected ($0.30)
Seat 6: Worlz folded before Flop



PokerStars Hand #166667390394:  Hold'em No Limit ($0.05/$0.10 USD) - 2017/02/23 16:00:07 ET
Table 'Wilkens II' 6-max Seat #3 is the button
Seat 1: Islamiq-GuRL ($12.30 in chips) 
Seat 2: manashov ($10 in chips) 
Seat 3: Namhkal ($10.95 in chips) 
Seat 5: patrick19111 ($10 in chips) 
Seat 6: XaXaTyH4uK ($14.61 in chips) 
myevc will be allowed to play after the button
patrick19111: posts small blind $0.05
XaXaTyH4uK: posts big blind $0.10
*** HOLE CARDS ***
Islamiq-GuRL: folds 
manashov: raises $0.20 to $0.30
Namhkal: folds 
patrick19111: folds 
XaXaTyH4uK: folds 
Uncalled bet ($0.20) returned to manashov
manashov collected $0.25 from pot
*** SUMMARY ***
Total pot $0.25 | Rake $0 
Seat 1: Islamiq-GuRL folded before Flop (didn't bet)
Seat 2: manashov collected ($0.25)
Seat 3: Namhkal (button) folded before Flop (didn't bet)
Seat 5: patrick19111 (small blind) folded before Flop
Seat 6: XaXaTyH4uK (big blind) folded before Flop



PokerStars Hand #166667390908:  Hold'em No Limit ($0.05/$0.10 USD) - 2017/02/23 16:00:07 ET
Table 'Gelria' 6-max Seat #5 is the button
Seat 1: ab260414 ($10.27 in chips) 
Seat 2: fishhook5 ($10 in chips) 
Seat 3: Orlangoor ($10.34 in chips) 
Seat 5: apenvel ($7.64 in chips) 
Seat 6: Andrei ProFF ($10.47 in chips) 
Andrei ProFF: posts small blind $0.05
ab260414: posts big blind $0.10
*** HOLE CARDS ***
fishhook5: folds 
Orlangoor: folds 
apenvel: folds 
Andrei ProFF: raises $0.20 to $0.30
ab260414: folds 
Uncalled bet ($0.20) returned to Andrei ProFF
Andrei ProFF collected $0.20 from pot
*** SUMMARY ***
Total pot $0.20 | Rake $0 
Seat 1: ab260414 (big blind) folded before Flop
Seat 2: fishhook5 folded before Flop (didn't bet)
Seat 3: Orlangoor folded before Flop (didn't bet)
Seat 5: apenvel (button) folded before Flop (didn't bet)
Seat 6: Andrei ProFF (small blind) collected ($0.20)



PokerStars Hand #166667391007:  Hold'em No Limit ($0.05/$0.10 USD) - 2017/02/23 16:00:08 ET
Table 'Martha' 6-max Seat #3 is the button
Seat 1: Peter0087 ($10.30 in chips) 
Seat 2: pauli95 ($7.41 in chips) 
Seat 3: Hyd SK ($12.11 in chips) 
Seat 4: dittoro ($10.89 in chips) 
Seat 6: 8th wonders ($10 in chips) 
dittoro: posts small blind $0.05
RkaczoR: is sitting out 
8th wonders: posts big blind $0.10
*** HOLE CARDS ***
Peter0087: folds 
pauli95: folds 
Hyd SK: folds 
dittoro: folds 
Uncalled bet ($0.05) returned to 8th wonders
8th wonders collected $0.10 from pot
*** SUMMARY ***
Total pot $0.10 | Rake $0 
Seat 1: Peter0087 folded before Flop (didn't bet)
Seat 2: pauli95 folded before Flop (didn't bet)
Seat 3: Hyd SK (button) folded before Flop (didn't bet)
Seat 4: dittoro (small blind) folded before Flop
Seat 6: 8th wonders (big blind) collected ($0.10)



PokerStars Hand #166667391022:  Hold'em No Limit ($0.05/$0.10 USD) - 2017/02/23 16:00:08 ET
Table 'Camilla II' 6-max Seat #5 is the button
Seat 2: Giyorod ($15.81 in chips) 
Seat 3: JahSoldier69 ($10 in chips) 
Seat 4: chimera252 ($12.81 in chips) 
Seat 5: LarryTheStar ($11.12 in chips) 
Seat 6: david_sara83 ($10.05 in chips) 
david_sara83: posts small blind $0.05
Giyorod: posts big blind $0.10
*** HOLE CARDS ***
JahSoldier69: folds 
chimera252: folds 
LarryTheStar: raises $0.10 to $0.20
david_sara83: folds 
Giyorod: folds 
Uncalled bet ($0.10) returned to LarryTheStar
LarryTheStar collected $0.25 from pot
*** SUMMARY ***
Total pot $0.25 | Rake $0 
Seat 2: Giyorod (big blind) folded before Flop
Seat 3: JahSoldier69 folded before Flop (didn't bet)
Seat 4: chimera252 folded before Flop (didn't bet)
Seat 5: LarryTheStar (button) collected ($0.25)
Seat 6: david_sara83 (small blind) folded before Flop



PokerStars Hand #166667391129:  Hold'em No Limit ($0.05/$0.10 USD) - 2017/02/23 16:00:08 ET
Table 'Jokaste II' 6-max Seat #4 is the button
Seat 1: Hyd SK ($13.48 in chips) 
Seat 3: crazydevill ($10 in chips) 
Seat 4: FRAID358 ($14.86 in chips) 
Seat 5: Vrinni ($10 in chips) 
Seat 6: Adailton07 ($14.27 in chips) 
Vrinni: posts small blind $0.05
Adailton07: posts big blind $0.10
T9MS: sits out 
*** HOLE CARDS ***
Hyd SK: folds 
crazydevill: folds 
FRAID358: folds 
Vrinni: folds 
Uncalled bet ($0.05) returned to Adailton07
Adailton07 collected $0.10 from pot
*** SUMMARY ***
Total pot $0.10 | Rake $0 
Seat 1: Hyd SK folded before Flop (didn't bet)
Seat 3: crazydevill folded before Flop (didn't bet)
Seat 4: FRAID358 (button) folded before Flop (didn't bet)
Seat 5: Vrinni (small blind) folded before Flop
Seat 6: Adailton07 (big blind) collected ($0.10)



PokerStars Hand #166667391144:  Hold'em No Limit ($0.05/$0.10 USD) - 2017/02/23 16:00:08 ET
Table 'Walpurga' 6-max Seat #4 is the button
Seat 1: chimera252 ($11.16 in chips) 
Seat 3: Innerwuss ($19.24 in chips) 
Seat 4: oddshoff ($12.89 in chips) 
chimera252: posts small blind $0.05
Innerwuss: posts big blind $0.10
*** HOLE CARDS ***
Lucky HoBBiT leaves the table
oddshoff: folds 
chimera252: folds 
Uncalled bet ($0.05) returned to Innerwuss
Innerwuss collected $0.10 from pot
*** SUMMARY ***
Total pot $0.10 | Rake $0 
Seat 1: chimera252 (small blind) folded before Flop
Seat 3: Innerwuss (big blind) collected ($0.10)
Seat 4: oddshoff (button) folded before Flop (didn't bet)



PokerStars Hand #166667391201:  Hold'em No Limit ($0.05/$0.10 USD) - 2017/02/23 16:00:08 ET
Table 'Antielus II' 6-max Seat #2 is the button
Seat 1: Dcaro31 ($17.30 in chips) 
Seat 2: Orlangoor ($11.45 in chips) 
Seat 3: mcyi3at2 ($12.20 in chips) 
Seat 4: hoedje72 ($13.06 in chips) 
Seat 5: Hyd SK ($10 in chips) 
Seat 6: GiveTwoMe ($11.30 in chips) 
mcyi3at2: posts small blind $0.05
hoedje72: posts big blind $0.10
*** HOLE CARDS ***
Hyd SK: folds 
GiveTwoMe: folds 
Dcaro31: folds 
Orlangoor: raises $0.12 to $0.22
mcyi3at2: raises $0.43 to $0.65
hoedje72: folds 
Orlangoor: calls $0.43
*** FLOP *** [Qd As 5c]
hoedje72 leaves the table
mcyi3at2: bets $0.70
Orlangoor: folds 
Uncalled bet ($0.70) returned to mcyi3at2
mcyi3at2 collected $1.34 from pot
*** SUMMARY ***
Total pot $1.40 | Rake $0.06 
Board [Qd As 5c]
Seat 1: Dcaro31 folded before Flop (didn't bet)
Seat 2: Orlangoor (button) folded on the Flop
Seat 3: mcyi3at2 (small blind) collected ($1.34)
Seat 4: hoedje72 (big blind) folded before Flop
Seat 5: Hyd SK folded before Flop (didn't bet)
Seat 6: GiveTwoMe folded before Flop (didn't bet)



PokerStars Hand #166667391280:  Hold'em No Limit ($0.05/$0.10 USD) - 2017/02/23 16:00:08 ET
Table 'Marbachia II' 6-max Seat #4 is the button
Seat 2: Yabidooo ($10 in chips) 
Seat 3: CDestructivo ($16.24 in chips) 
Seat 4: BahiaMinhaP ($10 in chips) 
Seat 5: Kow6oy ($10.05 in chips) 
Seat 6: DamDatsAnAce ($10 in chips) 
Kow6oy: posts small blind $0.05
DamDatsAnAce: posts big blind $0.10
AC Evergreen: sits out 
*** HOLE CARDS ***
Yabidooo: folds 
CDestructivo: calls $0.10
BahiaMinhaP: folds 
Kow6oy: folds 
DamDatsAnAce: checks 
*** FLOP *** [7h 8c 2s]
DamDatsAnAce: checks 
CDestructivo: checks 
*** TURN *** [7h 8c 2s] [Ad]
DamDatsAnAce: checks 
CDestructivo: bets $0.20
DamDatsAnAce: folds 
Uncalled bet ($0.20) returned to CDestructivo
CDestructivo collected $0.24 from pot
*** SUMMARY ***
Total pot $0.25 | Rake $0.01 
Board [7h 8c 2s Ad]
Seat 2: Yabidooo folded before Flop (didn't bet)
Seat 3: CDestructivo collected ($0.24)
Seat 4: BahiaMinhaP (button) folded before Flop (didn't bet)
Seat 5: Kow6oy (small blind) folded before Flop
Seat 6: DamDatsAnAce (big blind) folded on the Turn



PokerStars Hand #166667391373:  Hold'em No Limit ($0.05/$0.10 USD) - 2017/02/23 16:00:08 ET
Table 'Cassini' 6-max Seat #5 is the button
Seat 1: Pokeaster ($10 in chips) 
Seat 2: mhonielsen ($10.23 in chips) 
Seat 4: fortieth ($13.57 in chips) 
Seat 5: johkom ($7.90 in chips) 
Seat 6: JahSoldier69 ($11.25 in chips) 
JahSoldier69: posts small blind $0.05
Pokeaster: posts big blind $0.10
*** HOLE CARDS ***
mhonielsen: folds 
fortieth: raises $0.17 to $0.27
johkom: folds 
JahSoldier69: folds 
Pokeaster: folds 
Uncalled bet ($0.17) returned to fortieth
fortieth collected $0.25 from pot
*** SUMMARY ***
Total pot $0.25 | Rake $0 
Seat 1: Pokeaster (big blind) folded before Flop
Seat 2: mhonielsen folded before Flop (didn't bet)
Seat 4: fortieth collected ($0.25)
Seat 5: johkom (button) folded before Flop (didn't bet)
Seat 6: JahSoldier69 (small blind) folded before Flop



PokerStars Hand #166667391424:  Hold'em No Limit ($0.05/$0.10 USD) - 2017/02/23 16:00:08 ET
Table 'Pandora III' 6-max Seat #2 is the button
Seat 1: Pokeaster ($11.44 in chips) 
Seat 2: garigura ($11.47 in chips) 
Seat 3: ChuikaPridi ($15.92 in chips) 
Seat 4: mhonielsen ($10 in chips) 
Seat 5: MühliJr ($10.30 in chips) 
Seat 6: IAntikI ($10.27 in chips) 
ChuikaPridi: posts small blind $0.05
mhonielsen: posts big blind $0.10
*** HOLE CARDS ***
MühliJr: folds 
IAntikI: folds 
Pokeaster: folds 
garigura: folds 
ChuikaPridi: raises $0.20 to $0.30
mhonielsen: calls $0.20
*** FLOP *** [Kd 3c 8d]
ChuikaPridi: bets $0.40
mhonielsen: folds 
Uncalled bet ($0.40) returned to ChuikaPridi
ChuikaPridi collected $0.57 from pot
*** SUMMARY ***
Total pot $0.60 | Rake $0.03 
Board [Kd 3c 8d]
Seat 1: Pokeaster folded before Flop (didn't bet)
Seat 2: garigura (button) folded before Flop (didn't bet)
Seat 3: ChuikaPridi (small blind) collected ($0.57)
Seat 4: mhonielsen (big blind) folded on the Flop
Seat 5: MühliJr folded before Flop (didn't bet)
Seat 6: IAntikI folded before Flop (didn't bet)



PokerStars Hand #166667391593:  Hold'em No Limit ($0.05/$0.10 USD) - 2017/02/23 16:00:08 ET
Table 'Marghanna II' 6-max Seat #3 is the button
Seat 1: steepfell ($11.89 in chips) 
Seat 2: Namhkal ($11.86 in chips) 
Seat 3: Innerwuss ($11.32 in chips) 
Seat 4: D3NyA ($12.42 in chips) 
Seat 5: ofl21189 ($7.20 in chips) 
Seat 6: VAD21 ($13.31 in chips) 
D3NyA: posts small blind $0.05
ofl21189: posts big blind $0.10
*** HOLE CARDS ***
VAD21 has timed out
VAD21: folds 
steepfell: folds 
Namhkal: raises $0.15 to $0.25
Innerwuss has timed out
Innerwuss: folds 
D3NyA: folds 
ofl21189: calls $0.15
*** FLOP *** [Qc 7h Jh]
ofl21189: checks 
Namhkal: checks 
*** TURN *** [Qc 7h Jh] [9h]
ofl21189: checks 
Namhkal: checks 
*** RIVER *** [Qc 7h Jh 9h] [Kd]
ofl21189: checks 
Namhkal: checks 
*** SHOW DOWN ***
ofl21189: shows [Kc Js] (two pair, Kings and Jacks)
Namhkal: mucks hand 
ofl21189 collected $0.53 from pot
*** SUMMARY ***
Total pot $0.55 | Rake $0.02 
Board [Qc 7h Jh 9h Kd]
Seat 1: steepfell folded before Flop (didn't bet)
Seat 2: Namhkal mucked
Seat 3: Innerwuss (button) folded before Flop (didn't bet)
Seat 4: D3NyA (small blind) folded before Flop
Seat 5: ofl21189 (big blind) showed [Kc Js] and won ($0.53) with two pair, Kings and Jacks
Seat 6: VAD21 folded before Flop (didn't bet)



PokerStars Hand #166667391636:  Hold'em No Limit ($0.05/$0.10 USD) - 2017/02/23 16:00:08 ET
Table 'Markab II' 6-max Seat #6 is the button
Seat 1: david_sara83 ($10.22 in chips) 
Seat 2: truck1234 ($11.40 in chips) 
Seat 3: sexy_seagull ($10 in chips) 
Seat 4: Crafty23@PS ($11.08 in chips) 
Seat 5: Rodik002 ($19.17 in chips) 
Seat 6: Comeback3392 ($10.64 in chips) 
david_sara83: posts small blind $0.05
truck1234: posts big blind $0.10
*** HOLE CARDS ***
sexy_seagull: folds 
Crafty23@PS: folds 
Rodik002: folds 
Comeback3392: folds 
david_sara83: folds 
Uncalled bet ($0.05) returned to truck1234
truck1234 collected $0.10 from pot
*** SUMMARY ***
Total pot $0.10 | Rake $0 
Seat 1: david_sara83 (small blind) folded before Flop
Seat 2: truck1234 (big blind) collected ($0.10)
Seat 3: sexy_seagull folded before Flop (didn't bet)
Seat 4: Crafty23@PS folded before Flop (didn't bet)
Seat 5: Rodik002 folded before Flop (didn't bet)
Seat 6: Comeback3392 (button) folded before Flop (didn't bet)



PokerStars Hand #166667391725:  Hold'em No Limit ($0.05/$0.10 USD) - 2017/02/23 16:00:09 ET
Table 'Esperanto II' 6-max Seat #4 is the button
Seat 1: kurasd ($9.92 in chips) 
Seat 2: EggMayo ($10 in chips) 
Seat 3: Namhkal ($10.64 in chips) 
Seat 4: Andrei ProFF ($10.41 in chips) 
Seat 5: FRAID358 ($9.85 in chips) 
Seat 6: ArcticBearDK ($13.85 in chips) 
FRAID358: posts small blind $0.05
ArcticBearDK: posts big blind $0.10
*** HOLE CARDS ***
kurasd: folds 
EggMayo: folds 
Namhkal: raises $0.15 to $0.25
Andrei ProFF: folds 
FRAID358: raises $0.65 to $0.90
ArcticBearDK: folds 
Namhkal: calls $0.65
*** FLOP *** [3c 2h 6s]
FRAID358: checks 
Namhkal: checks 
*** TURN *** [3c 2h 6s] [Ah]
FRAID358: bets $0.90
Namhkal: calls $0.90
*** RIVER *** [3c 2h 6s Ah] [4d]
FRAID358: checks 
Namhkal: bets $1.77
FRAID358: folds 
Uncalled bet ($1.77) returned to Namhkal
Namhkal collected $3.53 from pot
*** SUMMARY ***
Total pot $3.70 | Rake $0.17 
Board [3c 2h 6s Ah 4d]
Seat 1: kurasd folded before Flop (didn't bet)
Seat 2: EggMayo folded before Flop (didn't bet)
Seat 3: Namhkal collected ($3.53)
Seat 4: Andrei ProFF (button) folded before Flop (didn't bet)
Seat 5: FRAID358 (small blind) folded on the River
Seat 6: ArcticBearDK (big blind) folded before Flop



PokerStars Hand #166667391962:  Hold'em No Limit ($0.05/$0.10 USD) - 2017/02/23 16:00:09 ET
Table 'Ostara III' 6-max Seat #2 is the button
Seat 1: MühliJr ($10.52 in chips) 
Seat 2: Action_Gibi ($7.45 in chips) 
Seat 3: vtalian ($10.51 in chips) 
Seat 4: Goovr ($29.01 in chips) 
Seat 5: dzesio18 ($12.05 in chips) 
Seat 6: FlopsterGB ($12.05 in chips) 
vtalian: posts small blind $0.05
Goovr: posts big blind $0.10
*** HOLE CARDS ***
dzesio18: folds 
FlopsterGB: folds 
MühliJr: folds 
Action_Gibi: raises $0.20 to $0.30
vtalian: folds 
Goovr: folds 
Uncalled bet ($0.20) returned to Action_Gibi
Action_Gibi collected $0.25 from pot
*** SUMMARY ***
Total pot $0.25 | Rake $0 
Seat 1: MühliJr folded before Flop (didn't bet)
Seat 2: Action_Gibi (button) collected ($0.25)
Seat 3: vtalian (small blind) folded before Flop
Seat 4: Goovr (big blind) folded before Flop
Seat 5: dzesio18 folded before Flop (didn't bet)
Seat 6: FlopsterGB folded before Flop (didn't bet)



PokerStars Hand #166667392497:  Hold'em No Limit ($0.05/$0.10 USD) - 2017/02/23 16:00:10 ET
Table 'Clavel' 6-max Seat #4 is the button
Seat 1: KRZuff ($13.77 in chips) 
Seat 2: RoJ1 ($12.59 in chips) 
Seat 3: Darkfrai ($10.39 in chips) 
Seat 4: Dcaro31 ($12.18 in chips) 
Seat 5: Vrinni ($10.59 in chips) 
Seat 6: Gra_anD77 ($4.01 in chips) 
Vrinni: posts small blind $0.05
Gra_anD77: posts big blind $0.10
*** HOLE CARDS ***
KRZuff: raises $0.20 to $0.30
RoJ1: folds 
Darkfrai: folds 
Dcaro31: folds 
Vrinni: folds 
Gra_anD77: folds 
Uncalled bet ($0.20) returned to KRZuff
KRZuff collected $0.25 from pot
*** SUMMARY ***
Total pot $0.25 | Rake $0 
Seat 1: KRZuff collected ($0.25)
Seat 2: RoJ1 folded before Flop (didn't bet)
Seat 3: Darkfrai folded before Flop (didn't bet)
Seat 4: Dcaro31 (button) folded before Flop (didn't bet)
Seat 5: Vrinni (small blind) folded before Flop
Seat 6: Gra_anD77 (big blind) folded before Flop



PokerStars Hand #166667392533:  Hold'em No Limit ($0.05/$0.10 USD) - 2017/02/23 16:00:10 ET
Table 'Phereclos II' 6-max Seat #3 is the button
Seat 2: Kazacha ($10.13 in chips) 
Seat 3: kickereens ($21.31 in chips) 
Seat 4: DamDatsAnAce ($10.28 in chips) 
Seat 5: Smitty03300 ($10 in chips) 
Seat 6: mhonielsen ($16.07 in chips) 
DamDatsAnAce: posts small blind $0.05
Smitty03300: posts big blind $0.10
Croplayer1: sits out 
*** HOLE CARDS ***
mhonielsen: folds 
Kazacha: raises $0.14 to $0.24
kickereens: folds 
DamDatsAnAce: folds 
Smitty03300: folds 
Uncalled bet ($0.14) returned to Kazacha
Kazacha collected $0.25 from pot
*** SUMMARY ***
Total pot $0.25 | Rake $0 
Seat 2: Kazacha collected ($0.25)
Seat 3: kickereens (button) folded before Flop (didn't bet)
Seat 4: DamDatsAnAce (small blind) folded before Flop
Seat 5: Smitty03300 (big blind) folded before Flop
Seat 6: mhonielsen folded before Flop (didn't bet)



PokerStars Hand #166667392593:  Hold'em No Limit ($0.05/$0.10 USD) - 2017/02/23 16:00:10 ET
Table 'Gaika' 6-max Seat #6 is the button
Seat 1: oddshoff ($12.46 in chips) 
Seat 2: NvR.m1nD ($17.92 in chips) 
Seat 3: david_sara83 ($10.32 in chips) 
Seat 4: fortieth ($11.65 in chips) 
Seat 5: fedorka rus ($10.65 in chips) 
Seat 6: dr.goofy ($11.15 in chips) 
oddshoff: posts small blind $0.05
NvR.m1nD: posts big blind $0.10
*** HOLE CARDS ***
david_sara83: raises $0.20 to $0.30
fortieth: folds 
fedorka rus: folds 
dr.goofy: folds 
oddshoff: folds 
NvR.m1nD: folds 
Uncalled bet ($0.20) returned to david_sara83
david_sara83 collected $0.25 from pot
*** SUMMARY ***
Total pot $0.25 | Rake $0 
Seat 1: oddshoff (small blind) folded before Flop
Seat 2: NvR.m1nD (big blind) folded before Flop
Seat 3: david_sara83 collected ($0.25)
Seat 4: fortieth folded before Flop (didn't bet)
Seat 5: fedorka rus folded before Flop (didn't bet)
Seat 6: dr.goofy (button) folded before Flop (didn't bet)



PokerStars Hand #166667392595:  Hold'em No Limit ($0.05/$0.10 USD) - 2017/02/23 16:00:10 ET
Table 'Kunigunde II' 6-max Seat #6 is the button
Seat 1: facewald ($10.01 in chips) 
Seat 2: dragonste89 ($15.03 in chips) 
Seat 3: pancernik21 ($12.20 in chips) 
Seat 4: david_sara83 ($12.83 in chips) 
Seat 5: mdelfin0 ($11.59 in chips) 
Seat 6: Zooplack ($11.16 in chips) 
facewald: posts small blind $0.05
dragonste89: posts big blind $0.10
*** HOLE CARDS ***
pancernik21: folds 
david_sara83: folds 
mdelfin0: folds 
Zooplack: folds 
facewald: raises $0.19 to $0.29
dragonste89: folds 
Uncalled bet ($0.19) returned to facewald
facewald collected $0.20 from pot
*** SUMMARY ***
Total pot $0.20 | Rake $0 
Seat 1: facewald (small blind) collected ($0.20)
Seat 2: dragonste89 (big blind) folded before Flop
Seat 3: pancernik21 folded before Flop (didn't bet)
Seat 4: david_sara83 folded before Flop (didn't bet)
Seat 5: mdelfin0 folded before Flop (didn't bet)
Seat 6: Zooplack (button) folded before Flop (didn't bet)



PokerStars Hand #166667392643:  Hold'em No Limit ($0.05/$0.10 USD) - 2017/02/23 16:00:10 ET
Table 'Pompeja III' 6-max Seat #1 is the button
Seat 1: Iarlei ($10.64 in chips) 
Seat 2: steepfell ($11.74 in chips) 
Seat 3: Yspenyanin ($12.15 in chips) 
Seat 4: Cluckh ($12.06 in chips) 
Seat 5: Spud014 ($12.14 in chips) 
Seat 6: mega spasser ($5.20 in chips) 
steepfell: posts small blind $0.05
Yspenyanin: posts big blind $0.10
*** HOLE CARDS ***
Cluckh: folds 
Spud014: folds 
mega spasser: calls $0.10
Iarlei: raises $0.30 to $0.40
steepfell: raises $0.80 to $1.20
Yspenyanin has timed out
Yspenyanin: folds 
mega spasser: folds 
Iarlei: raises $2.30 to $3.50
steepfell: folds 
Uncalled bet ($2.30) returned to Iarlei
Iarlei collected $2.60 from pot
*** SUMMARY ***
Total pot $2.60 | Rake $0 
Seat 1: Iarlei (button) collected ($2.60)
Seat 2: steepfell (small blind) folded before Flop
Seat 3: Yspenyanin (big blind) folded before Flop
Seat 4: Cluckh folded before Flop (didn't bet)
Seat 5: Spud014 folded before Flop (didn't bet)
Seat 6: mega spasser folded before Flop



PokerStars Hand #166667392844:  Hold'em No Limit ($0.05/$0.10 USD) - 2017/02/23 16:00:10 ET
Table 'Armenia' 6-max Seat #5 is the button
Seat 1: tr41n3r12 ($12.32 in chips) 
Seat 2: Yabidooo ($10 in chips) 
Seat 3: CDestructivo ($12.28 in chips) 
Seat 4: x3ultimate ($11.40 in chips) 
Seat 5: boxer821 ($11.40 in chips) 
Seat 6: mega spasser ($5.27 in chips) 
mega spasser: posts small blind $0.05
tr41n3r12: posts big blind $0.10
*** HOLE CARDS ***
Yabidooo: folds 
CDestructivo: folds 
x3ultimate: raises $0.20 to $0.30
boxer821: raises $0.60 to $0.90
mega spasser: folds 
tr41n3r12: folds 
x3ultimate: folds 
Uncalled bet ($0.60) returned to boxer821
boxer821 collected $0.75 from pot
*** SUMMARY ***
Total pot $0.75 | Rake $0 
Seat 1: tr41n3r12 (big blind) folded before Flop
Seat 2: Yabidooo folded before Flop (didn't bet)
Seat 3: CDestructivo folded before Flop (didn't bet)
Seat 4: x3ultimate folded before Flop
Seat 5: boxer821 (button) collected ($0.75)
Seat 6: mega spasser (small blind) folded before Flop



PokerStars Hand #166667393254:  Hold'em No Limit ($0.05/$0.10 USD) - 2017/02/23 16:00:11 ET
Table 'Manto II' 6-max Seat #6 is the button
Seat 2: voledy ($10 in chips) 
Seat 3: Komap511 ($12.32 in chips) 
Seat 4: dr.goofy ($11.67 in chips) 
Seat 5: ArcticBearDK ($18.75 in chips) 
Seat 6: pancernik21 ($16.85 in chips) 
MihaGr will be allowed to play after the button
voledy: posts small blind $0.05
Komap511: posts big blind $0.10
*** HOLE CARDS ***
dr.goofy: raises $0.20 to $0.30
ArcticBearDK: folds 
pancernik21: folds 
voledy: folds 
Komap511: calls $0.20
*** FLOP *** [9d Js Ts]
Komap511: checks 
dr.goofy: checks 
*** TURN *** [9d Js Ts] [3s]
Komap511: bets $0.40
dr.goofy: calls $0.40
*** RIVER *** [9d Js Ts 3s] [6s]
Komap511: bets $0.70
dr.goofy: folds 
Uncalled bet ($0.70) returned to Komap511
Komap511 collected $1.38 from pot
*** SUMMARY ***
Total pot $1.45 | Rake $0.07 
Board [9d Js Ts 3s 6s]
Seat 2: voledy (small blind) folded before Flop
Seat 3: Komap511 (big blind) collected ($1.38)
Seat 4: dr.goofy folded on the River
Seat 5: ArcticBearDK folded before Flop (didn't bet)
Seat 6: pancernik21 (button) folded before Flop (didn't bet)



PokerStars Hand #166667393467:  Hold'em No Limit ($0.05/$0.10 USD) - 2017/02/23 16:00:11 ET
Table 'Bootes' 6-max Seat #4 is the button
Seat 1: Namhkal ($13.45 in chips) 
Seat 2: Bird et al ($19.45 in chips) 
Seat 3: KA3AXCTAHEU, ($19.35 in chips) 
Seat 4: totonove ($4.71 in chips) 
Seat 5: Pekaml ($15.24 in chips) 
Seat 6: cherep61987 ($10 in chips) 
Pekaml: posts small blind $0.05
cherep61987: posts big blind $0.10
*** HOLE CARDS ***
Namhkal: folds 
Bird et al: raises $0.21 to $0.31
KA3AXCTAHEU,: folds 
totonove: folds 
Pekaml: folds 
cherep61987: folds 
Uncalled bet ($0.21) returned to Bird et al
Bird et al collected $0.25 from pot
*** SUMMARY ***
Total pot $0.25 | Rake $0 
Seat 1: Namhkal folded before Flop (didn't bet)
Seat 2: Bird et al collected ($0.25)
Seat 3: KA3AXCTAHEU, folded before Flop (didn't bet)
Seat 4: totonove (button) folded before Flop (didn't bet)
Seat 5: Pekaml (small blind) folded before Flop
Seat 6: cherep61987 (big blind) folded before Flop



PokerStars Hand #166667393521:  Hold'em No Limit ($0.05/$0.10 USD) - 2017/02/23 16:00:11 ET
Table 'Wesselink II' 6-max Seat #3 is the button
Seat 1: vladcol ($8 in chips) 
Seat 2: jamalungma ($11.26 in chips) 
Seat 3: Wargolandros ($9.07 in chips) 
Seat 4: BahiaMinhaP ($10 in chips) 
Seat 5: xdjango07x ($16.96 in chips) 
Seat 6: bambolejro ($10 in chips) 
BahiaMinhaP: posts small blind $0.05
xdjango07x: posts big blind $0.10
vladcol: posts big blind $0.10
*** HOLE CARDS ***
bambolejro: folds 
vladcol: checks 
jamalungma: folds 
Wargolandros: folds 
BahiaMinhaP: folds 
xdjango07x: checks 
*** FLOP *** [8d 6d 9c]
xdjango07x: checks 
vladcol: checks 
*** TURN *** [8d 6d 9c] [3c]
xdjango07x: bets $0.18
vladcol: raises $0.28 to $0.46
xdjango07x: calls $0.28
*** RIVER *** [8d 6d 9c 3c] [5d]
xdjango07x: checks 
vladcol: bets $1
xdjango07x: calls $1
*** SHOW DOWN ***
vladcol: shows [4s Qd] (high card Queen)
xdjango07x: shows [9d 3s] (two pair, Nines and Threes)
xdjango07x collected $3.03 from pot
*** SUMMARY ***
Total pot $3.17 | Rake $0.14 
Board [8d 6d 9c 3c 5d]
Seat 1: vladcol showed [4s Qd] and lost with high card Queen
Seat 2: jamalungma folded before Flop (didn't bet)
Seat 3: Wargolandros (button) folded before Flop (didn't bet)
Seat 4: BahiaMinhaP (small blind) folded before Flop
Seat 5: xdjango07x (big blind) showed [9d 3s] and won ($3.03) with two pair, Nines and Threes
Seat 6: bambolejro folded before Flop (didn't bet)



PokerStars Hand #166667393565:  Hold'em No Limit ($0.05/$0.10 USD) - 2017/02/23 16:00:11 ET
Table 'Arkab' 6-max Seat #4 is the button
Seat 1: iamkakaroto ($10.15 in chips) 
Seat 2: aktion4ik ($12.39 in chips) 
Seat 3: sexy_seagull ($10.15 in chips) 
Seat 4: donkucallme ($8.98 in chips) 
Seat 5: OrionYusupov ($9.54 in chips) 
OrionYusupov: posts small blind $0.05
jamalungma: is sitting out 
iamkakaroto: posts big blind $0.10
jamalungma leaves the table
*** HOLE CARDS ***
MihaGr joins the table at seat #6 
aktion4ik: folds 
sexy_seagull: raises $0.20 to $0.30
donkucallme: calls $0.30
OrionYusupov: folds 
iamkakaroto: folds 
*** FLOP *** [Ks Qc 2d]
sexy_seagull: checks 
donkucallme: bets $0.70
sexy_seagull: calls $0.70
*** TURN *** [Ks Qc 2d] [Kc]
sexy_seagull: checks 
donkucallme: bets $2
sexy_seagull: calls $2
*** RIVER *** [Ks Qc 2d Kc] [5h]
sexy_seagull: checks 
donkucallme: bets $5.90
sexy_seagull: calls $5.90
*** SHOW DOWN ***
donkucallme: shows [Kd 3d] (three of a kind, Kings)
sexy_seagull: mucks hand 
donkucallme collected $17.14 from pot
*** SUMMARY ***
Total pot $17.95 | Rake $0.81 
Board [Ks Qc 2d Kc 5h]
Seat 1: iamkakaroto (big blind) folded before Flop
Seat 2: aktion4ik folded before Flop (didn't bet)
Seat 3: sexy_seagull mucked
Seat 4: donkucallme (button) showed [Kd 3d] and won ($17.14) with three of a kind, Kings
Seat 5: OrionYusupov (small blind) folded before Flop



PokerStars Hand #166667393734:  Hold'em No Limit ($0.05/$0.10 USD) - 2017/02/23 16:00:11 ET
Table 'Syringa II' 6-max Seat #2 is the button
Seat 1: GiveTwoMe ($11.41 in chips) 
Seat 2: Cluckh ($10.05 in chips) 
Seat 3: gaHy_HaXeP ($10.78 in chips) 
Seat 4: MBen10 ($10.25 in chips) 
Seat 5: Mishapok196 ($6.85 in chips) 
Seat 6: WinninBikini ($11.31 in chips) 
gaHy_HaXeP: posts small blind $0.05
MBen10: posts big blind $0.10
*** HOLE CARDS ***
Mishapok196: calls $0.10
WinninBikini: folds 
GiveTwoMe: raises $0.20 to $0.30
Cluckh: folds 
gaHy_HaXeP: folds 
MBen10: folds 
Mishapok196: calls $0.20
*** FLOP *** [Ks 7h 3d]
Mishapok196: checks 
GiveTwoMe: checks 
*** TURN *** [Ks 7h 3d] [4d]
Mishapok196: checks 
GiveTwoMe: bets $0.43
Mishapok196: folds 
Uncalled bet ($0.43) returned to GiveTwoMe
GiveTwoMe collected $0.72 from pot
*** SUMMARY ***
Total pot $0.75 | Rake $0.03 
Board [Ks 7h 3d 4d]
Seat 1: GiveTwoMe collected ($0.72)
Seat 2: Cluckh (button) folded before Flop (didn't bet)
Seat 3: gaHy_HaXeP (small blind) folded before Flop
Seat 4: MBen10 (big blind) folded before Flop
Seat 5: Mishapok196 folded on the Turn
Seat 6: WinninBikini folded before Flop (didn't bet)



PokerStars Hand #166667393919:  Hold'em No Limit ($0.05/$0.10 USD) - 2017/02/23 16:00:11 ET
Table 'Geisha' 6-max Seat #1 is the button
Seat 1: facewald ($34.09 in chips) 
Seat 2: voledy ($10 in chips) 
Seat 4: jvstsayyes ($12.96 in chips) 
Seat 5: KRZuff ($15.10 in chips) 
Seat 6: Namhkal ($19.85 in chips) 
voledy: posts small blind $0.05
Polapa D.: is sitting out 
Polapa D. leaves the table
jvstsayyes: posts big blind $0.10
*** HOLE CARDS ***
KRZuff: folds 
Eddys Edge joins the table at seat #3 
Namhkal: folds 
facewald: raises $0.19 to $0.29
voledy: folds 
jvstsayyes: calls $0.19
*** FLOP *** [Jd 3h 2h]
jvstsayyes: checks 
facewald: checks 
*** TURN *** [Jd 3h 2h] [2c]
jvstsayyes: checks 
facewald: bets $0.25
jvstsayyes: calls $0.25
*** RIVER *** [Jd 3h 2h 2c] [6s]
jvstsayyes: checks 
facewald: bets $0.35
jvstsayyes: folds 
Uncalled bet ($0.35) returned to facewald
facewald collected $1.08 from pot
*** SUMMARY ***
Total pot $1.13 | Rake $0.05 
Board [Jd 3h 2h 2c 6s]
Seat 1: facewald (button) collected ($1.08)
Seat 2: voledy (small blind) folded before Flop
Seat 4: jvstsayyes (big blind) folded on the River
Seat 5: KRZuff folded before Flop (didn't bet)
Seat 6: Namhkal folded before Flop (didn't bet)



PokerStars Hand #166667394146:  Hold'em No Limit ($0.05/$0.10 USD) - 2017/02/23 16:00:12 ET
Table 'Huberta II' 6-max Seat #3 is the button
Seat 1: tr41n3r12 ($10 in chips) 
Seat 2: Ice_Isayev ($12.48 in chips) 
Seat 3: patrick19111 ($10 in chips) 
Seat 4: VAD21 ($11.43 in chips) 
Seat 5: Feverhead ($28.28 in chips) 
VAD21: posts small blind $0.05
Feverhead: posts big blind $0.10
*** HOLE CARDS ***
tr41n3r12: folds 
Ice_Isayev: folds 
patrick19111: raises $0.15 to $0.25
VAD21: folds 
Feverhead: raises $0.60 to $0.85
patrick19111: raises $1.45 to $2.30
Feverhead: folds 
Uncalled bet ($1.45) returned to patrick19111
patrick19111 collected $1.75 from pot
*** SUMMARY ***
Total pot $1.75 | Rake $0 
Seat 1: tr41n3r12 folded before Flop (didn't bet)
Seat 2: Ice_Isayev folded before Flop (didn't bet)
Seat 3: patrick19111 (button) collected ($1.75)
Seat 4: VAD21 (small blind) folded before Flop
Seat 5: Feverhead (big blind) folded before Flop



PokerStars Hand #166667394280:  Hold'em No Limit ($0.05/$0.10 USD) - 2017/02/23 16:00:12 ET
Table 'Nauheima II' 6-max Seat #2 is the button
Seat 1: HARDCORE66RU ($17.74 in chips) 
Seat 2: Peter0087 ($9.59 in chips) 
Seat 3: KokoulinV ($13.79 in chips) 
Seat 4: Innerwuss ($10.27 in chips) 
Seat 5: Kow6oy ($10.60 in chips) 
Seat 6: bonyo71 ($5.04 in chips) 
KokoulinV: posts small blind $0.05
Innerwuss: posts big blind $0.10
*** HOLE CARDS ***
Kow6oy: folds 
bonyo71: folds 
HARDCORE66RU: raises $0.20 to $0.30
Peter0087: folds 
KokoulinV: folds 
Innerwuss: folds 
Uncalled bet ($0.20) returned to HARDCORE66RU
HARDCORE66RU collected $0.25 from pot
*** SUMMARY ***
Total pot $0.25 | Rake $0 
Seat 1: HARDCORE66RU collected ($0.25)
Seat 2: Peter0087 (button) folded before Flop (didn't bet)
Seat 3: KokoulinV (small blind) folded before Flop
Seat 4: Innerwuss (big blind) folded before Flop
Seat 5: Kow6oy folded before Flop (didn't bet)
Seat 6: bonyo71 folded before Flop (didn't bet)



PokerStars Hand #166667394412:  Hold'em No Limit ($0.05/$0.10 USD) - 2017/02/23 16:00:12 ET
Table 'Aludra II' 6-max Seat #2 is the button
Seat 1: voledy ($10.15 in chips) 
Seat 2: JahSoldier69 ($10 in chips) 
Seat 3: 2G28 ($11.65 in chips) 
Seat 4: MihaGr ($10 in chips) 
Seat 5: kingartur222 ($16 in chips) 
Seat 6: call me haaa ($15 in chips) 
2G28: posts small blind $0.05
MihaGr: posts big blind $0.10
*** HOLE CARDS ***
kingartur222: folds 
call me haaa: folds 
voledy: folds 
JahSoldier69: raises $0.15 to $0.25
2G28: folds 
MihaGr: calls $0.15
*** FLOP *** [Kh Qh Ad]
MihaGr: checks 
JahSoldier69: bets $0.40
MihaGr: folds 
Uncalled bet ($0.40) returned to JahSoldier69
JahSoldier69 collected $0.53 from pot
*** SUMMARY ***
Total pot $0.55 | Rake $0.02 
Board [Kh Qh Ad]
Seat 1: voledy folded before Flop (didn't bet)
Seat 2: JahSoldier69 (button) collected ($0.53)
Seat 3: 2G28 (small blind) folded before Flop
Seat 4: MihaGr (big blind) folded on the Flop
Seat 5: kingartur222 folded before Flop (didn't bet)
Seat 6: call me haaa folded before Flop (didn't bet)



PokerStars Hand #166667394476:  Hold'em No Limit ($0.05/$0.10 USD) - 2017/02/23 16:00:12 ET
Table 'Vesta II' 6-max Seat #6 is the button
Seat 1: Yabidooo ($12.98 in chips) 
Seat 2: joewatson90 ($8.42 in chips) 
Seat 3: Pokeaster ($12.16 in chips) 
Seat 4: Dcaro31 ($10.42 in chips) 
Seat 5: Andy Wolf ($11.72 in chips) 
Seat 6: CDestructivo ($13.59 in chips) 
Yabidooo: posts small blind $0.05
joewatson90: posts big blind $0.10
*** HOLE CARDS ***
Pokeaster: folds 
Dcaro31: folds 
Andy Wolf: raises $0.20 to $0.30
CDestructivo: folds 
Yabidooo: folds 
joewatson90: folds 
Uncalled bet ($0.20) returned to Andy Wolf
Andy Wolf collected $0.25 from pot
*** SUMMARY ***
Total pot $0.25 | Rake $0 
Seat 1: Yabidooo (small blind) folded before Flop
Seat 2: joewatson90 (big blind) folded before Flop
Seat 3: Pokeaster folded before Flop (didn't bet)
Seat 4: Dcaro31 folded before Flop (didn't bet)
Seat 5: Andy Wolf collected ($0.25)
Seat 6: CDestructivo (button) folded before Flop (didn't bet)



PokerStars Hand #166667394519:  Hold'em No Limit ($0.05/$0.10 USD) - 2017/02/23 16:00:12 ET
Table 'Hyakutake' 6-max Seat #2 is the button
Seat 1: Asilvagoat ($11.22 in chips) 
Seat 2: boxer821 ($10.91 in chips) 
Seat 3: lenboysprite ($10 in chips) 
Seat 4: eniksenik ($10.15 in chips) 
Seat 5: RoJ1 ($12.29 in chips) 
Seat 6: maxiv608 ($13.42 in chips) 
lenboysprite: posts small blind $0.05
eniksenik: posts big blind $0.10
*** HOLE CARDS ***
RoJ1: folds 
maxiv608: folds 
Asilvagoat: folds 
boxer821: raises $0.15 to $0.25
lenboysprite: calls $0.20
eniksenik: raises $0.95 to $1.20
boxer821: folds 
lenboysprite: calls $0.95
*** FLOP *** [7h Ad 8d]
lenboysprite: checks 
eniksenik: checks 
*** TURN *** [7h Ad 8d] [Qh]
lenboysprite: checks 
eniksenik: bets $1.40
lenboysprite: calls $1.40
*** RIVER *** [7h Ad 8d Qh] [7s]
lenboysprite: checks 
eniksenik: checks 
*** SHOW DOWN ***
lenboysprite: shows [5s 5c] (two pair, Sevens and Fives)
eniksenik: shows [Ac Jc] (two pair, Aces and Sevens)
eniksenik collected $5.20 from pot
*** SUMMARY ***
Total pot $5.45 | Rake $0.25 
Board [7h Ad 8d Qh 7s]
Seat 1: Asilvagoat folded before Flop (didn't bet)
Seat 2: boxer821 (button) folded before Flop
Seat 3: lenboysprite (small blind) showed [5s 5c] and lost with two pair, Sevens and Fives
Seat 4: eniksenik (big blind) showed [Ac Jc] and won ($5.20) with two pair, Aces and Sevens
Seat 5: RoJ1 folded before Flop (didn't bet)
Seat 6: maxiv608 folded before Flop (didn't bet)



PokerStars Hand #166667395228:  Hold'em No Limit ($0.05/$0.10 USD) - 2017/02/23 16:00:13 ET
Table 'Rosalia' 6-max Seat #5 is the button
Seat 1: Hyd SK ($10.09 in chips) 
Seat 2: Bandyaev ($10 in chips) 
Seat 3: Andy Wolf ($12.48 in chips) 
Seat 5: miron762 ($10.52 in chips) 
Seat 6: facewald ($17.69 in chips) 
facewald: posts small blind $0.05
Hyd SK: posts big blind $0.10
THIMUCHIN: sits out 
*** HOLE CARDS ***
Bandyaev: raises $0.20 to $0.30
Andy Wolf: folds 
miron762: calls $0.30
facewald: folds 
Hyd SK: folds 
*** FLOP *** [9h Tc 2d]
Bandyaev: bets $0.71
miron762: raises $0.71 to $1.42
Bandyaev: raises $4.09 to $5.51
miron762: folds 
Uncalled bet ($4.09) returned to Bandyaev
Bandyaev collected $3.43 from pot
*** SUMMARY ***
Total pot $3.59 | Rake $0.16 
Board [9h Tc 2d]
Seat 1: Hyd SK (big blind) folded before Flop
Seat 2: Bandyaev collected ($3.43)
Seat 3: Andy Wolf folded before Flop (didn't bet)
Seat 5: miron762 (button) folded on the Flop
Seat 6: facewald (small blind) folded before Flop



PokerStars Hand #166667395374:  Hold'em No Limit ($0.05/$0.10 USD) - 2017/02/23 16:00:13 ET
Table 'Rotraut' 6-max Seat #1 is the button
Seat 1: Hypermetal ($13.34 in chips) 
Seat 2: Newqbrown ($10.83 in chips) 
Seat 4: Darkfrai ($10 in chips) 
Seat 5: Bird et al ($11.75 in chips) 
Seat 6: KokoulinV ($13.14 in chips) 
Newqbrown: posts small blind $0.05
Darkfrai: posts big blind $0.10
*** HOLE CARDS ***
Bird et al: folds 
KokoulinV: folds 
Hypermetal: raises $0.10 to $0.20
Newqbrown: folds 
Darkfrai: folds 
Uncalled bet ($0.10) returned to Hypermetal
Hypermetal collected $0.25 from pot
*** SUMMARY ***
Total pot $0.25 | Rake $0 
Seat 1: Hypermetal (button) collected ($0.25)
Seat 2: Newqbrown (small blind) folded before Flop
Seat 4: Darkfrai (big blind) folded before Flop
Seat 5: Bird et al folded before Flop (didn't bet)
Seat 6: KokoulinV folded before Flop (didn't bet)



PokerStars Hand #166667395407:  Hold'em No Limit ($0.05/$0.10 USD) - 2017/02/23 16:00:13 ET
Table 'Siebohme II' 6-max Seat #5 is the button
Seat 1: homelessdan ($18.27 in chips) 
Seat 2: townerz1991 ($14.52 in chips) 
Seat 4: POT_TRADER ($12.14 in chips) 
Seat 5: NvR.m1nD ($10 in chips) 
homelessdan: posts small blind $0.05
townerz1991: posts big blind $0.10
D3NyA: sits out 
*** HOLE CARDS ***
Fozzy690 joins the table at seat #6 
POT_TRADER: folds 
NvR.m1nD: raises $0.15 to $0.25
homelessdan: folds 
townerz1991: folds 
Uncalled bet ($0.15) returned to NvR.m1nD
NvR.m1nD collected $0.25 from pot
*** SUMMARY ***
Total pot $0.25 | Rake $0 
Seat 1: homelessdan (small blind) folded before Flop
Seat 2: townerz1991 (big blind) folded before Flop
Seat 4: POT_TRADER folded before Flop (didn't bet)
Seat 5: NvR.m1nD (button) collected ($0.25)



PokerStars Hand #166667395667:  Hold'em No Limit ($0.05/$0.10 USD) - 2017/02/23 16:00:14 ET
Table 'Tristan III' 6-max Seat #1 is the button
Seat 1: CHRO8 ($20.35 in chips) 
Seat 2: Hyd SK ($15.68 in chips) 
Seat 3: fedorka rus ($13.05 in chips) 
Seat 4: Feverhead ($11.28 in chips) 
Seat 5: david_sara83 ($10.76 in chips) 
Seat 6: joewatson90 ($8.46 in chips) 
Hyd SK: posts small blind $0.05
fedorka rus: posts big blind $0.10
*** HOLE CARDS ***
Feverhead: folds 
david_sara83: folds 
joewatson90: folds 
CHRO8: folds 
Hyd SK: folds 
Uncalled bet ($0.05) returned to fedorka rus
fedorka rus collected $0.10 from pot
*** SUMMARY ***
Total pot $0.10 | Rake $0 
Seat 1: CHRO8 (button) folded before Flop (didn't bet)
Seat 2: Hyd SK (small blind) folded before Flop
Seat 3: fedorka rus (big blind) collected ($0.10)
Seat 4: Feverhead folded before Flop (didn't bet)
Seat 5: david_sara83 folded before Flop (didn't bet)
Seat 6: joewatson90 folded before Flop (didn't bet)



PokerStars Hand #166667395721:  Hold'em No Limit ($0.05/$0.10 USD) - 2017/02/23 16:00:14 ET
Table 'Fechtig III' 6-max Seat #1 is the button
Seat 1: Scanner17 ($10 in chips) 
Seat 2: GV82 ($14.97 in chips) 
Seat 3: eniksenik ($10 in chips) 
Seat 5: ksandr_hom ($10 in chips) 
Seat 6: Glatzemandse ($20.50 in chips) 
GV82: posts small blind $0.05
eniksenik: posts big blind $0.10
kickereens: sits out 
*** HOLE CARDS ***
ksandr_hom: folds 
Glatzemandse: folds 
Scanner17: folds 
GV82: folds 
Uncalled bet ($0.05) returned to eniksenik
eniksenik collected $0.10 from pot
*** SUMMARY ***
Total pot $0.10 | Rake $0 
Seat 1: Scanner17 (button) folded before Flop (didn't bet)
Seat 2: GV82 (small blind) folded before Flop
Seat 3: eniksenik (big blind) collected ($0.10)
Seat 5: ksandr_hom folded before Flop (didn't bet)
Seat 6: Glatzemandse folded before Flop (didn't bet)



PokerStars Hand #166667395951:  Hold'em No Limit ($0.05/$0.10 USD) - 2017/02/23 16:00:14 ET
Table 'Lederle' 6-max Seat #5 is the button
Seat 1: D3NyA ($10 in chips) 
Seat 2: truck1234 ($16 in chips) 
Seat 3: Kazacha ($10 in chips) 
Seat 4: Pokeaster ($13.76 in chips) 
Seat 5: 8th wonders ($12.91 in chips) 
D3NyA: posts small blind $0.05
truck1234: posts big blind $0.10
*** HOLE CARDS ***
Kazacha: folds 
Pokeaster: folds 
8th wonders: folds 
D3NyA: folds 
Uncalled bet ($0.05) returned to truck1234
truck1234 collected $0.10 from pot
*** SUMMARY ***
Total pot $0.10 | Rake $0 
Seat 1: D3NyA (small blind) folded before Flop
Seat 2: truck1234 (big blind) collected ($0.10)
Seat 3: Kazacha folded before Flop (didn't bet)
Seat 4: Pokeaster folded before Flop (didn't bet)
Seat 5: 8th wonders (button) folded before Flop (didn't bet)



PokerStars Hand #166667396614:  Hold'em No Limit ($0.05/$0.10 USD) - 2017/02/23 16:00:15 ET
Table 'Lacroute' 6-max Seat #6 is the button
Seat 1: johnnyPieper ($8.68 in chips) 
Seat 2: Andy Wolf ($10.20 in chips) 
Seat 3: Croplayer1 ($10.95 in chips) 
Seat 4: st4tion ($16.06 in chips) 
Seat 5: steepfell ($11.42 in chips) 
Seat 6: IAntikI ($10 in chips) 
johnnyPieper: posts small blind $0.05
Andy Wolf: posts big blind $0.10
*** HOLE CARDS ***
Croplayer1: folds 
st4tion: folds 
steepfell: folds 
IAntikI: raises $0.15 to $0.25
johnnyPieper: calls $0.20
Andy Wolf: folds 
*** FLOP *** [8h 2h 8c]
johnnyPieper: bets $0.10
IAntikI: folds 
Uncalled bet ($0.10) returned to johnnyPieper
johnnyPieper collected $0.57 from pot
*** SUMMARY ***
Total pot $0.60 | Rake $0.03 
Board [8h 2h 8c]
Seat 1: johnnyPieper (small blind) collected ($0.57)
Seat 2: Andy Wolf (big blind) folded before Flop
Seat 3: Croplayer1 folded before Flop (didn't bet)
Seat 4: st4tion folded before Flop (didn't bet)
Seat 5: steepfell folded before Flop (didn't bet)
Seat 6: IAntikI (button) folded on the Flop



PokerStars Hand #166667396947:  Hold'em No Limit ($0.05/$0.10 USD) - 2017/02/23 16:00:15 ET
Table 'Stroobantia II' 6-max Seat #2 is the button
Seat 1: XBrosh ($8.18 in chips) 
Seat 2: IAntikI ($10 in chips) 
Seat 3: 8th wonders ($10.93 in chips) 
Seat 4: Xander188 ($10.63 in chips) 
Seat 5: Zooplack ($12.48 in chips) 
Seat 6: CHRO8 ($11.52 in chips) 
8th wonders: posts small blind $0.05
Xander188: posts big blind $0.10
*** HOLE CARDS ***
Zooplack: folds 
CHRO8: folds 
XBrosh: folds 
IAntikI: raises $0.15 to $0.25
8th wonders: folds 
Xander188: calls $0.15
*** FLOP *** [6s Js Tc]
Xander188: checks 
IAntikI: checks 
*** TURN *** [6s Js Tc] [Kd]
Xander188: bets $0.40
IAntikI: folds 
Uncalled bet ($0.40) returned to Xander188
Xander188 collected $0.53 from pot
*** SUMMARY ***
Total pot $0.55 | Rake $0.02 
Board [6s Js Tc Kd]
Seat 1: XBrosh folded before Flop (didn't bet)
Seat 2: IAntikI (button) folded on the Turn
Seat 3: 8th wonders (small blind) folded before Flop
Seat 4: Xander188 (big blind) collected ($0.53)
Seat 5: Zooplack folded before Flop (didn't bet)
Seat 6: CHRO8 folded before Flop (didn't bet)



PokerStars Hand #166667396949:  Hold'em No Limit ($0.05/$0.10 USD) - 2017/02/23 16:00:15 ET
Table 'Tyndareus III' 6-max Seat #2 is the button
Seat 1: MBen10 ($10 in chips) 
Seat 2: MihaGr ($10 in chips) 
Seat 3: XaXaTyH4uK ($10.20 in chips) 
Seat 4: Therodorus ($11.76 in chips) 
Seat 5: Chodemuncher ($10 in chips) 
Seat 6: Elinaattor ($9.52 in chips) 
XaXaTyH4uK: posts small blind $0.05
Therodorus: posts big blind $0.10
*** HOLE CARDS ***
Chodemuncher: folds 
Elinaattor: folds 
MBen10: folds 
MihaGr: raises $0.20 to $0.30
XaXaTyH4uK: raises $0.70 to $1
Therodorus: folds 
MihaGr: folds 
Uncalled bet ($0.70) returned to XaXaTyH4uK
XaXaTyH4uK collected $0.70 from pot
*** SUMMARY ***
Total pot $0.70 | Rake $0 
Seat 1: MBen10 folded before Flop (didn't bet)
Seat 2: MihaGr (button) folded before Flop
Seat 3: XaXaTyH4uK (small blind) collected ($0.70)
Seat 4: Therodorus (big blind) folded before Flop
Seat 5: Chodemuncher folded before Flop (didn't bet)
Seat 6: Elinaattor folded before Flop (didn't bet)



PokerStars Hand #166667397406:  Hold'em No Limit ($0.05/$0.10 USD) - 2017/02/23 16:00:16 ET
Table 'Aegle' 6-max Seat #3 is the button
Seat 1: steepfell ($11.36 in chips) 
Seat 3: Crafty23@PS ($10 in chips) 
Seat 4: ab260414 ($11.10 in chips) 
Seat 5: KokoulinV ($11.18 in chips) 
Seat 6: CHRO8 ($20.59 in chips) 
ab260414: posts small blind $0.05
KokoulinV: posts big blind $0.10
*** HOLE CARDS ***
CHRO8: folds 
steepfell: folds 
Crafty23@PS: folds 
ab260414: folds 
Uncalled bet ($0.05) returned to KokoulinV
KokoulinV collected $0.10 from pot
*** SUMMARY ***
Total pot $0.10 | Rake $0 
Seat 1: steepfell folded before Flop (didn't bet)
Seat 3: Crafty23@PS (button) folded before Flop (didn't bet)
Seat 4: ab260414 (small blind) folded before Flop
Seat 5: KokoulinV (big blind) collected ($0.10)
Seat 6: CHRO8 folded before Flop (didn't bet)



PokerStars Hand #166667397697:  Hold'em No Limit ($0.05/$0.10 USD) - 2017/02/23 16:00:16 ET
Table 'Peiroos III' 6-max Seat #4 is the button
Seat 3: nabatov.m ($5.76 in chips) 
Seat 4: pivanki11 ($11.19 in chips) 
Seat 5: ChuikaPridi ($9.77 in chips) 
Seat 6: CHRO8 ($9.90 in chips) 
ChuikaPridi: posts small blind $0.05
CHRO8: posts big blind $0.10
tequila_joop: sits out 
nabatov.m: posts the ante $0.02
pivanki11: posts the ante $0.02
ChuikaPridi: posts the ante $0.02
CHRO8: posts the ante $0.02
*** HOLE CARDS ***
nabatov.m: folds 
pivanki11: folds 
ChuikaPridi: folds 
Uncalled bet ($0.05) returned to CHRO8
CHRO8 collected $0.18 from pot
*** SUMMARY ***
Total pot $0.18 | Rake $0 
Seat 3: nabatov.m folded before Flop (didn't bet)
Seat 4: pivanki11 (button) folded before Flop (didn't bet)
Seat 5: ChuikaPridi (small blind) folded before Flop
Seat 6: CHRO8 (big blind) collected ($0.18)



PokerStars Hand #166667397911:  Hold'em No Limit ($0.05/$0.10 USD) - 2017/02/23 16:00:16 ET
Table 'Walpurga' 6-max Seat #1 is the button
Seat 1: chimera252 ($11.11 in chips) 
Seat 3: Innerwuss ($19.29 in chips) 
Seat 4: oddshoff ($12.89 in chips) 
Innerwuss: posts small blind $0.05
oddshoff: posts big blind $0.10
*** HOLE CARDS ***
chimera252: raises $0.15 to $0.25
maxt92 is disconnected 
Czezar Life joins the table at seat #6 
paxit71 joins the table at seat #2 
Czezar Life leaves the table
AIONCMA1988 joins the table at seat #6 
Innerwuss has timed out
Innerwuss: folds 
oddshoff: folds 
Uncalled bet ($0.15) returned to chimera252
chimera252 collected $0.25 from pot
*** SUMMARY ***
Total pot $0.25 | Rake $0 
Seat 1: chimera252 (button) collected ($0.25)
Seat 3: Innerwuss (small blind) folded before Flop
Seat 4: oddshoff (big blind) folded before Flop



PokerStars Hand #166667398118:  Hold'em No Limit ($0.05/$0.10 USD) - 2017/02/23 16:00:17 ET
Table 'Union' 6-max Seat #3 is the button
Seat 1: Krumi1703 ($6.42 in chips) 
Seat 2: Zooplack ($10 in chips) 
Seat 3: Rodik002 ($12.01 in chips) 
Seat 4: Croplayer1 ($14.21 in chips) 
Seat 5: Chodemuncher ($10 in chips) 
Seat 6: bonyo71 ($4 in chips) 
Croplayer1: posts small blind $0.05
Chodemuncher: posts big blind $0.10
*** HOLE CARDS ***
bonyo71: folds 
Krumi1703: folds 
Zooplack: folds 
Rodik002: raises $0.10 to $0.20
Croplayer1: folds 
Chodemuncher: folds 
Uncalled bet ($0.10) returned to Rodik002
Rodik002 collected $0.25 from pot
*** SUMMARY ***
Total pot $0.25 | Rake $0 
Seat 1: Krumi1703 folded before Flop (didn't bet)
Seat 2: Zooplack folded before Flop (didn't bet)
Seat 3: Rodik002 (button) collected ($0.25)
Seat 4: Croplayer1 (small blind) folded before Flop
Seat 5: Chodemuncher (big blind) folded before Flop
Seat 6: bonyo71 folded before Flop (didn't bet)



PokerStars Hand #166667398173:  Hold'em No Limit ($0.05/$0.10 USD) - 2017/02/23 16:00:17 ET
Table 'Hamal II' 6-max Seat #5 is the button
Seat 1: saxoalto2011 ($8.64 in chips) 
Seat 2: pancernik21 ($10 in chips) 
Seat 3: Cluckh ($11.69 in chips) 
Seat 4: ArcticBearDK ($10 in chips) 
Seat 5: AIONCMA1988 ($6.38 in chips) 
Seat 6: LarryTheStar ($10.29 in chips) 
LarryTheStar: posts small blind $0.05
saxoalto2011: posts big blind $0.10
*** HOLE CARDS ***
pancernik21: raises $0.20 to $0.30
Cluckh: folds 
ArcticBearDK: raises $0.60 to $0.90
AIONCMA1988: folds 
LarryTheStar: folds 
saxoalto2011: folds 
pancernik21: calls $0.60
*** FLOP *** [4s 8d Kd]
pancernik21: checks 
AIONCMA1988 leaves the table
ArcticBearDK: checks 
*** TURN *** [4s 8d Kd] [Ts]
pancernik21: checks 
ArcticBearDK: bets $1.10
pancernik21: folds 
Uncalled bet ($1.10) returned to ArcticBearDK
ArcticBearDK collected $1.86 from pot
*** SUMMARY ***
Total pot $1.95 | Rake $0.09 
Board [4s 8d Kd Ts]
Seat 1: saxoalto2011 (big blind) folded before Flop
Seat 2: pancernik21 folded on the Turn
Seat 3: Cluckh folded before Flop (didn't bet)
Seat 4: ArcticBearDK collected ($1.86)
Seat 5: AIONCMA1988 (button) folded before Flop (didn't bet)
Seat 6: LarryTheStar (small blind) folded before Flop



PokerStars Hand #166667398619:  Hold'em No Limit ($0.05/$0.10 USD) - 2017/02/23 16:00:17 ET
Table 'Scabiosa III' 6-max Seat #5 is the button
Seat 1: Feverhead ($13.41 in chips) 
Seat 2: kinaó ($9.36 in chips) 
Seat 3: Goroshkos88 ($11.25 in chips) 
Seat 4: voledy ($10 in chips) 
Seat 5: patrick19111 ($24.75 in chips) 
Seat 6: Smitty03300 ($11.95 in chips) 
Smitty03300: posts small blind $0.05
Feverhead: posts big blind $0.10
*** HOLE CARDS ***
kinaó: folds 
Goroshkos88: raises $0.20 to $0.30
voledy: folds 
patrick19111: folds 
Smitty03300: folds 
Feverhead: folds 
Uncalled bet ($0.20) returned to Goroshkos88
Goroshkos88 collected $0.25 from pot
*** SUMMARY ***
Total pot $0.25 | Rake $0 
Seat 1: Feverhead (big blind) folded before Flop
Seat 2: kinaó folded before Flop (didn't bet)
Seat 3: Goroshkos88 collected ($0.25)
Seat 4: voledy folded before Flop (didn't bet)
Seat 5: patrick19111 (button) folded before Flop (didn't bet)
Seat 6: Smitty03300 (small blind) folded before Flop



PokerStars Hand #166667398811:  Hold'em No Limit ($0.05/$0.10 USD) - 2017/02/23 16:00:18 ET
Table 'Postrema' 6-max Seat #6 is the button
Seat 1: CHRO8 ($9.99 in chips) 
Seat 2: pancernik21 ($12.76 in chips) 
Seat 3: edcc19 ($2.92 in chips) 
Seat 4: ChuikaPridi ($13.48 in chips) 
Seat 5: Comeback3392 ($10.51 in chips) 
Seat 6: Scanner17 ($10 in chips) 
CHRO8: posts small blind $0.05
pancernik21: posts big blind $0.10
*** HOLE CARDS ***
edcc19: calls $0.10
ChuikaPridi: folds 
Comeback3392: folds 
Scanner17: folds 
CHRO8: folds 
pancernik21: checks 
*** FLOP *** [Tc Ac 3c]
pancernik21: checks 
edcc19: checks 
*** TURN *** [Tc Ac 3c] [9h]
pancernik21: checks 
edcc19: checks 
*** RIVER *** [Tc Ac 3c 9h] [5c]
pancernik21: checks 
edcc19: checks 
*** SHOW DOWN ***
pancernik21: shows [8s 6d] (high card Ace)
edcc19: shows [Ad 4s] (a pair of Aces)
edcc19 collected $0.24 from pot
*** SUMMARY ***
Total pot $0.25 | Rake $0.01 
Board [Tc Ac 3c 9h 5c]
Seat 1: CHRO8 (small blind) folded before Flop
Seat 2: pancernik21 (big blind) showed [8s 6d] and lost with high card Ace
Seat 3: edcc19 showed [Ad 4s] and won ($0.24) with a pair of Aces
Seat 4: ChuikaPridi folded before Flop (didn't bet)
Seat 5: Comeback3392 folded before Flop (didn't bet)
Seat 6: Scanner17 (button) folded before Flop (didn't bet)



PokerStars Hand #166667398951:  Hold'em No Limit ($0.05/$0.10 USD) - 2017/02/23 16:00:18 ET
Table 'Aconcagua' 6-max Seat #4 is the button
Seat 3: RkaczoR ($11.47 in chips) 
Seat 4: pivanki11 ($8.88 in chips) 
Seat 5: frazaunch ($8.18 in chips) 
Seat 6: coolisses111 ($9.96 in chips) 
frazaunch: posts small blind $0.05
coolisses111: posts big blind $0.10
RkaczoR: posts the ante $0.02
pivanki11: posts the ante $0.02
frazaunch: posts the ante $0.02
coolisses111: posts the ante $0.02
*** HOLE CARDS ***
RkaczoR: raises $0.15 to $0.25
pivanki11: calls $0.25
frazaunch: calls $0.20
coolisses111: folds 
*** FLOP *** [2h 2d 8d]
frazaunch: checks 
RkaczoR: bets $0.48
pivanki11: folds 
frazaunch: calls $0.48
*** TURN *** [2h 2d 8d] [5c]
frazaunch: checks 
RkaczoR: checks 
*** RIVER *** [2h 2d 8d 5c] [7s]
frazaunch: bets $0.30
RkaczoR: calls $0.30
*** SHOW DOWN ***
frazaunch: shows [Ad Jd] (a pair of Deuces)
RkaczoR: shows [9c 7c] (two pair, Sevens and Deuces)
RkaczoR collected $2.38 from pot
*** SUMMARY ***
Total pot $2.49 | Rake $0.11 
Board [2h 2d 8d 5c 7s]
Seat 3: RkaczoR showed [9c 7c] and won ($2.38) with two pair, Sevens and Deuces
Seat 4: pivanki11 (button) folded on the Flop
Seat 5: frazaunch (small blind) showed [Ad Jd] and lost with a pair of Deuces
Seat 6: coolisses111 (big blind) folded before Flop



PokerStars Hand #166667398984:  Hold'em No Limit ($0.05/$0.10 USD) - 2017/02/23 16:00:18 ET
Table 'Kochera' 6-max Seat #4 is the button
Seat 1: chimera252 ($11.65 in chips) 
Seat 2: bartabs2 ($10.76 in chips) 
Seat 3: KA3AXCTAHEU, ($10 in chips) 
Seat 4: johkom ($5.31 in chips) 
Seat 5: univibe68 ($11.90 in chips) 
Seat 6: oddshoff ($9.48 in chips) 
univibe68: posts small blind $0.05
oddshoff: posts big blind $0.10
*** HOLE CARDS ***
chimera252: folds 
bartabs2: folds 
KA3AXCTAHEU,: folds 
johkom: folds 
univibe68: raises $0.20 to $0.30
oddshoff: folds 
Uncalled bet ($0.20) returned to univibe68
univibe68 collected $0.20 from pot
*** SUMMARY ***
Total pot $0.20 | Rake $0 
Seat 1: chimera252 folded before Flop (didn't bet)
Seat 2: bartabs2 folded before Flop (didn't bet)
Seat 3: KA3AXCTAHEU, folded before Flop (didn't bet)
Seat 4: johkom (button) folded before Flop (didn't bet)
Seat 5: univibe68 (small blind) collected ($0.20)
Seat 6: oddshoff (big blind) folded before Flop



PokerStars Hand #166667399556:  Hold'em No Limit ($0.05/$0.10 USD) - 2017/02/23 16:00:18 ET
Table 'Tomita II' 6-max Seat #2 is the button
Seat 1: HARDCORE66RU ($24.88 in chips) 
Seat 2: mhonielsen ($10 in chips) 
Seat 3: Lucky HoBBiT ($10 in chips) 
Seat 4: Hyd SK ($10 in chips) 
Seat 6: Punzzzer ($12.36 in chips) 
Lucky HoBBiT: posts small blind $0.05
Hyd SK: posts big blind $0.10
*** HOLE CARDS ***
Punzzzer: folds 
HARDCORE66RU: raises $0.20 to $0.30
mhonielsen: folds 
Lucky HoBBiT is connected 
Lucky HoBBiT: calls $0.25
Hyd SK: folds 
*** FLOP *** [2s 5c 4c]
Lucky HoBBiT: checks 
HARDCORE66RU: bets $0.50
Lucky HoBBiT: calls $0.50
*** TURN *** [2s 5c 4c] [5d]
Lucky HoBBiT: checks 
HARDCORE66RU: bets $1.30
Lucky HoBBiT: raises $1.30 to $2.60
HARDCORE66RU: folds 
Uncalled bet ($1.30) returned to Lucky HoBBiT
Lucky HoBBiT collected $4.11 from pot
*** SUMMARY ***
Total pot $4.30 | Rake $0.19 
Board [2s 5c 4c 5d]
Seat 1: HARDCORE66RU folded on the Turn
Seat 2: mhonielsen (button) folded before Flop (didn't bet)
Seat 3: Lucky HoBBiT (small blind) collected ($4.11)
Seat 4: Hyd SK (big blind) folded before Flop
Seat 6: Punzzzer folded before Flop (didn't bet)



PokerStars Hand #166667399835:  Hold'em No Limit ($0.05/$0.10 USD) - 2017/02/23 16:00:19 ET
Table 'Laetitia II' 6-max Seat #3 is the button
Seat 1: Cluckh ($12.18 in chips) 
Seat 2: manashov ($10.37 in chips) 
Seat 3: 6ePeMeHHa9 ($10 in chips) 
Seat 4: Feverhead ($16.86 in chips) 
Seat 5: D3NyA ($17.08 in chips) 
Seat 6: Dima91360 ($3.61 in chips) 
Feverhead: posts small blind $0.05
D3NyA: posts big blind $0.10
*** HOLE CARDS ***
Dima91360: raises $0.30 to $0.40
Cluckh: folds 
manashov: folds 
6ePeMeHHa9: folds 
Feverhead: folds 
D3NyA: folds 
Uncalled bet ($0.30) returned to Dima91360
Dima91360 collected $0.25 from pot
*** SUMMARY ***
Total pot $0.25 | Rake $0 
Seat 1: Cluckh folded before Flop (didn't bet)
Seat 2: manashov folded before Flop (didn't bet)
Seat 3: 6ePeMeHHa9 (button) folded before Flop (didn't bet)
Seat 4: Feverhead (small blind) folded before Flop
Seat 5: D3NyA (big blind) folded before Flop
Seat 6: Dima91360 collected ($0.25)



PokerStars Hand #166667399840:  Hold'em No Limit ($0.05/$0.10 USD) - 2017/02/23 16:00:19 ET
Table 'Martha' 6-max Seat #4 is the button
Seat 1: Peter0087 ($10.30 in chips) 
Seat 2: pauli95 ($7.41 in chips) 
Seat 3: Hyd SK ($12.11 in chips) 
Seat 4: dittoro ($10.84 in chips) 
Seat 6: 8th wonders ($10.05 in chips) 
8th wonders: posts small blind $0.05
Peter0087: posts big blind $0.10
*** HOLE CARDS ***
pauli95: folds 
Hyd SK: folds 
dittoro: folds 
8th wonders: raises $0.20 to $0.30
Peter0087: calls $0.20
*** FLOP *** [Kd 5h 7d]
8th wonders: bets $0.20
MihaGr joins the table at seat #5 
Peter0087: calls $0.20
*** TURN *** [Kd 5h 7d] [5d]
8th wonders: checks 
Peter0087: bets $0.48
8th wonders: folds 
Uncalled bet ($0.48) returned to Peter0087
Peter0087 collected $0.96 from pot
*** SUMMARY ***
Total pot $1 | Rake $0.04 
Board [Kd 5h 7d 5d]
Seat 1: Peter0087 (big blind) collected ($0.96)
Seat 2: pauli95 folded before Flop (didn't bet)
Seat 3: Hyd SK folded before Flop (didn't bet)
Seat 4: dittoro (button) folded before Flop (didn't bet)
Seat 6: 8th wonders (small blind) folded on the Turn



PokerStars Hand #166667399870:  Hold'em No Limit ($0.05/$0.10 USD) - 2017/02/23 16:00:19 ET
Table 'Amalia' 6-max Seat #2 is the button
Seat 1: voledy ($12.99 in chips) 
Seat 2: DamDatsAnAce ($10.15 in chips) 
Seat 3: kickereens ($10 in chips) 
Seat 4: Rodik002 ($16.53 in chips) 
Seat 5: coolisses111 ($10 in chips) 
Seat 6: oktomber778 ($24.74 in chips) 
kickereens: posts small blind $0.05
Rodik002: posts big blind $0.10
*** HOLE CARDS ***
coolisses111: folds 
oktomber778: calls $0.10
voledy: folds 
DamDatsAnAce: raises $0.35 to $0.45
kickereens: folds 
Rodik002: folds 
oktomber778: calls $0.35
*** FLOP *** [4h Qh 6d]
oktomber778: checks 
DamDatsAnAce: bets $0.65
oktomber778: folds 
Uncalled bet ($0.65) returned to DamDatsAnAce
DamDatsAnAce collected $1 from pot
*** SUMMARY ***
Total pot $1.05 | Rake $0.05 
Board [4h Qh 6d]
Seat 1: voledy folded before Flop (didn't bet)
Seat 2: DamDatsAnAce (button) collected ($1)
Seat 3: kickereens (small blind) folded before Flop
Seat 4: Rodik002 (big blind) folded before Flop
Seat 5: coolisses111 folded before Flop (didn't bet)
Seat 6: oktomber778 folded on the Flop



PokerStars Hand #166667400009:  Hold'em No Limit ($0.05/$0.10 USD) - 2017/02/23 16:00:19 ET
Table 'Themisto II' 6-max Seat #5 is the button
Seat 1: kickereens ($12.63 in chips) 
Seat 2: CA225 ($8.77 in chips) 
Seat 3: eniksenik ($11.21 in chips) 
Seat 4: Innerwuss ($11.19 in chips) 
Seat 5: ex3Lero86 ($10.94 in chips) 
Seat 6: noobigrok ($4.80 in chips) 
noobigrok: posts small blind $0.05
kickereens: posts big blind $0.10
*** HOLE CARDS ***
CA225: folds 
eniksenik: folds 
Innerwuss has timed out
Innerwuss: folds 
ex3Lero86: folds 
noobigrok: calls $0.05
kickereens: checks 
*** FLOP *** [Ah Jc 2d]
noobigrok: checks 
kickereens: checks 
*** TURN *** [Ah Jc 2d] [3h]
noobigrok: bets $0.10
kickereens: calls $0.10
*** RIVER *** [Ah Jc 2d 3h] [Kh]
noobigrok: checks 
kickereens: bets $0.60
noobigrok: calls $0.60
*** SHOW DOWN ***
kickereens: shows [7h Th] (a flush, Ace high)
noobigrok: mucks hand 
kickereens collected $1.53 from pot
*** SUMMARY ***
Total pot $1.60 | Rake $0.07 
Board [Ah Jc 2d 3h Kh]
Seat 1: kickereens (big blind) showed [7h Th] and won ($1.53) with a flush, Ace high
Seat 2: CA225 folded before Flop (didn't bet)
Seat 3: eniksenik folded before Flop (didn't bet)
Seat 4: Innerwuss folded before Flop (didn't bet)
Seat 5: ex3Lero86 (button) folded before Flop (didn't bet)
Seat 6: noobigrok (small blind) mucked



PokerStars Hand #166667400438:  Hold'em No Limit ($0.05/$0.10 USD) - 2017/02/23 16:00:20 ET
Table 'Cyane' 6-max Seat #3 is the button
Seat 1: KA3AXCTAHEU, ($10.47 in chips) 
Seat 2: Temniy Elf ($10 in chips) 
Seat 3: Mamm0nism ($14.09 in chips) 
Seat 4: truck1234 ($21.01 in chips) 
Seat 5: ChuikaPridi ($10.17 in chips) 
Seat 6: 8th wonders ($10.15 in chips) 
truck1234: posts small blind $0.05
ChuikaPridi: posts big blind $0.10
*** HOLE CARDS ***
8th wonders: folds 
KA3AXCTAHEU,: folds 
Temniy Elf: folds 
Mamm0nism: folds 
truck1234: folds 
Uncalled bet ($0.05) returned to ChuikaPridi
ChuikaPridi collected $0.10 from pot
*** SUMMARY ***
Total pot $0.10 | Rake $0 
Seat 1: KA3AXCTAHEU, folded before Flop (didn't bet)
Seat 2: Temniy Elf folded before Flop (didn't bet)
Seat 3: Mamm0nism (button) folded before Flop (didn't bet)
Seat 4: truck1234 (small blind) folded before Flop
Seat 5: ChuikaPridi (big blind) collected ($0.10)
Seat 6: 8th wonders folded before Flop (didn't bet)



PokerStars Hand #166667400800:  Hold'em No Limit ($0.05/$0.10 USD) - 2017/02/23 16:00:20 ET
Table 'Pyrrhus III' 6-max Seat #3 is the button
Seat 1: skatejeff ($17.26 in chips) 
Seat 2: univibe68 ($20.86 in chips) 
Seat 3: coolisses111 ($9.81 in chips) 
Seat 4: ex3Lero86 ($11.93 in chips) 
Seat 5: mAEgar ($5.19 in chips) 
Seat 6: MLPlayer16 ($19.35 in chips) 
ex3Lero86: posts small blind $0.05
mAEgar: posts big blind $0.10
skatejeff: posts the ante $0.02
univibe68: posts the ante $0.02
coolisses111: posts the ante $0.02
ex3Lero86: posts the ante $0.02
mAEgar: posts the ante $0.02
MLPlayer16: posts the ante $0.02
*** HOLE CARDS ***
MLPlayer16: raises $0.15 to $0.25
skatejeff: calls $0.25
univibe68: calls $0.25
coolisses111: folds 
ex3Lero86: folds 
mAEgar: folds 
*** FLOP *** [Qh Ts 3c]
MLPlayer16: bets $0.53
skatejeff: folds 
univibe68: folds 
Uncalled bet ($0.53) returned to MLPlayer16
MLPlayer16 collected $0.97 from pot
*** SUMMARY ***
Total pot $1.02 | Rake $0.05 
Board [Qh Ts 3c]
Seat 1: skatejeff folded on the Flop
Seat 2: univibe68 folded on the Flop
Seat 3: coolisses111 (button) folded before Flop (didn't bet)
Seat 4: ex3Lero86 (small blind) folded before Flop
Seat 5: mAEgar (big blind) folded before Flop
Seat 6: MLPlayer16 collected ($0.97)



PokerStars Hand #166667400867:  Hold'em No Limit ($0.05/$0.10 USD) - 2017/02/23 16:00:20 ET
Table 'Nikko II' 6-max Seat #1 is the button
Seat 1: bdixon_5 ($9.85 in chips) 
Seat 2: popypaleta ($10 in chips) 
Seat 3: Hyd SK ($10.40 in chips) 
Seat 4: Peter0087 ($9.99 in chips) 
Seat 5: Aescul@pius ($11.07 in chips) 
popypaleta: posts small blind $0.05
Hyd SK: posts big blind $0.10
*** HOLE CARDS ***
Peter0087: folds 
Aescul@pius: folds 
bdixon_5: folds 
popypaleta: folds 
Uncalled bet ($0.05) returned to Hyd SK
Hyd SK collected $0.10 from pot
*** SUMMARY ***
Total pot $0.10 | Rake $0 
Seat 1: bdixon_5 (button) folded before Flop (didn't bet)
Seat 2: popypaleta (small blind) folded before Flop
Seat 3: Hyd SK (big blind) collected ($0.10)
Seat 4: Peter0087 folded before Flop (didn't bet)
Seat 5: Aescul@pius folded before Flop (didn't bet)



PokerStars Hand #166667400968:  Hold'em No Limit ($0.05/$0.10 USD) - 2017/02/23 16:00:20 ET
Table 'Emma II' 6-max Seat #5 is the button
Seat 1: LarryTheStar ($10.15 in chips) 
Seat 3: oddshoff ($9.97 in chips) 
Seat 4: Jucatorul823 ($5.97 in chips) 
Seat 5: Scanner17 ($10.15 in chips) 
Seat 6: CHRO8 ($14.87 in chips) 
CHRO8: posts small blind $0.05
LarryTheStar: posts big blind $0.10
T9MS: sits out 
*** HOLE CARDS ***
oddshoff: folds 
Jucatorul823: folds 
Scanner17: raises $0.15 to $0.25
CHRO8: folds 
LarryTheStar: calls $0.15
*** FLOP *** [9h Qs 5s]
LarryTheStar: checks 
Scanner17: bets $0.40
LarryTheStar: calls $0.40
*** TURN *** [9h Qs 5s] [3d]
LarryTheStar: checks 
Scanner17: bets $1
LarryTheStar: folds 
Uncalled bet ($1) returned to Scanner17
Scanner17 collected $1.29 from pot
*** SUMMARY ***
Total pot $1.35 | Rake $0.06 
Board [9h Qs 5s 3d]
Seat 1: LarryTheStar (big blind) folded on the Turn
Seat 3: oddshoff folded before Flop (didn't bet)
Seat 4: Jucatorul823 folded before Flop (didn't bet)
Seat 5: Scanner17 (button) collected ($1.29)
Seat 6: CHRO8 (small blind) folded before Flop



PokerStars Hand #166667401873:  Hold'em No Limit ($0.05/$0.10 USD) - 2017/02/23 16:00:21 ET
Table 'Antinous' 6-max Seat #5 is the button
Seat 1: Andrei ProFF ($16.36 in chips) 
Seat 2: Nr847 ($10.39 in chips) 
Seat 3: dittoro ($10 in chips) 
Seat 4: Pekaml ($15.54 in chips) 
Seat 5: Covetsoles ($6.34 in chips) 
Andrei ProFF: posts small blind $0.05
Nr847: posts big blind $0.10
*** HOLE CARDS ***
dittoro: folds 
Pekaml: folds 
Covetsoles: folds 
Andrei ProFF: raises $0.20 to $0.30
BAHEK163RUS leaves the table
Nr847: calls $0.20
*** FLOP *** [8c 9c 4c]
coolisses111 joins the table at seat #6 
Andrei ProFF: checks 
Nr847: bets $0.38
Andrei ProFF: folds 
Uncalled bet ($0.38) returned to Nr847
Nr847 collected $0.57 from pot
*** SUMMARY ***
Total pot $0.60 | Rake $0.03 
Board [8c 9c 4c]
Seat 1: Andrei ProFF (small blind) folded on the Flop
Seat 2: Nr847 (big blind) collected ($0.57)
Seat 3: dittoro folded before Flop (didn't bet)
Seat 4: Pekaml folded before Flop (didn't bet)
Seat 5: Covetsoles (button) folded before Flop (didn't bet)



PokerStars Hand #166667402108:  Hold'em No Limit ($0.05/$0.10 USD) - 2017/02/23 16:00:22 ET
Table 'Arduina' 6-max Seat #6 is the button
Seat 1: kickereens ($21.29 in chips) 
Seat 2: Andy Wolf ($11.87 in chips) 
Seat 3: Dcaro31 ($13.26 in chips) 
Seat 4: ChuikaPridi ($30.88 in chips) 
Seat 5: ettedallas ($5.81 in chips) 
Seat 6: dierri ($9.30 in chips) 
kickereens: posts small blind $0.05
Andy Wolf: posts big blind $0.10
*** HOLE CARDS ***
Dcaro31: folds 
ChuikaPridi: folds 
ettedallas: raises $0.25 to $0.35
dierri: raises $0.25 to $0.60
kickereens: folds 
Andy Wolf: folds 
ettedallas: calls $0.25
*** FLOP *** [3h 8s 2h]
ettedallas: checks 
dierri: bets $1
ettedallas: folds 
Uncalled bet ($1) returned to dierri
dierri collected $1.29 from pot
*** SUMMARY ***
Total pot $1.35 | Rake $0.06 
Board [3h 8s 2h]
Seat 1: kickereens (small blind) folded before Flop
Seat 2: Andy Wolf (big blind) folded before Flop
Seat 3: Dcaro31 folded before Flop (didn't bet)
Seat 4: ChuikaPridi folded before Flop (didn't bet)
Seat 5: ettedallas folded on the Flop
Seat 6: dierri (button) collected ($1.29)



PokerStars Hand #166667402220:  Hold'em No Limit ($0.05/$0.10 USD) - 2017/02/23 16:00:22 ET
Table 'Serpens' 6-max Seat #5 is the button
Seat 1: Namhkal ($10 in chips) 
Seat 2: KA3AXCTAHEU, ($10.28 in chips) 
Seat 3: homelessdan ($28.50 in chips) 
Seat 4: Ragazzi3 ($17.19 in chips) 
Seat 5: XwinX25 ($11.81 in chips) 
Seat 6: Croplayer1 ($10 in chips) 
Croplayer1: posts small blind $0.05
Namhkal: posts big blind $0.10
*** HOLE CARDS ***
KA3AXCTAHEU,: raises $0.15 to $0.25
homelessdan: folds 
Ragazzi3: folds 
XwinX25: folds 
Croplayer1: folds 
Namhkal: folds 
Uncalled bet ($0.15) returned to KA3AXCTAHEU,
KA3AXCTAHEU, collected $0.25 from pot
*** SUMMARY ***
Total pot $0.25 | Rake $0 
Seat 1: Namhkal (big blind) folded before Flop
Seat 2: KA3AXCTAHEU, collected ($0.25)
Seat 3: homelessdan folded before Flop (didn't bet)
Seat 4: Ragazzi3 folded before Flop (didn't bet)
Seat 5: XwinX25 (button) folded before Flop (didn't bet)
Seat 6: Croplayer1 (small blind) folded before Flop



PokerStars Hand #166667402250:  Hold'em No Limit ($0.05/$0.10 USD) - 2017/02/23 16:00:22 ET
Table 'Brendelia II' 6-max Seat #2 is the button
Seat 1: RkaczoR ($12.16 in chips) 
Seat 2: Crimsonr ($7.05 in chips) 
Seat 5: Kupi007 ($27.01 in chips) 
Seat 6: luckyPositiv ($10 in chips) 
Kupi007: posts small blind $0.05
luckyPositiv: posts big blind $0.10
RkaczoR: posts the ante $0.02
Crimsonr: posts the ante $0.02
Kupi007: posts the ante $0.02
luckyPositiv: posts the ante $0.02
*** HOLE CARDS ***
RkaczoR: folds 
Crimsonr: folds 
Kupi007: raises $0.20 to $0.30
luckyPositiv: folds 
Uncalled bet ($0.20) returned to Kupi007
Kupi007 collected $0.28 from pot
*** SUMMARY ***
Total pot $0.28 | Rake $0 
Seat 1: RkaczoR folded before Flop (didn't bet)
Seat 2: Crimsonr (button) folded before Flop (didn't bet)
Seat 5: Kupi007 (small blind) collected ($0.28)
Seat 6: luckyPositiv (big blind) folded before Flop



PokerStars Hand #166667402978:  Hold'em No Limit ($0.05/$0.10 USD) - 2017/02/23 16:00:23 ET
Table 'Nata II' 6-max Seat #2 is the button
Seat 1: luisantrs ($9.44 in chips) 
Seat 2: CHRO8 ($15.85 in chips) 
Seat 3: 8th wonders ($10.37 in chips) 
Seat 4: Comeback3392 ($10 in chips) 
Seat 6: IAntikI ($10 in chips) 
8th wonders: posts small blind $0.05
Comeback3392: posts big blind $0.10
RoJ1: sits out 
*** HOLE CARDS ***
IAntikI: folds 
luisantrs: calls $0.10
CHRO8: folds 
8th wonders: raises $0.50 to $0.60
Comeback3392: folds 
luisantrs: folds 
Uncalled bet ($0.50) returned to 8th wonders
8th wonders collected $0.30 from pot
*** SUMMARY ***
Total pot $0.30 | Rake $0 
Seat 1: luisantrs folded before Flop
Seat 2: CHRO8 (button) folded before Flop (didn't bet)
Seat 3: 8th wonders (small blind) collected ($0.30)
Seat 4: Comeback3392 (big blind) folded before Flop
Seat 6: IAntikI folded before Flop (didn't bet)



PokerStars Hand #166667403527:  Hold'em No Limit ($0.05/$0.10 USD) - 2017/02/23 16:00:24 ET
Table 'Ostara III' 6-max Seat #3 is the button
Seat 1: MühliJr ($10.52 in chips) 
Seat 2: Action_Gibi ($7.60 in chips) 
Seat 3: vtalian ($10.46 in chips) 
Seat 5: dzesio18 ($12.05 in chips) 
Seat 6: FlopsterGB ($12.05 in chips) 
dzesio18: posts small blind $0.05
FlopsterGB: posts big blind $0.10
*** HOLE CARDS ***
MühliJr: raises $0.20 to $0.30
Action_Gibi: folds 
vtalian: folds 
dzesio18: raises $1.10 to $1.40
FlopsterGB: folds 
MühliJr: folds 
Uncalled bet ($1.10) returned to dzesio18
dzesio18 collected $0.70 from pot
*** SUMMARY ***
Total pot $0.70 | Rake $0 
Seat 1: MühliJr folded before Flop
Seat 2: Action_Gibi folded before Flop (didn't bet)
Seat 3: vtalian (button) folded before Flop (didn't bet)
Seat 5: dzesio18 (small blind) collected ($0.70)
Seat 6: FlopsterGB (big blind) folded before Flop



PokerStars Hand #166667403701:  Hold'em No Limit ($0.05/$0.10 USD) - 2017/02/23 16:00:24 ET
Table 'Euryalos II' 6-max Seat #4 is the button
Seat 3: Hyd SK ($10.15 in chips) 
Seat 4: popypaleta ($15.87 in chips) 
Seat 5: voledy ($12.91 in chips) 
Seat 6: MihaGr ($10 in chips) 
voledy: posts small blind $0.05
MihaGr: posts big blind $0.10
kickereens: sits out 
Yspenyanin: sits out 
*** HOLE CARDS ***
Hyd SK: folds 
popypaleta: folds 
voledy: folds 
Uncalled bet ($0.05) returned to MihaGr
MihaGr collected $0.10 from pot
*** SUMMARY ***
Total pot $0.10 | Rake $0 
Seat 3: Hyd SK folded before Flop (didn't bet)
Seat 4: popypaleta (button) folded before Flop (didn't bet)
Seat 5: voledy (small blind) folded before Flop
Seat 6: MihaGr (big blind) collected ($0.10)



PokerStars Hand #166667403938:  Hold'em No Limit ($0.05/$0.10 USD) - 2017/02/23 16:00:24 ET
Table 'Nekkar' 6-max Seat #3 is the button
Seat 1: aapokerkot ($11.65 in chips) 
Seat 2: Bird et al ($10 in chips) 
Seat 3: Zemz_Ru ($17.06 in chips) 
Seat 4: kingartur222 ($12.38 in chips) 
Seat 5: Vrinni ($11.79 in chips) 
Seat 6: Eddys Edge ($10.85 in chips) 
kingartur222: posts small blind $0.05
Vrinni: posts big blind $0.10
*** HOLE CARDS ***
Eddys Edge: folds 
aapokerkot: folds 
Bird et al: raises $0.21 to $0.31
Zemz_Ru: folds 
kingartur222: folds 
Vrinni: raises $0.68 to $0.99
Bird et al: folds 
Uncalled bet ($0.68) returned to Vrinni
Vrinni collected $0.67 from pot
*** SUMMARY ***
Total pot $0.67 | Rake $0 
Seat 1: aapokerkot folded before Flop (didn't bet)
Seat 2: Bird et al folded before Flop
Seat 3: Zemz_Ru (button) folded before Flop (didn't bet)
Seat 4: kingartur222 (small blind) folded before Flop
Seat 5: Vrinni (big blind) collected ($0.67)
Seat 6: Eddys Edge folded before Flop (didn't bet)



PokerStars Hand #166667403977:  Hold'em No Limit ($0.05/$0.10 USD) - 2017/02/23 16:00:24 ET
Table 'Tirela' 6-max Seat #6 is the button
Seat 1: Smitty03300 ($10 in chips) 
Seat 2: Andrei ProFF ($19.29 in chips) 
Seat 3: aim444 ($14.14 in chips) 
Seat 4: ArcticBearDK ($10 in chips) 
Seat 5: KRZuff ($10.10 in chips) 
Seat 6: coolisses111 ($9.05 in chips) 
Smitty03300: posts small blind $0.05
Andrei ProFF: posts big blind $0.10
*** HOLE CARDS ***
aim444: calls $0.10
ArcticBearDK: raises $0.25 to $0.35
KRZuff: folds 
coolisses111: folds 
Smitty03300: folds 
Andrei ProFF: folds 
aim444: calls $0.25
*** FLOP *** [9h 2d 4d]
aim444: checks 
ArcticBearDK: bets $0.40
aim444: folds 
Uncalled bet ($0.40) returned to ArcticBearDK
ArcticBearDK collected $0.81 from pot
*** SUMMARY ***
Total pot $0.85 | Rake $0.04 
Board [9h 2d 4d]
Seat 1: Smitty03300 (small blind) folded before Flop
Seat 2: Andrei ProFF (big blind) folded before Flop
Seat 3: aim444 folded on the Flop
Seat 4: ArcticBearDK collected ($0.81)
Seat 5: KRZuff folded before Flop (didn't bet)
Seat 6: coolisses111 (button) folded before Flop (didn't bet)



PokerStars Hand #166667404016:  Hold'em No Limit ($0.05/$0.10 USD) - 2017/02/23 16:00:24 ET
Table 'Lampetia III' 6-max Seat #2 is the button
Seat 1: gaHy_HaXeP ($10.30 in chips) 
Seat 2: DamDatsAnAce ($10.10 in chips) 
Seat 3: Therodorus ($10.45 in chips) 
Seat 4: IAntikI ($10.54 in chips) 
Seat 5: robson1235 ($19.70 in chips) 
Seat 6: bdixon_5 ($9.50 in chips) 
Therodorus: posts small blind $0.05
IAntikI: posts big blind $0.10
*** HOLE CARDS ***
robson1235: folds 
bdixon_5: folds 
gaHy_HaXeP: folds 
DamDatsAnAce: folds 
Therodorus: raises $0.20 to $0.30
IAntikI: folds 
Uncalled bet ($0.20) returned to Therodorus
Therodorus collected $0.20 from pot
*** SUMMARY ***
Total pot $0.20 | Rake $0 
Seat 1: gaHy_HaXeP folded before Flop (didn't bet)
Seat 2: DamDatsAnAce (button) folded before Flop (didn't bet)
Seat 3: Therodorus (small blind) collected ($0.20)
Seat 4: IAntikI (big blind) folded before Flop
Seat 5: robson1235 folded before Flop (didn't bet)
Seat 6: bdixon_5 folded before Flop (didn't bet)



PokerStars Hand #166667404435:  Hold'em No Limit ($0.05/$0.10 USD) - 2017/02/23 16:00:25 ET
Table 'Nehalennia III' 6-max Seat #5 is the button
Seat 1: boxer821 ($13.45 in chips) 
Seat 2: fortieth ($9.77 in chips) 
Seat 3: ValdemorS ($17.67 in chips) 
Seat 5: wulffboy ($34.83 in chips) 
Seat 6: valzeny ($20.72 in chips) 
valzeny: posts small blind $0.05
boxer821: posts big blind $0.10
eniksenik: sits out 
boxer821: posts the ante $0.02
fortieth: posts the ante $0.02
ValdemorS: posts the ante $0.02
wulffboy: posts the ante $0.02
valzeny: posts the ante $0.02
*** HOLE CARDS ***
fortieth: folds 
ValdemorS: raises $0.20 to $0.30
wulffboy: calls $0.30
valzeny: folds 
boxer821: folds 
*** FLOP *** [Qs Js 6s]
ValdemorS: bets $0.61
wulffboy: folds 
Uncalled bet ($0.61) returned to ValdemorS
ValdemorS collected $0.81 from pot
*** SUMMARY ***
Total pot $0.85 | Rake $0.04 
Board [Qs Js 6s]
Seat 1: boxer821 (big blind) folded before Flop
Seat 2: fortieth folded before Flop (didn't bet)
Seat 3: ValdemorS collected ($0.81)
Seat 5: wulffboy (button) folded on the Flop
Seat 6: valzeny (small blind) folded before Flop



PokerStars Hand #166667404524:  Hold'em No Limit ($0.05/$0.10 USD) - 2017/02/23 16:00:25 ET
Table 'Nymphe II' 6-max Seat #4 is the button
Seat 1: jacktayra ($3.40 in chips) 
Seat 2: Newqbrown ($10 in chips) 
Seat 3: THIMUCHIN ($14.25 in chips) 
Seat 4: coolisses111 ($19.15 in chips) 
Seat 6: Xander188 ($18.58 in chips) 
Yspenyanin will be allowed to play after the button
Xander188: posts small blind $0.05
jacktayra: posts big blind $0.10
*** HOLE CARDS ***
Newqbrown: raises $0.20 to $0.30
THIMUCHIN: folds 
coolisses111: folds 
Xander188: folds 
jacktayra: folds 
Uncalled bet ($0.20) returned to Newqbrown
Newqbrown collected $0.25 from pot
*** SUMMARY ***
Total pot $0.25 | Rake $0 
Seat 1: jacktayra (big blind) folded before Flop
Seat 2: Newqbrown collected ($0.25)
Seat 3: THIMUCHIN folded before Flop (didn't bet)
Seat 4: coolisses111 (button) folded before Flop (didn't bet)
Seat 6: Xander188 (small blind) folded before Flop



PokerStars Hand #166667404552:  Hold'em No Limit ($0.05/$0.10 USD) - 2017/02/23 16:00:25 ET
Table 'Luanda' 6-max Seat #6 is the button
Seat 1: Kow6oy ($10.15 in chips) 
Seat 2: Xander188 ($10.30 in chips) 
Seat 4: aapokerkot ($10.38 in chips) 
Seat 5: st4tion ($11.64 in chips) 
Seat 6: KA3AXCTAHEU, ($11.41 in chips) 
Kow6oy: posts small blind $0.05
Xander188: posts big blind $0.10
DamDatsAnAce: sits out 
*** HOLE CARDS ***
aapokerkot: folds 
st4tion: raises $0.15 to $0.25
KA3AXCTAHEU,: folds 
Kow6oy: folds 
Xander188: calls $0.15
*** FLOP *** [Tc 8h Qd]
Xander188: checks 
st4tion: checks 
*** TURN *** [Tc 8h Qd] [3s]
Xander188: checks 
st4tion: checks 
*** RIVER *** [Tc 8h Qd 3s] [5d]
Xander188: checks 
st4tion: checks 
*** SHOW DOWN ***
Xander188: shows [9h Ah] (high card Ace)
st4tion: shows [4d 4h] (a pair of Fours)
st4tion collected $0.53 from pot
*** SUMMARY ***
Total pot $0.55 | Rake $0.02 
Board [Tc 8h Qd 3s 5d]
Seat 1: Kow6oy (small blind) folded before Flop
Seat 2: Xander188 (big blind) showed [9h Ah] and lost with high card Ace
Seat 4: aapokerkot folded before Flop (didn't bet)
Seat 5: st4tion showed [4d 4h] and won ($0.53) with a pair of Fours
Seat 6: KA3AXCTAHEU, (button) folded before Flop (didn't bet)



PokerStars Hand #166667404572:  Hold'em No Limit ($0.05/$0.10 USD) - 2017/02/23 16:00:25 ET
Table 'Lehigh' 6-max Seat #3 is the button
Seat 1: kowe4ka565 ($8.52 in chips) 
Seat 2: EggMayo ($10.19 in chips) 
Seat 3: Therodorus ($10 in chips) 
Seat 4: Chodemuncher ($10.25 in chips) 
Seat 5: Xander188 ($10 in chips) 
Seat 6: CallByValue ($9.60 in chips) 
Chodemuncher: posts small blind $0.05
Xander188: posts big blind $0.10
*** HOLE CARDS ***
CallByValue: folds 
kowe4ka565: calls $0.10
EggMayo: folds 
Therodorus: folds 
Chodemuncher: folds 
Xander188: raises $0.30 to $0.40
kowe4ka565: calls $0.30
*** FLOP *** [9d 9c 4c]
Xander188: bets $0.50
kowe4ka565: calls $0.50
*** TURN *** [9d 9c 4c] [4s]
Xander188: checks 
kowe4ka565: checks 
*** RIVER *** [9d 9c 4c 4s] [Qd]
Xander188: bets $1
kowe4ka565: raises $3.77 to $4.77
Xander188: folds 
Uncalled bet ($3.77) returned to kowe4ka565
kowe4ka565 collected $3.68 from pot
*** SUMMARY ***
Total pot $3.85 | Rake $0.17 
Board [9d 9c 4c 4s Qd]
Seat 1: kowe4ka565 collected ($3.68)
Seat 2: EggMayo folded before Flop (didn't bet)
Seat 3: Therodorus (button) folded before Flop (didn't bet)
Seat 4: Chodemuncher (small blind) folded before Flop
Seat 5: Xander188 (big blind) folded on the River
Seat 6: CallByValue folded before Flop (didn't bet)



PokerStars Hand #166667404615:  Hold'em No Limit ($0.05/$0.10 USD) - 2017/02/23 16:00:25 ET
Table 'Anhui II' 6-max Seat #1 is the button
Seat 1: kingartur222 ($11.99 in chips) 
Seat 2: kikus334 ($9.50 in chips) 
Seat 3: lochniak556 ($29.24 in chips) 
Seat 4: dragonste89 ($10 in chips) 
Seat 5: Bandyaev ($10 in chips) 
Seat 6: .BaRReL.1122 ($5.61 in chips) 
kikus334: posts small blind $0.05
lochniak556: posts big blind $0.10
*** HOLE CARDS ***
dragonste89: folds 
Bandyaev: raises $0.20 to $0.30
.BaRReL.1122: calls $0.30
kingartur222: folds 
kikus334: calls $0.25
lochniak556: calls $0.20
*** FLOP *** [4h 6d 2c]
kikus334: bets $0.30
lochniak556 said, "moje"
lochniak556: calls $0.30
Bandyaev: folds 
.BaRReL.1122: calls $0.30
*** TURN *** [4h 6d 2c] [Kd]
kikus334: checks 
lochniak556: checks 
.BaRReL.1122: checks 
*** RIVER *** [4h 6d 2c Kd] [5s]
kikus334: bets $0.60
lochniak556: calls $0.60
.BaRReL.1122: folds 
*** SHOW DOWN ***
kikus334: shows [6c 7c] (a pair of Sixes)
lochniak556: mucks hand 
kikus334 collected $3.15 from pot
*** SUMMARY ***
Total pot $3.30 | Rake $0.15 
Board [4h 6d 2c Kd 5s]
Seat 1: kingartur222 (button) folded before Flop (didn't bet)
Seat 2: kikus334 (small blind) showed [6c 7c] and won ($3.15) with a pair of Sixes
Seat 3: lochniak556 (big blind) mucked
Seat 4: dragonste89 folded before Flop (didn't bet)
Seat 5: Bandyaev folded on the Flop
Seat 6: .BaRReL.1122 folded on the River



PokerStars Hand #166667404616:  Hold'em No Limit ($0.05/$0.10 USD) - 2017/02/23 16:00:25 ET
Table 'Jokaste II' 6-max Seat #5 is the button
Seat 1: Hyd SK ($13.48 in chips) 
Seat 3: crazydevill ($10 in chips) 
Seat 4: FRAID358 ($14.86 in chips) 
Seat 5: Vrinni ($10 in chips) 
Seat 6: Adailton07 ($14.32 in chips) 
Adailton07: posts small blind $0.05
Hyd SK: posts big blind $0.10
T9MS: sits out 
*** HOLE CARDS ***
crazydevill: raises $0.20 to $0.30
FRAID358: folds 
Vrinni: folds 
Adailton07: calls $0.25
Hyd SK: folds 
*** FLOP *** [7c Ac 4h]
Adailton07: checks 
crazydevill: bets $0.40
Adailton07: calls $0.40
*** TURN *** [7c Ac 4h] [Qs]
Adailton07: checks 
crazydevill: checks 
*** RIVER *** [7c Ac 4h Qs] [9h]
Adailton07: checks 
crazydevill: checks 
*** SHOW DOWN ***
Adailton07: shows [3d 7d] (a pair of Sevens)
crazydevill: mucks hand 
Adailton07 collected $1.43 from pot
*** SUMMARY ***
Total pot $1.50 | Rake $0.07 
Board [7c Ac 4h Qs 9h]
Seat 1: Hyd SK (big blind) folded before Flop
Seat 3: crazydevill mucked
Seat 4: FRAID358 folded before Flop (didn't bet)
Seat 5: Vrinni (button) folded before Flop (didn't bet)
Seat 6: Adailton07 (small blind) showed [3d 7d] and won ($1.43) with a pair of Sevens



PokerStars Hand #166667404621:  Hold'em No Limit ($0.05/$0.10 USD) - 2017/02/23 16:00:25 ET
Table 'Atropos' 6-max Seat #4 is the button
Seat 1: ScorpionF39 ($1.28 in chips) 
Seat 2: Ice_Isayev ($10.51 in chips) 
Seat 3: NvR.m1nD ($10.99 in chips) 
Seat 4: iDecMate ($13.05 in chips) 
Seat 5: KokoulinV ($12.14 in chips) 
Seat 6: Iarlei ($10.44 in chips) 
KokoulinV: posts small blind $0.05
Iarlei: posts big blind $0.10
*** HOLE CARDS ***
ScorpionF39: folds 
Ice_Isayev: raises $0.20 to $0.30
NvR.m1nD: folds 
iDecMate: folds 
KokoulinV: folds 
Iarlei: folds 
Uncalled bet ($0.20) returned to Ice_Isayev
Ice_Isayev collected $0.25 from pot
*** SUMMARY ***
Total pot $0.25 | Rake $0 
Seat 1: ScorpionF39 folded before Flop (didn't bet)
Seat 2: Ice_Isayev collected ($0.25)
Seat 3: NvR.m1nD folded before Flop (didn't bet)
Seat 4: iDecMate (button) folded before Flop (didn't bet)
Seat 5: KokoulinV (small blind) folded before Flop
Seat 6: Iarlei (big blind) folded before Flop



PokerStars Hand #166667404743:  Hold'em No Limit ($0.05/$0.10 USD) - 2017/02/23 16:00:25 ET
Table 'Azelfafage' 6-max Seat #6 is the button
Seat 1: Sbozzz ($14.86 in chips) 
Seat 2: tr41n3r12 ($10.70 in chips) 
Seat 3: todor1711 ($22.29 in chips) 
Seat 4: fedorka rus ($11.57 in chips) 
Seat 5: 8th wonders ($10 in chips) 
Seat 6: KA3AXCTAHEU, ($10 in chips) 
Sbozzz: posts small blind $0.05
tr41n3r12: posts big blind $0.10
*** HOLE CARDS ***
todor1711: calls $0.10
fedorka rus: folds 
8th wonders: raises $0.40 to $0.50
KA3AXCTAHEU,: folds 
Sbozzz: folds 
tr41n3r12: folds 
todor1711: calls $0.40
*** FLOP *** [Ad 3h Kd]
todor1711: checks 
8th wonders: checks 
*** TURN *** [Ad 3h Kd] [2s]
todor1711: checks 
8th wonders: bets $0.83
todor1711: calls $0.83
*** RIVER *** [Ad 3h Kd 2s] [Ah]
todor1711: checks 
8th wonders: checks 
*** SHOW DOWN ***
todor1711: shows [Jd 2c] (two pair, Aces and Deuces)
8th wonders: shows [Qh Ks] (two pair, Aces and Kings)
8th wonders collected $2.68 from pot
*** SUMMARY ***
Total pot $2.81 | Rake $0.13 
Board [Ad 3h Kd 2s Ah]
Seat 1: Sbozzz (small blind) folded before Flop
Seat 2: tr41n3r12 (big blind) folded before Flop
Seat 3: todor1711 showed [Jd 2c] and lost with two pair, Aces and Deuces
Seat 4: fedorka rus folded before Flop (didn't bet)
Seat 5: 8th wonders showed [Qh Ks] and won ($2.68) with two pair, Aces and Kings
Seat 6: KA3AXCTAHEU, (button) folded before Flop (didn't bet)



PokerStars Hand #166667404822:  Hold'em No Limit ($0.05/$0.10 USD) - 2017/02/23 16:00:25 ET
Table 'Brambilla II' 6-max Seat #5 is the button
Seat 1: Rodik002 ($10 in chips) 
Seat 2: dwonder75 ($17.78 in chips) 
Seat 3: BORIS_ENEV ($14.49 in chips) 
Seat 4: david_sara83 ($10.30 in chips) 
Seat 5: FRAID358 ($10 in chips) 
Seat 6: boxer821 ($11.38 in chips) 
boxer821: posts small blind $0.05
Rodik002: posts big blind $0.10
*** HOLE CARDS ***
dwonder75: raises $0.20 to $0.30
BORIS_ENEV: folds 
david_sara83: folds 
FRAID358: folds 
boxer821: raises $0.60 to $0.90
Rodik002: calls $0.80
dwonder75: calls $0.60
*** FLOP *** [5s 7h Th]
boxer821: checks 
Rodik002: checks 
dwonder75: checks 
*** TURN *** [5s 7h Th] [5h]
boxer821: checks 
Rodik002: bets $1.48
dwonder75: folds 
boxer821: folds 
Uncalled bet ($1.48) returned to Rodik002
Rodik002 collected $2.58 from pot
*** SUMMARY ***
Total pot $2.70 | Rake $0.12 
Board [5s 7h Th 5h]
Seat 1: Rodik002 (big blind) collected ($2.58)
Seat 2: dwonder75 folded on the Turn
Seat 3: BORIS_ENEV folded before Flop (didn't bet)
Seat 4: david_sara83 folded before Flop (didn't bet)
Seat 5: FRAID358 (button) folded before Flop (didn't bet)
Seat 6: boxer821 (small blind) folded on the Turn



PokerStars Hand #166667404848:  Hold'em No Limit ($0.05/$0.10 USD) - 2017/02/23 16:00:25 ET
Table 'Girtab II' 6-max Seat #1 is the button
Seat 1: Kow6oy ($10.30 in chips) 
Seat 2: Pokeaster ($14.12 in chips) 
Seat 4: Hyd SK ($27.48 in chips) 
Seat 5: dzesio18 ($11.04 in chips) 
Seat 6: DamDatsAnAce ($10 in chips) 
Pokeaster: posts small blind $0.05
jamalungma: is sitting out 
jamalungma leaves the table
Hyd SK: posts big blind $0.10
*** HOLE CARDS ***
dzesio18: calls $0.10
DamDatsAnAce: folds 
Kow6oy: folds 
Pokeaster: folds 
Hyd SK: checks 
*** FLOP *** [7h Jc 2h]
Hyd SK: checks 
dzesio18: checks 
*** TURN *** [7h Jc 2h] [2s]
Hyd SK: checks 
dzesio18: checks 
*** RIVER *** [7h Jc 2h 2s] [Td]
Hyd SK: checks 
chimera252 joins the table at seat #3 
dzesio18: bets $0.30
Hyd SK: folds 
Uncalled bet ($0.30) returned to dzesio18
dzesio18 collected $0.24 from pot
*** SUMMARY ***
Total pot $0.25 | Rake $0.01 
Board [7h Jc 2h 2s Td]
Seat 1: Kow6oy (button) folded before Flop (didn't bet)
Seat 2: Pokeaster (small blind) folded before Flop
Seat 4: Hyd SK (big blind) folded on the River
Seat 5: dzesio18 collected ($0.24)
Seat 6: DamDatsAnAce folded before Flop (didn't bet)



PokerStars Hand #166667404979:  Hold'em No Limit ($0.05/$0.10 USD) - 2017/02/23 16:00:25 ET
Table 'Samitchell III' 6-max Seat #5 is the button
Seat 1: dr.goofy ($10.42 in chips) 
Seat 3: Kow6oy ($10.10 in chips) 
Seat 4: eniksenik ($10.40 in chips) 
Seat 5: boxer821 ($18.31 in chips) 
Seat 6: fedorka rus ($12.59 in chips) 
fedorka rus: posts small blind $0.05
dr.goofy: posts big blind $0.10
Orlangoor: sits out 
*** HOLE CARDS ***
Kow6oy: folds 
eniksenik: raises $0.20 to $0.30
boxer821: folds 
fedorka rus: calls $0.25
dr.goofy: folds 
*** FLOP *** [4h Tc 8d]
fedorka rus: bets $0.50
eniksenik: folds 
Uncalled bet ($0.50) returned to fedorka rus
fedorka rus collected $0.67 from pot
*** SUMMARY ***
Total pot $0.70 | Rake $0.03 
Board [4h Tc 8d]
Seat 1: dr.goofy (big blind) folded before Flop
Seat 3: Kow6oy folded before Flop (didn't bet)
Seat 4: eniksenik folded on the Flop
Seat 5: boxer821 (button) folded before Flop (didn't bet)
Seat 6: fedorka rus (small blind) collected ($0.67)



PokerStars Hand #166667405164:  Hold'em No Limit ($0.05/$0.10 USD) - 2017/02/23 16:00:26 ET
Table 'Gaika' 6-max Seat #1 is the button
Seat 1: oddshoff ($12.41 in chips) 
Seat 2: NvR.m1nD ($17.82 in chips) 
Seat 3: david_sara83 ($10.47 in chips) 
Seat 4: fortieth ($11.65 in chips) 
Seat 5: fedorka rus ($10.65 in chips) 
Seat 6: dr.goofy ($11.15 in chips) 
NvR.m1nD: posts small blind $0.05
david_sara83: posts big blind $0.10
*** HOLE CARDS ***
fortieth: folds 
fedorka rus: folds 
dr.goofy: folds 
oddshoff: raises $0.10 to $0.20
NvR.m1nD: folds 
david_sara83: folds 
Uncalled bet ($0.10) returned to oddshoff
oddshoff collected $0.25 from pot
*** SUMMARY ***
Total pot $0.25 | Rake $0 
Seat 1: oddshoff (button) collected ($0.25)
Seat 2: NvR.m1nD (small blind) folded before Flop
Seat 3: david_sara83 (big blind) folded before Flop
Seat 4: fortieth folded before Flop (didn't bet)
Seat 5: fedorka rus folded before Flop (didn't bet)
Seat 6: dr.goofy folded before Flop (didn't bet)



PokerStars Hand #166667405397:  Hold'em No Limit ($0.05/$0.10 USD) - 2017/02/23 16:00:26 ET
Table 'Peiroos III' 6-max Seat #5 is the button
Seat 1: tequila_joop ($10 in chips) 
Seat 3: nabatov.m ($5.74 in chips) 
Seat 4: pivanki11 ($11.17 in chips) 
Seat 5: ChuikaPridi ($9.70 in chips) 
Seat 6: CHRO8 ($10.01 in chips) 
CHRO8: posts small blind $0.05
tequila_joop: posts big blind $0.10
tequila_joop: posts the ante $0.02
nabatov.m: posts the ante $0.02
pivanki11: posts the ante $0.02
ChuikaPridi: posts the ante $0.02
CHRO8: posts the ante $0.02
*** HOLE CARDS ***
nabatov.m: folds 
pivanki11: folds 
ChuikaPridi: folds 
CHRO8: calls $0.05
tequila_joop: raises $0.80 to $0.90
CHRO8: folds 
Uncalled bet ($0.80) returned to tequila_joop
tequila_joop collected $0.30 from pot
*** SUMMARY ***
Total pot $0.30 | Rake $0 
Seat 1: tequila_joop (big blind) collected ($0.30)
Seat 3: nabatov.m folded before Flop (didn't bet)
Seat 4: pivanki11 folded before Flop (didn't bet)
Seat 5: ChuikaPridi (button) folded before Flop (didn't bet)
Seat 6: CHRO8 (small blind) folded before Flop



PokerStars Hand #166667405482:  Hold'em No Limit ($0.05/$0.10 USD) - 2017/02/23 16:00:26 ET
Table 'Sinon II' 6-max Seat #4 is the button
Seat 1: Aescul@pius ($11.39 in chips) 
Seat 2: ÄissesHai ($12.32 in chips) 
Seat 3: crazydevill ($10 in chips) 
Seat 4: Bandyaev ($15.48 in chips) 
Seat 5: ab260414 ($11.11 in chips) 
Seat 6: hartmut2012 ($8.06 in chips) 
ab260414: posts small blind $0.05
hartmut2012: posts big blind $0.10
*** HOLE CARDS ***
Aescul@pius: folds 
ÄissesHai: folds 
crazydevill: raises $0.20 to $0.30
Bandyaev: folds 
ab260414: folds 
hartmut2012: calls $0.20
*** FLOP *** [8s 6h 6c]
hartmut2012: checks 
crazydevill: checks 
*** TURN *** [8s 6h 6c] [7d]
hartmut2012: checks 
crazydevill: checks 
*** RIVER *** [8s 6h 6c 7d] [5s]
hartmut2012: bets $0.50
crazydevill: folds 
Uncalled bet ($0.50) returned to hartmut2012
hartmut2012 collected $0.62 from pot
*** SUMMARY ***
Total pot $0.65 | Rake $0.03 
Board [8s 6h 6c 7d 5s]
Seat 1: Aescul@pius folded before Flop (didn't bet)
Seat 2: ÄissesHai folded before Flop (didn't bet)
Seat 3: crazydevill folded on the River
Seat 4: Bandyaev (button) folded before Flop (didn't bet)
Seat 5: ab260414 (small blind) folded before Flop
Seat 6: hartmut2012 (big blind) collected ($0.62)



PokerStars Hand #166667405571:  Hold'em No Limit ($0.05/$0.10 USD) - 2017/02/23 16:00:26 ET
Table 'Markab II' 6-max Seat #1 is the button
Seat 1: david_sara83 ($10.17 in chips) 
Seat 2: truck1234 ($11.45 in chips) 
Seat 3: sexy_seagull ($10 in chips) 
Seat 4: Crafty23@PS ($11.08 in chips) 
Seat 5: Rodik002 ($19.17 in chips) 
Seat 6: Comeback3392 ($10.64 in chips) 
truck1234: posts small blind $0.05
sexy_seagull: posts big blind $0.10
*** HOLE CARDS ***
Crafty23@PS: raises $0.30 to $0.40
Rodik002: folds 
Comeback3392: folds 
david_sara83: folds 
truck1234: calls $0.35
sexy_seagull: folds 
*** FLOP *** [As 7s Ac]
truck1234: checks 
Crafty23@PS: checks 
*** TURN *** [As 7s Ac] [9c]
truck1234: checks 
Crafty23@PS: checks 
*** RIVER *** [As 7s Ac 9c] [5h]
truck1234: checks 
Crafty23@PS: checks 
*** SHOW DOWN ***
truck1234: shows [Qs Kh] (a pair of Aces)
Crafty23@PS: shows [8d 8h] (two pair, Aces and Eights)
Crafty23@PS collected $0.86 from pot
*** SUMMARY ***
Total pot $0.90 | Rake $0.04 
Board [As 7s Ac 9c 5h]
Seat 1: david_sara83 (button) folded before Flop (didn't bet)
Seat 2: truck1234 (small blind) showed [Qs Kh] and lost with a pair of Aces
Seat 3: sexy_seagull (big blind) folded before Flop
Seat 4: Crafty23@PS showed [8d 8h] and won ($0.86) with two pair, Aces and Eights
Seat 5: Rodik002 folded before Flop (didn't bet)
Seat 6: Comeback3392 folded before Flop (didn't bet)



PokerStars Hand #166667405614:  Hold'em No Limit ($0.05/$0.10 USD) - 2017/02/23 16:00:26 ET
Table 'Pandora III' 6-max Seat #3 is the button
Seat 1: Pokeaster ($11.44 in chips) 
Seat 2: garigura ($11.47 in chips) 
Seat 3: ChuikaPridi ($16.19 in chips) 
Seat 4: mhonielsen ($10 in chips) 
Seat 5: MühliJr ($10.30 in chips) 
Seat 6: IAntikI ($10.27 in chips) 
mhonielsen: posts small blind $0.05
MühliJr: posts big blind $0.10
*** HOLE CARDS ***
IAntikI: folds 
Pokeaster: raises $0.20 to $0.30
garigura: folds 
ChuikaPridi: calls $0.30
mhonielsen: folds 
MühliJr: folds 
*** FLOP *** [8d Js 2d]
Pokeaster: checks 
ChuikaPridi: bets $0.40
Pokeaster: folds 
Uncalled bet ($0.40) returned to ChuikaPridi
ChuikaPridi collected $0.72 from pot
*** SUMMARY ***
Total pot $0.75 | Rake $0.03 
Board [8d Js 2d]
Seat 1: Pokeaster folded on the Flop
Seat 2: garigura folded before Flop (didn't bet)
Seat 3: ChuikaPridi (button) collected ($0.72)
Seat 4: mhonielsen (small blind) folded before Flop
Seat 5: MühliJr (big blind) folded before Flop
Seat 6: IAntikI folded before Flop (didn't bet)



PokerStars Hand #166667406123:  Hold'em No Limit ($0.05/$0.10 USD) - 2017/02/23 16:00:27 ET
Table 'Pirola III' 6-max Seat #6 is the button
Seat 1: bdixon_5 ($9.82 in chips) 
Seat 2: gaHy_HaXeP ($10 in chips) 
Seat 3: kingartur222 ($10.37 in chips) 
Seat 4: McCleans ($10.15 in chips) 
Seat 6: T9MS ($10 in chips) 
bdixon_5: posts small blind $0.05
gaHy_HaXeP: posts big blind $0.10
*** HOLE CARDS ***
kingartur222: folds 
McCleans: folds 
T9MS: folds 
bdixon_5: folds 
Uncalled bet ($0.05) returned to gaHy_HaXeP
gaHy_HaXeP collected $0.10 from pot
*** SUMMARY ***
Total pot $0.10 | Rake $0 
Seat 1: bdixon_5 (small blind) folded before Flop
Seat 2: gaHy_HaXeP (big blind) collected ($0.10)
Seat 3: kingartur222 folded before Flop (didn't bet)
Seat 4: McCleans folded before Flop (didn't bet)
Seat 6: T9MS (button) folded before Flop (didn't bet)



PokerStars Hand #166667406148:  Hold'em No Limit ($0.05/$0.10 USD) - 2017/02/23 16:00:27 ET
Table 'Lorbach' 6-max Seat #4 is the button
Seat 1: LarryTheStar ($11.27 in chips) 
Seat 2: fabadam ($12.48 in chips) 
Seat 3: ArcticBearDK ($11.05 in chips) 
Seat 4: McCleans ($10 in chips) 
Seat 5: Cluckh ($14.97 in chips) 
Seat 6: Worlz ($12.97 in chips) 
Cluckh: posts small blind $0.05
Worlz: posts big blind $0.10
*** HOLE CARDS ***
LarryTheStar: folds 
fabadam: folds 
ArcticBearDK: folds 
McCleans: folds 
Cluckh: raises $0.20 to $0.30
Worlz: folds 
Uncalled bet ($0.20) returned to Cluckh
Cluckh collected $0.20 from pot
*** SUMMARY ***
Total pot $0.20 | Rake $0 
Seat 1: LarryTheStar folded before Flop (didn't bet)
Seat 2: fabadam folded before Flop (didn't bet)
Seat 3: ArcticBearDK folded before Flop (didn't bet)
Seat 4: McCleans (button) folded before Flop (didn't bet)
Seat 5: Cluckh (small blind) collected ($0.20)
Seat 6: Worlz (big blind) folded before Flop



PokerStars Hand #166667406410:  Hold'em No Limit ($0.05/$0.10 USD) - 2017/02/23 16:00:27 ET
Table 'Aegle' 6-max Seat #4 is the button
Seat 1: steepfell ($11.36 in chips) 
Seat 3: Crafty23@PS ($10 in chips) 
Seat 4: ab260414 ($11.05 in chips) 
Seat 5: KokoulinV ($11.23 in chips) 
Seat 6: CHRO8 ($20.59 in chips) 
KokoulinV: posts small blind $0.05
CHRO8: posts big blind $0.10
*** HOLE CARDS ***
Brumbycat leaves the table
steepfell: folds 
Crafty23@PS: folds 
ab260414: folds 
KokoulinV: folds 
Uncalled bet ($0.05) returned to CHRO8
CHRO8 collected $0.10 from pot
*** SUMMARY ***
Total pot $0.10 | Rake $0 
Seat 1: steepfell folded before Flop (didn't bet)
Seat 3: Crafty23@PS folded before Flop (didn't bet)
Seat 4: ab260414 (button) folded before Flop (didn't bet)
Seat 5: KokoulinV (small blind) folded before Flop
Seat 6: CHRO8 (big blind) collected ($0.10)



PokerStars Hand #166667406449:  Hold'em No Limit ($0.05/$0.10 USD) - 2017/02/23 16:00:27 ET
Table 'Kobresia II' 6-max Seat #4 is the button
Seat 1: RoJ1 ($14.11 in chips) 
Seat 2: Dcaro31 ($14.04 in chips) 
Seat 3: FRAID358 ($10.84 in chips) 
Seat 4: armstv ($9.95 in chips) 
Seat 5: Goroshkos88 ($11.94 in chips) 
Seat 6: WinninBikini ($10 in chips) 
Goroshkos88: posts small blind $0.05
WinninBikini: posts big blind $0.10
*** HOLE CARDS ***
RoJ1: folds 
Dcaro31: folds 
FRAID358: folds 
armstv: raises $0.10 to $0.20
Goroshkos88: folds 
WinninBikini: calls $0.10
*** FLOP *** [2d As 5c]
WinninBikini: checks 
armstv: bets $0.30
WinninBikini: folds 
Uncalled bet ($0.30) returned to armstv
armstv collected $0.43 from pot
*** SUMMARY ***
Total pot $0.45 | Rake $0.02 
Board [2d As 5c]
Seat 1: RoJ1 folded before Flop (didn't bet)
Seat 2: Dcaro31 folded before Flop (didn't bet)
Seat 3: FRAID358 folded before Flop (didn't bet)
Seat 4: armstv (button) collected ($0.43)
Seat 5: Goroshkos88 (small blind) folded before Flop
Seat 6: WinninBikini (big blind) folded on the Flop



PokerStars Hand #166667406675:  Hold'em No Limit ($0.05/$0.10 USD) - 2017/02/23 16:00:28 ET
Table 'Apollonia' 6-max Seat #3 is the button
Seat 1: ex3Lero86 ($10.99 in chips) 
Seat 2: ibara000 ($19.11 in chips) 
Seat 3: derbesteojr ($8.13 in chips) 
Seat 4: Goroshkos88 ($17.51 in chips) 
Seat 5: EphemeralBen ($13.89 in chips) 
Seat 6: Namhkal ($10 in chips) 
Goroshkos88: posts small blind $0.05
EphemeralBen: posts big blind $0.10
*** HOLE CARDS ***
Namhkal: folds 
ex3Lero86: raises $0.17 to $0.27
ibara000: calls $0.27
derbesteojr: calls $0.27
Goroshkos88: folds 
EphemeralBen: folds 
*** FLOP *** [Jd 7c Tc]
ex3Lero86: checks 
ibara000: checks 
derbesteojr: bets $0.46
ex3Lero86: calls $0.46
ibara000: folds 
*** TURN *** [Jd 7c Tc] [2s]
ex3Lero86: checks 
derbesteojr: bets $2.10
ex3Lero86: folds 
Uncalled bet ($2.10) returned to derbesteojr
derbesteojr collected $1.80 from pot
*** SUMMARY ***
Total pot $1.88 | Rake $0.08 
Board [Jd 7c Tc 2s]
Seat 1: ex3Lero86 folded on the Turn
Seat 2: ibara000 folded on the Flop
Seat 3: derbesteojr (button) collected ($1.80)
Seat 4: Goroshkos88 (small blind) folded before Flop
Seat 5: EphemeralBen (big blind) folded before Flop
Seat 6: Namhkal folded before Flop (didn't bet)



PokerStars Hand #166667406918:  Hold'em No Limit ($0.05/$0.10 USD) - 2017/02/23 16:00:28 ET
Table 'Lobelia II' 6-max Seat #2 is the button
Seat 1: facewald ($29.10 in chips) 
Seat 2: Dcaro31 ($18.59 in chips) 
Seat 3: oddshoff ($10.70 in chips) 
Seat 5: Feverhead ($20.68 in chips) 
oddshoff: posts small blind $0.05
Feverhead: posts big blind $0.10
NvR.m1nD: sits out 
*** HOLE CARDS ***
facewald: folds 
Dcaro31: folds 
oddshoff: raises $0.10 to $0.20
Feverhead: calls $0.10
*** FLOP *** [Ac 2h 5h]
oddshoff: checks 
Feverhead: checks 
*** TURN *** [Ac 2h 5h] [Jc]
oddshoff: bets $0.25
Feverhead: folds 
Uncalled bet ($0.25) returned to oddshoff
oddshoff collected $0.38 from pot
*** SUMMARY ***
Total pot $0.40 | Rake $0.02 
Board [Ac 2h 5h Jc]
Seat 1: facewald folded before Flop (didn't bet)
Seat 2: Dcaro31 (button) folded before Flop (didn't bet)
Seat 3: oddshoff (small blind) collected ($0.38)
Seat 5: Feverhead (big blind) folded on the Turn



PokerStars Hand #166667407103:  Hold'em No Limit ($0.05/$0.10 USD) - 2017/02/23 16:00:28 ET
Table 'Stroobantia' 6-max Seat #3 is the button
Seat 1: mam9zyc ($8 in chips) 
Seat 2: XwinX25 ($10.15 in chips) 
Seat 3: Namhkal ($10 in chips) 
Seat 5: boxer821 ($10.32 in chips) 
Seat 6: KokoulinV ($15.52 in chips) 
Yspenyanin will be allowed to play after the button
boxer821: posts small blind $0.05
KokoulinV: posts big blind $0.10
*** HOLE CARDS ***
mam9zyc: folds 
XwinX25: raises $0.20 to $0.30
Namhkal: folds 
boxer821: folds 
KokoulinV: folds 
Uncalled bet ($0.20) returned to XwinX25
XwinX25 collected $0.25 from pot
*** SUMMARY ***
Total pot $0.25 | Rake $0 
Seat 1: mam9zyc folded before Flop (didn't bet)
Seat 2: XwinX25 collected ($0.25)
Seat 3: Namhkal (button) folded before Flop (didn't bet)
Seat 5: boxer821 (small blind) folded before Flop
Seat 6: KokoulinV (big blind) folded before Flop



PokerStars Hand #166667407104:  Hold'em No Limit ($0.05/$0.10 USD) - 2017/02/23 16:00:28 ET
Table 'Gaika II' 6-max Seat #6 is the button
Seat 1: Ice_Isayev ($10 in chips) 
Seat 2: steepfell ($10.47 in chips) 
Seat 3: iDecMate ($15.60 in chips) 
Seat 4: Hyd SK ($11.82 in chips) 
Seat 5: KokoulinV ($14.75 in chips) 
Seat 6: bartabs2 ($9.15 in chips) 
Ice_Isayev: posts small blind $0.05
steepfell: posts big blind $0.10
*** HOLE CARDS ***
iDecMate: raises $0.20 to $0.30
Hyd SK: folds 
KokoulinV: folds 
bartabs2: folds 
Ice_Isayev: folds 
steepfell: folds 
Uncalled bet ($0.20) returned to iDecMate
iDecMate collected $0.25 from pot
*** SUMMARY ***
Total pot $0.25 | Rake $0 
Seat 1: Ice_Isayev (small blind) folded before Flop
Seat 2: steepfell (big blind) folded before Flop
Seat 3: iDecMate collected ($0.25)
Seat 4: Hyd SK folded before Flop (didn't bet)
Seat 5: KokoulinV folded before Flop (didn't bet)
Seat 6: bartabs2 (button) folded before Flop (didn't bet)



PokerStars Hand #166667407247:  Hold'em No Limit ($0.05/$0.10 USD) - 2017/02/23 16:00:28 ET
Table 'Cassini' 6-max Seat #6 is the button
Seat 1: Pokeaster ($10 in chips) 
Seat 2: mhonielsen ($10.23 in chips) 
Seat 4: fortieth ($13.72 in chips) 
Seat 5: johkom ($7.90 in chips) 
Seat 6: JahSoldier69 ($11.20 in chips) 
Pokeaster: posts small blind $0.05
mhonielsen: posts big blind $0.10
*** HOLE CARDS ***
fortieth: folds 
johkom: folds 
JahSoldier69: raises $0.15 to $0.25
Pokeaster: folds 
mhonielsen: calls $0.15
*** FLOP *** [9d 8s 5d]
mhonielsen: checks 
JahSoldier69: bets $0.32
mhonielsen: calls $0.32
*** TURN *** [9d 8s 5d] [Ts]
mhonielsen: bets $0.91
JahSoldier69: calls $0.91
*** RIVER *** [9d 8s 5d Ts] [3h]
mhonielsen: bets $1.66
JahSoldier69: calls $1.66
*** SHOW DOWN ***
mhonielsen: shows [Td Ah] (a pair of Tens)
JahSoldier69: mucks hand 
mhonielsen collected $6.05 from pot
*** SUMMARY ***
Total pot $6.33 | Rake $0.28 
Board [9d 8s 5d Ts 3h]
Seat 1: Pokeaster (small blind) folded before Flop
Seat 2: mhonielsen (big blind) showed [Td Ah] and won ($6.05) with a pair of Tens
Seat 4: fortieth folded before Flop (didn't bet)
Seat 5: johkom folded before Flop (didn't bet)
Seat 6: JahSoldier69 (button) mucked



PokerStars Hand #166667407550:  Hold'em No Limit ($0.05/$0.10 USD) - 2017/02/23 16:00:29 ET
Table 'Kunigunde II' 6-max Seat #1 is the button
Seat 1: facewald ($10.11 in chips) 
Seat 2: dragonste89 ($14.93 in chips) 
Seat 3: pancernik21 ($12.20 in chips) 
Seat 4: david_sara83 ($12.83 in chips) 
Seat 5: mdelfin0 ($11.59 in chips) 
Seat 6: Zooplack ($11.16 in chips) 
dragonste89: posts small blind $0.05
pancernik21: posts big blind $0.10
*** HOLE CARDS ***
david_sara83: folds 
mdelfin0: folds 
Zooplack: raises $0.15 to $0.25
facewald: folds 
dragonste89: folds 
pancernik21: calls $0.15
*** FLOP *** [5h 7s Kd]
pancernik21: checks 
Zooplack: bets $0.32
pancernik21: calls $0.32
*** TURN *** [5h 7s Kd] [Ts]
pancernik21: checks 
Zooplack: bets $0.86
pancernik21: calls $0.86
*** RIVER *** [5h 7s Kd Ts] [Qc]
pancernik21: checks 
Zooplack: bets $1.39
pancernik21: calls $1.39
*** SHOW DOWN ***
Zooplack: shows [Ad Ah] (a pair of Aces)
pancernik21: shows [Kc Tc] (two pair, Kings and Tens)
pancernik21 collected $5.43 from pot
*** SUMMARY ***
Total pot $5.69 | Rake $0.26 
Board [5h 7s Kd Ts Qc]
Seat 1: facewald (button) folded before Flop (didn't bet)
Seat 2: dragonste89 (small blind) folded before Flop
Seat 3: pancernik21 (big blind) showed [Kc Tc] and won ($5.43) with two pair, Kings and Tens
Seat 4: david_sara83 folded before Flop (didn't bet)
Seat 5: mdelfin0 folded before Flop (didn't bet)
Seat 6: Zooplack showed [Ad Ah] and lost with a pair of Aces



PokerStars Hand #166667407564:  Hold'em No Limit ($0.05/$0.10 USD) - 2017/02/23 16:00:29 ET
Table 'Rostia' 6-max Seat #4 is the button
Seat 2: david_sara83 ($19.41 in chips) 
Seat 3: ImpAV ($8.97 in chips) 
Seat 4: Hyd SK ($11.68 in chips) 
Seat 5: Buddy8711 ($15.68 in chips) 
Seat 6: Giyorod ($11 in chips) 
Buddy8711: posts small blind $0.05
Giyorod: posts big blind $0.10
paxit71: sits out 
*** HOLE CARDS ***
david_sara83: folds 
ImpAV: folds 
Hyd SK: folds 
Buddy8711: calls $0.05
Giyorod: checks 
*** FLOP *** [Ah 4s Ts]
Buddy8711: bets $0.20
Giyorod: folds 
Uncalled bet ($0.20) returned to Buddy8711
Buddy8711 collected $0.19 from pot
*** SUMMARY ***
Total pot $0.20 | Rake $0.01 
Board [Ah 4s Ts]
Seat 2: david_sara83 folded before Flop (didn't bet)
Seat 3: ImpAV folded before Flop (didn't bet)
Seat 4: Hyd SK (button) folded before Flop (didn't bet)
Seat 5: Buddy8711 (small blind) collected ($0.19)
Seat 6: Giyorod (big blind) folded on the Flop



PokerStars Hand #166667407644:  Hold'em No Limit ($0.05/$0.10 USD) - 2017/02/23 16:00:29 ET
Table 'Caupolican' 6-max Seat #6 is the button
Seat 1: kingartur222 ($10.13 in chips) 
Seat 2: garigura ($19.70 in chips) 
Seat 3: arturgalant ($4.77 in chips) 
Seat 4: mhonielsen ($11.46 in chips) 
Seat 5: Kazacha ($10.95 in chips) 
Seat 6: crazydevill ($10.87 in chips) 
kingartur222: posts small blind $0.05
garigura: posts big blind $0.10
*** HOLE CARDS ***
arturgalant: folds 
mhonielsen: folds 
Kazacha: folds 
crazydevill: raises $0.20 to $0.30
kingartur222: folds 
garigura: folds 
Uncalled bet ($0.20) returned to crazydevill
crazydevill collected $0.25 from pot
*** SUMMARY ***
Total pot $0.25 | Rake $0 
Seat 1: kingartur222 (small blind) folded before Flop
Seat 2: garigura (big blind) folded before Flop
Seat 3: arturgalant folded before Flop (didn't bet)
Seat 4: mhonielsen folded before Flop (didn't bet)
Seat 5: Kazacha folded before Flop (didn't bet)
Seat 6: crazydevill (button) collected ($0.25)



PokerStars Hand #166667407955:  Hold'em No Limit ($0.05/$0.10 USD) - 2017/02/23 16:00:29 ET
Table 'Krethon' 6-max Seat #1 is the button
Seat 1: Leda477 ($5.60 in chips) 
Seat 2: manashov ($10.53 in chips) 
Seat 3: Kow6oy ($15.01 in chips) 
Seat 4: chimera252 ($10.15 in chips) 
Seat 5: popypaleta ($10.55 in chips) 
Seat 6: fabadam ($19.28 in chips) 
manashov: posts small blind $0.05
Kow6oy: posts big blind $0.10
*** HOLE CARDS ***
chimera252: raises $0.20 to $0.30
popypaleta: folds 
fabadam: calls $0.30
Leda477: raises $0.90 to $1.20
manashov: folds 
Kow6oy: folds 
chimera252: raises $3.10 to $4.30
fabadam: folds 
Leda477: raises $1.30 to $5.60 and is all-in
chimera252: calls $1.30
*** FLOP *** [6d 5d Jh]
*** TURN *** [6d 5d Jh] [3h]
*** RIVER *** [6d 5d Jh 3h] [Qh]
*** SHOW DOWN ***
chimera252: shows [Js Jd] (three of a kind, Jacks)
Leda477: shows [Ad 8d] (high card Ace)
chimera252 collected $11.13 from pot
*** SUMMARY ***
Total pot $11.65 | Rake $0.52 
Board [6d 5d Jh 3h Qh]
Seat 1: Leda477 (button) showed [Ad 8d] and lost with high card Ace
Seat 2: manashov (small blind) folded before Flop
Seat 3: Kow6oy (big blind) folded before Flop
Seat 4: chimera252 showed [Js Jd] and won ($11.13) with three of a kind, Jacks
Seat 5: popypaleta folded before Flop (didn't bet)
Seat 6: fabadam folded before Flop



PokerStars Hand #166667407997:  Hold'em No Limit ($0.05/$0.10 USD) - 2017/02/23 16:00:29 ET
Table 'Hercynia III' 6-max Seat #2 is the button
Seat 1: Bird et al ($14.73 in chips) 
Seat 2: Action_Gibi ($9.20 in chips) 
Seat 3: Dcaro31 ($20.29 in chips) 
Seat 4: Darkfrai ($16.36 in chips) 
Seat 5: THIMUCHIN ($14.94 in chips) 
Seat 6: bdixon_5 ($10.87 in chips) 
Dcaro31: posts small blind $0.05
Darkfrai: posts big blind $0.10
*** HOLE CARDS ***
THIMUCHIN: folds 
bdixon_5: folds 
Bird et al: folds 
Action_Gibi: folds 
Dcaro31: raises $0.20 to $0.30
Darkfrai: folds 
Uncalled bet ($0.20) returned to Dcaro31
Dcaro31 collected $0.20 from pot
*** SUMMARY ***
Total pot $0.20 | Rake $0 
Seat 1: Bird et al folded before Flop (didn't bet)
Seat 2: Action_Gibi (button) folded before Flop (didn't bet)
Seat 3: Dcaro31 (small blind) collected ($0.20)
Seat 4: Darkfrai (big blind) folded before Flop
Seat 5: THIMUCHIN folded before Flop (didn't bet)
Seat 6: bdixon_5 folded before Flop (didn't bet)



PokerStars Hand #166667408102:  Hold'em No Limit ($0.05/$0.10 USD) - 2017/02/23 16:00:29 ET
Table 'Lederle' 6-max Seat #1 is the button
Seat 1: D3NyA ($10 in chips) 
Seat 2: truck1234 ($16.05 in chips) 
Seat 3: Kazacha ($10 in chips) 
Seat 4: Pokeaster ($13.76 in chips) 
Seat 5: 8th wonders ($12.91 in chips) 
truck1234: posts small blind $0.05
Kazacha: posts big blind $0.10
*** HOLE CARDS ***
Pokeaster: folds 
8th wonders: raises $0.20 to $0.30
D3NyA: folds 
truck1234: folds 
Kazacha: folds 
Uncalled bet ($0.20) returned to 8th wonders
8th wonders collected $0.25 from pot
*** SUMMARY ***
Total pot $0.25 | Rake $0 
Seat 1: D3NyA (button) folded before Flop (didn't bet)
Seat 2: truck1234 (small blind) folded before Flop
Seat 3: Kazacha (big blind) folded before Flop
Seat 4: Pokeaster folded before Flop (didn't bet)
Seat 5: 8th wonders collected ($0.25)



PokerStars Hand #166667408345:  Hold'em No Limit ($0.05/$0.10 USD) - 2017/02/23 16:00:30 ET
Table 'Vaisala' 6-max Seat #4 is the button
Seat 1: Pekaml ($10 in chips) 
Seat 3: x3ultimate ($10 in chips) 
Seat 4: sexy_seagull ($11.41 in chips) 
Seat 6: Aleksey K228 ($15.36 in chips) 
JahSoldier69 will be allowed to play after the button
JahSoldier69 leaves the table
Aleksey K228: posts small blind $0.05
Pekaml: posts big blind $0.10
*** HOLE CARDS ***
x3ultimate: folds 
sexy_seagull: raises $0.15 to $0.25
Aleksey K228: folds 
XaXaTyH4uK joins the table at seat #2 
Pekaml: folds 
Uncalled bet ($0.15) returned to sexy_seagull
sexy_seagull collected $0.25 from pot
*** SUMMARY ***
Total pot $0.25 | Rake $0 
Seat 1: Pekaml (big blind) folded before Flop
Seat 3: x3ultimate folded before Flop (didn't bet)
Seat 4: sexy_seagull (button) collected ($0.25)
Seat 6: Aleksey K228 (small blind) folded before Flop



PokerStars Hand #166667409159:  Hold'em No Limit ($0.05/$0.10 USD) - 2017/02/23 16:00:31 ET
Table 'Nemo III' 6-max Seat #6 is the button
Seat 2: Bandyaev ($11.08 in chips) 
Seat 3: Therodorus ($11.29 in chips) 
Seat 4: vtalian ($9.70 in chips) 
Seat 6: SALAMIS85 ($13.64 in chips) 
Bandyaev: posts small blind $0.05
Therodorus: posts big blind $0.10
*** HOLE CARDS ***
vtalian: folds 
falikcoola leaves the table
SALAMIS85: folds 
Joker51_wtf! joins the table at seat #5 
Bandyaev: raises $0.20 to $0.30
Therodorus: calls $0.20
*** FLOP *** [Td Qh 3d]
Bandyaev: bets $0.43
Therodorus: calls $0.43
*** TURN *** [Td Qh 3d] [8d]
Bandyaev: checks 
Therodorus: checks 
*** RIVER *** [Td Qh 3d 8d] [Kc]
Bandyaev: checks 
Therodorus: checks 
*** SHOW DOWN ***
Bandyaev: shows [Ah Qs] (a pair of Queens)
Therodorus: mucks hand 
Bandyaev collected $1.39 from pot
*** SUMMARY ***
Total pot $1.46 | Rake $0.07 
Board [Td Qh 3d 8d Kc]
Seat 2: Bandyaev (small blind) showed [Ah Qs] and won ($1.39) with a pair of Queens
Seat 3: Therodorus (big blind) mucked
Seat 4: vtalian folded before Flop (didn't bet)
Seat 6: SALAMIS85 (button) folded before Flop (didn't bet)



PokerStars Hand #166667409177:  Hold'em No Limit ($0.05/$0.10 USD) - 2017/02/23 16:00:31 ET
Table 'Lesath III' 6-max Seat #6 is the button
Seat 1: Gogeta26 ($6.88 in chips) 
Seat 2: WinninBikini ($10.18 in chips) 
Seat 3: Giyorod ($10 in chips) 
Seat 4: Eddys Edge ($10 in chips) 
Seat 5: eniksenik ($15.49 in chips) 
Seat 6: patrick19111 ($10.71 in chips) 
Gogeta26: posts small blind $0.05
WinninBikini: posts big blind $0.10
*** HOLE CARDS ***
Giyorod: raises $0.20 to $0.30
Eddys Edge: folds 
eniksenik: folds 
patrick19111: folds 
Gogeta26: folds 
WinninBikini: folds 
Uncalled bet ($0.20) returned to Giyorod
Giyorod collected $0.25 from pot
*** SUMMARY ***
Total pot $0.25 | Rake $0 
Seat 1: Gogeta26 (small blind) folded before Flop
Seat 2: WinninBikini (big blind) folded before Flop
Seat 3: Giyorod collected ($0.25)
Seat 4: Eddys Edge folded before Flop (didn't bet)
Seat 5: eniksenik folded before Flop (didn't bet)
Seat 6: patrick19111 (button) folded before Flop (didn't bet)



PokerStars Hand #166667409285:  Hold'em No Limit ($0.05/$0.10 USD) - 2017/02/23 16:00:31 ET
Table 'Rotraut' 6-max Seat #2 is the button
Seat 1: Hypermetal ($13.49 in chips) 
Seat 2: Newqbrown ($10.78 in chips) 
Seat 4: Darkfrai ($10 in chips) 
Seat 5: Bird et al ($11.75 in chips) 
Seat 6: KokoulinV ($13.14 in chips) 
Darkfrai: posts small blind $0.05
Bird et al: posts big blind $0.10
*** HOLE CARDS ***
KokoulinV: folds 
Hypermetal: folds 
Newqbrown: folds 
Darkfrai: folds 
Uncalled bet ($0.05) returned to Bird et al
Bird et al collected $0.10 from pot
*** SUMMARY ***
Total pot $0.10 | Rake $0 
Seat 1: Hypermetal folded before Flop (didn't bet)
Seat 2: Newqbrown (button) folded before Flop (didn't bet)
Seat 4: Darkfrai (small blind) folded before Flop
Seat 5: Bird et al (big blind) collected ($0.10)
Seat 6: KokoulinV folded before Flop (didn't bet)



PokerStars Hand #166667409349:  Hold'em No Limit ($0.05/$0.10 USD) - 2017/02/23 16:00:31 ET
Table 'Lampetia' 6-max Seat #3 is the button
Seat 1: WinninBikini ($11.24 in chips) 
Seat 2: ex3Lero86 ($10 in chips) 
Seat 3: Ice_Isayev ($10.73 in chips) 
Seat 4: Rodik002 ($14.69 in chips) 
Seat 5: luisantrs ($9.01 in chips) 
Rodik002: posts small blind $0.05
luisantrs: posts big blind $0.10
Scanner17: sits out 
*** HOLE CARDS ***
WinninBikini: folds 
ex3Lero86: folds 
Ice_Isayev: folds 
Rodik002: folds 
Uncalled bet ($0.05) returned to luisantrs
luisantrs collected $0.10 from pot
*** SUMMARY ***
Total pot $0.10 | Rake $0 
Seat 1: WinninBikini folded before Flop (didn't bet)
Seat 2: ex3Lero86 folded before Flop (didn't bet)
Seat 3: Ice_Isayev (button) folded before Flop (didn't bet)
Seat 4: Rodik002 (small blind) folded before Flop
Seat 5: luisantrs (big blind) collected ($0.10)



PokerStars Hand #166667409465:  Hold'em No Limit ($0.05/$0.10 USD) - 2017/02/23 16:00:31 ET
Table 'Wil' 6-max Seat #2 is the button
Seat 1: jwhelan94 ($24.47 in chips) 
Seat 2: Vrinni ($22.61 in chips) 
Seat 3: Namhkal ($10 in chips) 
Seat 4: x3ultimate ($10.42 in chips) 
Seat 5: Feverhead ($11.36 in chips) 
Seat 6: Comeback3392 ($14.33 in chips) 
Namhkal: posts small blind $0.05
x3ultimate: posts big blind $0.10
*** HOLE CARDS ***
Feverhead: folds 
Comeback3392: folds 
jwhelan94: folds 
Vrinni: raises $0.15 to $0.25
Namhkal: folds 
x3ultimate: raises $0.65 to $0.90
Vrinni: folds 
Uncalled bet ($0.65) returned to x3ultimate
x3ultimate collected $0.55 from pot
*** SUMMARY ***
Total pot $0.55 | Rake $0 
Seat 1: jwhelan94 folded before Flop (didn't bet)
Seat 2: Vrinni (button) folded before Flop
Seat 3: Namhkal (small blind) folded before Flop
Seat 4: x3ultimate (big blind) collected ($0.55)
Seat 5: Feverhead folded before Flop (didn't bet)
Seat 6: Comeback3392 folded before Flop (didn't bet)



PokerStars Hand #166667409737:  Hold'em No Limit ($0.05/$0.10 USD) - 2017/02/23 16:00:31 ET
Table 'Ebella II' 6-max Seat #2 is the button
Seat 1: gaHy_HaXeP ($10 in chips) 
Seat 2: Therodorus ($10 in chips) 
Seat 3: Torften2 ($8.37 in chips) 
Seat 4: ValdemorS ($10.30 in chips) 
Seat 5: Bird et al ($10.15 in chips) 
Torften2: posts small blind $0.05
ValdemorS: posts big blind $0.10
Joker51_wtf!: sits out 
*** HOLE CARDS ***
Bird et al: folds 
gaHy_HaXeP: folds 
Therodorus: raises $0.15 to $0.25
Torften2: calls $0.20
ValdemorS: folds 
*** FLOP *** [6d 7c 5s]
Torften2: bets $0.40
Therodorus: raises $1 to $1.40
Torften2: calls $1
*** TURN *** [6d 7c 5s] [4d]
Torften2: bets $6.72 and is all-in
Therodorus: calls $6.72
*** RIVER *** [6d 7c 5s 4d] [8c]
*** SHOW DOWN ***
Torften2: shows [5c 9d] (a straight, Five to Nine)
Therodorus: shows [7d 7s] (a straight, Four to Eight)
Torften2 collected $16.08 from pot
*** SUMMARY ***
Total pot $16.84 | Rake $0.76 
Board [6d 7c 5s 4d 8c]
Seat 1: gaHy_HaXeP folded before Flop (didn't bet)
Seat 2: Therodorus (button) showed [7d 7s] and lost with a straight, Four to Eight
Seat 3: Torften2 (small blind) showed [5c 9d] and won ($16.08) with a straight, Five to Nine
Seat 4: ValdemorS (big blind) folded before Flop
Seat 5: Bird et al folded before Flop (didn't bet)



PokerStars Hand #166667409925:  Hold'em No Limit ($0.05/$0.10 USD) - 2017/02/23 16:00:32 ET
Table 'Syringa' 6-max Seat #4 is the button
Seat 1: bdixon_5 ($8.10 in chips) 
Seat 2: Goroshkos88 ($10 in chips) 
Seat 4: tangler19 ($15.38 in chips) 
Seat 5: Andrei ProFF ($11.62 in chips) 
Seat 6: ibara000 ($17.64 in chips) 
Andrei ProFF: posts small blind $0.05
ibara000: posts big blind $0.10
Yspenyanin: sits out 
*** HOLE CARDS ***
bdixon_5: folds 
Goroshkos88: folds 
tangler19: folds 
Andrei ProFF: raises $0.20 to $0.30
ibara000: raises $0.60 to $0.90
Andrei ProFF: calls $0.60
*** FLOP *** [Jh As Ah]
Andrei ProFF: checks 
ibara000: checks 
*** TURN *** [Jh As Ah] [3c]
Andrei ProFF: checks 
ibara000: checks 
*** RIVER *** [Jh As Ah 3c] [2s]
Andrei ProFF: checks 
ibara000: checks 
*** SHOW DOWN ***
Andrei ProFF: shows [Ts Th] (two pair, Aces and Tens)
ibara000: mucks hand 
Andrei ProFF collected $1.72 from pot
*** SUMMARY ***
Total pot $1.80 | Rake $0.08 
Board [Jh As Ah 3c 2s]
Seat 1: bdixon_5 folded before Flop (didn't bet)
Seat 2: Goroshkos88 folded before Flop (didn't bet)
Seat 4: tangler19 (button) folded before Flop (didn't bet)
Seat 5: Andrei ProFF (small blind) showed [Ts Th] and won ($1.72) with two pair, Aces and Tens
Seat 6: ibara000 (big blind) mucked



PokerStars Hand #166667410050:  Hold'em No Limit ($0.05/$0.10 USD) - 2017/02/23 16:00:32 ET
Table 'Hunnia' 6-max Seat #1 is the button
Seat 1: univibe68 ($19.01 in chips) 
Seat 2: mhonielsen ($10.05 in chips) 
Seat 3: crazydevill ($10.17 in chips) 
Seat 4: Jalida3 ($10.71 in chips) 
Seat 5: Smarkon ($15.23 in chips) 
Seat 6: ChuikaPridi ($9.22 in chips) 
mhonielsen: posts small blind $0.05
crazydevill: posts big blind $0.10
*** HOLE CARDS ***
Jalida3: folds 
Smarkon: folds 
ChuikaPridi: folds 
univibe68: raises $0.10 to $0.20
mhonielsen: calls $0.15
crazydevill: calls $0.10
*** FLOP *** [Ts 8d 2d]
mhonielsen: checks 
crazydevill: checks 
univibe68: checks 
*** TURN *** [Ts 8d 2d] [Qh]
mhonielsen: bets $0.46
crazydevill: folds 
univibe68: calls $0.46
*** RIVER *** [Ts 8d 2d Qh] [6h]
mhonielsen: bets $1.16
univibe68: calls $1.16
*** SHOW DOWN ***
mhonielsen: shows [Ad Qc] (a pair of Queens)
univibe68: shows [8h Qd] (two pair, Queens and Eights)
univibe68 collected $3.67 from pot
*** SUMMARY ***
Total pot $3.84 | Rake $0.17 
Board [Ts 8d 2d Qh 6h]
Seat 1: univibe68 (button) showed [8h Qd] and won ($3.67) with two pair, Queens and Eights
Seat 2: mhonielsen (small blind) showed [Ad Qc] and lost with a pair of Queens
Seat 3: crazydevill (big blind) folded on the Turn
Seat 4: Jalida3 folded before Flop (didn't bet)
Seat 5: Smarkon folded before Flop (didn't bet)
Seat 6: ChuikaPridi folded before Flop (didn't bet)



PokerStars Hand #166667410119:  Hold'em No Limit ($0.05/$0.10 USD) - 2017/02/23 16:00:32 ET
Table 'Sheragul III' 6-max Seat #2 is the button
Seat 1: danky24 ($17.36 in chips) 
Seat 2: Bird et al ($11.96 in chips) 
Seat 4: maxiv608 ($11.14 in chips) 
Seat 5: Bandyaev ($14.81 in chips) 
Seat 6: Andrei ProFF ($10 in chips) 
maxiv608: posts small blind $0.05
Bandyaev: posts big blind $0.10
*** HOLE CARDS ***
Andrei ProFF: folds 
danky24: folds 
Bird et al: folds 
maxiv608: raises $0.20 to $0.30
Bandyaev: folds 
Uncalled bet ($0.20) returned to maxiv608
maxiv608 collected $0.20 from pot
*** SUMMARY ***
Total pot $0.20 | Rake $0 
Seat 1: danky24 folded before Flop (didn't bet)
Seat 2: Bird et al (button) folded before Flop (didn't bet)
Seat 4: maxiv608 (small blind) collected ($0.20)
Seat 5: Bandyaev (big blind) folded before Flop
Seat 6: Andrei ProFF folded before Flop (didn't bet)



PokerStars Hand #166667410170:  Hold'em No Limit ($0.05/$0.10 USD) - 2017/02/23 16:00:32 ET
Table 'Gelria' 6-max Seat #6 is the button
Seat 1: ab260414 ($10.17 in chips) 
Seat 2: fishhook5 ($10 in chips) 
Seat 3: Orlangoor ($10.34 in chips) 
Seat 5: apenvel ($7.64 in chips) 
Seat 6: Andrei ProFF ($10.57 in chips) 
ab260414: posts small blind $0.05
fishhook5: posts big blind $0.10
*** HOLE CARDS ***
Orlangoor: folds 
apenvel: folds 
Andrei ProFF: folds 
ab260414: folds 
Uncalled bet ($0.05) returned to fishhook5
fishhook5 collected $0.10 from pot
*** SUMMARY ***
Total pot $0.10 | Rake $0 
Seat 1: ab260414 (small blind) folded before Flop
Seat 2: fishhook5 (big blind) collected ($0.10)
Seat 3: Orlangoor folded before Flop (didn't bet)
Seat 5: apenvel folded before Flop (didn't bet)
Seat 6: Andrei ProFF (button) folded before Flop (didn't bet)



PokerStars Hand #166667410212:  Hold'em No Limit ($0.05/$0.10 USD) - 2017/02/23 16:00:32 ET
Table 'Siebohme II' 6-max Seat #1 is the button
Seat 1: homelessdan ($18.22 in chips) 
Seat 2: townerz1991 ($14.42 in chips) 
Seat 3: D3NyA ($10 in chips) 
Seat 4: POT_TRADER ($12.14 in chips) 
Seat 5: NvR.m1nD ($10.15 in chips) 
townerz1991: posts small blind $0.05
D3NyA: posts big blind $0.10
Fozzy690: sits out 
*** HOLE CARDS ***
POT_TRADER: folds 
NvR.m1nD: folds 
homelessdan: folds 
townerz1991: raises $0.15 to $0.25
D3NyA: calls $0.15
*** FLOP *** [Td 9s 2h]
townerz1991: checks 
D3NyA: checks 
*** TURN *** [Td 9s 2h] [8c]
townerz1991: checks 
D3NyA: checks 
*** RIVER *** [Td 9s 2h 8c] [Ac]
townerz1991: checks 
D3NyA: bets $0.34
townerz1991: folds 
Uncalled bet ($0.34) returned to D3NyA
D3NyA collected $0.48 from pot
*** SUMMARY ***
Total pot $0.50 | Rake $0.02 
Board [Td 9s 2h 8c Ac]
Seat 1: homelessdan (button) folded before Flop (didn't bet)
Seat 2: townerz1991 (small blind) folded on the River
Seat 3: D3NyA (big blind) collected ($0.48)
Seat 4: POT_TRADER folded before Flop (didn't bet)
Seat 5: NvR.m1nD folded before Flop (didn't bet)



PokerStars Hand #166667410474:  Hold'em No Limit ($0.05/$0.10 USD) - 2017/02/23 16:00:32 ET
Table 'Grietje' 6-max Seat #2 is the button
Seat 1: WinninBikini ($14.98 in chips) 
Seat 2: Feverhead ($13.17 in chips) 
Seat 3: a_tonis6 ($14.73 in chips) 
Seat 4: 6ePeMeHHa9 ($10 in chips) 
Seat 5: sbalass ($4.95 in chips) 
Seat 6: Prometheu$8 ($11.21 in chips) 
a_tonis6: posts small blind $0.05
6ePeMeHHa9: posts big blind $0.10
*** HOLE CARDS ***
sbalass: folds 
Prometheu$8: raises $0.25 to $0.35
WinninBikini: folds 
Feverhead: folds 
a_tonis6: folds 
6ePeMeHHa9: folds 
Uncalled bet ($0.25) returned to Prometheu$8
Prometheu$8 collected $0.25 from pot
*** SUMMARY ***
Total pot $0.25 | Rake $0 
Seat 1: WinninBikini folded before Flop (didn't bet)
Seat 2: Feverhead (button) folded before Flop (didn't bet)
Seat 3: a_tonis6 (small blind) folded before Flop
Seat 4: 6ePeMeHHa9 (big blind) folded before Flop
Seat 5: sbalass folded before Flop (didn't bet)
Seat 6: Prometheu$8 collected ($0.25)



PokerStars Hand #166667410515:  Hold'em No Limit ($0.05/$0.10 USD) - 2017/02/23 16:00:32 ET
Table 'Clavel' 6-max Seat #5 is the button
Seat 1: KRZuff ($13.92 in chips) 
Seat 2: RoJ1 ($12.59 in chips) 
Seat 3: Darkfrai ($10.39 in chips) 
Seat 4: Dcaro31 ($12.18 in chips) 
Seat 5: Vrinni ($10.54 in chips) 
Seat 6: Gra_anD77 ($3.91 in chips) 
Gra_anD77: posts small blind $0.05
KRZuff: posts big blind $0.10
*** HOLE CARDS ***
RoJ1: raises $0.12 to $0.22
Darkfrai: calls $0.22
Dcaro31: calls $0.22
Vrinni: folds 
Gra_anD77: folds 
KRZuff: raises $1.43 to $1.65
RoJ1: folds 
Darkfrai: folds 
Dcaro31: folds 
Uncalled bet ($1.43) returned to KRZuff
KRZuff collected $0.93 from pot
*** SUMMARY ***
Total pot $0.93 | Rake $0 
Seat 1: KRZuff (big blind) collected ($0.93)
Seat 2: RoJ1 folded before Flop
Seat 3: Darkfrai folded before Flop
Seat 4: Dcaro31 folded before Flop
Seat 5: Vrinni (button) folded before Flop (didn't bet)
Seat 6: Gra_anD77 (small blind) folded before Flop



PokerStars Hand #166667410865:  Hold'em No Limit ($0.05/$0.10 USD) - 2017/02/23 16:00:33 ET
Table 'Xanthippe II' 6-max Seat #2 is the button
Seat 1: ade22345 ($4.03 in chips) 
Seat 2: Bird et al ($13.91 in chips) 
Seat 3: Dcaro31 ($10 in chips) 
Seat 6: Orlangoor ($10.79 in chips) 
Dcaro31: posts small blind $0.05
Orlangoor: posts big blind $0.10
*** HOLE CARDS ***
ade22345: folds 
Bird et al: raises $0.15 to $0.25
Dcaro31: folds 
Orlangoor: raises $0.65 to $0.90
Bird et al: folds 
Uncalled bet ($0.65) returned to Orlangoor
Orlangoor collected $0.55 from pot
*** SUMMARY ***
Total pot $0.55 | Rake $0 
Seat 1: ade22345 folded before Flop (didn't bet)
Seat 2: Bird et al (button) folded before Flop
Seat 3: Dcaro31 (small blind) folded before Flop
Seat 6: Orlangoor (big blind) collected ($0.55)



PokerStars Hand #166667411014:  Hold'em No Limit ($0.05/$0.10 USD) - 2017/02/23 16:00:33 ET
Table 'Epimetheus' 6-max Seat #6 is the button
Seat 1: 6ePeMeHHa9 ($10.14 in chips) 
Seat 2: patrick19111 ($15.20 in chips) 
Seat 3: dineldidi ($9.67 in chips) 
Seat 5: afca128 ($24.63 in chips) 
Seat 6: voledy ($10.18 in chips) 
6ePeMeHHa9: posts small blind $0.05
patrick19111: posts big blind $0.10
*** HOLE CARDS ***
dineldidi: folds 
afca128: folds 
voledy: raises $0.15 to $0.25
6ePeMeHHa9: raises $0.65 to $0.90
patrick19111: folds 
voledy: folds 
Uncalled bet ($0.65) returned to 6ePeMeHHa9
6ePeMeHHa9 collected $0.60 from pot
*** SUMMARY ***
Total pot $0.60 | Rake $0 
Seat 1: 6ePeMeHHa9 (small blind) collected ($0.60)
Seat 2: patrick19111 (big blind) folded before Flop
Seat 3: dineldidi folded before Flop (didn't bet)
Seat 5: afca128 folded before Flop (didn't bet)
Seat 6: voledy (button) folded before Flop



PokerStars Hand #166667411053:  Hold'em No Limit ($0.05/$0.10 USD) - 2017/02/23 16:00:33 ET
Table 'Unitas II' 6-max Seat #4 is the button
Seat 1: Peter0087 ($9.35 in chips) 
Seat 2: dragonste89 ($10.61 in chips) 
Seat 3: CallByValue ($10 in chips) 
Seat 4: truck1234 ($10.72 in chips) 
Seat 5: chimera252 ($26.11 in chips) 
chimera252: posts small blind $0.05
jamalungma: is sitting out 
jamalungma leaves the table
Peter0087: posts big blind $0.10
*** HOLE CARDS ***
dragonste89: raises $0.30 to $0.40
CallByValue: folds 
paxit71 joins the table at seat #6 
truck1234: folds 
chimera252: folds 
Peter0087: folds 
Uncalled bet ($0.30) returned to dragonste89
dragonste89 collected $0.25 from pot
*** SUMMARY ***
Total pot $0.25 | Rake $0 
Seat 1: Peter0087 (big blind) folded before Flop
Seat 2: dragonste89 collected ($0.25)
Seat 3: CallByValue folded before Flop (didn't bet)
Seat 4: truck1234 (button) folded before Flop (didn't bet)
Seat 5: chimera252 (small blind) folded before Flop



PokerStars Hand #166667411353:  Hold'em No Limit ($0.05/$0.10 USD) - 2017/02/23 16:00:34 ET
Table 'Bootes' 6-max Seat #5 is the button
Seat 1: Namhkal ($13.45 in chips) 
Seat 2: Bird et al ($19.60 in chips) 
Seat 3: KA3AXCTAHEU, ($19.35 in chips) 
Seat 4: totonove ($4.71 in chips) 
Seat 5: Pekaml ($15.19 in chips) 
Seat 6: cherep61987 ($10 in chips) 
cherep61987: posts small blind $0.05
Namhkal: posts big blind $0.10
*** HOLE CARDS ***
Bird et al: folds 
KA3AXCTAHEU,: raises $0.15 to $0.25
totonove: folds 
Pekaml: folds 
cherep61987: folds 
Namhkal: folds 
Uncalled bet ($0.15) returned to KA3AXCTAHEU,
KA3AXCTAHEU, collected $0.25 from pot
*** SUMMARY ***
Total pot $0.25 | Rake $0 
Seat 1: Namhkal (big blind) folded before Flop
Seat 2: Bird et al folded before Flop (didn't bet)
Seat 3: KA3AXCTAHEU, collected ($0.25)
Seat 4: totonove folded before Flop (didn't bet)
Seat 5: Pekaml (button) folded before Flop (didn't bet)
Seat 6: cherep61987 (small blind) folded before Flop



PokerStars Hand #166667411566:  Hold'em No Limit ($0.05/$0.10 USD) - 2017/02/23 16:00:34 ET
Table 'Nikko II' 6-max Seat #2 is the button
Seat 1: bdixon_5 ($9.85 in chips) 
Seat 2: popypaleta ($10 in chips) 
Seat 3: Hyd SK ($10.45 in chips) 
Seat 4: Peter0087 ($9.99 in chips) 
Seat 5: Aescul@pius ($11.07 in chips) 
Hyd SK: posts small blind $0.05
Peter0087: posts big blind $0.10
*** HOLE CARDS ***
Aescul@pius: folds 
bdixon_5: folds 
popypaleta: raises $0.20 to $0.30
Hyd SK: folds 
Peter0087: folds 
Uncalled bet ($0.20) returned to popypaleta
popypaleta collected $0.25 from pot
*** SUMMARY ***
Total pot $0.25 | Rake $0 
Seat 1: bdixon_5 folded before Flop (didn't bet)
Seat 2: popypaleta (button) collected ($0.25)
Seat 3: Hyd SK (small blind) folded before Flop
Seat 4: Peter0087 (big blind) folded before Flop
Seat 5: Aescul@pius folded before Flop (didn't bet)



PokerStars Hand #166667411809:  Hold'em No Limit ($0.05/$0.10 USD) - 2017/02/23 16:00:34 ET
Table 'Selinur' 6-max Seat #2 is the button
Seat 1: KA3AXCTAHEU, ($10 in chips) 
Seat 2: jamalungma ($10.08 in chips) 
Seat 3: bambolejro ($10.57 in chips) 
Seat 4: freezing666 ($12.03 in chips) 
Seat 6: homelessdan ($17.30 in chips) 
bambolejro: posts small blind $0.05
freezing666: posts big blind $0.10
IAntikI: sits out 
*** HOLE CARDS ***
homelessdan: folds 
KA3AXCTAHEU,: folds 
jamalungma: raises $0.15 to $0.25
bambolejro: folds 
freezing666: folds 
Uncalled bet ($0.15) returned to jamalungma
jamalungma collected $0.25 from pot
*** SUMMARY ***
Total pot $0.25 | Rake $0 
Seat 1: KA3AXCTAHEU, folded before Flop (didn't bet)
Seat 2: jamalungma (button) collected ($0.25)
Seat 3: bambolejro (small blind) folded before Flop
Seat 4: freezing666 (big blind) folded before Flop
Seat 6: homelessdan folded before Flop (didn't bet)



PokerStars Hand #166667412402:  Hold'em No Limit ($0.05/$0.10 USD) - 2017/02/23 16:00:35 ET
Table 'Camilla II' 6-max Seat #6 is the button
Seat 2: Giyorod ($15.71 in chips) 
Seat 4: chimera252 ($12.81 in chips) 
Seat 5: LarryTheStar ($11.27 in chips) 
Seat 6: david_sara83 ($10 in chips) 
paxit71 joins the table at seat #1 
Giyorod: posts small blind $0.05
JahSoldier69: is sitting out 
chimera252: posts big blind $0.10
*** HOLE CARDS ***
LarryTheStar: folds 
david_sara83: folds 
JahSoldier69 leaves the table
Giyorod: raises $0.20 to $0.30
Andy Wolf joins the table at seat #3 
chimera252: folds 
Uncalled bet ($0.20) returned to Giyorod
Giyorod collected $0.20 from pot
*** SUMMARY ***
Total pot $0.20 | Rake $0 
Seat 2: Giyorod (small blind) collected ($0.20)
Seat 4: chimera252 (big blind) folded before Flop
Seat 5: LarryTheStar folded before Flop (didn't bet)
Seat 6: david_sara83 (button) folded before Flop (didn't bet)



PokerStars Hand #166667412403:  Hold'em No Limit ($0.05/$0.10 USD) - 2017/02/23 16:00:35 ET
Table 'Wilkens II' 6-max Seat #5 is the button
Seat 1: Islamiq-GuRL ($12.30 in chips) 
Seat 2: manashov ($10.15 in chips) 
Seat 3: Namhkal ($10.95 in chips) 
Seat 5: patrick19111 ($10 in chips) 
Seat 6: XaXaTyH4uK ($14.51 in chips) 
XaXaTyH4uK: posts small blind $0.05
Islamiq-GuRL: posts big blind $0.10
myevc: sits out 
*** HOLE CARDS ***
manashov: folds 
Namhkal: folds 
patrick19111: folds 
XaXaTyH4uK: raises $0.20 to $0.30
Islamiq-GuRL: folds 
Uncalled bet ($0.20) returned to XaXaTyH4uK
XaXaTyH4uK collected $0.20 from pot
*** SUMMARY ***
Total pot $0.20 | Rake $0 
Seat 1: Islamiq-GuRL (big blind) folded before Flop
Seat 2: manashov folded before Flop (didn't bet)
Seat 3: Namhkal folded before Flop (didn't bet)
Seat 5: patrick19111 (button) folded before Flop (didn't bet)
Seat 6: XaXaTyH4uK (small blind) collected ($0.20)



PokerStars Hand #166667412664:  Hold'em No Limit ($0.05/$0.10 USD) - 2017/02/23 16:00:35 ET
Table 'Juliet II' 6-max Seat #4 is the button
Seat 1: alexpolevaja ($10.46 in chips) 
Seat 2: KA3AXCTAHEU, ($15.15 in chips) 
Seat 3: patrick19111 ($11.72 in chips) 
Seat 4: x3ultimate ($10.45 in chips) 
Seat 5: Dcaro31 ($19.37 in chips) 
Seat 6: BookWorm78 ($31.97 in chips) 
Dcaro31: posts small blind $0.05
BookWorm78: posts big blind $0.10
*** HOLE CARDS ***
alexpolevaja: calls $0.10
KA3AXCTAHEU,: folds 
patrick19111: folds 
x3ultimate: raises $0.30 to $0.40
Dcaro31: folds 
BookWorm78: folds 
alexpolevaja: calls $0.30
*** FLOP *** [9h Td 9d]
alexpolevaja: checks 
x3ultimate: bets $0.45
alexpolevaja: raises $0.45 to $0.90
x3ultimate: folds 
Uncalled bet ($0.45) returned to alexpolevaja
alexpolevaja collected $1.77 from pot
*** SUMMARY ***
Total pot $1.85 | Rake $0.08 
Board [9h Td 9d]
Seat 1: alexpolevaja collected ($1.77)
Seat 2: KA3AXCTAHEU, folded before Flop (didn't bet)
Seat 3: patrick19111 folded before Flop (didn't bet)
Seat 4: x3ultimate (button) folded on the Flop
Seat 5: Dcaro31 (small blind) folded before Flop
Seat 6: BookWorm78 (big blind) folded before Flop



PokerStars Hand #166667412809:  Hold'em No Limit ($0.05/$0.10 USD) - 2017/02/23 16:00:35 ET
Table 'Syringa II' 6-max Seat #3 is the button
Seat 1: GiveTwoMe ($11.83 in chips) 
Seat 2: Cluckh ($10.05 in chips) 
Seat 3: gaHy_HaXeP ($10.73 in chips) 
Seat 4: MBen10 ($10.15 in chips) 
Seat 5: Mishapok196 ($6.55 in chips) 
Seat 6: WinninBikini ($11.31 in chips) 
MBen10: posts small blind $0.05
Mishapok196: posts big blind $0.10
*** HOLE CARDS ***
WinninBikini: folds 
GiveTwoMe: raises $0.20 to $0.30
Cluckh: folds 
gaHy_HaXeP: folds 
MBen10: folds 
Mishapok196: calls $0.20
*** FLOP *** [Qd Qc 7h]
Mishapok196: checks 
GiveTwoMe: checks 
*** TURN *** [Qd Qc 7h] [8h]
Mishapok196: checks 
GiveTwoMe: checks 
*** RIVER *** [Qd Qc 7h 8h] [Jh]
Mishapok196: checks 
GiveTwoMe: bets $0.37
Mishapok196: folds 
Uncalled bet ($0.37) returned to GiveTwoMe
GiveTwoMe collected $0.62 from pot
*** SUMMARY ***
Total pot $0.65 | Rake $0.03 
Board [Qd Qc 7h 8h Jh]
Seat 1: GiveTwoMe collected ($0.62)
Seat 2: Cluckh folded before Flop (didn't bet)
Seat 3: gaHy_HaXeP (button) folded before Flop (didn't bet)
Seat 4: MBen10 (small blind) folded before Flop
Seat 5: Mishapok196 (big blind) folded on the River
Seat 6: WinninBikini folded before Flop (didn't bet)



PokerStars Hand #166667413006:  Hold'em No Limit ($0.05/$0.10 USD) - 2017/02/23 16:00:36 ET
Table 'Caprera III' 6-max Seat #2 is the button
Seat 2: hg123454321 ($7.83 in chips) 
Seat 3: Darkfrai ($10 in chips) 
Seat 4: oddshoff ($9.71 in chips) 
Seat 5: fedorka rus ($50.73 in chips) 
Seat 6: GESPERIA ($18.79 in chips) 
Darkfrai: posts small blind $0.05
oddshoff: posts big blind $0.10
Vrinni: sits out 
*** HOLE CARDS ***
fedorka rus: folds 
GESPERIA: folds 
hg123454321: folds 
Darkfrai: folds 
Uncalled bet ($0.05) returned to oddshoff
oddshoff collected $0.10 from pot
*** SUMMARY ***
Total pot $0.10 | Rake $0 
Seat 2: hg123454321 (button) folded before Flop (didn't bet)
Seat 3: Darkfrai (small blind) folded before Flop
Seat 4: oddshoff (big blind) collected ($0.10)
Seat 5: fedorka rus folded before Flop (didn't bet)
Seat 6: GESPERIA folded before Flop (didn't bet)



PokerStars Hand #166667413012:  Hold'em No Limit ($0.05/$0.10 USD) - 2017/02/23 16:00:36 ET
Table 'Wabash' 6-max Seat #5 is the button
Seat 1: pivanki11 ($8.95 in chips) 
Seat 2: ex3Lero86 ($21.40 in chips) 
Seat 3: sszabi28 ($6.87 in chips) 
Seat 4: Nr847 ($10.12 in chips) 
Seat 5: popypaleta ($10.10 in chips) 
Seat 6: weez3r ($10.49 in chips) 
weez3r: posts small blind $0.05
pivanki11: posts big blind $0.10
*** HOLE CARDS ***
ex3Lero86: raises $0.20 to $0.30
sszabi28: folds 
Nr847: calls $0.30
popypaleta: folds 
weez3r: folds 
pivanki11: folds 
*** FLOP *** [3h Ac 9h]
ex3Lero86: bets $0.40
Nr847: folds 
Uncalled bet ($0.40) returned to ex3Lero86
ex3Lero86 collected $0.72 from pot
*** SUMMARY ***
Total pot $0.75 | Rake $0.03 
Board [3h Ac 9h]
Seat 1: pivanki11 (big blind) folded before Flop
Seat 2: ex3Lero86 collected ($0.72)
Seat 3: sszabi28 folded before Flop (didn't bet)
Seat 4: Nr847 folded on the Flop
Seat 5: popypaleta (button) folded before Flop (didn't bet)
Seat 6: weez3r (small blind) folded before Flop



PokerStars Hand #166667413111:  Hold'em No Limit ($0.05/$0.10 USD) - 2017/02/23 16:00:36 ET
Table 'Euryalos II' 6-max Seat #5 is the button
Seat 1: kickereens ($19.69 in chips) 
Seat 3: Hyd SK ($10.15 in chips) 
Seat 4: popypaleta ($15.87 in chips) 
Seat 5: voledy ($12.86 in chips) 
Seat 6: MihaGr ($10.05 in chips) 
MihaGr: posts small blind $0.05
kickereens: posts big blind $0.10
Yspenyanin: sits out 
*** HOLE CARDS ***
Hyd SK: folds 
popypaleta: folds 
voledy: folds 
MihaGr: folds 
Uncalled bet ($0.05) returned to kickereens
kickereens collected $0.10 from pot
*** SUMMARY ***
Total pot $0.10 | Rake $0 
Seat 1: kickereens (big blind) collected ($0.10)
Seat 3: Hyd SK folded before Flop (didn't bet)
Seat 4: popypaleta folded before Flop (didn't bet)
Seat 5: voledy (button) folded before Flop (didn't bet)
Seat 6: MihaGr (small blind) folded before Flop



PokerStars Hand #166667413561:  Hold'em No Limit ($0.05/$0.10 USD) - 2017/02/23 16:00:36 ET
Table 'Sirius II' 6-max Seat #1 is the button
Seat 1: Ampped87 ($9.22 in chips) 
Seat 2: jamalungma ($20.58 in chips) 
Seat 3: Spud014 ($10.23 in chips) 
jamalungma: posts small blind $0.05
Spud014: posts big blind $0.10
MihaGr: sits out 
*** HOLE CARDS ***
Ampped87: raises $0.10 to $0.20
jamalungma: folds 
Spud014: folds 
Uncalled bet ($0.10) returned to Ampped87
Ampped87 collected $0.25 from pot
*** SUMMARY ***
Total pot $0.25 | Rake $0 
Seat 1: Ampped87 (button) collected ($0.25)
Seat 2: jamalungma (small blind) folded before Flop
Seat 3: Spud014 (big blind) folded before Flop



PokerStars Hand #166667413698:  Hold'em No Limit ($0.05/$0.10 USD) - 2017/02/23 16:00:36 ET
Table 'Laetitia II' 6-max Seat #4 is the button
Seat 1: Cluckh ($12.18 in chips) 
Seat 2: manashov ($10.37 in chips) 
Seat 3: 6ePeMeHHa9 ($10 in chips) 
Seat 4: Feverhead ($16.81 in chips) 
Seat 5: D3NyA ($16.98 in chips) 
Seat 6: Dima91360 ($3.76 in chips) 
D3NyA: posts small blind $0.05
Dima91360: posts big blind $0.10
*** HOLE CARDS ***
Cluckh: raises $0.20 to $0.30
manashov: folds 
6ePeMeHHa9: calls $0.30
Feverhead: folds 
D3NyA: folds 
Dima91360: calls $0.20
*** FLOP *** [As 4d 8s]
Dima91360: bets $0.10
Cluckh: raises $0.40 to $0.50
6ePeMeHHa9: calls $0.50
Dima91360: calls $0.40
*** TURN *** [As 4d 8s] [5d]
Dima91360: checks 
Cluckh: checks 
6ePeMeHHa9: bets $1.80
Dima91360: folds 
Cluckh: calls $1.80
*** RIVER *** [As 4d 8s 5d] [7h]
Cluckh: checks 
6ePeMeHHa9: checks 
*** SHOW DOWN ***
Cluckh: shows [Ac Kd] (a pair of Aces)
6ePeMeHHa9: shows [Ah Kh] (a pair of Aces)
Cluckh collected $2.89 from pot
6ePeMeHHa9 collected $2.89 from pot
*** SUMMARY ***
Total pot $6.05 | Rake $0.27 
Board [As 4d 8s 5d 7h]
Seat 1: Cluckh showed [Ac Kd] and won ($2.89) with a pair of Aces
Seat 2: manashov folded before Flop (didn't bet)
Seat 3: 6ePeMeHHa9 showed [Ah Kh] and won ($2.89) with a pair of Aces
Seat 4: Feverhead (button) folded before Flop (didn't bet)
Seat 5: D3NyA (small blind) folded before Flop
Seat 6: Dima91360 (big blind) folded on the Turn



PokerStars Hand #166667413838:  Hold'em No Limit ($0.05/$0.10 USD) - 2017/02/23 16:00:37 ET
Table 'Hajek III' 6-max Seat #5 is the button
Seat 1: MBen10 ($10.85 in chips) 
Seat 2: fortieth ($12.81 in chips) 
Seat 3: fedorka rus ($10.61 in chips) 
Seat 4: NvR.m1nD ($10 in chips) 
Seat 5: Croplayer1 ($15.33 in chips) 
Seat 6: fabadam ($22.51 in chips) 
fabadam: posts small blind $0.05
MBen10: posts big blind $0.10
*** HOLE CARDS ***
fortieth: folds 
fedorka rus: folds 
NvR.m1nD: folds 
Croplayer1: raises $0.10 to $0.20
fabadam: folds 
MBen10: calls $0.10
*** FLOP *** [6c 2d Qh]
MBen10: checks 
Croplayer1: bets $0.22
MBen10: folds 
Uncalled bet ($0.22) returned to Croplayer1
Croplayer1 collected $0.43 from pot
*** SUMMARY ***
Total pot $0.45 | Rake $0.02 
Board [6c 2d Qh]
Seat 1: MBen10 (big blind) folded on the Flop
Seat 2: fortieth folded before Flop (didn't bet)
Seat 3: fedorka rus folded before Flop (didn't bet)
Seat 4: NvR.m1nD folded before Flop (didn't bet)
Seat 5: Croplayer1 (button) collected ($0.43)
Seat 6: fabadam (small blind) folded before Flop



PokerStars Hand #166667413946:  Hold'em No Limit ($0.05/$0.10 USD) - 2017/02/23 16:00:37 ET
Table 'Pirola III' 6-max Seat #1 is the button
Seat 1: bdixon_5 ($9.77 in chips) 
Seat 2: gaHy_HaXeP ($10.05 in chips) 
Seat 3: kingartur222 ($10.37 in chips) 
Seat 4: McCleans ($10.15 in chips) 
Seat 6: T9MS ($10 in chips) 
gaHy_HaXeP: posts small blind $0.05
kingartur222: posts big blind $0.10
*** HOLE CARDS ***
McCleans: raises $0.20 to $0.30
T9MS: folds 
bdixon_5: folds 
gaHy_HaXeP: folds 
kingartur222: folds 
Uncalled bet ($0.20) returned to McCleans
McCleans collected $0.25 from pot
*** SUMMARY ***
Total pot $0.25 | Rake $0 
Seat 1: bdixon_5 (button) folded before Flop (didn't bet)
Seat 2: gaHy_HaXeP (small blind) folded before Flop
Seat 3: kingartur222 (big blind) folded before Flop
Seat 4: McCleans collected ($0.25)
Seat 6: T9MS folded before Flop (didn't bet)



PokerStars Hand #166667414385:  Hold'em No Limit ($0.05/$0.10 USD) - 2017/02/23 16:00:37 ET
Table 'Crommelin II' 6-max Seat #5 is the button
Seat 1: THIMUCHIN ($11.22 in chips) 
Seat 2: Bird et al ($10.19 in chips) 
Seat 3: Strelok1974 ($21.15 in chips) 
Seat 4: Pequeño Clau ($10.15 in chips) 
Seat 5: Action_Gibi ($20.50 in chips) 
Seat 6: Darkfrai ($10 in chips) 
Darkfrai: posts small blind $0.05
THIMUCHIN: posts big blind $0.10
*** HOLE CARDS ***
Bird et al: raises $0.21 to $0.31
Strelok1974: folds 
Pequeño Clau: folds 
Action_Gibi: calls $0.31
Darkfrai: calls $0.26
THIMUCHIN: folds 
*** FLOP *** [7s Qs 3h]
Darkfrai: checks 
Bird et al: checks 
Action_Gibi: checks 
*** TURN *** [7s Qs 3h] [Ks]
Darkfrai: checks 
Bird et al: checks 
Action_Gibi: checks 
*** RIVER *** [7s Qs 3h Ks] [9c]
Darkfrai: bets $0.60
Bird et al: folds 
Action_Gibi: folds 
Uncalled bet ($0.60) returned to Darkfrai
Darkfrai collected $0.98 from pot
*** SUMMARY ***
Total pot $1.03 | Rake $0.05 
Board [7s Qs 3h Ks 9c]
Seat 1: THIMUCHIN (big blind) folded before Flop
Seat 2: Bird et al folded on the River
Seat 3: Strelok1974 folded before Flop (didn't bet)
Seat 4: Pequeño Clau folded before Flop (didn't bet)
Seat 5: Action_Gibi (button) folded on the River
Seat 6: Darkfrai (small blind) collected ($0.98)



PokerStars Hand #166667414433:  Hold'em No Limit ($0.05/$0.10 USD) - 2017/02/23 16:00:37 ET
Table 'Aegle' 6-max Seat #5 is the button
Seat 3: Crafty23@PS ($10 in chips) 
Seat 4: ab260414 ($11.05 in chips) 
Seat 5: KokoulinV ($11.18 in chips) 
Seat 6: CHRO8 ($20.64 in chips) 
CHRO8: posts small blind $0.05
steepfell: is sitting out 
Crafty23@PS: posts big blind $0.10
*** HOLE CARDS ***
ab260414: folds 
KokoulinV: folds 
CHRO8: folds 
Uncalled bet ($0.05) returned to Crafty23@PS
Crafty23@PS collected $0.10 from pot
*** SUMMARY ***
Total pot $0.10 | Rake $0 
Seat 3: Crafty23@PS (big blind) collected ($0.10)
Seat 4: ab260414 folded before Flop (didn't bet)
Seat 5: KokoulinV (button) folded before Flop (didn't bet)
Seat 6: CHRO8 (small blind) folded before Flop



PokerStars Hand #166667414587:  Hold'em No Limit ($0.05/$0.10 USD) - 2017/02/23 16:00:38 ET
Table 'Persephone' 6-max Seat #2 is the button
Seat 2: Kupi007 ($14.73 in chips) 
Seat 3: Kow6oy ($11.78 in chips) 
Seat 4: 2G28 ($10.09 in chips) 
Seat 6: popypaleta ($11.97 in chips) 
Kow6oy: posts small blind $0.05
2G28: posts big blind $0.10
D3NyA: sits out 
FRAID358: sits out 
*** HOLE CARDS ***
popypaleta: folds 
Kupi007: folds 
Kow6oy: raises $0.20 to $0.30
2G28: folds 
Uncalled bet ($0.20) returned to Kow6oy
Kow6oy collected $0.20 from pot
*** SUMMARY ***
Total pot $0.20 | Rake $0 
Seat 2: Kupi007 (button) folded before Flop (didn't bet)
Seat 3: Kow6oy (small blind) collected ($0.20)
Seat 4: 2G28 (big blind) folded before Flop
Seat 6: popypaleta folded before Flop (didn't bet)



PokerStars Hand #166667414595:  Hold'em No Limit ($0.05/$0.10 USD) - 2017/02/23 16:00:38 ET
Table 'Thia' 6-max Seat #1 is the button
Seat 1: Eddys Edge ($10.18 in chips) 
Seat 2: sugrob86 ($20.72 in chips) 
Seat 3: northug18 ($7.91 in chips) 
Seat 4: Bandyaev ($10 in chips) 
Seat 5: ab260414 ($10.11 in chips) 
Seat 6: ex3Lero86 ($15.51 in chips) 
sugrob86: posts small blind $0.05
northug18: posts big blind $0.10
*** HOLE CARDS ***
Bandyaev: folds 
ab260414: raises $0.20 to $0.30
ex3Lero86: calls $0.30
Eddys Edge: folds 
sugrob86: folds 
northug18: calls $0.20
*** FLOP *** [4d Th 9c]
northug18: checks 
ab260414: bets $0.68
ex3Lero86: folds 
northug18: folds 
Uncalled bet ($0.68) returned to ab260414
ab260414 collected $0.91 from pot
*** SUMMARY ***
Total pot $0.95 | Rake $0.04 
Board [4d Th 9c]
Seat 1: Eddys Edge (button) folded before Flop (didn't bet)
Seat 2: sugrob86 (small blind) folded before Flop
Seat 3: northug18 (big blind) folded on the Flop
Seat 4: Bandyaev folded before Flop (didn't bet)
Seat 5: ab260414 collected ($0.91)
Seat 6: ex3Lero86 folded on the Flop



PokerStars Hand #166667415492:  Hold'em No Limit ($0.05/$0.10 USD) - 2017/02/23 16:00:39 ET
Table 'Gyldenia II' 6-max Seat #6 is the button
Seat 1: KokoulinV ($10 in chips) 
Seat 2: Bandyaev ($10 in chips) 
Seat 3: ex3Lero86 ($23.37 in chips) 
Seat 5: CHRO8 ($17.74 in chips) 
Seat 6: 8th wonders ($10.64 in chips) 
KokoulinV: posts small blind $0.05
Bandyaev: posts big blind $0.10
*** HOLE CARDS ***
ex3Lero86: folds 
CHRO8: folds 
8th wonders: raises $0.10 to $0.20
KokoulinV: folds 
Bandyaev: folds 
Uncalled bet ($0.10) returned to 8th wonders
8th wonders collected $0.25 from pot
*** SUMMARY ***
Total pot $0.25 | Rake $0 
Seat 1: KokoulinV (small blind) folded before Flop
Seat 2: Bandyaev (big blind) folded before Flop
Seat 3: ex3Lero86 folded before Flop (didn't bet)
Seat 5: CHRO8 folded before Flop (didn't bet)
Seat 6: 8th wonders (button) collected ($0.25)



PokerStars Hand #166667415543:  Hold'em No Limit ($0.05/$0.10 USD) - 2017/02/23 16:00:39 ET
Table 'Thoas' 6-max Seat #1 is the button
Seat 1: Pekaml ($10.83 in chips) 
Seat 2: themacer24 ($8.25 in chips) 
Seat 3: by.y.y.y86 ($10.09 in chips) 
Seat 4: Morris_Chair ($18.46 in chips) 
Seat 5: Kow6oy ($10.17 in chips) 
Seat 6: takis nik ($10 in chips) 
themacer24: posts small blind $0.05
by.y.y.y86: posts big blind $0.10
*** HOLE CARDS ***
Morris_Chair: raises $0.20 to $0.30
Kow6oy: folds 
takis nik: folds 
Pekaml: raises $0.70 to $1
themacer24: folds 
by.y.y.y86: folds 
Morris_Chair: folds 
Uncalled bet ($0.70) returned to Pekaml
Pekaml collected $0.75 from pot
*** SUMMARY ***
Total pot $0.75 | Rake $0 
Seat 1: Pekaml (button) collected ($0.75)
Seat 2: themacer24 (small blind) folded before Flop
Seat 3: by.y.y.y86 (big blind) folded before Flop
Seat 4: Morris_Chair folded before Flop
Seat 5: Kow6oy folded before Flop (didn't bet)
Seat 6: takis nik folded before Flop (didn't bet)



PokerStars Hand #166667415641:  Hold'em No Limit ($0.05/$0.10 USD) - 2017/02/23 16:00:39 ET
Table 'Aludra II' 6-max Seat #3 is the button
Seat 1: voledy ($10.15 in chips) 
Seat 2: JahSoldier69 ($10.28 in chips) 
Seat 3: 2G28 ($11.60 in chips) 
Seat 4: MihaGr ($10 in chips) 
Seat 5: kingartur222 ($16 in chips) 
Seat 6: call me haaa ($15 in chips) 
MihaGr: posts small blind $0.05
kingartur222: posts big blind $0.10
*** HOLE CARDS ***
call me haaa: folds 
voledy: folds 
JahSoldier69: folds 
2G28: raises $0.10 to $0.20
MihaGr: folds 
kingartur222: folds 
Uncalled bet ($0.10) returned to 2G28
2G28 collected $0.25 from pot
*** SUMMARY ***
Total pot $0.25 | Rake $0 
Seat 1: voledy folded before Flop (didn't bet)
Seat 2: JahSoldier69 folded before Flop (didn't bet)
Seat 3: 2G28 (button) collected ($0.25)
Seat 4: MihaGr (small blind) folded before Flop
Seat 5: kingartur222 (big blind) folded before Flop
Seat 6: call me haaa folded before Flop (didn't bet)



PokerStars Hand #166667415891:  Hold'em No Limit ($0.05/$0.10 USD) - 2017/02/23 16:00:39 ET
Table 'Arpola' 6-max Seat #4 is the button
Seat 2: patrick19111 ($10.28 in chips) 
Seat 3: simaryk ($2.25 in chips) 
Seat 4: Orlangoor ($19.20 in chips) 
Seat 5: truck1234 ($11.84 in chips) 
Seat 6: Andrei ProFF ($10 in chips) 
truck1234: posts small blind $0.05
Andrei ProFF: posts big blind $0.10
Eddys Edge: sits out 
*** HOLE CARDS ***
patrick19111: folds 
simaryk: raises $0.10 to $0.20
Orlangoor: folds 
truck1234: folds 
Andrei ProFF: calls $0.10
*** FLOP *** [9c Qd Jc]
Eddys Edge leaves the table
Andrei ProFF: checks 
simaryk: checks 
*** TURN *** [9c Qd Jc] [7h]
Andrei ProFF: checks 
simaryk: bets $0.20
dincimus joins the table at seat #1 
Andrei ProFF: folds 
Uncalled bet ($0.20) returned to simaryk
simaryk collected $0.43 from pot
*** SUMMARY ***
Total pot $0.45 | Rake $0.02 
Board [9c Qd Jc 7h]
Seat 2: patrick19111 folded before Flop (didn't bet)
Seat 3: simaryk collected ($0.43)
Seat 4: Orlangoor (button) folded before Flop (didn't bet)
Seat 5: truck1234 (small blind) folded before Flop
Seat 6: Andrei ProFF (big blind) folded on the Turn



PokerStars Hand #166667416006:  Hold'em No Limit ($0.05/$0.10 USD) - 2017/02/23 16:00:39 ET
Table 'Phereclos II' 6-max Seat #4 is the button
Seat 2: Kazacha ($10.28 in chips) 
Seat 3: kickereens ($21.31 in chips) 
Seat 4: DamDatsAnAce ($10.23 in chips) 
Seat 5: Smitty03300 ($10 in chips) 
Seat 6: mhonielsen ($16.07 in chips) 
Smitty03300: posts small blind $0.05
mhonielsen: posts big blind $0.10
Croplayer1: sits out 
*** HOLE CARDS ***
Kazacha: folds 
kickereens: folds 
DamDatsAnAce: folds 
Smitty03300: folds 
Uncalled bet ($0.05) returned to mhonielsen
mhonielsen collected $0.10 from pot
*** SUMMARY ***
Total pot $0.10 | Rake $0 
Seat 2: Kazacha folded before Flop (didn't bet)
Seat 3: kickereens folded before Flop (didn't bet)
Seat 4: DamDatsAnAce (button) folded before Flop (didn't bet)
Seat 5: Smitty03300 (small blind) folded before Flop
Seat 6: mhonielsen (big blind) collected ($0.10)



PokerStars Hand #166667416116:  Hold'em No Limit ($0.05/$0.10 USD) - 2017/02/23 16:00:40 ET
Table 'Cyane' 6-max Seat #4 is the button
Seat 1: KA3AXCTAHEU, ($10.47 in chips) 
Seat 2: Temniy Elf ($10 in chips) 
Seat 3: Mamm0nism ($14.09 in chips) 
Seat 4: truck1234 ($20.96 in chips) 
Seat 5: ChuikaPridi ($10.22 in chips) 
Seat 6: 8th wonders ($10.15 in chips) 
ChuikaPridi: posts small blind $0.05
8th wonders: posts big blind $0.10
*** HOLE CARDS ***
KA3AXCTAHEU,: folds 
Temniy Elf: raises $0.15 to $0.25
Mamm0nism: folds 
truck1234: folds 
ChuikaPridi: folds 
8th wonders: folds 
Uncalled bet ($0.15) returned to Temniy Elf
Temniy Elf collected $0.25 from pot
*** SUMMARY ***
Total pot $0.25 | Rake $0 
Seat 1: KA3AXCTAHEU, folded before Flop (didn't bet)
Seat 2: Temniy Elf collected ($0.25)
Seat 3: Mamm0nism folded before Flop (didn't bet)
Seat 4: truck1234 (button) folded before Flop (didn't bet)
Seat 5: ChuikaPridi (small blind) folded before Flop
Seat 6: 8th wonders (big blind) folded before Flop



PokerStars Hand #166667416239:  Hold'em No Limit ($0.05/$0.10 USD) - 2017/02/23 16:00:40 ET
Table 'Siebohme' 6-max Seat #3 is the button
Seat 1: kusa4ki ($11.38 in chips) 
Seat 2: el toro 1507 ($11.68 in chips) 
Seat 3: ex3Lero86 ($10 in chips) 
Seat 4: Innerwuss ($10.14 in chips) 
Seat 5: Kazacha ($10.25 in chips) 
Seat 6: townerz1991 ($10.53 in chips) 
Innerwuss: posts small blind $0.05
Kazacha: posts big blind $0.10
*** HOLE CARDS ***
townerz1991: folds 
kusa4ki: folds 
el toro 1507: folds 
ex3Lero86: raises $0.13 to $0.23
Innerwuss: folds 
Kazacha: folds 
Uncalled bet ($0.13) returned to ex3Lero86
ex3Lero86 collected $0.25 from pot
*** SUMMARY ***
Total pot $0.25 | Rake $0 
Seat 1: kusa4ki folded before Flop (didn't bet)
Seat 2: el toro 1507 folded before Flop (didn't bet)
Seat 3: ex3Lero86 (button) collected ($0.25)
Seat 4: Innerwuss (small blind) folded before Flop
Seat 5: Kazacha (big blind) folded before Flop
Seat 6: townerz1991 folded before Flop (didn't bet)



PokerStars Hand #166667416331:  Hold'em No Limit ($0.05/$0.10 USD) - 2017/02/23 16:00:40 ET
Table 'Lampetia' 6-max Seat #4 is the button
Seat 1: WinninBikini ($11.24 in chips) 
Seat 2: ex3Lero86 ($10 in chips) 
Seat 3: Ice_Isayev ($10.73 in chips) 
Seat 4: Rodik002 ($14.64 in chips) 
Seat 5: luisantrs ($9.06 in chips) 
Seat 6: Scanner17 ($11.91 in chips) 
luisantrs: posts small blind $0.05
Scanner17: posts big blind $0.10
*** HOLE CARDS ***
WinninBikini: raises $0.20 to $0.30
ex3Lero86: folds 
Ice_Isayev: folds 
Rodik002: calls $0.30
luisantrs: folds 
Scanner17: folds 
*** FLOP *** [Jh 6c Ac]
WinninBikini: checks 
Rodik002: checks 
*** TURN *** [Jh 6c Ac] [Js]
WinninBikini: checks 
Rodik002: bets $0.30
WinninBikini: calls $0.30
*** RIVER *** [Jh 6c Ac Js] [5s]
WinninBikini: checks 
Rodik002: bets $0.30
WinninBikini: folds 
Uncalled bet ($0.30) returned to Rodik002
Rodik002 collected $1.29 from pot
*** SUMMARY ***
Total pot $1.35 | Rake $0.06 
Board [Jh 6c Ac Js 5s]
Seat 1: WinninBikini folded on the River
Seat 2: ex3Lero86 folded before Flop (didn't bet)
Seat 3: Ice_Isayev folded before Flop (didn't bet)
Seat 4: Rodik002 (button) collected ($1.29)
Seat 5: luisantrs (small blind) folded before Flop
Seat 6: Scanner17 (big blind) folded before Flop



PokerStars Hand #166667416399:  Hold'em No Limit ($0.05/$0.10 USD) - 2017/02/23 16:00:40 ET
Table 'Eudora' 6-max Seat #6 is the button
Seat 1: archer2511 ($10.68 in chips) 
Seat 2: popypaleta ($10 in chips) 
Seat 3: Ice_Isayev ($10 in chips) 
Seat 4: ZZPAWN ($11.25 in chips) 
Seat 5: chimera252 ($10.77 in chips) 
Seat 6: HARDCORE66RU ($10 in chips) 
archer2511: posts small blind $0.05
popypaleta: posts big blind $0.10
*** HOLE CARDS ***
Ice_Isayev: raises $0.20 to $0.30
ZZPAWN: calls $0.30
chimera252: raises $0.98 to $1.28
HARDCORE66RU: folds 
archer2511: folds 
popypaleta: folds 
Ice_Isayev: folds 
ZZPAWN: folds 
Uncalled bet ($0.98) returned to chimera252
chimera252 collected $1.05 from pot
*** SUMMARY ***
Total pot $1.05 | Rake $0 
Seat 1: archer2511 (small blind) folded before Flop
Seat 2: popypaleta (big blind) folded before Flop
Seat 3: Ice_Isayev folded before Flop
Seat 4: ZZPAWN folded before Flop
Seat 5: chimera252 collected ($1.05)
Seat 6: HARDCORE66RU (button) folded before Flop (didn't bet)



PokerStars Hand #166667416408:  Hold'em No Limit ($0.05/$0.10 USD) - 2017/02/23 16:00:40 ET
Table 'Halawe II' 6-max Seat #1 is the button
Seat 1: DIGOR100 ($6.60 in chips) 
Seat 2: Darkfrai ($10 in chips) 
Seat 3: cherep61987 ($10.87 in chips) 
Seat 4: voledy ($12.04 in chips) 
Seat 5: takis nik ($12.83 in chips) 
Seat 6: Rodik002 ($20.52 in chips) 
Darkfrai: posts small blind $0.05
cherep61987: posts big blind $0.10
*** HOLE CARDS ***
voledy: folds 
takis nik: folds 
Rodik002: folds 
DIGOR100: calls $0.10
Darkfrai: raises $0.30 to $0.40
cherep61987: folds 
DIGOR100: folds 
Uncalled bet ($0.30) returned to Darkfrai
Darkfrai collected $0.30 from pot
*** SUMMARY ***
Total pot $0.30 | Rake $0 
Seat 1: DIGOR100 (button) folded before Flop
Seat 2: Darkfrai (small blind) collected ($0.30)
Seat 3: cherep61987 (big blind) folded before Flop
Seat 4: voledy folded before Flop (didn't bet)
Seat 5: takis nik folded before Flop (didn't bet)
Seat 6: Rodik002 folded before Flop (didn't bet)



PokerStars Hand #166667416461:  Hold'em No Limit ($0.05/$0.10 USD) - 2017/02/23 16:00:40 ET
Table 'Crocus' 6-max Seat #6 is the button
Seat 1: truck1234 ($24.81 in chips) 
Seat 2: garigura ($11.53 in chips) 
Seat 3: Limpa Meza ($0.44 in chips) 
Seat 4: patrick19111 ($12.38 in chips) 
Seat 5: Golsuorsi ($10 in chips) 
Seat 6: Rodik002 ($10 in chips) 
truck1234: posts small blind $0.05
garigura: posts big blind $0.10
*** HOLE CARDS ***
Limpa Meza: folds 
patrick19111: folds 
Golsuorsi: folds 
Rodik002: folds 
truck1234: folds 
Uncalled bet ($0.05) returned to garigura
garigura collected $0.10 from pot
*** SUMMARY ***
Total pot $0.10 | Rake $0 
Seat 1: truck1234 (small blind) folded before Flop
Seat 2: garigura (big blind) collected ($0.10)
Seat 3: Limpa Meza folded before Flop (didn't bet)
Seat 4: patrick19111 folded before Flop (didn't bet)
Seat 5: Golsuorsi folded before Flop (didn't bet)
Seat 6: Rodik002 (button) folded before Flop (didn't bet)



PokerStars Hand #166667416551:  Hold'em No Limit ($0.05/$0.10 USD) - 2017/02/23 16:00:40 ET
Table 'Atropos' 6-max Seat #5 is the button
Seat 1: ScorpionF39 ($1.28 in chips) 
Seat 2: Ice_Isayev ($10.66 in chips) 
Seat 3: NvR.m1nD ($10.99 in chips) 
Seat 4: iDecMate ($13.05 in chips) 
Seat 5: KokoulinV ($12.09 in chips) 
Seat 6: Iarlei ($10.34 in chips) 
Iarlei: posts small blind $0.05
ScorpionF39: posts big blind $0.10
*** HOLE CARDS ***
Ice_Isayev: folds 
NvR.m1nD: folds 
iDecMate has timed out
iDecMate: folds 
KokoulinV: folds 
Iarlei: folds 
Uncalled bet ($0.05) returned to ScorpionF39
ScorpionF39 collected $0.10 from pot
*** SUMMARY ***
Total pot $0.10 | Rake $0 
Seat 1: ScorpionF39 (big blind) collected ($0.10)
Seat 2: Ice_Isayev folded before Flop (didn't bet)
Seat 3: NvR.m1nD folded before Flop (didn't bet)
Seat 4: iDecMate folded before Flop (didn't bet)
Seat 5: KokoulinV (button) folded before Flop (didn't bet)
Seat 6: Iarlei (small blind) folded before Flop



PokerStars Hand #166667416563:  Hold'em No Limit ($0.05/$0.10 USD) - 2017/02/23 16:00:40 ET
Table 'Repsolda' 6-max Seat #5 is the button
Seat 1: fabadam ($10 in chips) 
Seat 2: MBen10 ($26.06 in chips) 
Seat 3: manashov ($12.47 in chips) 
Seat 4: jamalungma ($10 in chips) 
Seat 5: danky24 ($7.45 in chips) 
Seat 6: RkaczoR ($10 in chips) 
RkaczoR: posts small blind $0.05
fabadam: posts big blind $0.10
*** HOLE CARDS ***
MBen10: folds 
manashov: folds 
jamalungma: folds 
danky24: folds 
RkaczoR: raises $0.20 to $0.30
fabadam: folds 
Uncalled bet ($0.20) returned to RkaczoR
RkaczoR collected $0.20 from pot
*** SUMMARY ***
Total pot $0.20 | Rake $0 
Seat 1: fabadam (big blind) folded before Flop
Seat 2: MBen10 folded before Flop (didn't bet)
Seat 3: manashov folded before Flop (didn't bet)
Seat 4: jamalungma folded before Flop (didn't bet)
Seat 5: danky24 (button) folded before Flop (didn't bet)
Seat 6: RkaczoR (small blind) collected ($0.20)



PokerStars Hand #166667416638:  Hold'em No Limit ($0.05/$0.10 USD) - 2017/02/23 16:00:40 ET
Table 'Fechtig III' 6-max Seat #2 is the button
Seat 1: Scanner17 ($10 in chips) 
Seat 2: GV82 ($14.92 in chips) 
Seat 3: eniksenik ($10.05 in chips) 
Seat 4: kickereens ($11.58 in chips) 
Seat 5: ksandr_hom ($10 in chips) 
Seat 6: Glatzemandse ($20.50 in chips) 
eniksenik: posts small blind $0.05
kickereens: posts big blind $0.10
*** HOLE CARDS ***
ksandr_hom: raises $0.20 to $0.30
Glatzemandse: calls $0.30
Scanner17: folds 
GV82: calls $0.30
eniksenik: folds 
kickereens: calls $0.20
*** FLOP *** [7s 3h Jd]
kickereens: checks 
ksandr_hom: checks 
Glatzemandse: checks 
GV82: bets $0.90
kickereens: folds 
ksandr_hom: folds 
Glatzemandse: folds 
Uncalled bet ($0.90) returned to GV82
GV82 collected $1.19 from pot
*** SUMMARY ***
Total pot $1.25 | Rake $0.06 
Board [7s 3h Jd]
Seat 1: Scanner17 folded before Flop (didn't bet)
Seat 2: GV82 (button) collected ($1.19)
Seat 3: eniksenik (small blind) folded before Flop
Seat 4: kickereens (big blind) folded on the Flop
Seat 5: ksandr_hom folded on the Flop
Seat 6: Glatzemandse folded on the Flop



PokerStars Hand #166667416687:  Hold'em No Limit ($0.05/$0.10 USD) - 2017/02/23 16:00:40 ET
Table 'Aisakos II' 6-max Seat #2 is the button
Seat 1: Crafty23@PS ($10 in chips) 
Seat 2: svaika24 ($17.63 in chips) 
Seat 3: iamkakaroto ($10.74 in chips) 
Seat 4: T9MS ($10 in chips) 
Seat 5: KokoulinV ($10.87 in chips) 
Seat 6: LarryTheStar ($10 in chips) 
iamkakaroto: posts small blind $0.05
T9MS: posts big blind $0.10
*** HOLE CARDS ***
KokoulinV: folds 
LarryTheStar: raises $0.20 to $0.30
Crafty23@PS: folds 
svaika24: folds 
iamkakaroto: folds 
T9MS: folds 
Uncalled bet ($0.20) returned to LarryTheStar
LarryTheStar collected $0.25 from pot
*** SUMMARY ***
Total pot $0.25 | Rake $0 
Seat 1: Crafty23@PS folded before Flop (didn't bet)
Seat 2: svaika24 (button) folded before Flop (didn't bet)
Seat 3: iamkakaroto (small blind) folded before Flop
Seat 4: T9MS (big blind) folded before Flop
Seat 5: KokoulinV folded before Flop (didn't bet)
Seat 6: LarryTheStar collected ($0.25)



PokerStars Hand #166667416782:  Hold'em No Limit ($0.05/$0.10 USD) - 2017/02/23 16:00:40 ET
Table 'Tyndareus III' 6-max Seat #3 is the button
Seat 1: MBen10 ($10 in chips) 
Seat 2: MihaGr ($10 in chips) 
Seat 3: XaXaTyH4uK ($10.60 in chips) 
Seat 4: Therodorus ($11.66 in chips) 
Seat 5: Chodemuncher ($10 in chips) 
Seat 6: Elinaattor ($9.52 in chips) 
Therodorus: posts small blind $0.05
Chodemuncher: posts big blind $0.10
*** HOLE CARDS ***
Elinaattor: folds 
MBen10: folds 
MihaGr: folds 
XaXaTyH4uK: folds 
Therodorus: folds 
Uncalled bet ($0.05) returned to Chodemuncher
Chodemuncher collected $0.10 from pot
*** SUMMARY ***
Total pot $0.10 | Rake $0 
Seat 1: MBen10 folded before Flop (didn't bet)
Seat 2: MihaGr folded before Flop (didn't bet)
Seat 3: XaXaTyH4uK (button) folded before Flop (didn't bet)
Seat 4: Therodorus (small blind) folded before Flop
Seat 5: Chodemuncher (big blind) collected ($0.10)
Seat 6: Elinaattor folded before Flop (didn't bet)



PokerStars Hand #166667417123:  Hold'em No Limit ($0.05/$0.10 USD) - 2017/02/23 16:00:41 ET
Table 'Stroobantia' 6-max Seat #5 is the button
Seat 1: mam9zyc ($8 in chips) 
Seat 2: XwinX25 ($10.30 in chips) 
Seat 3: Namhkal ($10 in chips) 
Seat 5: boxer821 ($10.27 in chips) 
Seat 6: KokoulinV ($15.42 in chips) 
KokoulinV: posts small blind $0.05
mam9zyc: posts big blind $0.10
Yspenyanin: sits out 
*** HOLE CARDS ***
XwinX25: folds 
Namhkal: folds 
boxer821: raises $0.15 to $0.25
KokoulinV: folds 
mam9zyc: calls $0.15
*** FLOP *** [3h 7h Qh]
mam9zyc: bets $0.10
boxer821: raises $0.50 to $0.60
mam9zyc: folds 
Uncalled bet ($0.50) returned to boxer821
boxer821 collected $0.72 from pot
*** SUMMARY ***
Total pot $0.75 | Rake $0.03 
Board [3h 7h Qh]
Seat 1: mam9zyc (big blind) folded on the Flop
Seat 2: XwinX25 folded before Flop (didn't bet)
Seat 3: Namhkal folded before Flop (didn't bet)
Seat 5: boxer821 (button) collected ($0.72)
Seat 6: KokoulinV (small blind) folded before Flop



PokerStars Hand #166667417334:  Hold'em No Limit ($0.05/$0.10 USD) - 2017/02/23 16:00:41 ET
Table 'Gaika II' 6-max Seat #1 is the button
Seat 1: Ice_Isayev ($10 in chips) 
Seat 2: steepfell ($10.37 in chips) 
Seat 3: iDecMate ($15.75 in chips) 
Seat 4: Hyd SK ($11.82 in chips) 
Seat 5: KokoulinV ($14.75 in chips) 
Seat 6: bartabs2 ($9.15 in chips) 
steepfell: posts small blind $0.05
iDecMate: posts big blind $0.10
*** HOLE CARDS ***
Hyd SK: folds 
KokoulinV: folds 
bartabs2: raises $0.10 to $0.20
Ice_Isayev: calls $0.20
steepfell: folds 
iDecMate: calls $0.10
*** FLOP *** [As Td Tc]
iDecMate: checks 
bartabs2: bets $0.20
Ice_Isayev: folds 
iDecMate: raises $0.60 to $0.80
bartabs2: folds 
Uncalled bet ($0.60) returned to iDecMate
iDecMate collected $1 from pot
*** SUMMARY ***
Total pot $1.05 | Rake $0.05 
Board [As Td Tc]
Seat 1: Ice_Isayev (button) folded on the Flop
Seat 2: steepfell (small blind) folded before Flop
Seat 3: iDecMate (big blind) collected ($1)
Seat 4: Hyd SK folded before Flop (didn't bet)
Seat 5: KokoulinV folded before Flop (didn't bet)
Seat 6: bartabs2 folded on the Flop



PokerStars Hand #166667417390:  Hold'em No Limit ($0.05/$0.10 USD) - 2017/02/23 16:00:41 ET
Table 'Lorbach' 6-max Seat #5 is the button
Seat 1: LarryTheStar ($11.27 in chips) 
Seat 2: fabadam ($12.48 in chips) 
Seat 3: ArcticBearDK ($11.05 in chips) 
Seat 4: McCleans ($10 in chips) 
Seat 5: Cluckh ($15.07 in chips) 
Seat 6: Worlz ($12.87 in chips) 
Worlz: posts small blind $0.05
LarryTheStar: posts big blind $0.10
*** HOLE CARDS ***
fabadam: folds 
ArcticBearDK: raises $0.15 to $0.25
McCleans: folds 
Cluckh: folds 
Worlz: folds 
LarryTheStar: folds 
Uncalled bet ($0.15) returned to ArcticBearDK
ArcticBearDK collected $0.25 from pot
*** SUMMARY ***
Total pot $0.25 | Rake $0 
Seat 1: LarryTheStar (big blind) folded before Flop
Seat 2: fabadam folded before Flop (didn't bet)
Seat 3: ArcticBearDK collected ($0.25)
Seat 4: McCleans folded before Flop (didn't bet)
Seat 5: Cluckh (button) folded before Flop (didn't bet)
Seat 6: Worlz (small blind) folded before Flop



PokerStars Hand #166667417482:  Hold'em No Limit ($0.05/$0.10 USD) - 2017/02/23 16:00:41 ET
Table 'Alnasl II' 6-max Seat #1 is the button
Seat 1: dragonste89 ($12.64 in chips) 
Seat 2: Therodorus ($11.96 in chips) 
Seat 3: ICBM-RS26 ($8.24 in chips) 
Seat 4: by.y.y.y86 ($10.35 in chips) 
Seat 5: mdelfin0 ($12.46 in chips) 
Seat 6: Bommer78 ($4.89 in chips) 
Therodorus: posts small blind $0.05
ICBM-RS26: posts big blind $0.10
*** HOLE CARDS ***
by.y.y.y86: folds 
mdelfin0: folds 
Bommer78: calls $0.10
dragonste89: folds 
by.y.y.y86 leaves the table
Therodorus: folds 
ICBM-RS26: checks 
*** FLOP *** [6d Qh 3c]
Eddys Edge joins the table at seat #4 
ICBM-RS26: checks 
Bommer78: checks 
*** TURN *** [6d Qh 3c] [Ad]
ICBM-RS26: checks 
Bommer78: checks 
*** RIVER *** [6d Qh 3c Ad] [Kh]
ICBM-RS26: checks 
Bommer78: bets $0.20
ICBM-RS26: folds 
Uncalled bet ($0.20) returned to Bommer78
Bommer78 collected $0.24 from pot
*** SUMMARY ***
Total pot $0.25 | Rake $0.01 
Board [6d Qh 3c Ad Kh]
Seat 1: dragonste89 (button) folded before Flop (didn't bet)
Seat 2: Therodorus (small blind) folded before Flop
Seat 3: ICBM-RS26 (big blind) folded on the River
Seat 4: by.y.y.y86 folded before Flop (didn't bet)
Seat 5: mdelfin0 folded before Flop (didn't bet)
Seat 6: Bommer78 collected ($0.24)



PokerStars Hand #166667417764:  Hold'em No Limit ($0.05/$0.10 USD) - 2017/02/23 16:00:42 ET
Table 'Senta II' 6-max Seat #4 is the button
Seat 2: NvR.m1nD ($10.78 in chips) 
Seat 3: Aescul@pius ($21.10 in chips) 
Seat 4: fedorka rus ($21.67 in chips) 
Seat 5: Algarah ($6.09 in chips) 
Seat 6: T9MS ($12.07 in chips) 
Algarah: posts small blind $0.05
T9MS: posts big blind $0.10
*** HOLE CARDS ***
NvR.m1nD: folds 
Aescul@pius: raises $0.20 to $0.30
fedorka rus: folds 
Algarah: folds 
T9MS: folds 
Uncalled bet ($0.20) returned to Aescul@pius
Aescul@pius collected $0.25 from pot
*** SUMMARY ***
Total pot $0.25 | Rake $0 
Seat 2: NvR.m1nD folded before Flop (didn't bet)
Seat 3: Aescul@pius collected ($0.25)
Seat 4: fedorka rus (button) folded before Flop (didn't bet)
Seat 5: Algarah (small blind) folded before Flop
Seat 6: T9MS (big blind) folded before Flop



PokerStars Hand #166667418104:  Hold'em No Limit ($0.05/$0.10 USD) - 2017/02/23 16:00:42 ET
Table 'Lampetia III' 6-max Seat #3 is the button
Seat 1: gaHy_HaXeP ($10.30 in chips) 
Seat 2: DamDatsAnAce ($10.10 in chips) 
Seat 3: Therodorus ($10.55 in chips) 
Seat 4: IAntikI ($10.44 in chips) 
Seat 5: robson1235 ($19.70 in chips) 
Seat 6: bdixon_5 ($9.50 in chips) 
IAntikI: posts small blind $0.05
robson1235: posts big blind $0.10
*** HOLE CARDS ***
bdixon_5: folds 
gaHy_HaXeP: folds 
DamDatsAnAce: folds 
Therodorus: raises $0.15 to $0.25
IAntikI: calls $0.20
robson1235: calls $0.15
*** FLOP *** [2h Kh Qs]
IAntikI: checks 
robson1235: checks 
Therodorus: checks 
*** TURN *** [2h Kh Qs] [Kc]
IAntikI: bets $0.45
robson1235: folds 
Therodorus: folds 
Uncalled bet ($0.45) returned to IAntikI
IAntikI collected $0.72 from pot
*** SUMMARY ***
Total pot $0.75 | Rake $0.03 
Board [2h Kh Qs Kc]
Seat 1: gaHy_HaXeP folded before Flop (didn't bet)
Seat 2: DamDatsAnAce folded before Flop (didn't bet)
Seat 3: Therodorus (button) folded on the Turn
Seat 4: IAntikI (small blind) collected ($0.72)
Seat 5: robson1235 (big blind) folded on the Turn
Seat 6: bdixon_5 folded before Flop (didn't bet)



PokerStars Hand #166667418238:  Hold'em No Limit ($0.05/$0.10 USD) - 2017/02/23 16:00:42 ET
Table 'Vaisala' 6-max Seat #6 is the button
Seat 1: Pekaml ($10 in chips) 
Seat 2: XaXaTyH4uK ($10 in chips) 
Seat 3: x3ultimate ($10 in chips) 
Seat 4: sexy_seagull ($11.56 in chips) 
Seat 6: Aleksey K228 ($15.31 in chips) 
Pekaml: posts small blind $0.05
XaXaTyH4uK: posts big blind $0.10
*** HOLE CARDS ***
AIONCMA1988 joins the table at seat #5 
x3ultimate: folds 
sexy_seagull: raises $0.20 to $0.30
Aleksey K228: calls $0.30
Pekaml: folds 
XaXaTyH4uK: folds 
*** FLOP *** [Kh 2h Jd]
sexy_seagull: checks 
Aleksey K228: checks 
*** TURN *** [Kh 2h Jd] [7h]
sexy_seagull: checks 
Aleksey K228: bets $0.40
sexy_seagull: folds 
Uncalled bet ($0.40) returned to Aleksey K228
Aleksey K228 collected $0.72 from pot
*** SUMMARY ***
Total pot $0.75 | Rake $0.03 
Board [Kh 2h Jd 7h]
Seat 1: Pekaml (small blind) folded before Flop
Seat 2: XaXaTyH4uK (big blind) folded before Flop
Seat 3: x3ultimate folded before Flop (didn't bet)
Seat 4: sexy_seagull folded on the Turn
Seat 6: Aleksey K228 (button) collected ($0.72)



PokerStars Hand #166667418295:  Hold'em No Limit ($0.05/$0.10 USD) - 2017/02/23 16:00:42 ET
Table 'Serpens' 6-max Seat #6 is the button
Seat 1: Namhkal ($10 in chips) 
Seat 2: KA3AXCTAHEU, ($10.43 in chips) 
Seat 3: homelessdan ($28.50 in chips) 
Seat 4: Ragazzi3 ($17.19 in chips) 
Seat 5: XwinX25 ($11.81 in chips) 
Seat 6: Croplayer1 ($10 in chips) 
Namhkal: posts small blind $0.05
KA3AXCTAHEU,: posts big blind $0.10
*** HOLE CARDS ***
homelessdan: folds 
Ragazzi3: folds 
XwinX25: folds 
Croplayer1: raises $0.10 to $0.20
Namhkal: folds 
KA3AXCTAHEU,: folds 
Uncalled bet ($0.10) returned to Croplayer1
Croplayer1 collected $0.25 from pot
*** SUMMARY ***
Total pot $0.25 | Rake $0 
Seat 1: Namhkal (small blind) folded before Flop
Seat 2: KA3AXCTAHEU, (big blind) folded before Flop
Seat 3: homelessdan folded before Flop (didn't bet)
Seat 4: Ragazzi3 folded before Flop (didn't bet)
Seat 5: XwinX25 folded before Flop (didn't bet)
Seat 6: Croplayer1 (button) collected ($0.25)



PokerStars Hand #166667418498:  Hold'em No Limit ($0.05/$0.10 USD) - 2017/02/23 16:00:43 ET
Table 'Marbachia II' 6-max Seat #5 is the button
Seat 1: AC Evergreen ($10 in chips) 
Seat 2: Yabidooo ($10 in chips) 
Seat 3: CDestructivo ($16.38 in chips) 
Seat 4: BahiaMinhaP ($10 in chips) 
Seat 5: Kow6oy ($10 in chips) 
Seat 6: DamDatsAnAce ($10 in chips) 
DamDatsAnAce: posts small blind $0.05
AC Evergreen: posts big blind $0.10
*** HOLE CARDS ***
Yabidooo: folds 
CDestructivo: calls $0.10
BahiaMinhaP: folds 
Kow6oy: folds 
DamDatsAnAce: raises $0.30 to $0.40
AC Evergreen: folds 
CDestructivo: calls $0.30
*** FLOP *** [7d As 4h]
DamDatsAnAce: bets $0.65
CDestructivo: calls $0.65
*** TURN *** [7d As 4h] [Jd]
DamDatsAnAce: checks 
CDestructivo: bets $1.05
DamDatsAnAce: raises $1.55 to $2.60
CDestructivo: raises $1.55 to $4.15
DamDatsAnAce: raises $4.80 to $8.95 and is all-in
CDestructivo: calls $4.80
*** RIVER *** [7d As 4h Jd] [Td]
*** SHOW DOWN ***
DamDatsAnAce: shows [7c 7s] (three of a kind, Sevens)
CDestructivo: shows [Qd Ad] (a flush, Ace high)
CDestructivo collected $19.20 from pot
*** SUMMARY ***
Total pot $20.10 | Rake $0.90 
Board [7d As 4h Jd Td]
Seat 1: AC Evergreen (big blind) folded before Flop
Seat 2: Yabidooo folded before Flop (didn't bet)
Seat 3: CDestructivo showed [Qd Ad] and won ($19.20) with a flush, Ace high
Seat 4: BahiaMinhaP folded before Flop (didn't bet)
Seat 5: Kow6oy (button) folded before Flop (didn't bet)
Seat 6: DamDatsAnAce (small blind) showed [7c 7s] and lost with three of a kind, Sevens



PokerStars Hand #166667418575:  Hold'em No Limit ($0.05/$0.10 USD) - 2017/02/23 16:00:43 ET
Table 'Reginhild' 6-max Seat #1 is the button
Seat 1: iamkakaroto ($11.40 in chips) 
Seat 2: Kow6oy ($10 in chips) 
Seat 3: ARCHITECT83 ($4.94 in chips) 
Seat 4: Raymondo21 ($23.66 in chips) 
Seat 5: XCarlos610 ($28.64 in chips) 
Seat 6: eniksenik ($11.09 in chips) 
Kow6oy: posts small blind $0.05
ARCHITECT83: posts big blind $0.10
*** HOLE CARDS ***
Raymondo21: folds 
XCarlos610: folds 
eniksenik: raises $0.20 to $0.30
iamkakaroto: folds 
Kow6oy: calls $0.25
ARCHITECT83: calls $0.20
*** FLOP *** [Ad 5s Qc]
Kow6oy: checks 
ARCHITECT83: bets $0.20
eniksenik: folds 
Kow6oy: folds 
Uncalled bet ($0.20) returned to ARCHITECT83
ARCHITECT83 collected $0.86 from pot
*** SUMMARY ***
Total pot $0.90 | Rake $0.04 
Board [Ad 5s Qc]
Seat 1: iamkakaroto (button) folded before Flop (didn't bet)
Seat 2: Kow6oy (small blind) folded on the Flop
Seat 3: ARCHITECT83 (big blind) collected ($0.86)
Seat 4: Raymondo21 folded before Flop (didn't bet)
Seat 5: XCarlos610 folded before Flop (didn't bet)
Seat 6: eniksenik folded on the Flop



PokerStars Hand #166667418594:  Hold'em No Limit ($0.05/$0.10 USD) - 2017/02/23 16:00:43 ET
Table 'Orthos III' 6-max Seat #5 is the button
Seat 1: sexy_seagull ($10.15 in chips) 
Seat 2: Xander188 ($16.18 in chips) 
Seat 3: koka4cs ($7.07 in chips) 
Seat 4: FlopsterGB ($14.79 in chips) 
Seat 5: Bird et al ($20.54 in chips) 
Seat 6: RoJ1 ($10.29 in chips) 
RoJ1: posts small blind $0.05
sexy_seagull: posts big blind $0.10
*** HOLE CARDS ***
Xander188: folds 
koka4cs: folds 
FlopsterGB: folds 
Bird et al: raises $0.15 to $0.25
RoJ1: raises $0.60 to $0.85
sexy_seagull: folds 
Bird et al: folds 
Uncalled bet ($0.60) returned to RoJ1
RoJ1 collected $0.60 from pot
*** SUMMARY ***
Total pot $0.60 | Rake $0 
Seat 1: sexy_seagull (big blind) folded before Flop
Seat 2: Xander188 folded before Flop (didn't bet)
Seat 3: koka4cs folded before Flop (didn't bet)
Seat 4: FlopsterGB folded before Flop (didn't bet)
Seat 5: Bird et al (button) folded before Flop
Seat 6: RoJ1 (small blind) collected ($0.60)



PokerStars Hand #166667418875:  Hold'em No Limit ($0.05/$0.10 USD) - 2017/02/23 16:00:43 ET
Table 'Ophelia' 6-max Seat #2 is the button
Seat 1: ralfi37 ($11.01 in chips) 
Seat 2: popypaleta ($16.12 in chips) 
Seat 3: mvp0013 ($11.65 in chips) 
Seat 4: Cluckh ($11.65 in chips) 
Seat 5: truck1234 ($14.01 in chips) 
Seat 6: Yabidooo ($10.72 in chips) 
mvp0013: posts small blind $0.05
Cluckh: posts big blind $0.10
*** HOLE CARDS ***
truck1234: folds 
Yabidooo: folds 
ralfi37: folds 
popypaleta: folds 
mvp0013: folds 
Uncalled bet ($0.05) returned to Cluckh
Cluckh collected $0.10 from pot
*** SUMMARY ***
Total pot $0.10 | Rake $0 
Seat 1: ralfi37 folded before Flop (didn't bet)
Seat 2: popypaleta (button) folded before Flop (didn't bet)
Seat 3: mvp0013 (small blind) folded before Flop
Seat 4: Cluckh (big blind) collected ($0.10)
Seat 5: truck1234 folded before Flop (didn't bet)
Seat 6: Yabidooo folded before Flop (didn't bet)



PokerStars Hand #166667418970:  Hold'em No Limit ($0.05/$0.10 USD) - 2017/02/23 16:00:43 ET
Table 'Joella' 6-max Seat #5 is the button
Seat 1: Dcaro31 ($13.40 in chips) 
Seat 2: Kaelyns_Bark ($10.06 in chips) 
Seat 3: Joker51_wtf! ($10.20 in chips) 
Seat 5: Anestakis777 ($4.96 in chips) 
Seat 6: dr.goofy ($10 in chips) 
dr.goofy: posts small blind $0.05
Dcaro31: posts big blind $0.10
*** HOLE CARDS ***
Kaelyns_Bark: calls $0.10
Joker51_wtf!: folds 
Anestakis777: calls $0.10
dr.goofy: folds 
Dcaro31: checks 
*** FLOP *** [As Qh 8s]
Dcaro31: checks 
Kaelyns_Bark: checks 
Anestakis777: checks 
*** TURN *** [As Qh 8s] [Js]
Dcaro31: checks 
Kaelyns_Bark: checks 
Anestakis777: bets $0.30
Dcaro31: folds 
Kaelyns_Bark: folds 
Uncalled bet ($0.30) returned to Anestakis777
Anestakis777 collected $0.33 from pot
*** SUMMARY ***
Total pot $0.35 | Rake $0.02 
Board [As Qh 8s Js]
Seat 1: Dcaro31 (big blind) folded on the Turn
Seat 2: Kaelyns_Bark folded on the Turn
Seat 3: Joker51_wtf! folded before Flop (didn't bet)
Seat 5: Anestakis777 (button) collected ($0.33)
Seat 6: dr.goofy (small blind) folded before Flop



PokerStars Hand #166667419468:  Hold'em No Limit ($0.05/$0.10 USD) - 2017/02/23 16:00:44 ET
Table 'Peiroos III' 6-max Seat #6 is the button
Seat 1: tequila_joop ($10.18 in chips) 
Seat 3: nabatov.m ($5.72 in chips) 
Seat 4: pivanki11 ($11.15 in chips) 
Seat 5: ChuikaPridi ($9.68 in chips) 
Seat 6: CHRO8 ($9.89 in chips) 
tequila_joop: posts small blind $0.05
nabatov.m: posts big blind $0.10
tequila_joop: posts the ante $0.02
nabatov.m: posts the ante $0.02
pivanki11: posts the ante $0.02
ChuikaPridi: posts the ante $0.02
CHRO8: posts the ante $0.02
*** HOLE CARDS ***
pivanki11: folds 
ChuikaPridi: folds 
CHRO8: raises $0.20 to $0.30
tequila_joop: folds 
nabatov.m: calls $0.20
*** FLOP *** [9c Ks Th]
nabatov.m: checks 
CHRO8: checks 
*** TURN *** [9c Ks Th] [6h]
nabatov.m: checks 
CHRO8: checks 
*** RIVER *** [9c Ks Th 6h] [2h]
nabatov.m: bets $0.36
CHRO8: folds 
Uncalled bet ($0.36) returned to nabatov.m
nabatov.m collected $0.72 from pot
*** SUMMARY ***
Total pot $0.75 | Rake $0.03 
Board [9c Ks Th 6h 2h]
Seat 1: tequila_joop (small blind) folded before Flop
Seat 3: nabatov.m (big blind) collected ($0.72)
Seat 4: pivanki11 folded before Flop (didn't bet)
Seat 5: ChuikaPridi folded before Flop (didn't bet)
Seat 6: CHRO8 (button) folded on the River



PokerStars Hand #166667419538:  Hold'em No Limit ($0.05/$0.10 USD) - 2017/02/23 16:00:44 ET
Table 'Pallas II' 6-max Seat #4 is the button
Seat 1: mdelfin0 ($16.03 in chips) 
Seat 2: FRAID358 ($10 in chips) 
Seat 3: jamalungma ($10 in chips) 
Seat 4: Mr. Bluff 34 ($10.29 in chips) 
Seat 6: xdjango07x ($12.43 in chips) 
Yspenyanin will be allowed to play after the button
xdjango07x: posts small blind $0.05
mdelfin0: posts big blind $0.10
*** HOLE CARDS ***
FRAID358: raises $0.20 to $0.30
jamalungma: folds 
Mr. Bluff 34: folds 
xdjango07x: folds 
mdelfin0: folds 
Uncalled bet ($0.20) returned to FRAID358
FRAID358 collected $0.25 from pot
*** SUMMARY ***
Total pot $0.25 | Rake $0 
Seat 1: mdelfin0 (big blind) folded before Flop
Seat 2: FRAID358 collected ($0.25)
Seat 3: jamalungma folded before Flop (didn't bet)
Seat 4: Mr. Bluff 34 (button) folded before Flop (didn't bet)
Seat 6: xdjango07x (small blind) folded before Flop



PokerStars Hand #166667419571:  Hold'em No Limit ($0.05/$0.10 USD) - 2017/02/23 16:00:44 ET
Table 'Tyche III' 6-max Seat #3 is the button
Seat 1: milt65 ($10.16 in chips) 
Seat 2: arti192837 ($12.53 in chips) 
Seat 3: ChuikaPridi ($9.79 in chips) 
Seat 4: Kazacha ($10 in chips) 
Seat 5: chimera252 ($10.85 in chips) 
Seat 6: Ice_Isayev ($10 in chips) 
Kazacha: posts small blind $0.05
chimera252: posts big blind $0.10
*** HOLE CARDS ***
Ice_Isayev: folds 
milt65: raises $0.15 to $0.25
arti192837: folds 
ChuikaPridi: folds 
Kazacha: folds 
chimera252: folds 
Uncalled bet ($0.15) returned to milt65
milt65 collected $0.25 from pot
*** SUMMARY ***
Total pot $0.25 | Rake $0 
Seat 1: milt65 collected ($0.25)
Seat 2: arti192837 folded before Flop (didn't bet)
Seat 3: ChuikaPridi (button) folded before Flop (didn't bet)
Seat 4: Kazacha (small blind) folded before Flop
Seat 5: chimera252 (big blind) folded before Flop
Seat 6: Ice_Isayev folded before Flop (didn't bet)



PokerStars Hand #166667420187:  Hold'em No Limit ($0.05/$0.10 USD) - 2017/02/23 16:00:45 ET
Table 'Armenia' 6-max Seat #6 is the button
Seat 1: tr41n3r12 ($12.22 in chips) 
Seat 2: Yabidooo ($10 in chips) 
Seat 3: CDestructivo ($12.28 in chips) 
Seat 4: x3ultimate ($11.10 in chips) 
Seat 5: boxer821 ($11.85 in chips) 
Seat 6: mega spasser ($5.22 in chips) 
tr41n3r12: posts small blind $0.05
Yabidooo: posts big blind $0.10
*** HOLE CARDS ***
CDestructivo: folds 
x3ultimate: raises $0.20 to $0.30
boxer821: folds 
mega spasser: folds 
tr41n3r12: folds 
Yabidooo: folds 
Uncalled bet ($0.20) returned to x3ultimate
x3ultimate collected $0.25 from pot
*** SUMMARY ***
Total pot $0.25 | Rake $0 
Seat 1: tr41n3r12 (small blind) folded before Flop
Seat 2: Yabidooo (big blind) folded before Flop
Seat 3: CDestructivo folded before Flop (didn't bet)
Seat 4: x3ultimate collected ($0.25)
Seat 5: boxer821 folded before Flop (didn't bet)
Seat 6: mega spasser (button) folded before Flop (didn't bet)



PokerStars Hand #166667420321:  Hold'em No Limit ($0.05/$0.10 USD) - 2017/02/23 16:00:45 ET
Table 'Tristan III' 6-max Seat #2 is the button
Seat 1: CHRO8 ($20.35 in chips) 
Seat 2: Hyd SK ($15.63 in chips) 
Seat 3: fedorka rus ($13.10 in chips) 
Seat 4: Feverhead ($11.28 in chips) 
Seat 5: david_sara83 ($10.76 in chips) 
Seat 6: joewatson90 ($10 in chips) 
fedorka rus: posts small blind $0.05
Feverhead: posts big blind $0.10
*** HOLE CARDS ***
david_sara83: folds 
joewatson90: folds 
CHRO8: folds 
Hyd SK: raises $0.15 to $0.25
fedorka rus: folds 
Feverhead: raises $0.60 to $0.85
Hyd SK: folds 
Uncalled bet ($0.60) returned to Feverhead
Feverhead collected $0.55 from pot
*** SUMMARY ***
Total pot $0.55 | Rake $0 
Seat 1: CHRO8 folded before Flop (didn't bet)
Seat 2: Hyd SK (button) folded before Flop
Seat 3: fedorka rus (small blind) folded before Flop
Seat 4: Feverhead (big blind) collected ($0.55)
Seat 5: david_sara83 folded before Flop (didn't bet)
Seat 6: joewatson90 folded before Flop (didn't bet)



PokerStars Hand #166667420393:  Hold'em No Limit ($0.05/$0.10 USD) - 2017/02/23 16:00:45 ET
Table 'Brendelia II' 6-max Seat #5 is the button
Seat 2: Crimsonr ($7.03 in chips) 
Seat 5: Kupi007 ($27.17 in chips) 
Seat 6: luckyPositiv ($9.88 in chips) 
luckyPositiv: posts small blind $0.05
RkaczoR: is sitting out 
Crimsonr: posts big blind $0.10
ValdemorS: sits out 
Crimsonr: posts the ante $0.02
Kupi007: posts the ante $0.02
luckyPositiv: posts the ante $0.02
*** HOLE CARDS ***
Kupi007: raises $0.10 to $0.20
RkaczoR leaves the table
luckyPositiv: folds 
Crimsonr: calls $0.10
*** FLOP *** [Qs 6c 9s]
Crimsonr: checks 
Kupi007: bets $0.35
Crimsonr: folds 
Uncalled bet ($0.35) returned to Kupi007
Kupi007 collected $0.49 from pot
*** SUMMARY ***
Total pot $0.51 | Rake $0.02 
Board [Qs 6c 9s]
Seat 2: Crimsonr (big blind) folded on the Flop
Seat 5: Kupi007 (button) collected ($0.49)
Seat 6: luckyPositiv (small blind) folded before Flop



PokerStars Hand #166667420440:  Hold'em No Limit ($0.05/$0.10 USD) - 2017/02/23 16:00:45 ET
Table 'Aegle' 6-max Seat #6 is the button
Seat 3: Crafty23@PS ($10.05 in chips) 
Seat 4: ab260414 ($11.05 in chips) 
Seat 5: KokoulinV ($11.18 in chips) 
Seat 6: CHRO8 ($20.59 in chips) 
Crafty23@PS: posts small blind $0.05
ab260414: posts big blind $0.10
*** HOLE CARDS ***
KokoulinV: folds 
CHRO8: folds 
Crafty23@PS: raises $0.20 to $0.30
ab260414: calls $0.20
*** FLOP *** [7d 7h 2c]
Crafty23@PS: checks 
ab260414: bets $0.29
Crafty23@PS: folds 
Uncalled bet ($0.29) returned to ab260414
ab260414 collected $0.57 from pot
*** SUMMARY ***
Total pot $0.60 | Rake $0.03 
Board [7d 7h 2c]
Seat 3: Crafty23@PS (small blind) folded on the Flop
Seat 4: ab260414 (big blind) collected ($0.57)
Seat 5: KokoulinV folded before Flop (didn't bet)
Seat 6: CHRO8 (button) folded before Flop (didn't bet)



PokerStars Hand #166667420472:  Hold'em No Limit ($0.05/$0.10 USD) - 2017/02/23 16:00:45 ET
Table 'Eurykleia' 6-max Seat #2 is the button
Seat 1: Giyorod ($10.15 in chips) 
Seat 2: x3ultimate ($10.07 in chips) 
Seat 3: boxer821 ($20.33 in chips) 
Seat 4: 6ePeMeHHa9 ($16.66 in chips) 
Seat 6: afca128 ($6.57 in chips) 
boxer821: posts small blind $0.05
6ePeMeHHa9: posts big blind $0.10
fishhook5: sits out 
*** HOLE CARDS ***
afca128: folds 
Giyorod: raises $0.20 to $0.30
x3ultimate: raises $0.60 to $0.90
boxer821: folds 
6ePeMeHHa9: folds 
Giyorod: raises $1.95 to $2.85
x3ultimate: folds 
Uncalled bet ($1.95) returned to Giyorod
Giyorod collected $1.95 from pot
*** SUMMARY ***
Total pot $1.95 | Rake $0 
Seat 1: Giyorod collected ($1.95)
Seat 2: x3ultimate (button) folded before Flop
Seat 3: boxer821 (small blind) folded before Flop
Seat 4: 6ePeMeHHa9 (big blind) folded before Flop
Seat 6: afca128 folded before Flop (didn't bet)



PokerStars Hand #166667420518:  Hold'em No Limit ($0.05/$0.10 USD) - 2017/02/23 16:00:45 ET
Table 'Peiroos' 6-max Seat #2 is the button
Seat 1: ksandr_hom ($10 in chips) 
Seat 2: Nr847 ($10 in chips) 
Seat 3: atlx0711 ($21.92 in chips) 
Seat 4: Peter0087 ($7.79 in chips) 
Seat 5: sergio-cb164 ($9.55 in chips) 
Seat 6: DevonMiles88 ($9.42 in chips) 
atlx0711: posts small blind $0.05
Peter0087: posts big blind $0.10
*** HOLE CARDS ***
sergio-cb164: folds 
DevonMiles88: calls $0.10
ksandr_hom: folds 
Nr847: folds 
atlx0711: calls $0.05
Peter0087: checks 
*** FLOP *** [9h Td As]
atlx0711: checks 
Peter0087: bets $0.30
DevonMiles88: folds 
atlx0711: folds 
Uncalled bet ($0.30) returned to Peter0087
Peter0087 collected $0.29 from pot
*** SUMMARY ***
Total pot $0.30 | Rake $0.01 
Board [9h Td As]
Seat 1: ksandr_hom folded before Flop (didn't bet)
Seat 2: Nr847 (button) folded before Flop (didn't bet)
Seat 3: atlx0711 (small blind) folded on the Flop
Seat 4: Peter0087 (big blind) collected ($0.29)
Seat 5: sergio-cb164 folded before Flop (didn't bet)
Seat 6: DevonMiles88 folded on the Flop



PokerStars Hand #166667420630:  Hold'em No Limit ($0.05/$0.10 USD) - 2017/02/23 16:00:45 ET
Table 'Sheragul III' 6-max Seat #4 is the button
Seat 1: danky24 ($17.36 in chips) 
Seat 2: Bird et al ($11.96 in chips) 
Seat 4: maxiv608 ($11.24 in chips) 
Seat 5: Bandyaev ($14.71 in chips) 
Seat 6: Andrei ProFF ($10 in chips) 
Bandyaev: posts small blind $0.05
Andrei ProFF: posts big blind $0.10
*** HOLE CARDS ***
danky24: raises $0.10 to $0.20
Bird et al: folds 
maxiv608: folds 
Bandyaev: calls $0.15
Andrei ProFF: folds 
*** FLOP *** [5s 3s Qs]
Bandyaev: checks 
danky24: bets $0.20
Bandyaev: folds 
Uncalled bet ($0.20) returned to danky24
danky24 collected $0.48 from pot
*** SUMMARY ***
Total pot $0.50 | Rake $0.02 
Board [5s 3s Qs]
Seat 1: danky24 collected ($0.48)
Seat 2: Bird et al folded before Flop (didn't bet)
Seat 4: maxiv608 (button) folded before Flop (didn't bet)
Seat 5: Bandyaev (small blind) folded on the Flop
Seat 6: Andrei ProFF (big blind) folded before Flop



PokerStars Hand #166667420662:  Hold'em No Limit ($0.05/$0.10 USD) - 2017/02/23 16:00:45 ET
Table 'Rosalia' 6-max Seat #6 is the button
Seat 1: Hyd SK ($10 in chips) 
Seat 2: Bandyaev ($11.71 in chips) 
Seat 3: Andy Wolf ($12.48 in chips) 
Seat 5: miron762 ($8.80 in chips) 
Seat 6: facewald ($17.64 in chips) 
Hyd SK: posts small blind $0.05
Bandyaev: posts big blind $0.10
THIMUCHIN: sits out 
*** HOLE CARDS ***
Andy Wolf: folds 
miron762: calls $0.10
facewald: raises $0.30 to $0.40
Hyd SK: folds 
Bandyaev: folds 
miron762: calls $0.30
*** FLOP *** [2d Qh 6c]
miron762: bets $0.10
facewald: raises $0.55 to $0.65
miron762: calls $0.55
*** TURN *** [2d Qh 6c] [4d]
miron762: checks 
facewald: bets $1.61
miron762: folds 
Uncalled bet ($1.61) returned to facewald
facewald collected $2.15 from pot
*** SUMMARY ***
Total pot $2.25 | Rake $0.10 
Board [2d Qh 6c 4d]
Seat 1: Hyd SK (small blind) folded before Flop
Seat 2: Bandyaev (big blind) folded before Flop
Seat 3: Andy Wolf folded before Flop (didn't bet)
Seat 5: miron762 folded on the Turn
Seat 6: facewald (button) collected ($2.15)



PokerStars Hand #166667420752:  Hold'em No Limit ($0.05/$0.10 USD) - 2017/02/23 16:00:45 ET
Table 'Vesta II' 6-max Seat #1 is the button
Seat 1: Yabidooo ($12.93 in chips) 
Seat 2: joewatson90 ($10 in chips) 
Seat 3: Pokeaster ($12.16 in chips) 
Seat 4: Dcaro31 ($10.42 in chips) 
Seat 5: Andy Wolf ($11.87 in chips) 
Seat 6: CDestructivo ($13.59 in chips) 
joewatson90: posts small blind $0.05
Pokeaster: posts big blind $0.10
*** HOLE CARDS ***
Dcaro31: folds 
Andy Wolf: folds 
CDestructivo: folds 
Yabidooo: raises $0.10 to $0.20
joewatson90: folds 
Pokeaster: calls $0.10
*** FLOP *** [9s Jd 8d]
Pokeaster: checks 
Yabidooo: bets $0.29
Pokeaster: folds 
Uncalled bet ($0.29) returned to Yabidooo
Yabidooo collected $0.43 from pot
*** SUMMARY ***
Total pot $0.45 | Rake $0.02 
Board [9s Jd 8d]
Seat 1: Yabidooo (button) collected ($0.43)
Seat 2: joewatson90 (small blind) folded before Flop
Seat 3: Pokeaster (big blind) folded on the Flop
Seat 4: Dcaro31 folded before Flop (didn't bet)
Seat 5: Andy Wolf folded before Flop (didn't bet)
Seat 6: CDestructivo folded before Flop (didn't bet)



PokerStars Hand #166667420965:  Hold'em No Limit ($0.05/$0.10 USD) - 2017/02/23 16:00:46 ET
Table 'Pirola' 6-max Seat #6 is the button
Seat 1: Rodik002 ($11.77 in chips) 
Seat 2: lmlmlmlm90 ($18.55 in chips) 
Seat 3: XaXaTyH4uK ($11.77 in chips) 
Seat 4: barons89 ($9.50 in chips) 
Seat 5: Iarlei ($14.39 in chips) 
Seat 6: Hyd SK ($10 in chips) 
Rodik002: posts small blind $0.05
lmlmlmlm90: posts big blind $0.10
*** HOLE CARDS ***
XaXaTyH4uK: folds 
barons89: raises $0.20 to $0.30
Iarlei: folds 
Hyd SK: folds 
Rodik002: raises $0.70 to $1
lmlmlmlm90: folds 
barons89: calls $0.70
*** FLOP *** [Ks 2d Js]
Rodik002: bets $1.40
barons89: folds 
Uncalled bet ($1.40) returned to Rodik002
Rodik002 collected $2.01 from pot
*** SUMMARY ***
Total pot $2.10 | Rake $0.09 
Board [Ks 2d Js]
Seat 1: Rodik002 (small blind) collected ($2.01)
Seat 2: lmlmlmlm90 (big blind) folded before Flop
Seat 3: XaXaTyH4uK folded before Flop (didn't bet)
Seat 4: barons89 folded on the Flop
Seat 5: Iarlei folded before Flop (didn't bet)
Seat 6: Hyd SK (button) folded before Flop (didn't bet)



PokerStars Hand #166667421012:  Hold'em No Limit ($0.05/$0.10 USD) - 2017/02/23 16:00:46 ET
Table 'Pandora III' 6-max Seat #4 is the button
Seat 1: Pokeaster ($11.14 in chips) 
Seat 2: garigura ($11.47 in chips) 
Seat 3: ChuikaPridi ($16.61 in chips) 
Seat 4: mhonielsen ($10 in chips) 
Seat 5: MühliJr ($10.20 in chips) 
MühliJr: posts small blind $0.05
IAntikI: is sitting out 
Pokeaster: posts big blind $0.10
*** HOLE CARDS ***
IAntikI leaves the table
garigura: raises $0.20 to $0.30
ChuikaPridi: folds 
mhonielsen: folds 
MühliJr: folds 
Pokeaster: folds 
Uncalled bet ($0.20) returned to garigura
garigura collected $0.25 from pot
*** SUMMARY ***
Total pot $0.25 | Rake $0 
Seat 1: Pokeaster (big blind) folded before Flop
Seat 2: garigura collected ($0.25)
Seat 3: ChuikaPridi folded before Flop (didn't bet)
Seat 4: mhonielsen (button) folded before Flop (didn't bet)
Seat 5: MühliJr (small blind) folded before Flop



PokerStars Hand #166667421080:  Hold'em No Limit ($0.05/$0.10 USD) - 2017/02/23 16:00:46 ET
Table 'Risha II' 6-max Seat #6 is the button
Seat 1: R. Lemonte ($10.36 in chips) 
Seat 2: KA3AXCTAHEU, ($12.80 in chips) 
Seat 3: steepfell ($10 in chips) 
Seat 4: Comeback3392 ($23.33 in chips) 
Seat 5: m.c-alkatraz ($10.50 in chips) 
Seat 6: univibe68 ($10.61 in chips) 
R. Lemonte: posts small blind $0.05
KA3AXCTAHEU,: posts big blind $0.10
*** HOLE CARDS ***
steepfell: folds 
Comeback3392: folds 
m.c-alkatraz: raises $0.20 to $0.30
univibe68: folds 
R. Lemonte: calls $0.25
KA3AXCTAHEU,: folds 
*** FLOP *** [2s 2h Tc]
R. Lemonte: bets $0.67
m.c-alkatraz: folds 
Uncalled bet ($0.67) returned to R. Lemonte
R. Lemonte collected $0.67 from pot
*** SUMMARY ***
Total pot $0.70 | Rake $0.03 
Board [2s 2h Tc]
Seat 1: R. Lemonte (small blind) collected ($0.67)
Seat 2: KA3AXCTAHEU, (big blind) folded before Flop
Seat 3: steepfell folded before Flop (didn't bet)
Seat 4: Comeback3392 folded before Flop (didn't bet)
Seat 5: m.c-alkatraz folded on the Flop
Seat 6: univibe68 (button) folded before Flop (didn't bet)



PokerStars Hand #166667421433:  Hold'em No Limit ($0.05/$0.10 USD) - 2017/02/23 16:00:46 ET
Table 'Sirius II' 6-max Seat #2 is the button
Seat 1: Ampped87 ($9.37 in chips) 
Seat 2: jamalungma ($20.53 in chips) 
Seat 3: Spud014 ($10.13 in chips) 
Seat 6: MihaGr ($10 in chips) 
Spud014: posts small blind $0.05
MihaGr: posts big blind $0.10
*** HOLE CARDS ***
Ampped87: folds 
jamalungma: folds 
Spud014: folds 
Uncalled bet ($0.05) returned to MihaGr
MihaGr collected $0.10 from pot
*** SUMMARY ***
Total pot $0.10 | Rake $0 
Seat 1: Ampped87 folded before Flop (didn't bet)
Seat 2: jamalungma (button) folded before Flop (didn't bet)
Seat 3: Spud014 (small blind) folded before Flop
Seat 6: MihaGr (big blind) collected ($0.10)



PokerStars Hand #166667421633:  Hold'em No Limit ($0.05/$0.10 USD) - 2017/02/23 16:00:46 ET
Table 'Glarona' 6-max Seat #1 is the button
Seat 1: LarryTheStar ($10.65 in chips) 
Seat 2: BookWorm78 ($10.07 in chips) 
Seat 3: hoedje72 ($4.63 in chips) 
Seat 4: CrippledGod ($6.87 in chips) 
Seat 5: david_sara83 ($10 in chips) 
Seat 6: Namhkal ($10.56 in chips) 
BookWorm78: posts small blind $0.05
hoedje72: posts big blind $0.10
*** HOLE CARDS ***
CrippledGod: folds 
david_sara83: folds 
Namhkal: raises $0.15 to $0.25
LarryTheStar: folds 
BookWorm78: folds 
hoedje72: calls $0.15
*** FLOP *** [8h 5s Tc]
hoedje72: checks 
Namhkal: bets $0.27
hoedje72: calls $0.27
*** TURN *** [8h 5s Tc] [6h]
hoedje72: checks 
Namhkal: checks 
*** RIVER *** [8h 5s Tc 6h] [Kd]
hoedje72: checks 
Namhkal: checks 
*** SHOW DOWN ***
hoedje72: shows [Ad Qs] (high card Ace)
Namhkal: shows [9h 9s] (a pair of Nines)
Namhkal collected $1.04 from pot
*** SUMMARY ***
Total pot $1.09 | Rake $0.05 
Board [8h 5s Tc 6h Kd]
Seat 1: LarryTheStar (button) folded before Flop (didn't bet)
Seat 2: BookWorm78 (small blind) folded before Flop
Seat 3: hoedje72 (big blind) showed [Ad Qs] and lost with high card Ace
Seat 4: CrippledGod folded before Flop (didn't bet)
Seat 5: david_sara83 folded before Flop (didn't bet)
Seat 6: Namhkal showed [9h 9s] and won ($1.04) with a pair of Nines



PokerStars Hand #166667421920:  Hold'em No Limit ($0.05/$0.10 USD) - 2017/02/23 16:00:47 ET
Table 'Wilkens II' 6-max Seat #6 is the button
Seat 1: Islamiq-GuRL ($12.20 in chips) 
Seat 2: manashov ($10.15 in chips) 
Seat 3: Namhkal ($10.95 in chips) 
Seat 5: patrick19111 ($10 in chips) 
Seat 6: XaXaTyH4uK ($14.61 in chips) 
Islamiq-GuRL: posts small blind $0.05
manashov: posts big blind $0.10
myevc: sits out 
*** HOLE CARDS ***
Namhkal: folds 
patrick19111: folds 
XaXaTyH4uK: folds 
Islamiq-GuRL: folds 
Uncalled bet ($0.05) returned to manashov
manashov collected $0.10 from pot
*** SUMMARY ***
Total pot $0.10 | Rake $0 
Seat 1: Islamiq-GuRL (small blind) folded before Flop
Seat 2: manashov (big blind) collected ($0.10)
Seat 3: Namhkal folded before Flop (didn't bet)
Seat 5: patrick19111 folded before Flop (didn't bet)
Seat 6: XaXaTyH4uK (button) folded before Flop (didn't bet)



PokerStars Hand #166667422606:  Hold'em No Limit ($0.05/$0.10 USD) - 2017/02/23 16:00:48 ET
Table 'Iapetus III' 6-max Seat #2 is the button
Seat 2: Pekaml ($10 in chips) 
Seat 3: takis nik ($10.17 in chips) 
Seat 4: XaXaTyH4uK ($10 in chips) 
Seat 5: homelessdan ($14.21 in chips) 
Seat 6: eniksenik ($13.98 in chips) 
takis nik: posts small blind $0.05
XaXaTyH4uK: posts big blind $0.10
*** HOLE CARDS ***
Czezar Life joins the table at seat #1 
homelessdan: folds 
eniksenik: folds 
Pekaml: raises $0.10 to $0.20
takis nik: folds 
XaXaTyH4uK: folds 
Uncalled bet ($0.10) returned to Pekaml
Pekaml collected $0.25 from pot
*** SUMMARY ***
Total pot $0.25 | Rake $0 
Seat 2: Pekaml (button) collected ($0.25)
Seat 3: takis nik (small blind) folded before Flop
Seat 4: XaXaTyH4uK (big blind) folded before Flop
Seat 5: homelessdan folded before Flop (didn't bet)
Seat 6: eniksenik folded before Flop (didn't bet)



PokerStars Hand #166667422640:  Hold'em No Limit ($0.05/$0.10 USD) - 2017/02/23 16:00:48 ET
Table 'Caprera III' 6-max Seat #3 is the button
Seat 2: hg123454321 ($7.83 in chips) 
Seat 3: Darkfrai ($10 in chips) 
Seat 4: oddshoff ($9.76 in chips) 
Seat 5: fedorka rus ($50.73 in chips) 
Seat 6: GESPERIA ($18.79 in chips) 
oddshoff: posts small blind $0.05
fedorka rus: posts big blind $0.10
Vrinni: sits out 
*** HOLE CARDS ***
GESPERIA: raises $0.20 to $0.30
hg123454321: raises $0.50 to $0.80
Darkfrai: folds 
oddshoff: folds 
fedorka rus: folds 
GESPERIA: calls $0.50
*** FLOP *** [9c 4c Ac]
GESPERIA: checks 
hg123454321: bets $0.80
GESPERIA: folds 
Uncalled bet ($0.80) returned to hg123454321
hg123454321 collected $1.67 from pot
*** SUMMARY ***
Total pot $1.75 | Rake $0.08 
Board [9c 4c Ac]
Seat 2: hg123454321 collected ($1.67)
Seat 3: Darkfrai (button) folded before Flop (didn't bet)
Seat 4: oddshoff (small blind) folded before Flop
Seat 5: fedorka rus (big blind) folded before Flop
Seat 6: GESPERIA folded on the Flop



PokerStars Hand #166667422709:  Hold'em No Limit ($0.05/$0.10 USD) - 2017/02/23 16:00:48 ET
Table 'Alnasl' 6-max Seat #5 is the button
Seat 1: KA3AXCTAHEU, ($11.42 in chips) 
Seat 2: XaXaTyH4uK ($10 in chips) 
Seat 3: david_sara83 ($22.84 in chips) 
Seat 4: oddshoff ($10.18 in chips) 
Seat 5: steepfell ($10.23 in chips) 
Seat 6: Zooplack ($13.58 in chips) 
Zooplack: posts small blind $0.05
KA3AXCTAHEU,: posts big blind $0.10
*** HOLE CARDS ***
XaXaTyH4uK: folds 
david_sara83: folds 
oddshoff: folds 
steepfell: folds 
Zooplack: raises $0.15 to $0.25
KA3AXCTAHEU,: folds 
Uncalled bet ($0.15) returned to Zooplack
Zooplack collected $0.20 from pot
Zooplack: doesn't show hand 
*** SUMMARY ***
Total pot $0.20 | Rake $0 
Seat 1: KA3AXCTAHEU, (big blind) folded before Flop
Seat 2: XaXaTyH4uK folded before Flop (didn't bet)
Seat 3: david_sara83 folded before Flop (didn't bet)
Seat 4: oddshoff folded before Flop (didn't bet)
Seat 5: steepfell (button) folded before Flop (didn't bet)
Seat 6: Zooplack (small blind) collected ($0.20)



PokerStars Hand #166667422711:  Hold'em No Limit ($0.05/$0.10 USD) - 2017/02/23 16:00:48 ET
Table 'California II' 6-max Seat #1 is the button
Seat 1: fedorka rus ($10 in chips) 
Seat 2: homelessdan ($10 in chips) 
Seat 3: Bird et al ($10.45 in chips) 
Seat 5: bambolejro ($15.17 in chips) 
Seat 6: chiko4040 ($8.81 in chips) 
homelessdan: posts small blind $0.05
Bird et al: posts big blind $0.10
*** HOLE CARDS ***
bambolejro: folds 
chiko4040: folds 
fedorka rus: raises $0.10 to $0.20
homelessdan: folds 
Bird et al: calls $0.10
*** FLOP *** [7s Ks 4s]
Bird et al: checks 
fedorka rus: bets $0.32
Bird et al: folds 
Uncalled bet ($0.32) returned to fedorka rus
fedorka rus collected $0.43 from pot
*** SUMMARY ***
Total pot $0.45 | Rake $0.02 
Board [7s Ks 4s]
Seat 1: fedorka rus (button) collected ($0.43)
Seat 2: homelessdan (small blind) folded before Flop
Seat 3: Bird et al (big blind) folded on the Flop
Seat 5: bambolejro folded before Flop (didn't bet)
Seat 6: chiko4040 folded before Flop (didn't bet)



PokerStars Hand #166667422738:  Hold'em No Limit ($0.05/$0.10 USD) - 2017/02/23 16:00:48 ET
Table 'Nephthys II' 6-max Seat #5 is the button
Seat 1: DamDatsAnAce ($10.20 in chips) 
Seat 2: coolisses111 ($9.82 in chips) 
Seat 3: Newqbrown ($20.44 in chips) 
Seat 4: RkaczoR ($11.18 in chips) 
Seat 5: kingartur222 ($9.01 in chips) 
Seat 6: CHRO8 ($14.74 in chips) 
CHRO8: posts small blind $0.05
DamDatsAnAce: posts big blind $0.10
*** HOLE CARDS ***
coolisses111: folds 
coolisses111 leaves the table
Newqbrown: folds 
AC Evergreen joins the table at seat #2 
RkaczoR: raises $0.15 to $0.25
kingartur222: folds 
CHRO8: calls $0.20
DamDatsAnAce: folds 
*** FLOP *** [8h Kh 2h]
CHRO8: checks 
RkaczoR: bets $0.40
CHRO8: folds 
Uncalled bet ($0.40) returned to RkaczoR
RkaczoR collected $0.57 from pot
*** SUMMARY ***
Total pot $0.60 | Rake $0.03 
Board [8h Kh 2h]
Seat 1: DamDatsAnAce (big blind) folded before Flop
Seat 2: coolisses111 folded before Flop (didn't bet)
Seat 3: Newqbrown folded before Flop (didn't bet)
Seat 4: RkaczoR collected ($0.57)
Seat 5: kingartur222 (button) folded before Flop (didn't bet)
Seat 6: CHRO8 (small blind) folded on the Flop



PokerStars Hand #166667422823:  Hold'em No Limit ($0.05/$0.10 USD) - 2017/02/23 16:00:48 ET
Table 'Kochera' 6-max Seat #5 is the button
Seat 1: chimera252 ($11.65 in chips) 
Seat 2: bartabs2 ($10.76 in chips) 
Seat 3: KA3AXCTAHEU, ($10 in chips) 
Seat 4: johkom ($5.31 in chips) 
Seat 5: univibe68 ($12 in chips) 
Seat 6: oddshoff ($9.38 in chips) 
oddshoff: posts small blind $0.05
chimera252: posts big blind $0.10
*** HOLE CARDS ***
bartabs2: folds 
KA3AXCTAHEU,: folds 
johkom: raises $0.25 to $0.35
univibe68: folds 
oddshoff: folds 
chimera252: folds 
Uncalled bet ($0.25) returned to johkom
johkom collected $0.25 from pot
*** SUMMARY ***
Total pot $0.25 | Rake $0 
Seat 1: chimera252 (big blind) folded before Flop
Seat 2: bartabs2 folded before Flop (didn't bet)
Seat 3: KA3AXCTAHEU, folded before Flop (didn't bet)
Seat 4: johkom collected ($0.25)
Seat 5: univibe68 (button) folded before Flop (didn't bet)
Seat 6: oddshoff (small blind) folded before Flop



PokerStars Hand #166667423214:  Hold'em No Limit ($0.05/$0.10 USD) - 2017/02/23 16:00:48 ET
Table 'Lacroute' 6-max Seat #1 is the button
Seat 1: johnnyPieper ($9 in chips) 
Seat 2: Andy Wolf ($10.10 in chips) 
Seat 3: Croplayer1 ($10.95 in chips) 
Seat 4: st4tion ($16.06 in chips) 
Seat 5: steepfell ($11.42 in chips) 
Seat 6: IAntikI ($10 in chips) 
Andy Wolf: posts small blind $0.05
Croplayer1: posts big blind $0.10
*** HOLE CARDS ***
st4tion: folds 
steepfell: raises $0.20 to $0.30
IAntikI: calls $0.30
johnnyPieper: calls $0.30
Andy Wolf: folds 
Croplayer1: calls $0.20
*** FLOP *** [Qd 9s 3c]
Croplayer1: checks 
steepfell: checks 
IAntikI: checks 
johnnyPieper: checks 
*** TURN *** [Qd 9s 3c] [3s]
Croplayer1: bets $0.94
steepfell: folds 
IAntikI: folds 
johnnyPieper: folds 
Uncalled bet ($0.94) returned to Croplayer1
Croplayer1 collected $1.19 from pot
*** SUMMARY ***
Total pot $1.25 | Rake $0.06 
Board [Qd 9s 3c 3s]
Seat 1: johnnyPieper (button) folded on the Turn
Seat 2: Andy Wolf (small blind) folded before Flop
Seat 3: Croplayer1 (big blind) collected ($1.19)
Seat 4: st4tion folded before Flop (didn't bet)
Seat 5: steepfell folded on the Turn
Seat 6: IAntikI folded on the Turn



PokerStars Hand #166667423243:  Hold'em No Limit ($0.05/$0.10 USD) - 2017/02/23 16:00:48 ET
Table 'Nymphe II' 6-max Seat #6 is the button
Seat 1: jacktayra ($3.30 in chips) 
Seat 2: Newqbrown ($10.15 in chips) 
Seat 3: THIMUCHIN ($14.25 in chips) 
Seat 4: coolisses111 ($19.15 in chips) 
Seat 6: Xander188 ($18.53 in chips) 
jacktayra: posts small blind $0.05
Newqbrown: posts big blind $0.10
Yspenyanin: sits out 
*** HOLE CARDS ***
THIMUCHIN: raises $0.20 to $0.30
coolisses111: folds 
Xander188: folds 
jacktayra: folds 
Newqbrown: folds 
Uncalled bet ($0.20) returned to THIMUCHIN
THIMUCHIN collected $0.25 from pot
*** SUMMARY ***
Total pot $0.25 | Rake $0 
Seat 1: jacktayra (small blind) folded before Flop
Seat 2: Newqbrown (big blind) folded before Flop
Seat 3: THIMUCHIN collected ($0.25)
Seat 4: coolisses111 folded before Flop (didn't bet)
Seat 6: Xander188 (button) folded before Flop (didn't bet)



PokerStars Hand #166667423304:  Hold'em No Limit ($0.05/$0.10 USD) - 2017/02/23 16:00:48 ET
Table 'Rotraut' 6-max Seat #4 is the button
Seat 1: Hypermetal ($13.49 in chips) 
Seat 2: Newqbrown ($10.78 in chips) 
Seat 3: FlackoD ($11.49 in chips) 
Seat 4: Darkfrai ($10 in chips) 
Seat 5: Bird et al ($11.80 in chips) 
Seat 6: KokoulinV ($13.14 in chips) 
Bird et al: posts small blind $0.05
KokoulinV: posts big blind $0.10
FlackoD: posts small & big blinds $0.15
*** HOLE CARDS ***
Hypermetal: folds 
Newqbrown: folds 
FlackoD: raises $0.20 to $0.30
Darkfrai: calls $0.30
Bird et al: folds 
KokoulinV: folds 
*** FLOP *** [3h 6c 5d]
FlackoD: bets $0.40
Darkfrai: folds 
Uncalled bet ($0.40) returned to FlackoD
FlackoD collected $0.76 from pot
*** SUMMARY ***
Total pot $0.80 | Rake $0.04 
Board [3h 6c 5d]
Seat 1: Hypermetal folded before Flop (didn't bet)
Seat 2: Newqbrown folded before Flop (didn't bet)
Seat 3: FlackoD collected ($0.76)
Seat 4: Darkfrai (button) folded on the Flop
Seat 5: Bird et al (small blind) folded before Flop
Seat 6: KokoulinV (big blind) folded before Flop



PokerStars Hand #166667423407:  Hold'em No Limit ($0.05/$0.10 USD) - 2017/02/23 16:00:49 ET
Table 'Klotho II' 6-max Seat #4 is the button
Seat 1: Alexey74516 ($7.77 in chips) 
Seat 3: Zooplack ($10.41 in chips) 
Seat 4: Lucky HoBBiT ($10.83 in chips) 
Seat 5: david_sara83 ($15.45 in chips) 
Seat 6: D3NyA ($11.72 in chips) 
david_sara83: posts small blind $0.05
D3NyA: posts big blind $0.10
kickereens: sits out 
*** HOLE CARDS ***
Alexey74516: calls $0.10
Zooplack: folds 
Lucky HoBBiT: folds 
david_sara83: calls $0.05
D3NyA: checks 
*** FLOP *** [As 6c Kh]
david_sara83: checks 
D3NyA: checks 
Alexey74516: checks 
*** TURN *** [As 6c Kh] [7c]
david_sara83: bets $0.15
D3NyA: folds 
Alexey74516: folds 
Uncalled bet ($0.15) returned to david_sara83
david_sara83 collected $0.29 from pot
*** SUMMARY ***
Total pot $0.30 | Rake $0.01 
Board [As 6c Kh 7c]
Seat 1: Alexey74516 folded on the Turn
Seat 3: Zooplack folded before Flop (didn't bet)
Seat 4: Lucky HoBBiT (button) folded before Flop (didn't bet)
Seat 5: david_sara83 (small blind) collected ($0.29)
Seat 6: D3NyA (big blind) folded on the Turn



PokerStars Hand #166667423422:  Hold'em No Limit ($0.05/$0.10 USD) - 2017/02/23 16:00:49 ET
Table 'Hamal II' 6-max Seat #6 is the button
Seat 1: saxoalto2011 ($8.54 in chips) 
Seat 2: pancernik21 ($10 in chips) 
Seat 3: Cluckh ($11.69 in chips) 
Seat 4: ArcticBearDK ($10.96 in chips) 
Seat 6: LarryTheStar ($10.24 in chips) 
saxoalto2011: posts small blind $0.05
pancernik21: posts big blind $0.10
*** HOLE CARDS ***
Cluckh: folds 
ArcticBearDK: folds 
LarryTheStar: raises $0.10 to $0.20
saxoalto2011: folds 
pancernik21: raises $0.60 to $0.80
eniksenik joins the table at seat #5 
LarryTheStar: raises $1.30 to $2.10
pancernik21: folds 
Uncalled bet ($1.30) returned to LarryTheStar
LarryTheStar collected $1.65 from pot
*** SUMMARY ***
Total pot $1.65 | Rake $0 
Seat 1: saxoalto2011 (small blind) folded before Flop
Seat 2: pancernik21 (big blind) folded before Flop
Seat 3: Cluckh folded before Flop (didn't bet)
Seat 4: ArcticBearDK folded before Flop (didn't bet)
Seat 6: LarryTheStar (button) collected ($1.65)



PokerStars Hand #166667423604:  Hold'em No Limit ($0.05/$0.10 USD) - 2017/02/23 16:00:49 ET
Table 'Scabiosa III' 6-max Seat #6 is the button
Seat 1: Feverhead ($13.31 in chips) 
Seat 2: kinaó ($9.36 in chips) 
Seat 3: Goroshkos88 ($11.40 in chips) 
Seat 4: voledy ($10 in chips) 
Seat 5: patrick19111 ($24.75 in chips) 
Seat 6: Smitty03300 ($11.90 in chips) 
Feverhead: posts small blind $0.05
kinaó: posts big blind $0.10
*** HOLE CARDS ***
Goroshkos88: folds 
voledy: folds 
patrick19111: folds 
Smitty03300: raises $0.20 to $0.30
Feverhead: folds 
kinaó: calls $0.20
*** FLOP *** [7c Ac 7h]
kinaó: checks 
Smitty03300: bets $0.47
kinaó: calls $0.47
*** TURN *** [7c Ac 7h] [3c]
kinaó: checks 
Smitty03300: bets $1.14
kinaó: calls $1.14
*** RIVER *** [7c Ac 7h 3c] [5h]
kinaó: checks 
Smitty03300: bets $2.04
kinaó: calls $2.04
*** SHOW DOWN ***
Smitty03300: shows [Ad Js] (two pair, Aces and Sevens)
kinaó: shows [7s 4c] (three of a kind, Sevens)
kinaó collected $7.59 from pot
*** SUMMARY ***
Total pot $7.95 | Rake $0.36 
Board [7c Ac 7h 3c 5h]
Seat 1: Feverhead (small blind) folded before Flop
Seat 2: kinaó (big blind) showed [7s 4c] and won ($7.59) with three of a kind, Sevens
Seat 3: Goroshkos88 folded before Flop (didn't bet)
Seat 4: voledy folded before Flop (didn't bet)
Seat 5: patrick19111 folded before Flop (didn't bet)
Seat 6: Smitty03300 (button) showed [Ad Js] and lost with two pair, Aces and Sevens



PokerStars Hand #166667423768:  Hold'em No Limit ($0.05/$0.10 USD) - 2017/02/23 16:00:49 ET
Table 'Unitas II' 6-max Seat #5 is the button
Seat 1: Peter0087 ($9.25 in chips) 
Seat 2: dragonste89 ($10.76 in chips) 
Seat 3: CallByValue ($10 in chips) 
Seat 4: truck1234 ($10.72 in chips) 
Seat 5: chimera252 ($26.06 in chips) 
paxit71 will be allowed to play after the button
Peter0087: posts small blind $0.05
dragonste89: posts big blind $0.10
*** HOLE CARDS ***
CallByValue: folds 
truck1234: folds 
chimera252: folds 
Peter0087: folds 
Uncalled bet ($0.05) returned to dragonste89
dragonste89 collected $0.10 from pot
*** SUMMARY ***
Total pot $0.10 | Rake $0 
Seat 1: Peter0087 (small blind) folded before Flop
Seat 2: dragonste89 (big blind) collected ($0.10)
Seat 3: CallByValue folded before Flop (didn't bet)
Seat 4: truck1234 folded before Flop (didn't bet)
Seat 5: chimera252 (button) folded before Flop (didn't bet)



PokerStars Hand #166667424150:  Hold'em No Limit ($0.05/$0.10 USD) - 2017/02/23 16:00:50 ET
Table 'Izar' 6-max Seat #2 is the button
Seat 1: bambolejro ($10.39 in chips) 
Seat 2: mvp0013 ($10.72 in chips) 
Seat 4: Matee92 ($7.01 in chips) 
Seat 5: fishhook5 ($10 in chips) 
Seat 6: jamalungma ($11.59 in chips) 
Yspenyanin will be allowed to play after the button
Matee92: posts small blind $0.05
fishhook5: posts big blind $0.10
*** HOLE CARDS ***
jamalungma: folds 
bambolejro: raises $0.20 to $0.30
mvp0013: folds 
Matee92: folds 
fishhook5: folds 
Uncalled bet ($0.20) returned to bambolejro
bambolejro collected $0.25 from pot
*** SUMMARY ***
Total pot $0.25 | Rake $0 
Seat 1: bambolejro collected ($0.25)
Seat 2: mvp0013 (button) folded before Flop (didn't bet)
Seat 4: Matee92 (small blind) folded before Flop
Seat 5: fishhook5 (big blind) folded before Flop
Seat 6: jamalungma folded before Flop (didn't bet)



PokerStars Hand #166667424193:  Hold'em No Limit ($0.05/$0.10 USD) - 2017/02/23 16:00:50 ET
Table 'Martha' 6-max Seat #6 is the button
Seat 1: Peter0087 ($10.76 in chips) 
Seat 2: pauli95 ($7.41 in chips) 
Seat 3: Hyd SK ($12.11 in chips) 
Seat 4: dittoro ($10.84 in chips) 
Seat 6: 8th wonders ($10 in chips) 
Peter0087: posts small blind $0.05
pauli95: posts big blind $0.10
MihaGr: sits out 
*** HOLE CARDS ***
Hyd SK: folds 
dittoro: folds 
8th wonders: folds 
Peter0087: raises $0.10 to $0.20
pauli95: calls $0.10
*** FLOP *** [6s 5c 6c]
Peter0087: checks 
pauli95: bets $0.38
Peter0087: folds 
Uncalled bet ($0.38) returned to pauli95
pauli95 collected $0.38 from pot
*** SUMMARY ***
Total pot $0.40 | Rake $0.02 
Board [6s 5c 6c]
Seat 1: Peter0087 (small blind) folded on the Flop
Seat 2: pauli95 (big blind) collected ($0.38)
Seat 3: Hyd SK folded before Flop (didn't bet)
Seat 4: dittoro folded before Flop (didn't bet)
Seat 6: 8th wonders (button) folded before Flop (didn't bet)



PokerStars Hand #166667424237:  Hold'em No Limit ($0.05/$0.10 USD) - 2017/02/23 16:00:50 ET
Table 'Ruvuma' 6-max Seat #1 is the button
Seat 1: FRAID358 ($10.25 in chips) 
Seat 2: Fab_1512 ($12.98 in chips) 
Seat 3: Spud014 ($11.41 in chips) 
Seat 4: DamDatsAnAce ($10 in chips) 
Seat 5: sexy_seagull ($10.15 in chips) 
Seat 6: Elinaattor ($9.60 in chips) 
Fab_1512: posts small blind $0.05
Spud014: posts big blind $0.10
*** HOLE CARDS ***
DamDatsAnAce: raises $0.30 to $0.40
sexy_seagull: folds 
Elinaattor: folds 
FRAID358: folds 
Fab_1512: folds 
Spud014: folds 
Uncalled bet ($0.30) returned to DamDatsAnAce
DamDatsAnAce collected $0.25 from pot
*** SUMMARY ***
Total pot $0.25 | Rake $0 
Seat 1: FRAID358 (button) folded before Flop (didn't bet)
Seat 2: Fab_1512 (small blind) folded before Flop
Seat 3: Spud014 (big blind) folded before Flop
Seat 4: DamDatsAnAce collected ($0.25)
Seat 5: sexy_seagull folded before Flop (didn't bet)
Seat 6: Elinaattor folded before Flop (didn't bet)



PokerStars Hand #166667424255:  Hold'em No Limit ($0.05/$0.10 USD) - 2017/02/23 16:00:50 ET
Table 'Kraz II' 6-max Seat #3 is the button
Seat 1: bdixon_5 ($9.85 in chips) 
Seat 2: Smok3008 ($8.10 in chips) 
Seat 3: Eddys Edge ($10 in chips) 
Seat 4: WinninBikini ($10.47 in chips) 
Seat 6: tr41n3r12 ($10.15 in chips) 
WinninBikini: posts small blind $0.05
xdjango07x: is sitting out 
tr41n3r12: posts big blind $0.10
*** HOLE CARDS ***
bdixon_5: folds 
Smok3008: folds 
Eddys Edge: folds 
WinninBikini: folds 
Uncalled bet ($0.05) returned to tr41n3r12
tr41n3r12 collected $0.10 from pot
*** SUMMARY ***
Total pot $0.10 | Rake $0 
Seat 1: bdixon_5 folded before Flop (didn't bet)
Seat 2: Smok3008 folded before Flop (didn't bet)
Seat 3: Eddys Edge (button) folded before Flop (didn't bet)
Seat 4: WinninBikini (small blind) folded before Flop
Seat 6: tr41n3r12 (big blind) collected ($0.10)



PokerStars Hand #166667424300:  Hold'em No Limit ($0.05/$0.10 USD) - 2017/02/23 16:00:50 ET
Table 'Torrence II' 6-max Seat #3 is the button
Seat 2: scorpionfish ($16.25 in chips) 
Seat 3: coolisses111 ($9.55 in chips) 
Seat 4: Zooplack ($10 in chips) 
Seat 5: Kow6oy ($12.88 in chips) 
Seat 6: Andy Wolf ($10 in chips) 
Zooplack: posts small blind $0.05
Kow6oy: posts big blind $0.10
*** HOLE CARDS ***
Andy Wolf: folds 
scorpionfish: folds 
coolisses111: folds 
Zooplack: raises $0.15 to $0.25
Kow6oy: calls $0.15
*** FLOP *** [As Ad 8s]
Zooplack: bets $0.29
Kow6oy: folds 
Uncalled bet ($0.29) returned to Zooplack
Zooplack collected $0.48 from pot
*** SUMMARY ***
Total pot $0.50 | Rake $0.02 
Board [As Ad 8s]
Seat 2: scorpionfish folded before Flop (didn't bet)
Seat 3: coolisses111 (button) folded before Flop (didn't bet)
Seat 4: Zooplack (small blind) collected ($0.48)
Seat 5: Kow6oy (big blind) folded on the Flop
Seat 6: Andy Wolf folded before Flop (didn't bet)



PokerStars Hand #166667424302:  Hold'em No Limit ($0.05/$0.10 USD) - 2017/02/23 16:00:50 ET
Table 'Nekkar' 6-max Seat #4 is the button
Seat 1: aapokerkot ($11.65 in chips) 
Seat 2: Bird et al ($10 in chips) 
Seat 3: Zemz_Ru ($17.06 in chips) 
Seat 4: kingartur222 ($12.33 in chips) 
Seat 5: Vrinni ($12.15 in chips) 
Seat 6: Eddys Edge ($10.85 in chips) 
Vrinni: posts small blind $0.05
Eddys Edge: posts big blind $0.10
*** HOLE CARDS ***
aapokerkot: raises $0.20 to $0.30
Bird et al: folds 
Zemz_Ru: folds 
kingartur222: folds 
Vrinni: folds 
Eddys Edge: calls $0.20
*** FLOP *** [5c 6s Jc]
Eddys Edge: checks 
aapokerkot: bets $0.47
Eddys Edge: folds 
Uncalled bet ($0.47) returned to aapokerkot
aapokerkot collected $0.62 from pot
*** SUMMARY ***
Total pot $0.65 | Rake $0.03 
Board [5c 6s Jc]
Seat 1: aapokerkot collected ($0.62)
Seat 2: Bird et al folded before Flop (didn't bet)
Seat 3: Zemz_Ru folded before Flop (didn't bet)
Seat 4: kingartur222 (button) folded before Flop (didn't bet)
Seat 5: Vrinni (small blind) folded before Flop
Seat 6: Eddys Edge (big blind) folded on the Flop



PokerStars Hand #166667424417:  Hold'em No Limit ($0.05/$0.10 USD) - 2017/02/23 16:00:50 ET
Table 'Tyndareus II' 6-max Seat #2 is the button
Seat 1: Makc1705 ($3.80 in chips) 
Seat 2: Therodorus ($11.30 in chips) 
Seat 3: McCleans ($11.26 in chips) 
Seat 4: gaHy_HaXeP ($11.07 in chips) 
Seat 5: vtalian ($8.55 in chips) 
Seat 6: sexy_seagull ($10 in chips) 
McCleans: posts small blind $0.05
gaHy_HaXeP: posts big blind $0.10
Makc1705: posts small & big blinds $0.15
*** HOLE CARDS ***
vtalian: folds 
sexy_seagull: folds 
Makc1705: checks 
Therodorus: folds 
McCleans: folds 
gaHy_HaXeP: checks 
*** FLOP *** [Ks 9h 4d]
gaHy_HaXeP: checks 
Makc1705: checks 
*** TURN *** [Ks 9h 4d] [6d]
gaHy_HaXeP: bets $0.22
Makc1705: folds 
Uncalled bet ($0.22) returned to gaHy_HaXeP
gaHy_HaXeP collected $0.29 from pot
*** SUMMARY ***
Total pot $0.30 | Rake $0.01 
Board [Ks 9h 4d 6d]
Seat 1: Makc1705 folded on the Turn
Seat 2: Therodorus (button) folded before Flop (didn't bet)
Seat 3: McCleans (small blind) folded before Flop
Seat 4: gaHy_HaXeP (big blind) collected ($0.29)
Seat 5: vtalian folded before Flop (didn't bet)
Seat 6: sexy_seagull folded before Flop (didn't bet)



PokerStars Hand #166667424462:  Hold'em No Limit ($0.05/$0.10 USD) - 2017/02/23 16:00:50 ET
Table 'Virginia II' 6-max Seat #1 is the button
Seat 1: Iarlei ($11.86 in chips) 
Seat 3: garigura ($14.76 in chips) 
Seat 4: onkelottoHH ($11.33 in chips) 
Seat 5: dr.goofy ($20.41 in chips) 
Seat 6: ab260414 ($10 in chips) 
Yspenyanin will be allowed to play after the button
garigura: posts small blind $0.05
onkelottoHH: posts big blind $0.10
*** HOLE CARDS ***
dr.goofy: folds 
ab260414: folds 
Iarlei: folds 
garigura: folds 
Uncalled bet ($0.05) returned to onkelottoHH
onkelottoHH collected $0.10 from pot
*** SUMMARY ***
Total pot $0.10 | Rake $0 
Seat 1: Iarlei (button) folded before Flop (didn't bet)
Seat 3: garigura (small blind) folded before Flop
Seat 4: onkelottoHH (big blind) collected ($0.10)
Seat 5: dr.goofy folded before Flop (didn't bet)
Seat 6: ab260414 folded before Flop (didn't bet)



PokerStars Hand #166667424463:  Hold'em No Limit ($0.05/$0.10 USD) - 2017/02/23 16:00:50 ET
Table 'Nerthus II' 6-max Seat #4 is the button
Seat 1: mdelfin0 ($10.33 in chips) 
Seat 2: Hovhannes990 ($9.33 in chips) 
Seat 3: Mamm0nism ($18.82 in chips) 
Seat 4: myevc ($15.21 in chips) 
Seat 5: Hyd SK ($12.75 in chips) 
Seat 6: Lucky HoBBiT ($10 in chips) 
Hyd SK: posts small blind $0.05
Lucky HoBBiT: posts big blind $0.10
*** HOLE CARDS ***
mdelfin0: folds 
Hovhannes990: calls $0.10
Mamm0nism: folds 
myevc: raises $0.25 to $0.35
Hyd SK: folds 
Lucky HoBBiT: calls $0.25
Hovhannes990: calls $0.25
*** FLOP *** [6d 8d Ac]
Lucky HoBBiT: checks 
Hovhannes990: bets $0.10
myevc: calls $0.10
Lucky HoBBiT: calls $0.10
*** TURN *** [6d 8d Ac] [Ts]
Lucky HoBBiT: checks 
Hovhannes990: bets $0.10
myevc: calls $0.10
Lucky HoBBiT: calls $0.10
*** RIVER *** [6d 8d Ac Ts] [Qd]
Lucky HoBBiT: checks 
Hovhannes990: checks 
myevc: checks 
*** SHOW DOWN ***
Lucky HoBBiT: shows [7d 7s] (a pair of Sevens)
Hovhannes990: mucks hand 
myevc: shows [Jh Qc] (a pair of Queens)
myevc collected $1.62 from pot
*** SUMMARY ***
Total pot $1.70 | Rake $0.08 
Board [6d 8d Ac Ts Qd]
Seat 1: mdelfin0 folded before Flop (didn't bet)
Seat 2: Hovhannes990 mucked
Seat 3: Mamm0nism folded before Flop (didn't bet)
Seat 4: myevc (button) showed [Jh Qc] and won ($1.62) with a pair of Queens
Seat 5: Hyd SK (small blind) folded before Flop
Seat 6: Lucky HoBBiT (big blind) showed [7d 7s] and lost with a pair of Sevens



PokerStars Hand #166667424620:  Hold'em No Limit ($0.05/$0.10 USD) - 2017/02/23 16:00:50 ET
Table 'Nehalennia III' 6-max Seat #6 is the button
Seat 1: boxer821 ($13.33 in chips) 
Seat 2: fortieth ($9.75 in chips) 
Seat 3: ValdemorS ($18.16 in chips) 
Seat 5: wulffboy ($34.51 in chips) 
Seat 6: valzeny ($20.65 in chips) 
boxer821: posts small blind $0.05
fortieth: posts big blind $0.10
eniksenik: sits out 
boxer821: posts the ante $0.02
fortieth: posts the ante $0.02
ValdemorS: posts the ante $0.02
wulffboy: posts the ante $0.02
valzeny: posts the ante $0.02
*** HOLE CARDS ***
ValdemorS: folds 
wulffboy: raises $0.20 to $0.30
valzeny: folds 
boxer821: folds 
fortieth: folds 
Uncalled bet ($0.20) returned to wulffboy
wulffboy collected $0.35 from pot
*** SUMMARY ***
Total pot $0.35 | Rake $0 
Seat 1: boxer821 (small blind) folded before Flop
Seat 2: fortieth (big blind) folded before Flop
Seat 3: ValdemorS folded before Flop (didn't bet)
Seat 5: wulffboy collected ($0.35)
Seat 6: valzeny (button) folded before Flop (didn't bet)



PokerStars Hand #166667424761:  Hold'em No Limit ($0.05/$0.10 USD) - 2017/02/23 16:00:50 ET
Table 'Antielus II' 6-max Seat #3 is the button
Seat 1: Dcaro31 ($17.30 in chips) 
Seat 2: Orlangoor ($10.80 in chips) 
Seat 3: mcyi3at2 ($12.89 in chips) 
Seat 5: Hyd SK ($10 in chips) 
Seat 6: GiveTwoMe ($11.30 in chips) 
XwinX25 joins the table at seat #4 
Hyd SK: posts small blind $0.05
GiveTwoMe: posts big blind $0.10
*** HOLE CARDS ***
Dcaro31: folds 
Orlangoor: folds 
mcyi3at2: folds 
Hyd SK: raises $0.25 to $0.35
GiveTwoMe: raises $0.56 to $0.91
Hyd SK: calls $0.56
*** FLOP *** [Qd Jc 9h]
Hyd SK: checks 
GiveTwoMe: bets $1.04
Hyd SK: folds 
Uncalled bet ($1.04) returned to GiveTwoMe
GiveTwoMe collected $1.74 from pot
*** SUMMARY ***
Total pot $1.82 | Rake $0.08 
Board [Qd Jc 9h]
Seat 1: Dcaro31 folded before Flop (didn't bet)
Seat 2: Orlangoor folded before Flop (didn't bet)
Seat 3: mcyi3at2 (button) folded before Flop (didn't bet)
Seat 5: Hyd SK (small blind) folded on the Flop
Seat 6: GiveTwoMe (big blind) collected ($1.74)



PokerStars Hand #166667424850:  Hold'em No Limit ($0.05/$0.10 USD) - 2017/02/23 16:00:50 ET
Table 'Manto II' 6-max Seat #2 is the button
Seat 2: voledy ($10 in chips) 
Seat 3: Komap511 ($13 in chips) 
Seat 4: dr.goofy ($10.97 in chips) 
Seat 5: ArcticBearDK ($18.75 in chips) 
Seat 6: pancernik21 ($16.85 in chips) 
Komap511: posts small blind $0.05
dr.goofy: posts big blind $0.10
MihaGr: sits out 
*** HOLE CARDS ***
ArcticBearDK: raises $0.15 to $0.25
pancernik21: folds 
voledy: folds 
Komap511: calls $0.20
dr.goofy: folds 
*** FLOP *** [9c As Ks]
Komap511: checks 
ArcticBearDK: bets $0.40
Komap511: calls $0.40
*** TURN *** [9c As Ks] [3h]
Komap511: checks 
ArcticBearDK: bets $0.90
Komap511: calls $0.90
*** RIVER *** [9c As Ks 3h] [6c]
Komap511: checks 
ArcticBearDK: bets $2.30
Komap511: calls $2.30
*** SHOW DOWN ***
ArcticBearDK: shows [9s 9h] (three of a kind, Nines)
Komap511: mucks hand 
ArcticBearDK collected $7.45 from pot
*** SUMMARY ***
Total pot $7.80 | Rake $0.35 
Board [9c As Ks 3h 6c]
Seat 2: voledy (button) folded before Flop (didn't bet)
Seat 3: Komap511 (small blind) mucked
Seat 4: dr.goofy (big blind) folded before Flop
Seat 5: ArcticBearDK showed [9s 9h] and won ($7.45) with three of a kind, Nines
Seat 6: pancernik21 folded before Flop (didn't bet)



PokerStars Hand #166667424893:  Hold'em No Limit ($0.05/$0.10 USD) - 2017/02/23 16:00:50 ET
Table 'Ostara III' 6-max Seat #5 is the button
Seat 1: MühliJr ($10.22 in chips) 
Seat 2: Action_Gibi ($7.60 in chips) 
Seat 3: vtalian ($10.46 in chips) 
Seat 5: dzesio18 ($12.45 in chips) 
Seat 6: FlopsterGB ($11.95 in chips) 
FlopsterGB: posts small blind $0.05
MühliJr: posts big blind $0.10
*** HOLE CARDS ***
Action_Gibi: raises $0.20 to $0.30
vtalian: folds 
dzesio18: folds 
FlopsterGB: folds 
MühliJr: calls $0.20
*** FLOP *** [2h Ah 2s]
MühliJr: checks 
Action_Gibi: checks 
*** TURN *** [2h Ah 2s] [5c]
MühliJr: checks 
Action_Gibi: bets $0.31
MühliJr: calls $0.31
*** RIVER *** [2h Ah 2s 5c] [Ts]
MühliJr: checks 
Action_Gibi: checks 
*** SHOW DOWN ***
MühliJr: shows [4s As] (two pair, Aces and Deuces)
Action_Gibi: mucks hand 
MühliJr collected $1.21 from pot
*** SUMMARY ***
Total pot $1.27 | Rake $0.06 
Board [2h Ah 2s 5c Ts]
Seat 1: MühliJr (big blind) showed [4s As] and won ($1.21) with two pair, Aces and Deuces
Seat 2: Action_Gibi mucked
Seat 3: vtalian folded before Flop (didn't bet)
Seat 5: dzesio18 (button) folded before Flop (didn't bet)
Seat 6: FlopsterGB (small blind) folded before Flop



PokerStars Hand #166667425079:  Hold'em No Limit ($0.05/$0.10 USD) - 2017/02/23 16:00:51 ET
Table 'Aludra II' 6-max Seat #4 is the button
Seat 1: voledy ($10.15 in chips) 
Seat 2: JahSoldier69 ($10.28 in chips) 
Seat 3: 2G28 ($11.75 in chips) 
Seat 4: MihaGr ($10 in chips) 
Seat 5: kingartur222 ($15.90 in chips) 
Seat 6: call me haaa ($15 in chips) 
kingartur222: posts small blind $0.05
call me haaa: posts big blind $0.10
*** HOLE CARDS ***
voledy: folds 
JahSoldier69: folds 
2G28: raises $0.15 to $0.25
MihaGr: folds 
kingartur222: folds 
call me haaa: folds 
Uncalled bet ($0.15) returned to 2G28
2G28 collected $0.25 from pot
*** SUMMARY ***
Total pot $0.25 | Rake $0 
Seat 1: voledy folded before Flop (didn't bet)
Seat 2: JahSoldier69 folded before Flop (didn't bet)
Seat 3: 2G28 collected ($0.25)
Seat 4: MihaGr (button) folded before Flop (didn't bet)
Seat 5: kingartur222 (small blind) folded before Flop
Seat 6: call me haaa (big blind) folded before Flop



PokerStars Hand #166667425313:  Hold'em No Limit ($0.05/$0.10 USD) - 2017/02/23 16:00:51 ET
Table 'Grietje' 6-max Seat #3 is the button
Seat 1: WinninBikini ($14.98 in chips) 
Seat 2: Feverhead ($13.17 in chips) 
Seat 3: a_tonis6 ($14.68 in chips) 
Seat 4: 6ePeMeHHa9 ($10 in chips) 
Seat 5: sbalass ($4.95 in chips) 
Seat 6: Prometheu$8 ($11.36 in chips) 
6ePeMeHHa9: posts small blind $0.05
sbalass: posts big blind $0.10
*** HOLE CARDS ***
Prometheu$8: raises $0.25 to $0.35
WinninBikini: folds 
Feverhead: folds 
a_tonis6: calls $0.35
6ePeMeHHa9: folds 
sbalass: calls $0.25
*** FLOP *** [Qs 7s 6s]
sbalass: checks 
Prometheu$8: checks 
a_tonis6: bets $1
sbalass: calls $1
Prometheu$8: folds 
*** TURN *** [Qs 7s 6s] [9c]
sbalass: checks 
a_tonis6: bets $1.50
sbalass: raises $2.10 to $3.60 and is all-in
a_tonis6: calls $2.10
*** RIVER *** [Qs 7s 6s 9c] [7h]
*** SHOW DOWN ***
sbalass: shows [Js As] (a flush, Ace high)
a_tonis6: shows [2d Qd] (two pair, Queens and Sevens)
sbalass collected $9.84 from pot
*** SUMMARY ***
Total pot $10.30 | Rake $0.46 
Board [Qs 7s 6s 9c 7h]
Seat 1: WinninBikini folded before Flop (didn't bet)
Seat 2: Feverhead folded before Flop (didn't bet)
Seat 3: a_tonis6 (button) showed [2d Qd] and lost with two pair, Queens and Sevens
Seat 4: 6ePeMeHHa9 (small blind) folded before Flop
Seat 5: sbalass (big blind) showed [Js As] and won ($9.84) with a flush, Ace high
Seat 6: Prometheu$8 folded on the Flop



PokerStars Hand #166667425466:  Hold'em No Limit ($0.05/$0.10 USD) - 2017/02/23 16:00:51 ET
Table 'Selinur' 6-max Seat #3 is the button
Seat 1: KA3AXCTAHEU, ($10 in chips) 
Seat 2: jamalungma ($10.23 in chips) 
Seat 3: bambolejro ($10.52 in chips) 
Seat 4: freezing666 ($11.93 in chips) 
Seat 5: IAntikI ($10 in chips) 
Seat 6: homelessdan ($17.30 in chips) 
freezing666: posts small blind $0.05
IAntikI: posts big blind $0.10
*** HOLE CARDS ***
homelessdan: folds 
KA3AXCTAHEU,: folds 
jamalungma: folds 
bambolejro: folds 
freezing666: raises $0.20 to $0.30
IAntikI: calls $0.20
*** FLOP *** [4d 8s Tc]
freezing666: checks 
IAntikI: bets $0.40
freezing666: folds 
Uncalled bet ($0.40) returned to IAntikI
IAntikI collected $0.57 from pot
*** SUMMARY ***
Total pot $0.60 | Rake $0.03 
Board [4d 8s Tc]
Seat 1: KA3AXCTAHEU, folded before Flop (didn't bet)
Seat 2: jamalungma folded before Flop (didn't bet)
Seat 3: bambolejro (button) folded before Flop (didn't bet)
Seat 4: freezing666 (small blind) folded on the Flop
Seat 5: IAntikI (big blind) collected ($0.57)
Seat 6: homelessdan folded before Flop (didn't bet)



PokerStars Hand #166667425988:  Hold'em No Limit ($0.05/$0.10 USD) - 2017/02/23 16:00:52 ET
Table 'Wingolfia II' 6-max Seat #4 is the button
Seat 1: BahiaMinhaP ($10 in chips) 
Seat 2: NvR.m1nD ($10 in chips) 
Seat 3: truck1234 ($10 in chips) 
Seat 4: zlobslob ($19.17 in chips) 
Seat 5: tr41n3r12 ($10.96 in chips) 
Seat 6: EphemeralBen ($11.52 in chips) 
tr41n3r12: posts small blind $0.05
EphemeralBen: posts big blind $0.10
*** HOLE CARDS ***
BahiaMinhaP: folds 
NvR.m1nD: folds 
truck1234: folds 
zlobslob: folds 
tr41n3r12: folds 
Uncalled bet ($0.05) returned to EphemeralBen
EphemeralBen collected $0.10 from pot
*** SUMMARY ***
Total pot $0.10 | Rake $0 
Seat 1: BahiaMinhaP folded before Flop (didn't bet)
Seat 2: NvR.m1nD folded before Flop (didn't bet)
Seat 3: truck1234 folded before Flop (didn't bet)
Seat 4: zlobslob (button) folded before Flop (didn't bet)
Seat 5: tr41n3r12 (small blind) folded before Flop
Seat 6: EphemeralBen (big blind) collected ($0.10)



PokerStars Hand #166667426234:  Hold'em No Limit ($0.05/$0.10 USD) - 2017/02/23 16:00:52 ET
Table 'Kanda' 6-max Seat #1 is the button
Seat 1: Andy Wolf ($10.24 in chips) 
Seat 2: Pelotín ($5.20 in chips) 
Seat 3: joewatson90 ($12.59 in chips) 
Seat 4: Orlangoor ($10.86 in chips) 
Seat 5: Temniy Elf ($10.15 in chips) 
Seat 6: oddshoff ($8.81 in chips) 
Pelotín: posts small blind $0.05
joewatson90: posts big blind $0.10
*** HOLE CARDS ***
Orlangoor: folds 
Temniy Elf: folds 
oddshoff: raises $0.15 to $0.25
Andy Wolf: folds 
Pelotín: folds 
joewatson90: folds 
Uncalled bet ($0.15) returned to oddshoff
oddshoff collected $0.25 from pot
*** SUMMARY ***
Total pot $0.25 | Rake $0 
Seat 1: Andy Wolf (button) folded before Flop (didn't bet)
Seat 2: Pelotín (small blind) folded before Flop
Seat 3: joewatson90 (big blind) folded before Flop
Seat 4: Orlangoor folded before Flop (didn't bet)
Seat 5: Temniy Elf folded before Flop (didn't bet)
Seat 6: oddshoff collected ($0.25)



PokerStars Hand #166667426773:  Hold'em No Limit ($0.05/$0.10 USD) - 2017/02/23 16:00:53 ET
Table 'Isberga' 6-max Seat #5 is the button
Seat 1: Feverhead ($17.52 in chips) 
Seat 2: GESPERIA ($10 in chips) 
Seat 3: HARDCORE66RU ($11.13 in chips) 
Seat 4: THIMUCHIN ($10.96 in chips) 
Seat 5: YoungGriff86 ($18.33 in chips) 
Seat 6: Goroshkos88 ($21.55 in chips) 
Goroshkos88: posts small blind $0.05
Feverhead: posts big blind $0.10
*** HOLE CARDS ***
GESPERIA: folds 
HARDCORE66RU: folds 
THIMUCHIN: raises $0.10 to $0.20
YoungGriff86: folds 
Goroshkos88: folds 
Feverhead: calls $0.10
*** FLOP *** [9d Jh Ts]
Feverhead: checks 
THIMUCHIN: bets $0.43
Feverhead: folds 
Uncalled bet ($0.43) returned to THIMUCHIN
THIMUCHIN collected $0.43 from pot
*** SUMMARY ***
Total pot $0.45 | Rake $0.02 
Board [9d Jh Ts]
Seat 1: Feverhead (big blind) folded on the Flop
Seat 2: GESPERIA folded before Flop (didn't bet)
Seat 3: HARDCORE66RU folded before Flop (didn't bet)
Seat 4: THIMUCHIN collected ($0.43)
Seat 5: YoungGriff86 (button) folded before Flop (didn't bet)
Seat 6: Goroshkos88 (small blind) folded before Flop



PokerStars Hand #166667426811:  Hold'em No Limit ($0.05/$0.10 USD) - 2017/02/23 16:00:53 ET
Table 'Pyrrhus III' 6-max Seat #4 is the button
Seat 1: skatejeff ($16.99 in chips) 
Seat 2: univibe68 ($20.59 in chips) 
Seat 3: coolisses111 ($9.79 in chips) 
Seat 4: ex3Lero86 ($11.86 in chips) 
Seat 5: mAEgar ($5.07 in chips) 
Seat 6: MLPlayer16 ($20.05 in chips) 
mAEgar: posts small blind $0.05
MLPlayer16: posts big blind $0.10
skatejeff: posts the ante $0.02
univibe68: posts the ante $0.02
coolisses111: posts the ante $0.02
ex3Lero86: posts the ante $0.02
mAEgar: posts the ante $0.02
MLPlayer16: posts the ante $0.02
*** HOLE CARDS ***
skatejeff: raises $0.30 to $0.40
univibe68: folds 
coolisses111: folds 
ex3Lero86: folds 
mAEgar: folds 
MLPlayer16: folds 
Uncalled bet ($0.30) returned to skatejeff
skatejeff collected $0.37 from pot
*** SUMMARY ***
Total pot $0.37 | Rake $0 
Seat 1: skatejeff collected ($0.37)
Seat 2: univibe68 folded before Flop (didn't bet)
Seat 3: coolisses111 folded before Flop (didn't bet)
Seat 4: ex3Lero86 (button) folded before Flop (didn't bet)
Seat 5: mAEgar (small blind) folded before Flop
Seat 6: MLPlayer16 (big blind) folded before Flop



PokerStars Hand #166667426843:  Hold'em No Limit ($0.05/$0.10 USD) - 2017/02/23 16:00:53 ET
Table 'Rostia' 6-max Seat #5 is the button
Seat 1: paxit71 ($8 in chips) 
Seat 2: david_sara83 ($19.41 in chips) 
Seat 3: ImpAV ($10 in chips) 
Seat 4: Hyd SK ($11.68 in chips) 
Seat 5: Buddy8711 ($15.77 in chips) 
Seat 6: Giyorod ($10.90 in chips) 
Giyorod: posts small blind $0.05
paxit71: posts big blind $0.10
*** HOLE CARDS ***
david_sara83: folds 
ImpAV: folds 
Hyd SK: folds 
Buddy8711: folds 
Giyorod: folds 
Uncalled bet ($0.05) returned to paxit71
paxit71 collected $0.10 from pot
*** SUMMARY ***
Total pot $0.10 | Rake $0 
Seat 1: paxit71 (big blind) collected ($0.10)
Seat 2: david_sara83 folded before Flop (didn't bet)
Seat 3: ImpAV folded before Flop (didn't bet)
Seat 4: Hyd SK folded before Flop (didn't bet)
Seat 5: Buddy8711 (button) folded before Flop (didn't bet)
Seat 6: Giyorod (small blind) folded before Flop



PokerStars Hand #166667426851:  Hold'em No Limit ($0.05/$0.10 USD) - 2017/02/23 16:00:53 ET
Table 'Gyldenia II' 6-max Seat #1 is the button
Seat 1: KokoulinV ($10 in chips) 
Seat 2: Bandyaev ($10 in chips) 
Seat 3: ex3Lero86 ($23.37 in chips) 
Seat 5: CHRO8 ($17.74 in chips) 
Seat 6: 8th wonders ($10.79 in chips) 
Bandyaev: posts small blind $0.05
ex3Lero86: posts big blind $0.10
*** HOLE CARDS ***
CHRO8: folds 
8th wonders: folds 
KokoulinV: folds 
Bandyaev: folds 
Uncalled bet ($0.05) returned to ex3Lero86
ex3Lero86 collected $0.10 from pot
*** SUMMARY ***
Total pot $0.10 | Rake $0 
Seat 1: KokoulinV (button) folded before Flop (didn't bet)
Seat 2: Bandyaev (small blind) folded before Flop
Seat 3: ex3Lero86 (big blind) collected ($0.10)
Seat 5: CHRO8 folded before Flop (didn't bet)
Seat 6: 8th wonders folded before Flop (didn't bet)



PokerStars Hand #166667427057:  Hold'em No Limit ($0.05/$0.10 USD) - 2017/02/23 16:00:53 ET
Table 'Sirius II' 6-max Seat #3 is the button
Seat 1: Ampped87 ($9.37 in chips) 
Seat 2: jamalungma ($20.53 in chips) 
Seat 3: Spud014 ($10.08 in chips) 
Seat 6: MihaGr ($10.05 in chips) 
MihaGr: posts small blind $0.05
Ampped87: posts big blind $0.10
*** HOLE CARDS ***
jamalungma: folds 
Spud014: raises $0.10 to $0.20
MihaGr: folds 
Ampped87: calls $0.10
*** FLOP *** [Ad 4h 3d]
Ampped87: checks 
Spud014: bets $0.32
Ampped87: raises $0.62 to $0.94
Spud014: calls $0.62
*** TURN *** [Ad 4h 3d] [2s]
Ampped87: bets $1.30
Spud014: calls $1.30
*** RIVER *** [Ad 4h 3d 2s] [3c]
Ampped87: bets $2.50
Spud014: calls $2.50
*** SHOW DOWN ***
Ampped87: shows [7h 5h] (a straight, Ace to Five)
Spud014: mucks hand 
Ampped87 collected $9.48 from pot
*** SUMMARY ***
Total pot $9.93 | Rake $0.45 
Board [Ad 4h 3d 2s 3c]
Seat 1: Ampped87 (big blind) showed [7h 5h] and won ($9.48) with a straight, Ace to Five
Seat 2: jamalungma folded before Flop (didn't bet)
Seat 3: Spud014 (button) mucked
Seat 6: MihaGr (small blind) folded before Flop



PokerStars Hand #166667427104:  Hold'em No Limit ($0.05/$0.10 USD) - 2017/02/23 16:00:53 ET
Table 'Xanthippe II' 6-max Seat #3 is the button
Seat 1: ade22345 ($4.03 in chips) 
Seat 2: Bird et al ($13.66 in chips) 
Seat 3: Dcaro31 ($10 in chips) 
Seat 6: Orlangoor ($11.09 in chips) 
Orlangoor: posts small blind $0.05
ade22345: posts big blind $0.10
*** HOLE CARDS ***
Bird et al: folds 
Dcaro31: folds 
Orlangoor: folds 
Uncalled bet ($0.05) returned to ade22345
ade22345 collected $0.10 from pot
*** SUMMARY ***
Total pot $0.10 | Rake $0 
Seat 1: ade22345 (big blind) collected ($0.10)
Seat 2: Bird et al folded before Flop (didn't bet)
Seat 3: Dcaro31 (button) folded before Flop (didn't bet)
Seat 6: Orlangoor (small blind) folded before Flop



PokerStars Hand #166667427119:  Hold'em No Limit ($0.05/$0.10 USD) - 2017/02/23 16:00:53 ET
Table 'Arduina' 6-max Seat #1 is the button
Seat 1: kickereens ($21.24 in chips) 
Seat 2: Andy Wolf ($11.77 in chips) 
Seat 3: Dcaro31 ($13.26 in chips) 
Seat 4: ChuikaPridi ($30.88 in chips) 
Seat 5: ettedallas ($5.21 in chips) 
Seat 6: dierri ($9.99 in chips) 
Andy Wolf: posts small blind $0.05
Dcaro31: posts big blind $0.10
*** HOLE CARDS ***
ChuikaPridi: folds 
ettedallas: raises $0.10 to $0.20
dierri: folds 
kickereens: folds 
Andy Wolf: folds 
Dcaro31: folds 
Uncalled bet ($0.10) returned to ettedallas
ettedallas collected $0.25 from pot
*** SUMMARY ***
Total pot $0.25 | Rake $0 
Seat 1: kickereens (button) folded before Flop (didn't bet)
Seat 2: Andy Wolf (small blind) folded before Flop
Seat 3: Dcaro31 (big blind) folded before Flop
Seat 4: ChuikaPridi folded before Flop (didn't bet)
Seat 5: ettedallas collected ($0.25)
Seat 6: dierri folded before Flop (didn't bet)



PokerStars Hand #166667427893:  Hold'em No Limit ($0.05/$0.10 USD) - 2017/02/23 16:00:54 ET
Table 'Iduberga II' 6-max Seat #6 is the button
Seat 1: mhonielsen ($10 in chips) 
Seat 2: popypaleta ($12.27 in chips) 
Seat 4: Peter0087 ($10.03 in chips) 
Seat 5: Pokeaster ($10.62 in chips) 
Seat 6: tblocos ($11.63 in chips) 
mhonielsen: posts small blind $0.05
popypaleta: posts big blind $0.10
scorpionfish: sits out 
*** HOLE CARDS ***
Peter0087: folds 
Pokeaster: folds 
tblocos: calls $0.10
mhonielsen: raises $0.50 to $0.60
popypaleta: folds 
tblocos: calls $0.50
*** FLOP *** [3c 2c Qd]
mhonielsen: bets $0.72
tblocos: calls $0.72
*** TURN *** [3c 2c Qd] [6c]
mhonielsen: checks 
tblocos: bets $0.10
mhonielsen: calls $0.10
*** RIVER *** [3c 2c Qd 6c] [9c]
mhonielsen: checks 
tblocos: bets $0.50
mhonielsen: calls $0.50
*** SHOW DOWN ***
tblocos: shows [8c Ac] (a flush, Ace high)
mhonielsen: mucks hand 
tblocos collected $3.76 from pot
*** SUMMARY ***
Total pot $3.94 | Rake $0.18 
Board [3c 2c Qd 6c 9c]
Seat 1: mhonielsen (small blind) mucked
Seat 2: popypaleta (big blind) folded before Flop
Seat 4: Peter0087 folded before Flop (didn't bet)
Seat 5: Pokeaster folded before Flop (didn't bet)
Seat 6: tblocos (button) showed [8c Ac] and won ($3.76) with a flush, Ace high



PokerStars Hand #166667427921:  Hold'em No Limit ($0.05/$0.10 USD) - 2017/02/23 16:00:54 ET
Table 'Pulcova II' 6-max Seat #2 is the button
Seat 1: sexy_seagull ($10 in chips) 
Seat 2: Kazacha ($10 in chips) 
Seat 3: Lao Tsy ($14.01 in chips) 
Seat 4: VioXion ($10.25 in chips) 
Seat 5: mdelfin0 ($12.94 in chips) 
Seat 6: Ice_Isayev ($10.61 in chips) 
Lao Tsy: posts small blind $0.05
VioXion: posts big blind $0.10
*** HOLE CARDS ***
mdelfin0: folds 
Ice_Isayev: folds 
sexy_seagull: folds 
Kazacha: folds 
Lao Tsy: folds 
Uncalled bet ($0.05) returned to VioXion
VioXion collected $0.10 from pot
*** SUMMARY ***
Total pot $0.10 | Rake $0 
Seat 1: sexy_seagull folded before Flop (didn't bet)
Seat 2: Kazacha (button) folded before Flop (didn't bet)
Seat 3: Lao Tsy (small blind) folded before Flop
Seat 4: VioXion (big blind) collected ($0.10)
Seat 5: mdelfin0 folded before Flop (didn't bet)
Seat 6: Ice_Isayev folded before Flop (didn't bet)



PokerStars Hand #166667428413:  Hold'em No Limit ($0.05/$0.10 USD) - 2017/02/23 16:00:55 ET
Table 'Huberta II' 6-max Seat #4 is the button
Seat 1: tr41n3r12 ($10 in chips) 
Seat 2: Ice_Isayev ($12.48 in chips) 
Seat 3: patrick19111 ($10.90 in chips) 
Seat 4: VAD21 ($11.38 in chips) 
Seat 5: Feverhead ($27.43 in chips) 
Feverhead: posts small blind $0.05
tr41n3r12: posts big blind $0.10
*** HOLE CARDS ***
Ice_Isayev: folds 
patrick19111: folds 
VAD21: folds 
Feverhead: folds 
Uncalled bet ($0.05) returned to tr41n3r12
tr41n3r12 collected $0.10 from pot
*** SUMMARY ***
Total pot $0.10 | Rake $0 
Seat 1: tr41n3r12 (big blind) collected ($0.10)
Seat 2: Ice_Isayev folded before Flop (didn't bet)
Seat 3: patrick19111 folded before Flop (didn't bet)
Seat 4: VAD21 (button) folded before Flop (didn't bet)
Seat 5: Feverhead (small blind) folded before Flop



PokerStars Hand #166667428633:  Hold'em No Limit ($0.05/$0.10 USD) - 2017/02/23 16:00:55 ET
Table 'Gelria' 6-max Seat #1 is the button
Seat 1: ab260414 ($10.12 in chips) 
Seat 2: fishhook5 ($10.05 in chips) 
Seat 3: Orlangoor ($10.34 in chips) 
Seat 5: apenvel ($7.64 in chips) 
Seat 6: Andrei ProFF ($10.57 in chips) 
fishhook5: posts small blind $0.05
Orlangoor: posts big blind $0.10
*** HOLE CARDS ***
apenvel: folds 
Andrei ProFF: folds 
ab260414: raises $0.10 to $0.20
fishhook5: folds 
Orlangoor: raises $0.50 to $0.70
ab260414: calls $0.50
*** FLOP *** [Ad 9h 4s]
Orlangoor: checks 
ab260414: checks 
*** TURN *** [Ad 9h 4s] [Ac]
Orlangoor: bets $0.69
ab260414: folds 
Uncalled bet ($0.69) returned to Orlangoor
Orlangoor collected $1.38 from pot
*** SUMMARY ***
Total pot $1.45 | Rake $0.07 
Board [Ad 9h 4s Ac]
Seat 1: ab260414 (button) folded on the Turn
Seat 2: fishhook5 (small blind) folded before Flop
Seat 3: Orlangoor (big blind) collected ($1.38)
Seat 5: apenvel folded before Flop (didn't bet)
Seat 6: Andrei ProFF folded before Flop (didn't bet)



PokerStars Hand #166667428777:  Hold'em No Limit ($0.05/$0.10 USD) - 2017/02/23 16:00:55 ET
Table 'Hyakutake' 6-max Seat #3 is the button
Seat 1: Asilvagoat ($11.22 in chips) 
Seat 2: boxer821 ($10.66 in chips) 
Seat 3: lenboysprite ($7.40 in chips) 
Seat 4: eniksenik ($12.75 in chips) 
Seat 5: RoJ1 ($12.29 in chips) 
Seat 6: maxiv608 ($13.42 in chips) 
eniksenik: posts small blind $0.05
RoJ1: posts big blind $0.10
*** HOLE CARDS ***
maxiv608: folds 
Asilvagoat: folds 
boxer821: folds 
lenboysprite: folds 
eniksenik: raises $0.20 to $0.30
RoJ1: raises $0.50 to $0.80
eniksenik: raises $1.40 to $2.20
RoJ1: folds 
Uncalled bet ($1.40) returned to eniksenik
eniksenik collected $1.60 from pot
*** SUMMARY ***
Total pot $1.60 | Rake $0 
Seat 1: Asilvagoat folded before Flop (didn't bet)
Seat 2: boxer821 folded before Flop (didn't bet)
Seat 3: lenboysprite (button) folded before Flop (didn't bet)
Seat 4: eniksenik (small blind) collected ($1.60)
Seat 5: RoJ1 (big blind) folded before Flop
Seat 6: maxiv608 folded before Flop (didn't bet)



PokerStars Hand #166667428972:  Hold'em No Limit ($0.05/$0.10 USD) - 2017/02/23 16:00:55 ET
Table 'Serpens' 6-max Seat #1 is the button
Seat 1: Namhkal ($10 in chips) 
Seat 2: KA3AXCTAHEU, ($10.33 in chips) 
Seat 3: homelessdan ($28.50 in chips) 
Seat 4: Ragazzi3 ($17.19 in chips) 
Seat 5: XwinX25 ($11.81 in chips) 
Seat 6: Croplayer1 ($10.15 in chips) 
KA3AXCTAHEU,: posts small blind $0.05
homelessdan: posts big blind $0.10
*** HOLE CARDS ***
Ragazzi3: calls $0.10
XwinX25: folds 
Croplayer1: folds 
Namhkal: folds 
KA3AXCTAHEU,: raises $0.25 to $0.35
homelessdan: folds 
Ragazzi3: raises $0.25 to $0.60
KA3AXCTAHEU,: folds 
Uncalled bet ($0.25) returned to Ragazzi3
Ragazzi3 collected $0.80 from pot
*** SUMMARY ***
Total pot $0.80 | Rake $0 
Seat 1: Namhkal (button) folded before Flop (didn't bet)
Seat 2: KA3AXCTAHEU, (small blind) folded before Flop
Seat 3: homelessdan (big blind) folded before Flop
Seat 4: Ragazzi3 collected ($0.80)
Seat 5: XwinX25 folded before Flop (didn't bet)
Seat 6: Croplayer1 folded before Flop (didn't bet)



PokerStars Hand #166667429035:  Hold'em No Limit ($0.05/$0.10 USD) - 2017/02/23 16:00:55 ET
Table 'Union' 6-max Seat #4 is the button
Seat 1: Krumi1703 ($6.42 in chips) 
Seat 2: Zooplack ($10 in chips) 
Seat 3: Rodik002 ($12.16 in chips) 
Seat 4: Croplayer1 ($14.16 in chips) 
Seat 5: Chodemuncher ($10 in chips) 
Seat 6: bonyo71 ($4 in chips) 
Chodemuncher: posts small blind $0.05
bonyo71: posts big blind $0.10
*** HOLE CARDS ***
Krumi1703: folds 
Zooplack: folds 
Rodik002: folds 
Croplayer1: raises $0.10 to $0.20
Chodemuncher: folds 
bonyo71: folds 
Uncalled bet ($0.10) returned to Croplayer1
Croplayer1 collected $0.25 from pot
*** SUMMARY ***
Total pot $0.25 | Rake $0 
Seat 1: Krumi1703 folded before Flop (didn't bet)
Seat 2: Zooplack folded before Flop (didn't bet)
Seat 3: Rodik002 folded before Flop (didn't bet)
Seat 4: Croplayer1 (button) collected ($0.25)
Seat 5: Chodemuncher (small blind) folded before Flop
Seat 6: bonyo71 (big blind) folded before Flop



PokerStars Hand #166667429181:  Hold'em No Limit ($0.05/$0.10 USD) - 2017/02/23 16:00:56 ET
Table 'Cyane' 6-max Seat #5 is the button
Seat 1: KA3AXCTAHEU, ($10.47 in chips) 
Seat 2: Temniy Elf ($10.15 in chips) 
Seat 3: Mamm0nism ($14.09 in chips) 
Seat 4: truck1234 ($20.96 in chips) 
Seat 5: ChuikaPridi ($10.17 in chips) 
Seat 6: 8th wonders ($10.05 in chips) 
8th wonders: posts small blind $0.05
KA3AXCTAHEU,: posts big blind $0.10
*** HOLE CARDS ***
Temniy Elf: folds 
Mamm0nism: folds 
truck1234: raises $0.20 to $0.30
ChuikaPridi: folds 
8th wonders: folds 
KA3AXCTAHEU,: folds 
Uncalled bet ($0.20) returned to truck1234
truck1234 collected $0.25 from pot
*** SUMMARY ***
Total pot $0.25 | Rake $0 
Seat 1: KA3AXCTAHEU, (big blind) folded before Flop
Seat 2: Temniy Elf folded before Flop (didn't bet)
Seat 3: Mamm0nism folded before Flop (didn't bet)
Seat 4: truck1234 collected ($0.25)
Seat 5: ChuikaPridi (button) folded before Flop (didn't bet)
Seat 6: 8th wonders (small blind) folded before Flop



PokerStars Hand #166667429339:  Hold'em No Limit ($0.05/$0.10 USD) - 2017/02/23 16:00:56 ET
Table 'Girtab' 6-max Seat #6 is the button
Seat 2: MühliJr ($11.41 in chips) 
Seat 3: kingartur222 ($12.59 in chips) 
Seat 4: Hyd SK ($10.79 in chips) 
Seat 5: sexy_seagull ($10.87 in chips) 
Seat 6: BahiaMinhaP ($10 in chips) 
MühliJr: posts small blind $0.05
kingartur222: posts big blind $0.10
*** HOLE CARDS ***
Hyd SK: raises $0.25 to $0.35
sexy_seagull: folds 
BahiaMinhaP: folds 
MühliJr: folds 
kingartur222: calls $0.25
*** FLOP *** [4h 9s 3h]
kingartur222: checks 
Hyd SK: checks 
*** TURN *** [4h 9s 3h] [Ks]
kingartur222: bets $0.54
Hyd SK: calls $0.54
*** RIVER *** [4h 9s 3h Ks] [7c]
kingartur222: checks 
Hyd SK: bets $1.16
kingartur222: folds 
Uncalled bet ($1.16) returned to Hyd SK
Hyd SK collected $1.75 from pot
*** SUMMARY ***
Total pot $1.83 | Rake $0.08 
Board [4h 9s 3h Ks 7c]
Seat 2: MühliJr (small blind) folded before Flop
Seat 3: kingartur222 (big blind) folded on the River
Seat 4: Hyd SK collected ($1.75)
Seat 5: sexy_seagull folded before Flop (didn't bet)
Seat 6: BahiaMinhaP (button) folded before Flop (didn't bet)



PokerStars Hand #166667429429:  Hold'em No Limit ($0.05/$0.10 USD) - 2017/02/23 16:00:56 ET
Table 'Hirons' 6-max Seat #6 is the button
Seat 1: RoJ1 ($10 in chips) 
Seat 2: coolisses111 ($8.79 in chips) 
Seat 3: czeczen7 ($15.28 in chips) 
Seat 4: Smitty03300 ($10 in chips) 
Seat 5: Pekaml ($10 in chips) 
Seat 6: garigura ($14.10 in chips) 
RoJ1: posts small blind $0.05
coolisses111: posts big blind $0.10
*** HOLE CARDS ***
czeczen7: calls $0.10
Smitty03300: folds 
Pekaml: folds 
garigura: raises $0.30 to $0.40
RoJ1: folds 
coolisses111: folds 
czeczen7: calls $0.30
*** FLOP *** [7d 4c 7h]
czeczen7: checks 
garigura: bets $0.46
czeczen7: folds 
Uncalled bet ($0.46) returned to garigura
garigura collected $0.91 from pot
*** SUMMARY ***
Total pot $0.95 | Rake $0.04 
Board [7d 4c 7h]
Seat 1: RoJ1 (small blind) folded before Flop
Seat 2: coolisses111 (big blind) folded before Flop
Seat 3: czeczen7 folded on the Flop
Seat 4: Smitty03300 folded before Flop (didn't bet)
Seat 5: Pekaml folded before Flop (didn't bet)
Seat 6: garigura (button) collected ($0.91)



PokerStars Hand #166667429450:  Hold'em No Limit ($0.05/$0.10 USD) - 2017/02/23 16:00:56 ET
Table 'Lobelia II' 6-max Seat #3 is the button
Seat 1: facewald ($29.10 in chips) 
Seat 2: Dcaro31 ($18.59 in chips) 
Seat 3: oddshoff ($10.88 in chips) 
Seat 5: Feverhead ($20.48 in chips) 
Seat 6: NvR.m1nD ($10 in chips) 
Feverhead: posts small blind $0.05
NvR.m1nD: posts big blind $0.10
*** HOLE CARDS ***
facewald: folds 
Dcaro31: folds 
oddshoff: folds 
Feverhead: folds 
Uncalled bet ($0.05) returned to NvR.m1nD
NvR.m1nD collected $0.10 from pot
*** SUMMARY ***
Total pot $0.10 | Rake $0 
Seat 1: facewald folded before Flop (didn't bet)
Seat 2: Dcaro31 folded before Flop (didn't bet)
Seat 3: oddshoff (button) folded before Flop (didn't bet)
Seat 5: Feverhead (small blind) folded before Flop
Seat 6: NvR.m1nD (big blind) collected ($0.10)



PokerStars Hand #166667429572:  Hold'em No Limit ($0.05/$0.10 USD) - 2017/02/23 16:00:56 ET
Table 'Caupolican' 6-max Seat #1 is the button
Seat 1: kingartur222 ($10.08 in chips) 
Seat 2: garigura ($19.60 in chips) 
Seat 3: arturgalant ($4.77 in chips) 
Seat 4: mhonielsen ($11.46 in chips) 
Seat 5: Kazacha ($10.95 in chips) 
Seat 6: crazydevill ($11.02 in chips) 
garigura: posts small blind $0.05
arturgalant: posts big blind $0.10
*** HOLE CARDS ***
mhonielsen: folds 
Kazacha: folds 
crazydevill: folds 
kingartur222: folds 
garigura: folds 
Uncalled bet ($0.05) returned to arturgalant
arturgalant collected $0.10 from pot
*** SUMMARY ***
Total pot $0.10 | Rake $0 
Seat 1: kingartur222 (button) folded before Flop (didn't bet)
Seat 2: garigura (small blind) folded before Flop
Seat 3: arturgalant (big blind) collected ($0.10)
Seat 4: mhonielsen folded before Flop (didn't bet)
Seat 5: Kazacha folded before Flop (didn't bet)
Seat 6: crazydevill folded before Flop (didn't bet)



PokerStars Hand #166667429794:  Hold'em No Limit ($0.05/$0.10 USD) - 2017/02/23 16:00:56 ET
Table 'Nikko II' 6-max Seat #3 is the button
Seat 1: bdixon_5 ($9.85 in chips) 
Seat 2: popypaleta ($10.15 in chips) 
Seat 3: Hyd SK ($10.40 in chips) 
Seat 4: Peter0087 ($9.89 in chips) 
Seat 5: Aescul@pius ($11.07 in chips) 
Peter0087: posts small blind $0.05
Aescul@pius: posts big blind $0.10
*** HOLE CARDS ***
bdixon_5: raises $0.20 to $0.30
popypaleta: folds 
Hyd SK: calls $0.30
Peter0087: folds 
Aescul@pius: raises $0.95 to $1.25
bdixon_5: calls $0.95
Hyd SK: calls $0.95
*** FLOP *** [Qs Qd 7d]
IAntikI leaves the table
JahSoldier69 joins the table at seat #6 
Aescul@pius: bets $1.65
bdixon_5: calls $1.65
Hyd SK: raises $4.29 to $5.94
Aescul@pius: folds 
bdixon_5: calls $4.29
*** TURN *** [Qs Qd 7d] [Jh]
bdixon_5: bets $2.66 and is all-in
Hyd SK: calls $2.66
*** RIVER *** [Qs Qd 7d Jh] [Jd]
*** SHOW DOWN ***
bdixon_5: shows [Qh Ah] (a full house, Queens full of Jacks)
Hyd SK: shows [Qc Ac] (a full house, Queens full of Jacks)
bdixon_5 collected $10.82 from pot
Hyd SK collected $10.81 from pot
*** SUMMARY ***
Total pot $22.65 | Rake $1.02 
Board [Qs Qd 7d Jh Jd]
Seat 1: bdixon_5 showed [Qh Ah] and won ($10.82) with a full house, Queens full of Jacks
Seat 2: popypaleta folded before Flop (didn't bet)
Seat 3: Hyd SK (button) showed [Qc Ac] and won ($10.81) with a full house, Queens full of Jacks
Seat 4: Peter0087 (small blind) folded before Flop
Seat 5: Aescul@pius (big blind) folded on the Flop



PokerStars Hand #166667429850:  Hold'em No Limit ($0.05/$0.10 USD) - 2017/02/23 16:00:56 ET
Table 'Azelfafage' 6-max Seat #1 is the button
Seat 1: Sbozzz ($14.81 in chips) 
Seat 2: tr41n3r12 ($10.60 in chips) 
Seat 3: todor1711 ($20.96 in chips) 
Seat 4: fedorka rus ($11.57 in chips) 
Seat 5: 8th wonders ($11.35 in chips) 
Seat 6: KA3AXCTAHEU, ($10 in chips) 
tr41n3r12: posts small blind $0.05
todor1711: posts big blind $0.10
*** HOLE CARDS ***
fedorka rus: folds 
8th wonders: folds 
KA3AXCTAHEU,: folds 
Sbozzz: raises $0.20 to $0.30
tr41n3r12: calls $0.25
todor1711: calls $0.20
*** FLOP *** [Td Jc 6d]
tr41n3r12: checks 
todor1711: checks 
Sbozzz: bets $0.43
tr41n3r12: folds 
todor1711: calls $0.43
*** TURN *** [Td Jc 6d] [6c]
todor1711: checks 
Sbozzz: checks 
*** RIVER *** [Td Jc 6d 6c] [5h]
todor1711: checks 
Sbozzz: checks 
*** SHOW DOWN ***
todor1711: shows [3h 3c] (two pair, Sixes and Threes)
Sbozzz: shows [9d Th] (two pair, Tens and Sixes)
Sbozzz collected $1.68 from pot
*** SUMMARY ***
Total pot $1.76 | Rake $0.08 
Board [Td Jc 6d 6c 5h]
Seat 1: Sbozzz (button) showed [9d Th] and won ($1.68) with two pair, Tens and Sixes
Seat 2: tr41n3r12 (small blind) folded on the Flop
Seat 3: todor1711 (big blind) showed [3h 3c] and lost with two pair, Sixes and Threes
Seat 4: fedorka rus folded before Flop (didn't bet)
Seat 5: 8th wonders folded before Flop (didn't bet)
Seat 6: KA3AXCTAHEU, folded before Flop (didn't bet)



PokerStars Hand #166667429887:  Hold'em No Limit ($0.05/$0.10 USD) - 2017/02/23 16:00:56 ET
Table 'Wilkens II' 6-max Seat #1 is the button
Seat 1: Islamiq-GuRL ($12.15 in chips) 
Seat 2: manashov ($10.20 in chips) 
Seat 3: Namhkal ($10.95 in chips) 
Seat 5: patrick19111 ($10 in chips) 
Seat 6: XaXaTyH4uK ($14.61 in chips) 
manashov: posts small blind $0.05
Namhkal: posts big blind $0.10
myevc: sits out 
*** HOLE CARDS ***
patrick19111: folds 
XaXaTyH4uK: raises $0.20 to $0.30
Islamiq-GuRL: folds 
manashov: folds 
Namhkal: folds 
Uncalled bet ($0.20) returned to XaXaTyH4uK
XaXaTyH4uK collected $0.25 from pot
*** SUMMARY ***
Total pot $0.25 | Rake $0 
Seat 1: Islamiq-GuRL (button) folded before Flop (didn't bet)
Seat 2: manashov (small blind) folded before Flop
Seat 3: Namhkal (big blind) folded before Flop
Seat 5: patrick19111 folded before Flop (didn't bet)
Seat 6: XaXaTyH4uK collected ($0.25)



PokerStars Hand #166667429977:  Hold'em No Limit ($0.05/$0.10 USD) - 2017/02/23 16:00:57 ET
Table 'Euryalos II' 6-max Seat #6 is the button
Seat 1: kickereens ($19.74 in chips) 
Seat 2: Yspenyanin ($10 in chips) 
Seat 3: Hyd SK ($10.15 in chips) 
Seat 4: popypaleta ($15.87 in chips) 
Seat 5: voledy ($12.86 in chips) 
Seat 6: MihaGr ($10 in chips) 
kickereens: posts small blind $0.05
Yspenyanin: posts big blind $0.10
*** HOLE CARDS ***
Hyd SK: raises $0.25 to $0.35
popypaleta: folds 
voledy: folds 
MihaGr: folds 
kickereens: folds 
Yspenyanin: folds 
Uncalled bet ($0.25) returned to Hyd SK
kickereens leaves the table
Hyd SK collected $0.25 from pot
*** SUMMARY ***
Total pot $0.25 | Rake $0 
Seat 1: kickereens (small blind) folded before Flop
Seat 2: Yspenyanin (big blind) folded before Flop
Seat 3: Hyd SK collected ($0.25)
Seat 4: popypaleta folded before Flop (didn't bet)
Seat 5: voledy folded before Flop (didn't bet)
Seat 6: MihaGr (button) folded before Flop (didn't bet)



PokerStars Hand #166667430601:  Hold'em No Limit ($0.05/$0.10 USD) - 2017/02/23 16:00:57 ET
Table 'Landi II' 6-max Seat #2 is the button
Seat 1: dersiemer ($11.97 in chips) 
Seat 2: Aescul@pius ($10.95 in chips) 
Seat 3: dr.goofy ($18.61 in chips) 
Seat 4: alesi13 ($6.35 in chips) 
Seat 5: Bird et al ($10.63 in chips) 
Seat 6: arti192837 ($10 in chips) 
dr.goofy: posts small blind $0.05
alesi13: posts big blind $0.10
*** HOLE CARDS ***
Bird et al: folds 
arti192837: folds 
dersiemer: folds 
Aescul@pius: raises $0.10 to $0.20
dr.goofy: folds 
alesi13: folds 
Uncalled bet ($0.10) returned to Aescul@pius
Aescul@pius collected $0.25 from pot
*** SUMMARY ***
Total pot $0.25 | Rake $0 
Seat 1: dersiemer folded before Flop (didn't bet)
Seat 2: Aescul@pius (button) collected ($0.25)
Seat 3: dr.goofy (small blind) folded before Flop
Seat 4: alesi13 (big blind) folded before Flop
Seat 5: Bird et al folded before Flop (didn't bet)
Seat 6: arti192837 folded before Flop (didn't bet)



PokerStars Hand #166667430625:  Hold'em No Limit ($0.05/$0.10 USD) - 2017/02/23 16:00:57 ET
Table 'Aconcagua' 6-max Seat #5 is the button
Seat 4: pivanki11 ($8.61 in chips) 
Seat 5: frazaunch ($7.13 in chips) 
Seat 6: coolisses111 ($9.84 in chips) 
coolisses111: posts small blind $0.05
RkaczoR: is sitting out 
pivanki11: posts big blind $0.10
pivanki11: posts the ante $0.02
frazaunch: posts the ante $0.02
coolisses111: posts the ante $0.02
*** HOLE CARDS ***
frazaunch: calls $0.10
coolisses111: calls $0.05
pivanki11: raises $0.20 to $0.30
frazaunch: calls $0.20
RkaczoR leaves the table
coolisses111: folds 
*** FLOP *** [4s Qd As]
pivanki11: bets $0.40
frazaunch: folds 
Uncalled bet ($0.40) returned to pivanki11
pivanki11 collected $0.73 from pot
*** SUMMARY ***
Total pot $0.76 | Rake $0.03 
Board [4s Qd As]
Seat 4: pivanki11 (big blind) collected ($0.73)
Seat 5: frazaunch (button) folded on the Flop
Seat 6: coolisses111 (small blind) folded before Flop



PokerStars Hand #166667430662:  Hold'em No Limit ($0.05/$0.10 USD) - 2017/02/23 16:00:57 ET
Table 'Gaika' 6-max Seat #2 is the button
Seat 1: oddshoff ($12.56 in chips) 
Seat 2: NvR.m1nD ($17.77 in chips) 
Seat 3: david_sara83 ($10.37 in chips) 
Seat 4: fortieth ($11.65 in chips) 
Seat 5: fedorka rus ($10.65 in chips) 
Seat 6: dr.goofy ($11.15 in chips) 
david_sara83: posts small blind $0.05
fortieth: posts big blind $0.10
*** HOLE CARDS ***
fedorka rus: folds 
dr.goofy: folds 
oddshoff: folds 
NvR.m1nD: raises $0.20 to $0.30
david_sara83: folds 
fortieth: folds 
Uncalled bet ($0.20) returned to NvR.m1nD
NvR.m1nD collected $0.25 from pot
*** SUMMARY ***
Total pot $0.25 | Rake $0 
Seat 1: oddshoff folded before Flop (didn't bet)
Seat 2: NvR.m1nD (button) collected ($0.25)
Seat 3: david_sara83 (small blind) folded before Flop
Seat 4: fortieth (big blind) folded before Flop
Seat 5: fedorka rus folded before Flop (didn't bet)
Seat 6: dr.goofy folded before Flop (didn't bet)



PokerStars Hand #166667431114:  Hold'em No Limit ($0.05/$0.10 USD) - 2017/02/23 16:00:58 ET
Table 'Sham' 6-max Seat #3 is the button
Seat 1: pancernik21 ($10 in chips) 
Seat 2: ex3Lero86 ($10 in chips) 
Seat 3: weez3r ($22.83 in chips) 
Seat 4: VAD21 ($12.85 in chips) 
Seat 5: T9MS ($10 in chips) 
Seat 6: bdixon_5 ($9.70 in chips) 
VAD21: posts small blind $0.05
T9MS: posts big blind $0.10
*** HOLE CARDS ***
bdixon_5: folds 
pancernik21: folds 
ex3Lero86: raises $0.15 to $0.25
weez3r: folds 
VAD21: folds 
T9MS: folds 
Uncalled bet ($0.15) returned to ex3Lero86
ex3Lero86 collected $0.25 from pot
*** SUMMARY ***
Total pot $0.25 | Rake $0 
Seat 1: pancernik21 folded before Flop (didn't bet)
Seat 2: ex3Lero86 collected ($0.25)
Seat 3: weez3r (button) folded before Flop (didn't bet)
Seat 4: VAD21 (small blind) folded before Flop
Seat 5: T9MS (big blind) folded before Flop
Seat 6: bdixon_5 folded before Flop (didn't bet)



PokerStars Hand #166667431136:  Hold'em No Limit ($0.05/$0.10 USD) - 2017/02/23 16:00:58 ET
Table 'Armenia' 6-max Seat #1 is the button
Seat 1: tr41n3r12 ($12.17 in chips) 
Seat 2: Yabidooo ($10 in chips) 
Seat 3: CDestructivo ($12.28 in chips) 
Seat 4: x3ultimate ($11.25 in chips) 
Seat 5: boxer821 ($11.85 in chips) 
Seat 6: mega spasser ($5.22 in chips) 
Yabidooo: posts small blind $0.05
CDestructivo: posts big blind $0.10
*** HOLE CARDS ***
x3ultimate: folds 
boxer821: raises $0.20 to $0.30
mega spasser: folds 
tr41n3r12: folds 
Yabidooo: folds 
CDestructivo: folds 
Uncalled bet ($0.20) returned to boxer821
boxer821 collected $0.25 from pot
*** SUMMARY ***
Total pot $0.25 | Rake $0 
Seat 1: tr41n3r12 (button) folded before Flop (didn't bet)
Seat 2: Yabidooo (small blind) folded before Flop
Seat 3: CDestructivo (big blind) folded before Flop
Seat 4: x3ultimate folded before Flop (didn't bet)
Seat 5: boxer821 collected ($0.25)
Seat 6: mega spasser folded before Flop (didn't bet)



PokerStars Hand #166667431212:  Hold'em No Limit ($0.05/$0.10 USD) - 2017/02/23 16:00:58 ET
Table 'Nata II' 6-max Seat #3 is the button
Seat 1: luisantrs ($9.34 in chips) 
Seat 2: CHRO8 ($15.85 in chips) 
Seat 3: 8th wonders ($10.57 in chips) 
Seat 4: Comeback3392 ($10 in chips) 
Seat 5: RoJ1 ($10 in chips) 
Seat 6: IAntikI ($10 in chips) 
Comeback3392: posts small blind $0.05
RoJ1: posts big blind $0.10
*** HOLE CARDS ***
IAntikI: folds 
luisantrs: folds 
CHRO8: folds 
8th wonders: raises $0.20 to $0.30
Comeback3392: folds 
RoJ1: folds 
Uncalled bet ($0.20) returned to 8th wonders
8th wonders collected $0.25 from pot
*** SUMMARY ***
Total pot $0.25 | Rake $0 
Seat 1: luisantrs folded before Flop (didn't bet)
Seat 2: CHRO8 folded before Flop (didn't bet)
Seat 3: 8th wonders (button) collected ($0.25)
Seat 4: Comeback3392 (small blind) folded before Flop
Seat 5: RoJ1 (big blind) folded before Flop
Seat 6: IAntikI folded before Flop (didn't bet)



PokerStars Hand #166667431387:  Hold'em No Limit ($0.05/$0.10 USD) - 2017/02/23 16:00:58 ET
Table 'Bootes' 6-max Seat #6 is the button
Seat 1: Namhkal ($13.35 in chips) 
Seat 2: Bird et al ($19.60 in chips) 
Seat 3: KA3AXCTAHEU, ($19.50 in chips) 
Seat 4: totonove ($4.71 in chips) 
Seat 5: Pekaml ($15.19 in chips) 
Seat 6: cherep61987 ($10 in chips) 
Namhkal: posts small blind $0.05
Bird et al: posts big blind $0.10
*** HOLE CARDS ***
KA3AXCTAHEU,: folds 
totonove: folds 
Pekaml: folds 
cherep61987: folds 
Namhkal: raises $0.15 to $0.25
Bird et al: folds 
Uncalled bet ($0.15) returned to Namhkal
Namhkal collected $0.20 from pot
*** SUMMARY ***
Total pot $0.20 | Rake $0 
Seat 1: Namhkal (small blind) collected ($0.20)
Seat 2: Bird et al (big blind) folded before Flop
Seat 3: KA3AXCTAHEU, folded before Flop (didn't bet)
Seat 4: totonove folded before Flop (didn't bet)
Seat 5: Pekaml folded before Flop (didn't bet)
Seat 6: cherep61987 (button) folded before Flop (didn't bet)



PokerStars Hand #166667431605:  Hold'em No Limit ($0.05/$0.10 USD) - 2017/02/23 16:00:58 ET
Table 'Girtab II' 6-max Seat #2 is the button
Seat 1: Kow6oy ($10.30 in chips) 
Seat 2: Pokeaster ($14.07 in chips) 
Seat 4: Hyd SK ($27.38 in chips) 
Seat 5: dzesio18 ($11.18 in chips) 
Seat 6: DamDatsAnAce ($10 in chips) 
chimera252 will be allowed to play after the button
Hyd SK: posts small blind $0.05
dzesio18: posts big blind $0.10
*** HOLE CARDS ***
DamDatsAnAce: folds 
Kow6oy: raises $0.20 to $0.30
Pokeaster: folds 
Hyd SK: folds 
dzesio18: raises $0.90 to $1.20
Kow6oy: folds 
Uncalled bet ($0.90) returned to dzesio18
dzesio18 collected $0.65 from pot
*** SUMMARY ***
Total pot $0.65 | Rake $0 
Seat 1: Kow6oy folded before Flop
Seat 2: Pokeaster (button) folded before Flop (didn't bet)
Seat 4: Hyd SK (small blind) folded before Flop
Seat 5: dzesio18 (big blind) collected ($0.65)
Seat 6: DamDatsAnAce folded before Flop (didn't bet)



PokerStars Hand #166667431659:  Hold'em No Limit ($0.05/$0.10 USD) - 2017/02/23 16:00:59 ET
Table 'Alzirr II' 6-max Seat #2 is the button
Seat 1: KA3AXCTAHEU, ($10.86 in chips) 
Seat 2: popypaleta ($10 in chips) 
Seat 3: Lucky HoBBiT ($10.58 in chips) 
Seat 4: Scanner17 ($18.89 in chips) 
Seat 5: Kosantin ($21.71 in chips) 
Seat 6: EggMayo ($10 in chips) 
Lucky HoBBiT: posts small blind $0.05
Scanner17: posts big blind $0.10
*** HOLE CARDS ***
Kosantin: folds 
EggMayo: folds 
KA3AXCTAHEU,: folds 
popypaleta: folds 
Lucky HoBBiT: folds 
Uncalled bet ($0.05) returned to Scanner17
Scanner17 collected $0.10 from pot
*** SUMMARY ***
Total pot $0.10 | Rake $0 
Seat 1: KA3AXCTAHEU, folded before Flop (didn't bet)
Seat 2: popypaleta (button) folded before Flop (didn't bet)
Seat 3: Lucky HoBBiT (small blind) folded before Flop
Seat 4: Scanner17 (big blind) collected ($0.10)
Seat 5: Kosantin folded before Flop (didn't bet)
Seat 6: EggMayo folded before Flop (didn't bet)



PokerStars Hand #166667431744:  Hold'em No Limit ($0.05/$0.10 USD) - 2017/02/23 16:00:59 ET
Table 'Heka II' 6-max Seat #6 is the button
Seat 1: Mamm0nism ($14.32 in chips) 
Seat 2: oddshoff ($11.72 in chips) 
Seat 3: MühliJr ($10 in chips) 
Seat 4: theNot0r1ous ($10.07 in chips) 
Seat 5: ArcticBearDK ($12.63 in chips) 
Seat 6: MonteCris92 ($10 in chips) 
Mamm0nism: posts small blind $0.05
oddshoff: posts big blind $0.10
*** HOLE CARDS ***
MühliJr: folds 
theNot0r1ous: folds 
ArcticBearDK: raises $0.12 to $0.22
MonteCris92: folds 
Mamm0nism: folds 
oddshoff: folds 
Uncalled bet ($0.12) returned to ArcticBearDK
ArcticBearDK collected $0.25 from pot
*** SUMMARY ***
Total pot $0.25 | Rake $0 
Seat 1: Mamm0nism (small blind) folded before Flop
Seat 2: oddshoff (big blind) folded before Flop
Seat 3: MühliJr folded before Flop (didn't bet)
Seat 4: theNot0r1ous folded before Flop (didn't bet)
Seat 5: ArcticBearDK collected ($0.25)
Seat 6: MonteCris92 (button) folded before Flop (didn't bet)



PokerStars Hand #166667432005:  Hold'em No Limit ($0.05/$0.10 USD) - 2017/02/23 16:00:59 ET
Table 'Kraz II' 6-max Seat #4 is the button
Seat 1: bdixon_5 ($9.85 in chips) 
Seat 2: Smok3008 ($8.10 in chips) 
Seat 3: Eddys Edge ($10 in chips) 
Seat 4: WinninBikini ($10.42 in chips) 
Seat 6: tr41n3r12 ($10.20 in chips) 
tr41n3r12: posts small blind $0.05
bdixon_5: posts big blind $0.10
*** HOLE CARDS ***
Joker51_wtf! joins the table at seat #5 
Smok3008: raises $0.10 to $0.20
Eddys Edge: folds 
Smok3008 said, "|-)"
Smok3008 said, "(tilt)"
WinninBikini: calls $0.20
tr41n3r12: folds 
bdixon_5: folds 
*** FLOP *** [7s 9d 2d]
Smok3008: bets $0.26
WinninBikini: folds 
Uncalled bet ($0.26) returned to Smok3008
Smok3008 collected $0.53 from pot
*** SUMMARY ***
Total pot $0.55 | Rake $0.02 
Board [7s 9d 2d]
Seat 1: bdixon_5 (big blind) folded before Flop
Seat 2: Smok3008 collected ($0.53)
Seat 3: Eddys Edge folded before Flop (didn't bet)
Seat 4: WinninBikini (button) folded on the Flop
Seat 6: tr41n3r12 (small blind) folded before Flop



PokerStars Hand #166667432060:  Hold'em No Limit ($0.05/$0.10 USD) - 2017/02/23 16:00:59 ET
Table 'Aisakos II' 6-max Seat #3 is the button
Seat 1: Crafty23@PS ($10 in chips) 
Seat 2: svaika24 ($17.63 in chips) 
Seat 3: iamkakaroto ($10.69 in chips) 
Seat 4: T9MS ($10 in chips) 
Seat 5: KokoulinV ($10.87 in chips) 
Seat 6: LarryTheStar ($10.15 in chips) 
T9MS: posts small blind $0.05
KokoulinV: posts big blind $0.10
*** HOLE CARDS ***
LarryTheStar: folds 
Crafty23@PS: folds 
svaika24: raises $0.10 to $0.20
iamkakaroto: folds 
T9MS: folds 
KokoulinV: calls $0.10
*** FLOP *** [2h As 4d]
KokoulinV: checks 
svaika24: bets $0.20
KokoulinV: calls $0.20
*** TURN *** [2h As 4d] [6c]
KokoulinV: checks 
svaika24: bets $0.20
KokoulinV: calls $0.20
*** RIVER *** [2h As 4d 6c] [9d]
KokoulinV: bets $0.70
svaika24: folds 
Uncalled bet ($0.70) returned to KokoulinV
KokoulinV collected $1.19 from pot
*** SUMMARY ***
Total pot $1.25 | Rake $0.06 
Board [2h As 4d 6c 9d]
Seat 1: Crafty23@PS folded before Flop (didn't bet)
Seat 2: svaika24 folded on the River
Seat 3: iamkakaroto (button) folded before Flop (didn't bet)
Seat 4: T9MS (small blind) folded before Flop
Seat 5: KokoulinV (big blind) collected ($1.19)
Seat 6: LarryTheStar folded before Flop (didn't bet)



PokerStars Hand #166667432266:  Hold'em No Limit ($0.05/$0.10 USD) - 2017/02/23 16:00:59 ET
Table 'Lesath III' 6-max Seat #1 is the button
Seat 1: Gogeta26 ($6.83 in chips) 
Seat 2: WinninBikini ($10.08 in chips) 
Seat 3: Giyorod ($10.15 in chips) 
Seat 4: Eddys Edge ($10 in chips) 
Seat 5: eniksenik ($15.49 in chips) 
Seat 6: patrick19111 ($10.71 in chips) 
WinninBikini: posts small blind $0.05
Giyorod: posts big blind $0.10
*** HOLE CARDS ***
Eddys Edge: folds 
eniksenik: folds 
patrick19111: folds 
Gogeta26: calls $0.10
WinninBikini: folds 
Giyorod: checks 
*** FLOP *** [7h 6h Kc]
Giyorod: checks 
Gogeta26: checks 
*** TURN *** [7h 6h Kc] [2d]
Giyorod: checks 
Gogeta26: checks 
*** RIVER *** [7h 6h Kc 2d] [2h]
Giyorod: checks 
Gogeta26: bets $0.40
Giyorod: folds 
Uncalled bet ($0.40) returned to Gogeta26
Gogeta26 collected $0.24 from pot
*** SUMMARY ***
Total pot $0.25 | Rake $0.01 
Board [7h 6h Kc 2d 2h]
Seat 1: Gogeta26 (button) collected ($0.24)
Seat 2: WinninBikini (small blind) folded before Flop
Seat 3: Giyorod (big blind) folded on the River
Seat 4: Eddys Edge folded before Flop (didn't bet)
Seat 5: eniksenik folded before Flop (didn't bet)
Seat 6: patrick19111 folded before Flop (didn't bet)



PokerStars Hand #166667432324:  Hold'em No Limit ($0.05/$0.10 USD) - 2017/02/23 16:00:59 ET
Table 'Nuki' 6-max Seat #4 is the button
Seat 1: bdixon_5 ($8.05 in chips) 
Seat 2: ArcticBearDK ($18.58 in chips) 
Seat 3: david_sara83 ($13.40 in chips) 
Seat 4: GESPERIA ($28.86 in chips) 
Seat 5: fabadam ($11.28 in chips) 
Seat 6: Zooplack ($25.42 in chips) 
fabadam: posts small blind $0.05
Zooplack: posts big blind $0.10
*** HOLE CARDS ***
bdixon_5: folds 
ArcticBearDK: folds 
david_sara83: raises $0.15 to $0.25
GESPERIA: calls $0.25
fabadam: folds 
Zooplack: folds 
*** FLOP *** [Ah Ts 2h]
david_sara83: checks 
GESPERIA: checks 
*** TURN *** [Ah Ts 2h] [3s]
david_sara83: checks 
GESPERIA: checks 
*** RIVER *** [Ah Ts 2h 3s] [2d]
david_sara83: checks 
GESPERIA: checks 
*** SHOW DOWN ***
david_sara83: shows [7s 7h] (two pair, Sevens and Deuces)
GESPERIA: mucks hand 
david_sara83 collected $0.62 from pot
*** SUMMARY ***
Total pot $0.65 | Rake $0.03 
Board [Ah Ts 2h 3s 2d]
Seat 1: bdixon_5 folded before Flop (didn't bet)
Seat 2: ArcticBearDK folded before Flop (didn't bet)
Seat 3: david_sara83 showed [7s 7h] and won ($0.62) with two pair, Sevens and Deuces
Seat 4: GESPERIA (button) mucked
Seat 5: fabadam (small blind) folded before Flop
Seat 6: Zooplack (big blind) folded before Flop



PokerStars Hand #166667432355:  Hold'em No Limit ($0.05/$0.10 USD) - 2017/02/23 16:00:59 ET
Table 'Lorbach' 6-max Seat #6 is the button
Seat 1: LarryTheStar ($11.17 in chips) 
Seat 2: fabadam ($12.48 in chips) 
Seat 3: ArcticBearDK ($11.20 in chips) 
Seat 4: McCleans ($10 in chips) 
Seat 5: Cluckh ($15.07 in chips) 
Seat 6: Worlz ($12.82 in chips) 
LarryTheStar: posts small blind $0.05
fabadam: posts big blind $0.10
*** HOLE CARDS ***
ArcticBearDK: folds 
McCleans: folds 
Cluckh: raises $0.15 to $0.25
Worlz: folds 
LarryTheStar: folds 
fabadam: folds 
Uncalled bet ($0.15) returned to Cluckh
Cluckh collected $0.25 from pot
*** SUMMARY ***
Total pot $0.25 | Rake $0 
Seat 1: LarryTheStar (small blind) folded before Flop
Seat 2: fabadam (big blind) folded before Flop
Seat 3: ArcticBearDK folded before Flop (didn't bet)
Seat 4: McCleans folded before Flop (didn't bet)
Seat 5: Cluckh collected ($0.25)
Seat 6: Worlz (button) folded before Flop (didn't bet)



PokerStars Hand #166667432418:  Hold'em No Limit ($0.05/$0.10 USD) - 2017/02/23 16:00:59 ET
Table 'Lagrula' 6-max Seat #4 is the button
Seat 1: Ice_Isayev ($10 in chips) 
Seat 2: jamalungma ($10.96 in chips) 
Seat 3: micke667 ($15.91 in chips) 
Seat 4: Calimero2408 ($4.87 in chips) 
Seat 5: Iarlei ($10 in chips) 
Seat 6: Spud014 ($11.10 in chips) 
Iarlei: posts small blind $0.05
Spud014: posts big blind $0.10
*** HOLE CARDS ***
Ice_Isayev: folds 
jamalungma: folds 
micke667: calls $0.10
Calimero2408: calls $0.10
Iarlei: calls $0.05
Spud014: checks 
*** FLOP *** [6s 4h Ad]
Iarlei: checks 
Spud014: checks 
micke667: bets $0.10
Calimero2408: calls $0.10
Iarlei: folds 
Spud014: folds 
*** TURN *** [6s 4h Ad] [6c]
micke667: bets $0.30
Calimero2408: folds 
Uncalled bet ($0.30) returned to micke667
micke667 collected $0.57 from pot
*** SUMMARY ***
Total pot $0.60 | Rake $0.03 
Board [6s 4h Ad 6c]
Seat 1: Ice_Isayev folded before Flop (didn't bet)
Seat 2: jamalungma folded before Flop (didn't bet)
Seat 3: micke667 collected ($0.57)
Seat 4: Calimero2408 (button) folded on the Turn
Seat 5: Iarlei (small blind) folded on the Flop
Seat 6: Spud014 (big blind) folded on the Flop



PokerStars Hand #166667432717:  Hold'em No Limit ($0.05/$0.10 USD) - 2017/02/23 16:01:00 ET
Table 'Lederle' 6-max Seat #2 is the button
Seat 1: D3NyA ($10 in chips) 
Seat 2: truck1234 ($16 in chips) 
Seat 3: Kazacha ($10 in chips) 
Seat 4: Pokeaster ($13.76 in chips) 
Seat 5: 8th wonders ($13.06 in chips) 
Kazacha: posts small blind $0.05
Pokeaster: posts big blind $0.10
*** HOLE CARDS ***
8th wonders: folds 
D3NyA: raises $0.15 to $0.25
truck1234: folds 
Kazacha: raises $0.65 to $0.90
Pokeaster: folds 
D3NyA: folds 
Uncalled bet ($0.65) returned to Kazacha
Kazacha collected $0.60 from pot
*** SUMMARY ***
Total pot $0.60 | Rake $0 
Seat 1: D3NyA folded before Flop
Seat 2: truck1234 (button) folded before Flop (didn't bet)
Seat 3: Kazacha (small blind) collected ($0.60)
Seat 4: Pokeaster (big blind) folded before Flop
Seat 5: 8th wonders folded before Flop (didn't bet)



PokerStars Hand #166667432923:  Hold'em No Limit ($0.05/$0.10 USD) - 2017/02/23 16:01:00 ET
Table 'Halawe II' 6-max Seat #2 is the button
Seat 1: DIGOR100 ($6.50 in chips) 
Seat 2: Darkfrai ($10.20 in chips) 
Seat 3: cherep61987 ($10.77 in chips) 
Seat 4: voledy ($12.04 in chips) 
Seat 5: takis nik ($12.83 in chips) 
Seat 6: Rodik002 ($20.52 in chips) 
cherep61987: posts small blind $0.05
voledy: posts big blind $0.10
*** HOLE CARDS ***
takis nik: folds 
Rodik002: folds 
DIGOR100: folds 
Darkfrai: raises $0.15 to $0.25
cherep61987: folds 
voledy: calls $0.15
*** FLOP *** [9h 7d 5d]
voledy: checks 
Darkfrai: bets $0.31
voledy: raises $0.66 to $0.97
Darkfrai: folds 
Uncalled bet ($0.66) returned to voledy
voledy collected $1.12 from pot
*** SUMMARY ***
Total pot $1.17 | Rake $0.05 
Board [9h 7d 5d]
Seat 1: DIGOR100 folded before Flop (didn't bet)
Seat 2: Darkfrai (button) folded on the Flop
Seat 3: cherep61987 (small blind) folded before Flop
Seat 4: voledy (big blind) collected ($1.12)
Seat 5: takis nik folded before Flop (didn't bet)
Seat 6: Rodik002 folded before Flop (didn't bet)



PokerStars Hand #166667433026:  Hold'em No Limit ($0.05/$0.10 USD) - 2017/02/23 16:01:00 ET
Table 'Geisha' 6-max Seat #2 is the button
Seat 1: facewald ($34.63 in chips) 
Seat 2: voledy ($10 in chips) 
Seat 4: jvstsayyes ($12.42 in chips) 
Seat 5: KRZuff ($15.10 in chips) 
Seat 6: Namhkal ($19.85 in chips) 
Eddys Edge will be allowed to play after the button
jvstsayyes: posts small blind $0.05
KRZuff: posts big blind $0.10
*** HOLE CARDS ***
Namhkal: folds 
facewald: folds 
voledy: raises $0.15 to $0.25
jvstsayyes: folds 
KRZuff: folds 
Uncalled bet ($0.15) returned to voledy
voledy collected $0.25 from pot
*** SUMMARY ***
Total pot $0.25 | Rake $0 
Seat 1: facewald folded before Flop (didn't bet)
Seat 2: voledy (button) collected ($0.25)
Seat 4: jvstsayyes (small blind) folded before Flop
Seat 5: KRZuff (big blind) folded before Flop
Seat 6: Namhkal folded before Flop (didn't bet)



PokerStars Hand #166667433133:  Hold'em No Limit ($0.05/$0.10 USD) - 2017/02/23 16:01:00 ET
Table 'Xanthippe II' 6-max Seat #6 is the button
Seat 1: ade22345 ($4.08 in chips) 
Seat 2: Bird et al ($13.66 in chips) 
Seat 3: Dcaro31 ($10 in chips) 
Seat 6: Orlangoor ($11.04 in chips) 
ade22345: posts small blind $0.05
Bird et al: posts big blind $0.10
*** HOLE CARDS ***
Dcaro31: raises $0.20 to $0.30
Orlangoor: folds 
yodzik joins the table at seat #5 
ade22345: raises $0.80 to $1.10
Bird et al: folds 
Barcardi14 joins the table at seat #4 
Dcaro31: folds 
Uncalled bet ($0.80) returned to ade22345
ade22345 collected $0.70 from pot
*** SUMMARY ***
Total pot $0.70 | Rake $0 
Seat 1: ade22345 (small blind) collected ($0.70)
Seat 2: Bird et al (big blind) folded before Flop
Seat 3: Dcaro31 folded before Flop
Seat 6: Orlangoor (button) folded before Flop (didn't bet)



PokerStars Hand #166667433177:  Hold'em No Limit ($0.05/$0.10 USD) - 2017/02/23 16:01:00 ET
Table 'Nymphe II' 6-max Seat #1 is the button
Seat 1: jacktayra ($3.25 in chips) 
Seat 2: Newqbrown ($10.05 in chips) 
Seat 3: THIMUCHIN ($14.40 in chips) 
Seat 4: coolisses111 ($19.15 in chips) 
Seat 6: Xander188 ($18.53 in chips) 
Newqbrown: posts small blind $0.05
THIMUCHIN: posts big blind $0.10
Yspenyanin: sits out 
*** HOLE CARDS ***
coolisses111: folds 
Xander188: raises $0.20 to $0.30
jacktayra: calls $0.30
Newqbrown: folds 
THIMUCHIN: folds 
*** FLOP *** [Kc 3s 5d]
Xander188: checks 
jacktayra: bets $0.20
Xander188: folds 
Uncalled bet ($0.20) returned to jacktayra
jacktayra collected $0.72 from pot
*** SUMMARY ***
Total pot $0.75 | Rake $0.03 
Board [Kc 3s 5d]
Seat 1: jacktayra (button) collected ($0.72)
Seat 2: Newqbrown (small blind) folded before Flop
Seat 3: THIMUCHIN (big blind) folded before Flop
Seat 4: coolisses111 folded before Flop (didn't bet)
Seat 6: Xander188 folded on the Flop



PokerStars Hand #166667433532:  Hold'em No Limit ($0.05/$0.10 USD) - 2017/02/23 16:01:01 ET
Table 'Antinous' 6-max Seat #1 is the button
Seat 1: Andrei ProFF ($16.06 in chips) 
Seat 2: Nr847 ($10.66 in chips) 
Seat 3: dittoro ($10 in chips) 
Seat 4: Pekaml ($15.54 in chips) 
Seat 5: Covetsoles ($6.34 in chips) 
Nr847: posts small blind $0.05
dittoro: posts big blind $0.10
coolisses111: sits out 
*** HOLE CARDS ***
Pekaml: folds 
Covetsoles: folds 
Andrei ProFF: raises $0.15 to $0.25
Nr847: folds 
dittoro: calls $0.15
*** FLOP *** [8c Jd 5d]
dittoro: checks 
Andrei ProFF: bets $0.40
dittoro: folds 
Uncalled bet ($0.40) returned to Andrei ProFF
Andrei ProFF collected $0.53 from pot
*** SUMMARY ***
Total pot $0.55 | Rake $0.02 
Board [8c Jd 5d]
Seat 1: Andrei ProFF (button) collected ($0.53)
Seat 2: Nr847 (small blind) folded before Flop
Seat 3: dittoro (big blind) folded on the Flop
Seat 4: Pekaml folded before Flop (didn't bet)
Seat 5: Covetsoles folded before Flop (didn't bet)



PokerStars Hand #166667433590:  Hold'em No Limit ($0.05/$0.10 USD) - 2017/02/23 16:01:01 ET
Table 'Pandora III' 6-max Seat #5 is the button
Seat 1: Pokeaster ($11.04 in chips) 
Seat 2: garigura ($11.62 in chips) 
Seat 3: ChuikaPridi ($16.61 in chips) 
Seat 4: mhonielsen ($10 in chips) 
Seat 5: MühliJr ($10.15 in chips) 
Pokeaster: posts small blind $0.05
garigura: posts big blind $0.10
*** HOLE CARDS ***
ChuikaPridi: folds 
mhonielsen: folds 
MühliJr: folds 
yodzik joins the table at seat #6 
Pokeaster: folds 
Uncalled bet ($0.05) returned to garigura
garigura collected $0.10 from pot
*** SUMMARY ***
Total pot $0.10 | Rake $0 
Seat 1: Pokeaster (small blind) folded before Flop
Seat 2: garigura (big blind) collected ($0.10)
Seat 3: ChuikaPridi folded before Flop (didn't bet)
Seat 4: mhonielsen folded before Flop (didn't bet)
Seat 5: MühliJr (button) folded before Flop (didn't bet)



PokerStars Hand #166667433777:  Hold'em No Limit ($0.05/$0.10 USD) - 2017/02/23 16:01:01 ET
Table 'Persephone' 6-max Seat #3 is the button
Seat 2: Kupi007 ($14.73 in chips) 
Seat 3: Kow6oy ($11.88 in chips) 
Seat 4: 2G28 ($10 in chips) 
Seat 5: D3NyA ($10 in chips) 
Seat 6: popypaleta ($11.97 in chips) 
2G28: posts small blind $0.05
D3NyA: posts big blind $0.10
FRAID358: sits out 
*** HOLE CARDS ***
popypaleta: folds 
Kupi007: folds 
Kow6oy: folds 
2G28: folds 
Uncalled bet ($0.05) returned to D3NyA
D3NyA collected $0.10 from pot
*** SUMMARY ***
Total pot $0.10 | Rake $0 
Seat 2: Kupi007 folded before Flop (didn't bet)
Seat 3: Kow6oy (button) folded before Flop (didn't bet)
Seat 4: 2G28 (small blind) folded before Flop
Seat 5: D3NyA (big blind) collected ($0.10)
Seat 6: popypaleta folded before Flop (didn't bet)



PokerStars Hand #166667434123:  Hold'em No Limit ($0.05/$0.10 USD) - 2017/02/23 16:01:01 ET
Table 'Gyldenia II' 6-max Seat #2 is the button
Seat 1: KokoulinV ($10 in chips) 
Seat 2: Bandyaev ($10 in chips) 
Seat 3: ex3Lero86 ($23.42 in chips) 
Seat 5: CHRO8 ($17.74 in chips) 
Seat 6: 8th wonders ($10.79 in chips) 
ex3Lero86: posts small blind $0.05
CHRO8: posts big blind $0.10
*** HOLE CARDS ***
8th wonders: folds 
KokoulinV: raises $0.15 to $0.25
Bandyaev: folds 
ex3Lero86: folds 
CHRO8: calls $0.15
*** FLOP *** [9c Kd 9h]
CHRO8: checks 
KokoulinV: checks 
*** TURN *** [9c Kd 9h] [5s]
CHRO8: checks 
KokoulinV: checks 
*** RIVER *** [9c Kd 9h 5s] [Qs]
CHRO8: checks 
KokoulinV: checks 
*** SHOW DOWN ***
CHRO8: shows [As Jh] (a pair of Nines)
KokoulinV: shows [Tc Ah] (a pair of Nines)
CHRO8 collected $0.27 from pot
KokoulinV collected $0.26 from pot
*** SUMMARY ***
Total pot $0.55 | Rake $0.02 
Board [9c Kd 9h 5s Qs]
Seat 1: KokoulinV showed [Tc Ah] and won ($0.26) with a pair of Nines
Seat 2: Bandyaev (button) folded before Flop (didn't bet)
Seat 3: ex3Lero86 (small blind) folded before Flop
Seat 5: CHRO8 (big blind) showed [As Jh] and won ($0.27) with a pair of Nines
Seat 6: 8th wonders folded before Flop (didn't bet)



PokerStars Hand #166667434374:  Hold'em No Limit ($0.05/$0.10 USD) - 2017/02/23 16:01:02 ET
Table 'Hestia' 6-max Seat #2 is the button
Seat 2: RoJ1 ($11.47 in chips) 
Seat 3: MBen10 ($12.91 in chips) 
Seat 4: Lucky HoBBiT ($10 in chips) 
Seat 5: CiisCi ($16.55 in chips) 
Seat 6: MihaGr ($10 in chips) 
MBen10: posts small blind $0.05
Lucky HoBBiT: posts big blind $0.10
Pekaml: sits out 
*** HOLE CARDS ***
CiisCi: raises $0.25 to $0.35
MihaGr: folds 
RoJ1: raises $0.70 to $1.05
MBen10: folds 
Lucky HoBBiT: folds 
CiisCi: folds 
Uncalled bet ($0.70) returned to RoJ1
RoJ1 collected $0.85 from pot
*** SUMMARY ***
Total pot $0.85 | Rake $0 
Seat 2: RoJ1 (button) collected ($0.85)
Seat 3: MBen10 (small blind) folded before Flop
Seat 4: Lucky HoBBiT (big blind) folded before Flop
Seat 5: CiisCi folded before Flop
Seat 6: MihaGr folded before Flop (didn't bet)



PokerStars Hand #166667434441:  Hold'em No Limit ($0.05/$0.10 USD) - 2017/02/23 16:01:02 ET
Table 'Samitchell III' 6-max Seat #6 is the button
Seat 1: dr.goofy ($10.32 in chips) 
Seat 2: Orlangoor ($10 in chips) 
Seat 3: Kow6oy ($10.10 in chips) 
Seat 4: eniksenik ($10.10 in chips) 
Seat 5: boxer821 ($18.31 in chips) 
Seat 6: fedorka rus ($12.96 in chips) 
dr.goofy: posts small blind $0.05
Orlangoor: posts big blind $0.10
*** HOLE CARDS ***
Kow6oy: folds 
eniksenik: folds 
boxer821: folds 
fedorka rus: raises $0.10 to $0.20
dr.goofy: folds 
Orlangoor: folds 
Uncalled bet ($0.10) returned to fedorka rus
fedorka rus collected $0.25 from pot
*** SUMMARY ***
Total pot $0.25 | Rake $0 
Seat 1: dr.goofy (small blind) folded before Flop
Seat 2: Orlangoor (big blind) folded before Flop
Seat 3: Kow6oy folded before Flop (didn't bet)
Seat 4: eniksenik folded before Flop (didn't bet)
Seat 5: boxer821 folded before Flop (didn't bet)
Seat 6: fedorka rus (button) collected ($0.25)



PokerStars Hand #166667434784:  Hold'em No Limit ($0.05/$0.10 USD) - 2017/02/23 16:01:02 ET
Table 'Ophelia' 6-max Seat #3 is the button
Seat 1: ralfi37 ($11.01 in chips) 
Seat 2: popypaleta ($16.12 in chips) 
Seat 3: mvp0013 ($11.60 in chips) 
Seat 4: Cluckh ($11.70 in chips) 
Seat 5: truck1234 ($14.01 in chips) 
Seat 6: Yabidooo ($10.72 in chips) 
Cluckh: posts small blind $0.05
truck1234: posts big blind $0.10
*** HOLE CARDS ***
Yabidooo: folds 
ralfi37: folds 
popypaleta: folds 
mvp0013: folds 
Cluckh: folds 
Uncalled bet ($0.05) returned to truck1234
truck1234 collected $0.10 from pot
*** SUMMARY ***
Total pot $0.10 | Rake $0 
Seat 1: ralfi37 folded before Flop (didn't bet)
Seat 2: popypaleta folded before Flop (didn't bet)
Seat 3: mvp0013 (button) folded before Flop (didn't bet)
Seat 4: Cluckh (small blind) folded before Flop
Seat 5: truck1234 (big blind) collected ($0.10)
Seat 6: Yabidooo folded before Flop (didn't bet)



PokerStars Hand #166667434999:  Hold'em No Limit ($0.05/$0.10 USD) - 2017/02/23 16:01:03 ET
Table 'Pirola III' 6-max Seat #2 is the button
Seat 1: bdixon_5 ($9.77 in chips) 
Seat 2: gaHy_HaXeP ($10 in chips) 
Seat 3: kingartur222 ($10.27 in chips) 
Seat 4: McCleans ($10.30 in chips) 
Seat 6: T9MS ($10 in chips) 
kingartur222: posts small blind $0.05
McCleans: posts big blind $0.10
*** HOLE CARDS ***
T9MS: folds 
bdixon_5: raises $0.20 to $0.30
gaHy_HaXeP: folds 
kingartur222: folds 
McCleans: folds 
Uncalled bet ($0.20) returned to bdixon_5
bdixon_5 collected $0.25 from pot
*** SUMMARY ***
Total pot $0.25 | Rake $0 
Seat 1: bdixon_5 collected ($0.25)
Seat 2: gaHy_HaXeP (button) folded before Flop (didn't bet)
Seat 3: kingartur222 (small blind) folded before Flop
Seat 4: McCleans (big blind) folded before Flop
Seat 6: T9MS folded before Flop (didn't bet)



PokerStars Hand #166667435300:  Hold'em No Limit ($0.05/$0.10 USD) - 2017/02/23 16:01:03 ET
Table 'Izar' 6-max Seat #4 is the button
Seat 1: bambolejro ($10.54 in chips) 
Seat 2: mvp0013 ($10.72 in chips) 
Seat 4: Matee92 ($6.96 in chips) 
Seat 5: fishhook5 ($10 in chips) 
fishhook5: posts small blind $0.05
jamalungma: is sitting out 
jamalungma leaves the table
bambolejro: posts big blind $0.10
Yspenyanin: sits out 
*** HOLE CARDS ***
mvp0013: folds 
Matee92: folds 
fishhook5: raises $0.14 to $0.24
bambolejro: folds 
Uncalled bet ($0.14) returned to fishhook5
fishhook5 collected $0.20 from pot
*** SUMMARY ***
Total pot $0.20 | Rake $0 
Seat 1: bambolejro (big blind) folded before Flop
Seat 2: mvp0013 folded before Flop (didn't bet)
Seat 4: Matee92 (button) folded before Flop (didn't bet)
Seat 5: fishhook5 (small blind) collected ($0.20)



PokerStars Hand #166667435690:  Hold'em No Limit ($0.05/$0.10 USD) - 2017/02/23 16:01:03 ET
Table 'Bengt' 6-max Seat #5 is the button
Seat 1: Lucky HoBBiT ($10 in chips) 
Seat 2: ChefRocco ($23.37 in chips) 
Seat 3: nantes15 ($12.51 in chips) 
Seat 4: 8th wonders ($10 in chips) 
Seat 5: RoJ1 ($10.46 in chips) 
Seat 6: Goroshkos88 ($10.05 in chips) 
Goroshkos88: posts small blind $0.05
Lucky HoBBiT: posts big blind $0.10
*** HOLE CARDS ***
ChefRocco: folds 
nantes15: folds 
8th wonders: folds 
RoJ1: folds 
Goroshkos88: folds 
Uncalled bet ($0.05) returned to Lucky HoBBiT
Lucky HoBBiT collected $0.10 from pot
*** SUMMARY ***
Total pot $0.10 | Rake $0 
Seat 1: Lucky HoBBiT (big blind) collected ($0.10)
Seat 2: ChefRocco folded before Flop (didn't bet)
Seat 3: nantes15 folded before Flop (didn't bet)
Seat 4: 8th wonders folded before Flop (didn't bet)
Seat 5: RoJ1 (button) folded before Flop (didn't bet)
Seat 6: Goroshkos88 (small blind) folded before Flop



PokerStars Hand #166667435766:  Hold'em No Limit ($0.05/$0.10 USD) - 2017/02/23 16:01:03 ET
Table 'Deflotte' 6-max Seat #1 is the button
Seat 1: Zooplack ($15.54 in chips) 
Seat 3: Croplayer1 ($10 in chips) 
Seat 4: 8th wonders ($10 in chips) 
Seat 5: Pokeaster ($11.52 in chips) 
Seat 6: Iarlei ($11.39 in chips) 
MonteCris92 will be allowed to play after the button
Croplayer1: posts small blind $0.05
8th wonders: posts big blind $0.10
*** HOLE CARDS ***
Pokeaster: folds 
Iarlei: folds 
Zooplack: folds 
Croplayer1: raises $0.10 to $0.20
8th wonders: raises $0.60 to $0.80
Croplayer1: folds 
Uncalled bet ($0.60) returned to 8th wonders
8th wonders collected $0.40 from pot
*** SUMMARY ***
Total pot $0.40 | Rake $0 
Seat 1: Zooplack (button) folded before Flop (didn't bet)
Seat 3: Croplayer1 (small blind) folded before Flop
Seat 4: 8th wonders (big blind) collected ($0.40)
Seat 5: Pokeaster folded before Flop (didn't bet)
Seat 6: Iarlei folded before Flop (didn't bet)



PokerStars Hand #166667435924:  Hold'em No Limit ($0.05/$0.10 USD) - 2017/02/23 16:01:04 ET
Table 'Iapetus III' 6-max Seat #3 is the button
Seat 2: Pekaml ($10.15 in chips) 
Seat 3: takis nik ($10.12 in chips) 
Seat 4: XaXaTyH4uK ($10 in chips) 
Seat 5: homelessdan ($14.21 in chips) 
Seat 6: eniksenik ($13.98 in chips) 
XaXaTyH4uK: posts small blind $0.05
homelessdan: posts big blind $0.10
Czezar Life: sits out 
*** HOLE CARDS ***
eniksenik: folds 
Pekaml: folds 
eniksenik leaves the table
takis nik: raises $0.10 to $0.20
yodzik joins the table at seat #6 
XaXaTyH4uK: raises $0.80 to $1
homelessdan: folds 
takis nik: folds 
Uncalled bet ($0.80) returned to XaXaTyH4uK
XaXaTyH4uK collected $0.50 from pot
*** SUMMARY ***
Total pot $0.50 | Rake $0 
Seat 2: Pekaml folded before Flop (didn't bet)
Seat 3: takis nik (button) folded before Flop
Seat 4: XaXaTyH4uK (small blind) collected ($0.50)
Seat 5: homelessdan (big blind) folded before Flop
Seat 6: eniksenik folded before Flop (didn't bet)



PokerStars Hand #166667436201:  Hold'em No Limit ($0.05/$0.10 USD) - 2017/02/23 16:01:04 ET
Table 'Sinon II' 6-max Seat #5 is the button
Seat 1: Aescul@pius ($11.39 in chips) 
Seat 2: ÄissesHai ($12.32 in chips) 
Seat 3: crazydevill ($10 in chips) 
Seat 4: Bandyaev ($15.48 in chips) 
Seat 5: ab260414 ($11.06 in chips) 
Seat 6: hartmut2012 ($8.38 in chips) 
hartmut2012: posts small blind $0.05
Aescul@pius: posts big blind $0.10
*** HOLE CARDS ***
ÄissesHai: calls $0.10
crazydevill: folds 
Bandyaev: folds 
ab260414: folds 
hartmut2012: calls $0.05
Aescul@pius: checks 
*** FLOP *** [As 7d Th]
hartmut2012: checks 
Aescul@pius: checks 
ÄissesHai: checks 
*** TURN *** [As 7d Th] [9s]
hartmut2012: bets $0.20
Aescul@pius: raises $0.40 to $0.60
ÄissesHai: calls $0.60
hartmut2012: calls $0.40
*** RIVER *** [As 7d Th 9s] [3d]
hartmut2012: bets $1
Aescul@pius: calls $1
ÄissesHai: calls $1
*** SHOW DOWN ***
hartmut2012: shows [Ah 2s] (a pair of Aces)
Aescul@pius: shows [Ac 7s] (two pair, Aces and Sevens)
ÄissesHai: shows [9d 9h] (three of a kind, Nines)
ÄissesHai collected $4.87 from pot
*** SUMMARY ***
Total pot $5.10 | Rake $0.23 
Board [As 7d Th 9s 3d]
Seat 1: Aescul@pius (big blind) showed [Ac 7s] and lost with two pair, Aces and Sevens
Seat 2: ÄissesHai showed [9d 9h] and won ($4.87) with three of a kind, Nines
Seat 3: crazydevill folded before Flop (didn't bet)
Seat 4: Bandyaev folded before Flop (didn't bet)
Seat 5: ab260414 (button) folded before Flop (didn't bet)
Seat 6: hartmut2012 (small blind) showed [Ah 2s] and lost with a pair of Aces



PokerStars Hand #166667436578:  Hold'em No Limit ($0.05/$0.10 USD) - 2017/02/23 16:01:04 ET
Table 'Postrema' 6-max Seat #1 is the button
Seat 1: CHRO8 ($9.94 in chips) 
Seat 2: pancernik21 ($12.66 in chips) 
Seat 3: edcc19 ($3.06 in chips) 
Seat 4: ChuikaPridi ($13.48 in chips) 
Seat 5: Comeback3392 ($10.51 in chips) 
Seat 6: Scanner17 ($10 in chips) 
pancernik21: posts small blind $0.05
edcc19: posts big blind $0.10
*** HOLE CARDS ***
ChuikaPridi: folds 
Comeback3392: raises $0.20 to $0.30
Scanner17: calls $0.30
CHRO8: folds 
pancernik21: folds 
edcc19: folds 
*** FLOP *** [6d 7d 4s]
Comeback3392: bets $0.50
Scanner17: raises $0.90 to $1.40
Comeback3392: raises $2.35 to $3.75
Scanner17: folds 
Uncalled bet ($2.35) returned to Comeback3392
Comeback3392 collected $3.39 from pot
*** SUMMARY ***
Total pot $3.55 | Rake $0.16 
Board [6d 7d 4s]
Seat 1: CHRO8 (button) folded before Flop (didn't bet)
Seat 2: pancernik21 (small blind) folded before Flop
Seat 3: edcc19 (big blind) folded before Flop
Seat 4: ChuikaPridi folded before Flop (didn't bet)
Seat 5: Comeback3392 collected ($3.39)
Seat 6: Scanner17 folded on the Flop



PokerStars Hand #166667436731:  Hold'em No Limit ($0.05/$0.10 USD) - 2017/02/23 16:01:05 ET
Table 'Tyndareus III' 6-max Seat #4 is the button
Seat 1: MBen10 ($10 in chips) 
Seat 2: MihaGr ($10 in chips) 
Seat 3: XaXaTyH4uK ($10.60 in chips) 
Seat 4: Therodorus ($11.61 in chips) 
Seat 5: Chodemuncher ($10.05 in chips) 
Seat 6: Elinaattor ($9.52 in chips) 
Chodemuncher: posts small blind $0.05
Elinaattor: posts big blind $0.10
*** HOLE CARDS ***
MBen10: folds 
MihaGr: raises $0.20 to $0.30
XaXaTyH4uK: folds 
Therodorus: folds 
Chodemuncher: folds 
Elinaattor: folds 
Uncalled bet ($0.20) returned to MihaGr
MihaGr collected $0.25 from pot
*** SUMMARY ***
Total pot $0.25 | Rake $0 
Seat 1: MBen10 folded before Flop (didn't bet)
Seat 2: MihaGr collected ($0.25)
Seat 3: XaXaTyH4uK folded before Flop (didn't bet)
Seat 4: Therodorus (button) folded before Flop (didn't bet)
Seat 5: Chodemuncher (small blind) folded before Flop
Seat 6: Elinaattor (big blind) folded before Flop



PokerStars Hand #166667436938:  Hold'em No Limit ($0.05/$0.10 USD) - 2017/02/23 16:01:05 ET
Table 'Pallas II' 6-max Seat #6 is the button
Seat 1: mdelfin0 ($15.93 in chips) 
Seat 2: FRAID358 ($10.15 in chips) 
Seat 3: jamalungma ($10 in chips) 
Seat 4: Mr. Bluff 34 ($10.29 in chips) 
Seat 6: xdjango07x ($12.38 in chips) 
mdelfin0: posts small blind $0.05
FRAID358: posts big blind $0.10
Yspenyanin: sits out 
*** HOLE CARDS ***
jamalungma: raises $0.15 to $0.25
Mr. Bluff 34: calls $0.25
xdjango07x: folds 
mdelfin0: folds 
FRAID358: folds 
*** FLOP *** [5c Kc 8d]
jamalungma: bets $0.31
Mr. Bluff 34: raises $0.31 to $0.62
jamalungma: folds 
Uncalled bet ($0.31) returned to Mr. Bluff 34
Mr. Bluff 34 collected $1.21 from pot
*** SUMMARY ***
Total pot $1.27 | Rake $0.06 
Board [5c Kc 8d]
Seat 1: mdelfin0 (small blind) folded before Flop
Seat 2: FRAID358 (big blind) folded before Flop
Seat 3: jamalungma folded on the Flop
Seat 4: Mr. Bluff 34 collected ($1.21)
Seat 6: xdjango07x (button) folded before Flop (didn't bet)



PokerStars Hand #166667437171:  Hold'em No Limit ($0.05/$0.10 USD) - 2017/02/23 16:01:05 ET
Table 'Jacchia' 6-max Seat #6 is the button
Seat 1: viklundm ($35.84 in chips) 
Seat 2: VAD21 ($18.44 in chips) 
Seat 3: Polapa D. ($10.63 in chips) 
Seat 4: paterthomas ($9.40 in chips) 
Seat 6: RoJ1 ($11.83 in chips) 
viklundm: posts small blind $0.05
VAD21: posts big blind $0.10
*** HOLE CARDS ***
Polapa D.: raises $0.20 to $0.30
paterthomas: folds 
RoJ1: raises $0.50 to $0.80
viklundm: folds 
VAD21: folds 
Polapa D.: raises $1.40 to $2.20
RoJ1: folds 
Uncalled bet ($1.40) returned to Polapa D.
Polapa D. collected $1.75 from pot
*** SUMMARY ***
Total pot $1.75 | Rake $0 
Seat 1: viklundm (small blind) folded before Flop
Seat 2: VAD21 (big blind) folded before Flop
Seat 3: Polapa D. collected ($1.75)
Seat 4: paterthomas folded before Flop (didn't bet)
Seat 6: RoJ1 (button) folded before Flop



PokerStars Hand #166667438057:  Hold'em No Limit ($0.05/$0.10 USD) - 2017/02/23 16:01:06 ET
Table 'Crocus' 6-max Seat #1 is the button
Seat 1: truck1234 ($24.76 in chips) 
Seat 2: garigura ($11.58 in chips) 
Seat 3: Limpa Meza ($0.44 in chips) 
Seat 4: patrick19111 ($12.38 in chips) 
Seat 5: Golsuorsi ($10 in chips) 
Seat 6: Rodik002 ($10 in chips) 
garigura: posts small blind $0.05
Limpa Meza: posts big blind $0.10
*** HOLE CARDS ***
patrick19111: raises $0.20 to $0.30
Golsuorsi: folds 
Rodik002: folds 
truck1234: folds 
garigura: folds 
Limpa Meza: folds 
Uncalled bet ($0.20) returned to patrick19111
patrick19111 collected $0.25 from pot
*** SUMMARY ***
Total pot $0.25 | Rake $0 
Seat 1: truck1234 (button) folded before Flop (didn't bet)
Seat 2: garigura (small blind) folded before Flop
Seat 3: Limpa Meza (big blind) folded before Flop
Seat 4: patrick19111 collected ($0.25)
Seat 5: Golsuorsi folded before Flop (didn't bet)
Seat 6: Rodik002 folded before Flop (didn't bet)



PokerStars Hand #166667438238:  Hold'em No Limit ($0.05/$0.10 USD) - 2017/02/23 16:01:06 ET
Table 'Giclas' 6-max Seat #5 is the button
Seat 1: david_sara83 ($10 in chips) 
Seat 2: Crafty23@PS ($10 in chips) 
Seat 3: fidas1972 ($11.16 in chips) 
Seat 4: Eddys Edge ($10 in chips) 
Seat 5: dedea1989 ($26.36 in chips) 
Seat 6: eniksenik ($13.14 in chips) 
eniksenik: posts small blind $0.05
david_sara83: posts big blind $0.10
*** HOLE CARDS ***
Crafty23@PS: folds 
fidas1972: folds 
Eddys Edge: raises $0.15 to $0.25
dedea1989: raises $0.15 to $0.40
eniksenik: folds 
david_sara83: folds 
Eddys Edge: raises $0.80 to $1.20
dedea1989: calls $0.80
*** FLOP *** [Jd 7c Ad]
Eddys Edge: bets $1.85
dedea1989: raises $1.85 to $3.70
Eddys Edge: raises $5.10 to $8.80 and is all-in
dedea1989: calls $5.10
*** TURN *** [Jd 7c Ad] [2h]
*** RIVER *** [Jd 7c Ad 2h] [7s]
*** SHOW DOWN ***
Eddys Edge: shows [As Ks] (two pair, Aces and Sevens)
dedea1989: shows [Ah Kh] (two pair, Aces and Sevens)
Eddys Edge collected $9.62 from pot
dedea1989 collected $9.62 from pot
*** SUMMARY ***
Total pot $20.15 | Rake $0.91 
Board [Jd 7c Ad 2h 7s]
Seat 1: david_sara83 (big blind) folded before Flop
Seat 2: Crafty23@PS folded before Flop (didn't bet)
Seat 3: fidas1972 folded before Flop (didn't bet)
Seat 4: Eddys Edge showed [As Ks] and won ($9.62) with two pair, Aces and Sevens
Seat 5: dedea1989 (button) showed [Ah Kh] and won ($9.62) with two pair, Aces and Sevens
Seat 6: eniksenik (small blind) folded before Flop



PokerStars Hand #166667438677:  Hold'em No Limit ($0.05/$0.10 USD) - 2017/02/23 16:01:07 ET
Table 'Arkab' 6-max Seat #5 is the button
Seat 1: iamkakaroto ($10.05 in chips) 
Seat 2: aktion4ik ($12.39 in chips) 
Seat 3: sexy_seagull ($10 in chips) 
Seat 4: donkucallme ($17.22 in chips) 
Seat 5: OrionYusupov ($9.49 in chips) 
MihaGr will be allowed to play after the button
iamkakaroto: posts small blind $0.05
aktion4ik: posts big blind $0.10
*** HOLE CARDS ***
sexy_seagull: folds 
donkucallme: raises $0.10 to $0.20
OrionYusupov: calls $0.20
iamkakaroto: folds 
aktion4ik: folds 
*** FLOP *** [4s 9c 2d]
donkucallme: bets $2.30
OrionYusupov: folds 
Uncalled bet ($2.30) returned to donkucallme
donkucallme collected $0.53 from pot
*** SUMMARY ***
Total pot $0.55 | Rake $0.02 
Board [4s 9c 2d]
Seat 1: iamkakaroto (small blind) folded before Flop
Seat 2: aktion4ik (big blind) folded before Flop
Seat 3: sexy_seagull folded before Flop (didn't bet)
Seat 4: donkucallme collected ($0.53)
Seat 5: OrionYusupov (button) folded on the Flop



PokerStars Hand #166667438943:  Hold'em No Limit ($0.05/$0.10 USD) - 2017/02/23 16:01:07 ET
Table 'Wingolfia II' 6-max Seat #5 is the button
Seat 1: BahiaMinhaP ($10 in chips) 
Seat 2: NvR.m1nD ($10 in chips) 
Seat 3: truck1234 ($10 in chips) 
Seat 4: zlobslob ($19.17 in chips) 
Seat 5: tr41n3r12 ($10.91 in chips) 
Seat 6: EphemeralBen ($11.57 in chips) 
EphemeralBen: posts small blind $0.05
BahiaMinhaP: posts big blind $0.10
*** HOLE CARDS ***
NvR.m1nD: folds 
truck1234: folds 
zlobslob: folds 
tr41n3r12: raises $0.15 to $0.25
EphemeralBen: folds 
BahiaMinhaP: calls $0.15
*** FLOP *** [Jd 3s 3h]
BahiaMinhaP: checks 
tr41n3r12: bets $0.27
BahiaMinhaP: calls $0.27
*** TURN *** [Jd 3s 3h] [Ts]
BahiaMinhaP: checks 
tr41n3r12: bets $0.69
BahiaMinhaP: folds 
Uncalled bet ($0.69) returned to tr41n3r12
tr41n3r12 collected $1.04 from pot
*** SUMMARY ***
Total pot $1.09 | Rake $0.05 
Board [Jd 3s 3h Ts]
Seat 1: BahiaMinhaP (big blind) folded on the Turn
Seat 2: NvR.m1nD folded before Flop (didn't bet)
Seat 3: truck1234 folded before Flop (didn't bet)
Seat 4: zlobslob folded before Flop (didn't bet)
Seat 5: tr41n3r12 (button) collected ($1.04)
Seat 6: EphemeralBen (small blind) folded before Flop



PokerStars Hand #166667439067:  Hold'em No Limit ($0.05/$0.10 USD) - 2017/02/23 16:01:07 ET
Table 'Phereclos II' 6-max Seat #5 is the button
Seat 1: Croplayer1 ($10 in chips) 
Seat 2: Kazacha ($10.28 in chips) 
Seat 3: kickereens ($21.31 in chips) 
Seat 4: DamDatsAnAce ($10.23 in chips) 
Seat 5: Smitty03300 ($10 in chips) 
Seat 6: mhonielsen ($16.12 in chips) 
mhonielsen: posts small blind $0.05
Croplayer1: posts big blind $0.10
*** HOLE CARDS ***
Kazacha: folds 
kickereens: folds 
DamDatsAnAce: raises $0.20 to $0.30
Smitty03300: folds 
mhonielsen: folds 
Croplayer1: folds 
Uncalled bet ($0.20) returned to DamDatsAnAce
DamDatsAnAce collected $0.25 from pot
*** SUMMARY ***
Total pot $0.25 | Rake $0 
Seat 1: Croplayer1 (big blind) folded before Flop
Seat 2: Kazacha folded before Flop (didn't bet)
Seat 3: kickereens folded before Flop (didn't bet)
Seat 4: DamDatsAnAce collected ($0.25)
Seat 5: Smitty03300 (button) folded before Flop (didn't bet)
Seat 6: mhonielsen (small blind) folded before Flop



PokerStars Hand #166667439301:  Hold'em No Limit ($0.05/$0.10 USD) - 2017/02/23 16:01:08 ET
Table 'Ruvuma' 6-max Seat #2 is the button
Seat 1: FRAID358 ($10.25 in chips) 
Seat 2: Fab_1512 ($12.93 in chips) 
Seat 3: Spud014 ($11.31 in chips) 
Seat 4: DamDatsAnAce ($10.15 in chips) 
Seat 5: sexy_seagull ($10.15 in chips) 
Seat 6: Elinaattor ($9.60 in chips) 
Spud014: posts small blind $0.05
DamDatsAnAce: posts big blind $0.10
*** HOLE CARDS ***
sexy_seagull: folds 
Elinaattor: folds 
FRAID358: folds 
Fab_1512: raises $0.20 to $0.30
Spud014: folds 
DamDatsAnAce: folds 
Uncalled bet ($0.20) returned to Fab_1512
Fab_1512 collected $0.25 from pot
*** SUMMARY ***
Total pot $0.25 | Rake $0 
Seat 1: FRAID358 folded before Flop (didn't bet)
Seat 2: Fab_1512 (button) collected ($0.25)
Seat 3: Spud014 (small blind) folded before Flop
Seat 4: DamDatsAnAce (big blind) folded before Flop
Seat 5: sexy_seagull folded before Flop (didn't bet)
Seat 6: Elinaattor folded before Flop (didn't bet)



PokerStars Hand #166667439330:  Hold'em No Limit ($0.05/$0.10 USD) - 2017/02/23 16:01:08 ET
Table 'Lobelia II' 6-max Seat #5 is the button
Seat 1: facewald ($29.10 in chips) 
Seat 2: Dcaro31 ($18.59 in chips) 
Seat 3: oddshoff ($10.88 in chips) 
Seat 5: Feverhead ($20.43 in chips) 
Seat 6: NvR.m1nD ($10.05 in chips) 
NvR.m1nD: posts small blind $0.05
facewald: posts big blind $0.10
*** HOLE CARDS ***
Dcaro31: raises $0.20 to $0.30
oddshoff: calls $0.30
Feverhead: folds 
NvR.m1nD: calls $0.25
facewald: folds 
*** FLOP *** [As 8s 6h]
NvR.m1nD: checks 
Dcaro31: checks 
oddshoff: checks 
*** TURN *** [As 8s 6h] [5d]
NvR.m1nD: checks 
Dcaro31: checks 
oddshoff: checks 
*** RIVER *** [As 8s 6h 5d] [Ad]
NvR.m1nD: checks 
Dcaro31: checks 
oddshoff: checks 
*** SHOW DOWN ***
NvR.m1nD: shows [4d 4c] (two pair, Aces and Fours)
Dcaro31: mucks hand 
oddshoff: shows [Js Jc] (two pair, Aces and Jacks)
oddshoff collected $0.96 from pot
*** SUMMARY ***
Total pot $1 | Rake $0.04 
Board [As 8s 6h 5d Ad]
Seat 1: facewald (big blind) folded before Flop
Seat 2: Dcaro31 mucked
Seat 3: oddshoff showed [Js Jc] and won ($0.96) with two pair, Aces and Jacks
Seat 5: Feverhead (button) folded before Flop (didn't bet)
Seat 6: NvR.m1nD (small blind) showed [4d 4c] and lost with two pair, Aces and Fours



PokerStars Hand #166667439405:  Hold'em No Limit ($0.05/$0.10 USD) - 2017/02/23 16:01:08 ET
Table 'Eurydome II' 6-max Seat #6 is the button
Seat 2: Elinaattor ($10.39 in chips) 
Seat 3: gaHy_HaXeP ($10 in chips) 
Seat 5: kush-killa87 ($13.87 in chips) 
Seat 6: Jucatorul823 ($6.15 in chips) 
Elinaattor: posts small blind $0.05
gaHy_HaXeP: posts big blind $0.10
Smitty03300: sits out 
*** HOLE CARDS ***
kush-killa87: folds 
Jucatorul823: raises $0.20 to $0.30
Elinaattor: folds 
gaHy_HaXeP: folds 
Uncalled bet ($0.20) returned to Jucatorul823
Jucatorul823 collected $0.25 from pot
*** SUMMARY ***
Total pot $0.25 | Rake $0 
Seat 2: Elinaattor (small blind) folded before Flop
Seat 3: gaHy_HaXeP (big blind) folded before Flop
Seat 5: kush-killa87 folded before Flop (didn't bet)
Seat 6: Jucatorul823 (button) collected ($0.25)



PokerStars Hand #166667439869:  Hold'em No Limit ($0.05/$0.10 USD) - 2017/02/23 16:01:08 ET
Table 'Camilla II' 6-max Seat #2 is the button
Seat 2: Giyorod ($15.81 in chips) 
Seat 4: chimera252 ($12.71 in chips) 
Seat 5: LarryTheStar ($11.27 in chips) 
Seat 6: david_sara83 ($10 in chips) 
Andy Wolf will be allowed to play after the button
chimera252: posts small blind $0.05
LarryTheStar: posts big blind $0.10
paxit71: sits out 
*** HOLE CARDS ***
david_sara83: raises $0.15 to $0.25
Giyorod: folds 
chimera252: folds 
LarryTheStar: folds 
Uncalled bet ($0.15) returned to david_sara83
david_sara83 collected $0.25 from pot
*** SUMMARY ***
Total pot $0.25 | Rake $0 
Seat 2: Giyorod (button) folded before Flop (didn't bet)
Seat 4: chimera252 (small blind) folded before Flop
Seat 5: LarryTheStar (big blind) folded before Flop
Seat 6: david_sara83 collected ($0.25)



PokerStars Hand #166667439946:  Hold'em No Limit ($0.05/$0.10 USD) - 2017/02/23 16:01:08 ET
Table 'Repsolda' 6-max Seat #6 is the button
Seat 1: fabadam ($10 in chips) 
Seat 2: MBen10 ($26.06 in chips) 
Seat 3: manashov ($12.47 in chips) 
Seat 4: jamalungma ($10 in chips) 
Seat 5: danky24 ($7.45 in chips) 
Seat 6: RkaczoR ($10.10 in chips) 
fabadam: posts small blind $0.05
MBen10: posts big blind $0.10
*** HOLE CARDS ***
manashov: folds 
jamalungma: folds 
danky24: folds 
RkaczoR: folds 
fabadam: folds 
Uncalled bet ($0.05) returned to MBen10
MBen10 collected $0.10 from pot
*** SUMMARY ***
Total pot $0.10 | Rake $0 
Seat 1: fabadam (small blind) folded before Flop
Seat 2: MBen10 (big blind) collected ($0.10)
Seat 3: manashov folded before Flop (didn't bet)
Seat 4: jamalungma folded before Flop (didn't bet)
Seat 5: danky24 folded before Flop (didn't bet)
Seat 6: RkaczoR (button) folded before Flop (didn't bet)



PokerStars Hand #166667440122:  Hold'em No Limit ($0.05/$0.10 USD) - 2017/02/23 16:01:09 ET
Table 'Arduina' 6-max Seat #2 is the button
Seat 1: kickereens ($21.24 in chips) 
Seat 2: Andy Wolf ($11.72 in chips) 
Seat 3: Dcaro31 ($13.16 in chips) 
Seat 4: ChuikaPridi ($30.88 in chips) 
Seat 5: ettedallas ($5.36 in chips) 
Seat 6: dierri ($9.99 in chips) 
Dcaro31: posts small blind $0.05
ChuikaPridi: posts big blind $0.10
*** HOLE CARDS ***
ettedallas: raises $0.10 to $0.20
dierri: folds 
kickereens: calls $0.20
Andy Wolf: raises $1 to $1.20
Dcaro31: folds 
ChuikaPridi: folds 
ettedallas: folds 
kickereens: calls $1
*** FLOP *** [9s As Jd]
kickereens: checks 
Andy Wolf: bets $1.60
kickereens: calls $1.60
*** TURN *** [9s As Jd] [9h]
kickereens: checks 
Andy Wolf: bets $4
kickereens: folds 
Uncalled bet ($4) returned to Andy Wolf
Andy Wolf collected $5.68 from pot
*** SUMMARY ***
Total pot $5.95 | Rake $0.27 
Board [9s As Jd 9h]
Seat 1: kickereens folded on the Turn
Seat 2: Andy Wolf (button) collected ($5.68)
Seat 3: Dcaro31 (small blind) folded before Flop
Seat 4: ChuikaPridi (big blind) folded before Flop
Seat 5: ettedallas folded before Flop
Seat 6: dierri folded before Flop (didn't bet)



PokerStars Hand #166667440368:  Hold'em No Limit ($0.05/$0.10 USD) - 2017/02/23 16:01:09 ET
Table 'Tyche III' 6-max Seat #4 is the button
Seat 1: milt65 ($10.31 in chips) 
Seat 2: arti192837 ($12.53 in chips) 
Seat 3: ChuikaPridi ($9.79 in chips) 
Seat 4: Kazacha ($10 in chips) 
Seat 5: chimera252 ($10.75 in chips) 
Seat 6: Ice_Isayev ($10 in chips) 
chimera252: posts small blind $0.05
Ice_Isayev: posts big blind $0.10
*** HOLE CARDS ***
milt65: folds 
arti192837: folds 
ChuikaPridi: folds 
Kazacha: folds 
chimera252: raises $0.20 to $0.30
Ice_Isayev: raises $0.70 to $1
chimera252: raises $1.35 to $2.35
Ice_Isayev: folds 
Uncalled bet ($1.35) returned to chimera252
chimera252 collected $2 from pot
*** SUMMARY ***
Total pot $2 | Rake $0 
Seat 1: milt65 folded before Flop (didn't bet)
Seat 2: arti192837 folded before Flop (didn't bet)
Seat 3: ChuikaPridi folded before Flop (didn't bet)
Seat 4: Kazacha (button) folded before Flop (didn't bet)
Seat 5: chimera252 (small blind) collected ($2)
Seat 6: Ice_Isayev (big blind) folded before Flop



PokerStars Hand #166667440481:  Hold'em No Limit ($0.05/$0.10 USD) - 2017/02/23 16:01:09 ET
Table 'Tirela' 6-max Seat #1 is the button
Seat 1: Smitty03300 ($10 in chips) 
Seat 2: Andrei ProFF ($19.19 in chips) 
Seat 3: aim444 ($13.79 in chips) 
Seat 4: ArcticBearDK ($10.46 in chips) 
Seat 5: KRZuff ($10.10 in chips) 
Seat 6: coolisses111 ($9.05 in chips) 
Andrei ProFF: posts small blind $0.05
aim444: posts big blind $0.10
*** HOLE CARDS ***
ArcticBearDK: raises $0.20 to $0.30
KRZuff: folds 
coolisses111: folds 
Smitty03300: folds 
Andrei ProFF: calls $0.25
aim444: calls $0.20
*** FLOP *** [6h Ts 6s]
Andrei ProFF: checks 
aim444: bets $0.10
ArcticBearDK: folds 
Andrei ProFF: calls $0.10
*** TURN *** [6h Ts 6s] [6d]
Andrei ProFF: checks 
aim444: bets $0.10
Andrei ProFF: raises $0.90 to $1
aim444: calls $0.90
*** RIVER *** [6h Ts 6s 6d] [Ks]
Andrei ProFF: checks 
aim444: checks 
*** SHOW DOWN ***
Andrei ProFF: shows [8h 8d] (a full house, Sixes full of Eights)
aim444: shows [Th 2h] (a full house, Sixes full of Tens)
aim444 collected $2.96 from pot
*** SUMMARY ***
Total pot $3.10 | Rake $0.14 
Board [6h Ts 6s 6d Ks]
Seat 1: Smitty03300 (button) folded before Flop (didn't bet)
Seat 2: Andrei ProFF (small blind) showed [8h 8d] and lost with a full house, Sixes full of Eights
Seat 3: aim444 (big blind) showed [Th 2h] and won ($2.96) with a full house, Sixes full of Tens
Seat 4: ArcticBearDK folded on the Flop
Seat 5: KRZuff folded before Flop (didn't bet)
Seat 6: coolisses111 folded before Flop (didn't bet)



PokerStars Hand #166667440649:  Hold'em No Limit ($0.05/$0.10 USD) - 2017/02/23 16:01:09 ET
Table 'Nehalennia III' 6-max Seat #1 is the button
Seat 1: boxer821 ($13.26 in chips) 
Seat 2: fortieth ($9.63 in chips) 
Seat 3: ValdemorS ($18.14 in chips) 
Seat 5: wulffboy ($34.74 in chips) 
Seat 6: valzeny ($20.63 in chips) 
fortieth: posts small blind $0.05
ValdemorS: posts big blind $0.10
eniksenik: sits out 
boxer821: posts the ante $0.02
fortieth: posts the ante $0.02
ValdemorS: posts the ante $0.02
wulffboy: posts the ante $0.02
valzeny: posts the ante $0.02
*** HOLE CARDS ***
wulffboy: folds 
valzeny: folds 
boxer821: folds 
fortieth: raises $0.25 to $0.35
ValdemorS: folds 
Uncalled bet ($0.25) returned to fortieth
fortieth collected $0.30 from pot
*** SUMMARY ***
Total pot $0.30 | Rake $0 
Seat 1: boxer821 (button) folded before Flop (didn't bet)
Seat 2: fortieth (small blind) collected ($0.30)
Seat 3: ValdemorS (big blind) folded before Flop
Seat 5: wulffboy folded before Flop (didn't bet)
Seat 6: valzeny folded before Flop (didn't bet)



PokerStars Hand #166667440765:  Hold'em No Limit ($0.05/$0.10 USD) - 2017/02/23 16:01:10 ET
Table 'Kanda' 6-max Seat #2 is the button
Seat 1: Andy Wolf ($10.24 in chips) 
Seat 2: Pelotín ($5.15 in chips) 
Seat 3: joewatson90 ($12.49 in chips) 
Seat 4: Orlangoor ($10.86 in chips) 
Seat 5: Temniy Elf ($10.15 in chips) 
Seat 6: oddshoff ($8.96 in chips) 
joewatson90: posts small blind $0.05
Orlangoor: posts big blind $0.10
*** HOLE CARDS ***
Temniy Elf: folds 
oddshoff: folds 
Andy Wolf: folds 
Pelotín: raises $0.20 to $0.30
joewatson90: folds 
Orlangoor: folds 
Uncalled bet ($0.20) returned to Pelotín
Pelotín collected $0.25 from pot
*** SUMMARY ***
Total pot $0.25 | Rake $0 
Seat 1: Andy Wolf folded before Flop (didn't bet)
Seat 2: Pelotín (button) collected ($0.25)
Seat 3: joewatson90 (small blind) folded before Flop
Seat 4: Orlangoor (big blind) folded before Flop
Seat 5: Temniy Elf folded before Flop (didn't bet)
Seat 6: oddshoff folded before Flop (didn't bet)



PokerStars Hand #166667440999:  Hold'em No Limit ($0.05/$0.10 USD) - 2017/02/23 16:01:10 ET
Table 'Kobresia II' 6-max Seat #5 is the button
Seat 1: RoJ1 ($14.11 in chips) 
Seat 2: Dcaro31 ($14.04 in chips) 
Seat 3: FRAID358 ($10.84 in chips) 
Seat 4: armstv ($10.18 in chips) 
Seat 5: Goroshkos88 ($11.89 in chips) 
Seat 6: WinninBikini ($10 in chips) 
WinninBikini: posts small blind $0.05
RoJ1: posts big blind $0.10
*** HOLE CARDS ***
Dcaro31: raises $0.20 to $0.30
FRAID358: folds 
armstv: raises $0.30 to $0.60
Goroshkos88: folds 
WinninBikini: folds 
RoJ1: folds 
Dcaro31: calls $0.30
*** FLOP *** [8d 7h 6c]
Dcaro31: checks 
armstv: bets $0.70
Dcaro31: folds 
Uncalled bet ($0.70) returned to armstv
armstv collected $1.29 from pot
*** SUMMARY ***
Total pot $1.35 | Rake $0.06 
Board [8d 7h 6c]
Seat 1: RoJ1 (big blind) folded before Flop
Seat 2: Dcaro31 folded on the Flop
Seat 3: FRAID358 folded before Flop (didn't bet)
Seat 4: armstv collected ($1.29)
Seat 5: Goroshkos88 (button) folded before Flop (didn't bet)
Seat 6: WinninBikini (small blind) folded before Flop



PokerStars Hand #166667441453:  Hold'em No Limit ($0.05/$0.10 USD) - 2017/02/23 16:01:10 ET
Table 'Persephone' 6-max Seat #4 is the button
Seat 2: Kupi007 ($14.73 in chips) 
Seat 3: Kow6oy ($11.88 in chips) 
Seat 4: 2G28 ($10 in chips) 
Seat 5: D3NyA ($10.05 in chips) 
Seat 6: popypaleta ($11.97 in chips) 
D3NyA: posts small blind $0.05
popypaleta: posts big blind $0.10
FRAID358: sits out 
*** HOLE CARDS ***
Kupi007: raises $0.15 to $0.25
Kow6oy: folds 
2G28: folds 
D3NyA: raises $0.65 to $0.90
popypaleta: folds 
Kupi007: raises $1.30 to $2.20
D3NyA: folds 
Uncalled bet ($1.30) returned to Kupi007
Kupi007 collected $1.90 from pot
*** SUMMARY ***
Total pot $1.90 | Rake $0 
Seat 2: Kupi007 collected ($1.90)
Seat 3: Kow6oy folded before Flop (didn't bet)
Seat 4: 2G28 (button) folded before Flop (didn't bet)
Seat 5: D3NyA (small blind) folded before Flop
Seat 6: popypaleta (big blind) folded before Flop



PokerStars Hand #166667441577:  Hold'em No Limit ($0.05/$0.10 USD) - 2017/02/23 16:01:10 ET
Table 'Syringa II' 6-max Seat #4 is the button
Seat 1: GiveTwoMe ($12.15 in chips) 
Seat 2: Cluckh ($10.05 in chips) 
Seat 3: gaHy_HaXeP ($10.73 in chips) 
Seat 4: MBen10 ($10.10 in chips) 
Seat 5: Mishapok196 ($6.25 in chips) 
Seat 6: WinninBikini ($11.31 in chips) 
Mishapok196: posts small blind $0.05
WinninBikini: posts big blind $0.10
*** HOLE CARDS ***
GiveTwoMe: raises $0.20 to $0.30
Cluckh: folds 
gaHy_HaXeP: folds 
MBen10: calls $0.30
Mishapok196: calls $0.25
WinninBikini: calls $0.20
*** FLOP *** [Ts 3h 8h]
Mishapok196: checks 
WinninBikini: checks 
GiveTwoMe: checks 
MBen10: bets $0.59
Mishapok196: calls $0.59
WinninBikini: calls $0.59
GiveTwoMe: folds 
*** TURN *** [Ts 3h 8h] [7d]
Mishapok196: checks 
WinninBikini: checks 
MBen10: checks 
*** RIVER *** [Ts 3h 8h 7d] [3c]
Mishapok196: checks 
WinninBikini: checks 
MBen10: checks 
*** SHOW DOWN ***
Mishapok196: shows [3d 4s] (three of a kind, Threes)
WinninBikini: mucks hand 
MBen10: mucks hand 
Mishapok196 collected $2.84 from pot
*** SUMMARY ***
Total pot $2.97 | Rake $0.13 
Board [Ts 3h 8h 7d 3c]
Seat 1: GiveTwoMe folded on the Flop
Seat 2: Cluckh folded before Flop (didn't bet)
Seat 3: gaHy_HaXeP folded before Flop (didn't bet)
Seat 4: MBen10 (button) mucked
Seat 5: Mishapok196 (small blind) showed [3d 4s] and won ($2.84) with three of a kind, Threes
Seat 6: WinninBikini (big blind) mucked



PokerStars Hand #166667441831:  Hold'em No Limit ($0.05/$0.10 USD) - 2017/02/23 16:01:11 ET
Table 'Hajek III' 6-max Seat #6 is the button
Seat 1: MBen10 ($10.65 in chips) 
Seat 2: fortieth ($12.81 in chips) 
Seat 3: fedorka rus ($10.61 in chips) 
Seat 4: NvR.m1nD ($10 in chips) 
Seat 5: Croplayer1 ($15.56 in chips) 
Seat 6: fabadam ($22.46 in chips) 
MBen10: posts small blind $0.05
fortieth: posts big blind $0.10
*** HOLE CARDS ***
fedorka rus: folds 
NvR.m1nD: folds 
Croplayer1: folds 
fabadam: folds 
MBen10: raises $0.20 to $0.30
fortieth: folds 
Uncalled bet ($0.20) returned to MBen10
MBen10 collected $0.20 from pot
*** SUMMARY ***
Total pot $0.20 | Rake $0 
Seat 1: MBen10 (small blind) collected ($0.20)
Seat 2: fortieth (big blind) folded before Flop
Seat 3: fedorka rus folded before Flop (didn't bet)
Seat 4: NvR.m1nD folded before Flop (didn't bet)
Seat 5: Croplayer1 folded before Flop (didn't bet)
Seat 6: fabadam (button) folded before Flop (didn't bet)



PokerStars Hand #166667441911:  Hold'em No Limit ($0.05/$0.10 USD) - 2017/02/23 16:01:11 ET
Table 'Virginia II' 6-max Seat #3 is the button
Seat 1: Iarlei ($11.86 in chips) 
Seat 3: garigura ($14.71 in chips) 
Seat 4: onkelottoHH ($11.38 in chips) 
Seat 5: dr.goofy ($20.41 in chips) 
Seat 6: ab260414 ($10 in chips) 
onkelottoHH: posts small blind $0.05
dr.goofy: posts big blind $0.10
Yspenyanin: sits out 
*** HOLE CARDS ***
ab260414: raises $0.20 to $0.30
Iarlei: folds 
garigura: folds 
onkelottoHH: folds 
dr.goofy: folds 
Uncalled bet ($0.20) returned to ab260414
ab260414 collected $0.25 from pot
*** SUMMARY ***
Total pot $0.25 | Rake $0 
Seat 1: Iarlei folded before Flop (didn't bet)
Seat 3: garigura (button) folded before Flop (didn't bet)
Seat 4: onkelottoHH (small blind) folded before Flop
Seat 5: dr.goofy (big blind) folded before Flop
Seat 6: ab260414 collected ($0.25)



PokerStars Hand #166667441938:  Hold'em No Limit ($0.05/$0.10 USD) - 2017/02/23 16:01:11 ET
Table 'Aludra II' 6-max Seat #5 is the button
Seat 1: voledy ($10.15 in chips) 
Seat 2: JahSoldier69 ($10.28 in chips) 
Seat 3: 2G28 ($11.90 in chips) 
Seat 4: MihaGr ($10 in chips) 
Seat 5: kingartur222 ($15.85 in chips) 
Seat 6: call me haaa ($14.90 in chips) 
call me haaa: posts small blind $0.05
voledy: posts big blind $0.10
*** HOLE CARDS ***
JahSoldier69: folds 
2G28: raises $0.20 to $0.30
MihaGr: folds 
kingartur222: folds 
call me haaa: raises $0.70 to $1
voledy: folds 
2G28: raises $10.90 to $11.90 and is all-in
call me haaa: folds 
Uncalled bet ($10.90) returned to 2G28
2G28 collected $2.10 from pot
*** SUMMARY ***
Total pot $2.10 | Rake $0 
Seat 1: voledy (big blind) folded before Flop
Seat 2: JahSoldier69 folded before Flop (didn't bet)
Seat 3: 2G28 collected ($2.10)
Seat 4: MihaGr folded before Flop (didn't bet)
Seat 5: kingartur222 (button) folded before Flop (didn't bet)
Seat 6: call me haaa (small blind) folded before Flop



PokerStars Hand #166667442301:  Hold'em No Limit ($0.05/$0.10 USD) - 2017/02/23 16:01:11 ET
Table 'Markab II' 6-max Seat #2 is the button
Seat 1: david_sara83 ($10.17 in chips) 
Seat 2: truck1234 ($11.05 in chips) 
Seat 3: sexy_seagull ($10 in chips) 
Seat 4: Crafty23@PS ($11.54 in chips) 
Seat 5: Rodik002 ($19.17 in chips) 
Seat 6: Comeback3392 ($10.64 in chips) 
sexy_seagull: posts small blind $0.05
Crafty23@PS: posts big blind $0.10
*** HOLE CARDS ***
Rodik002: folds 
Comeback3392: folds 
david_sara83: folds 
truck1234: folds 
sexy_seagull: folds 
Uncalled bet ($0.05) returned to Crafty23@PS
Crafty23@PS collected $0.10 from pot
*** SUMMARY ***
Total pot $0.10 | Rake $0 
Seat 1: david_sara83 folded before Flop (didn't bet)
Seat 2: truck1234 (button) folded before Flop (didn't bet)
Seat 3: sexy_seagull (small blind) folded before Flop
Seat 4: Crafty23@PS (big blind) collected ($0.10)
Seat 5: Rodik002 folded before Flop (didn't bet)
Seat 6: Comeback3392 folded before Flop (didn't bet)



PokerStars Hand #166667442480:  Hold'em No Limit ($0.05/$0.10 USD) - 2017/02/23 16:01:11 ET
Table 'Brendelia II' 6-max Seat #6 is the button
Seat 2: Crimsonr ($6.81 in chips) 
Seat 3: ValdemorS ($17.75 in chips) 
Seat 5: Kupi007 ($27.44 in chips) 
Seat 6: luckyPositiv ($9.81 in chips) 
Crimsonr: posts small blind $0.05
ValdemorS: posts big blind $0.10
Crimsonr: posts the ante $0.02
ValdemorS: posts the ante $0.02
Kupi007: posts the ante $0.02
luckyPositiv: posts the ante $0.02
*** HOLE CARDS ***
Kupi007: folds 
luckyPositiv: folds 
Crimsonr: folds 
Uncalled bet ($0.05) returned to ValdemorS
ValdemorS collected $0.18 from pot
*** SUMMARY ***
Total pot $0.18 | Rake $0 
Seat 2: Crimsonr (small blind) folded before Flop
Seat 3: ValdemorS (big blind) collected ($0.18)
Seat 5: Kupi007 folded before Flop (didn't bet)
Seat 6: luckyPositiv (button) folded before Flop (didn't bet)



PokerStars Hand #166667442562:  Hold'em No Limit ($0.05/$0.10 USD) - 2017/02/23 16:01:11 ET
Table 'Sheragul III' 6-max Seat #5 is the button
Seat 1: danky24 ($17.64 in chips) 
Seat 2: Bird et al ($11.96 in chips) 
Seat 4: maxiv608 ($11.24 in chips) 
Seat 5: Bandyaev ($14.51 in chips) 
Seat 6: Andrei ProFF ($10 in chips) 
Andrei ProFF: posts small blind $0.05
danky24: posts big blind $0.10
*** HOLE CARDS ***
Bird et al: folds 
maxiv608: folds 
Bandyaev: folds 
Andrei ProFF: folds 
Uncalled bet ($0.05) returned to danky24
danky24 collected $0.10 from pot
*** SUMMARY ***
Total pot $0.10 | Rake $0 
Seat 1: danky24 (big blind) collected ($0.10)
Seat 2: Bird et al folded before Flop (didn't bet)
Seat 4: maxiv608 folded before Flop (didn't bet)
Seat 5: Bandyaev (button) folded before Flop (didn't bet)
Seat 6: Andrei ProFF (small blind) folded before Flop



PokerStars Hand #166667442679:  Hold'em No Limit ($0.05/$0.10 USD) - 2017/02/23 16:01:12 ET
Table 'Pyrrhus III' 6-max Seat #5 is the button
Seat 1: skatejeff ($17.24 in chips) 
Seat 2: univibe68 ($20.57 in chips) 
Seat 3: coolisses111 ($9.77 in chips) 
Seat 4: ex3Lero86 ($11.84 in chips) 
Seat 5: mAEgar ($5 in chips) 
Seat 6: MLPlayer16 ($19.93 in chips) 
MLPlayer16: posts small blind $0.05
skatejeff: posts big blind $0.10
skatejeff: posts the ante $0.02
univibe68: posts the ante $0.02
coolisses111: posts the ante $0.02
ex3Lero86: posts the ante $0.02
mAEgar: posts the ante $0.02
MLPlayer16: posts the ante $0.02
*** HOLE CARDS ***
univibe68: folds 
coolisses111: folds 
ex3Lero86: raises $0.17 to $0.27
mAEgar: calls $0.27
MLPlayer16: folds 
skatejeff: calls $0.17
*** FLOP *** [2d 4d Ad]
skatejeff: checks 
ex3Lero86: checks 
mAEgar: checks 
*** TURN *** [2d 4d Ad] [8c]
skatejeff: bets $1.30
ex3Lero86: raises $2.10 to $3.40
mAEgar: folds 
skatejeff: calls $2.10
*** RIVER *** [2d 4d Ad 8c] [As]
skatejeff: bets $7.43
ex3Lero86: calls $7.43
*** SHOW DOWN ***
skatejeff: shows [Qc Ah] (three of a kind, Aces)
ex3Lero86: shows [7d 8d] (a flush, Ace high)
ex3Lero86 collected $21.62 from pot
*** SUMMARY ***
Total pot $22.64 | Rake $1.02 
Board [2d 4d Ad 8c As]
Seat 1: skatejeff (big blind) showed [Qc Ah] and lost with three of a kind, Aces
Seat 2: univibe68 folded before Flop (didn't bet)
Seat 3: coolisses111 folded before Flop (didn't bet)
Seat 4: ex3Lero86 showed [7d 8d] and won ($21.62) with a flush, Ace high
Seat 5: mAEgar (button) folded on the Turn
Seat 6: MLPlayer16 (small blind) folded before Flop



PokerStars Hand #166667442960:  Hold'em No Limit ($0.05/$0.10 USD) - 2017/02/23 16:01:12 ET
Table 'Alnasl' 6-max Seat #6 is the button
Seat 1: KA3AXCTAHEU, ($11.32 in chips) 
Seat 2: XaXaTyH4uK ($10 in chips) 
Seat 3: david_sara83 ($22.84 in chips) 
Seat 4: oddshoff ($10.18 in chips) 
Seat 5: steepfell ($10.23 in chips) 
Seat 6: Zooplack ($13.68 in chips) 
KA3AXCTAHEU,: posts small blind $0.05
XaXaTyH4uK: posts big blind $0.10
*** HOLE CARDS ***
david_sara83: folds 
oddshoff: folds 
steepfell: folds 
Zooplack: folds 
KA3AXCTAHEU,: raises $0.15 to $0.25
XaXaTyH4uK: raises $0.75 to $1
KA3AXCTAHEU,: folds 
Uncalled bet ($0.75) returned to XaXaTyH4uK
XaXaTyH4uK collected $0.50 from pot
*** SUMMARY ***
Total pot $0.50 | Rake $0 
Seat 1: KA3AXCTAHEU, (small blind) folded before Flop
Seat 2: XaXaTyH4uK (big blind) collected ($0.50)
Seat 3: david_sara83 folded before Flop (didn't bet)
Seat 4: oddshoff folded before Flop (didn't bet)
Seat 5: steepfell folded before Flop (didn't bet)
Seat 6: Zooplack (button) folded before Flop (didn't bet)



PokerStars Hand #166667442962:  Hold'em No Limit ($0.05/$0.10 USD) - 2017/02/23 16:01:12 ET
Table 'Nemo III' 6-max Seat #2 is the button
Seat 2: Bandyaev ($11.74 in chips) 
Seat 3: Therodorus ($10.56 in chips) 
Seat 4: vtalian ($9.70 in chips) 
Seat 6: SALAMIS85 ($13.64 in chips) 
Therodorus: posts small blind $0.05
vtalian: posts big blind $0.10
Joker51_wtf!: sits out 
*** HOLE CARDS ***
SALAMIS85: folds 
Bandyaev: raises $0.15 to $0.25
Therodorus: folds 
vtalian: folds 
Uncalled bet ($0.15) returned to Bandyaev
Bandyaev collected $0.25 from pot
*** SUMMARY ***
Total pot $0.25 | Rake $0 
Seat 2: Bandyaev (button) collected ($0.25)
Seat 3: Therodorus (small blind) folded before Flop
Seat 4: vtalian (big blind) folded before Flop
Seat 6: SALAMIS85 folded before Flop (didn't bet)



PokerStars Hand #166667443020:  Hold'em No Limit ($0.05/$0.10 USD) - 2017/02/23 16:01:12 ET
Table 'Aegle' 6-max Seat #4 is the button
Seat 4: ab260414 ($11.32 in chips) 
Seat 5: KokoulinV ($11.18 in chips) 
Seat 6: CHRO8 ($20.59 in chips) 
KokoulinV: posts small blind $0.05
CHRO8: posts big blind $0.10
*** HOLE CARDS ***
ab260414: folds 
KokoulinV: folds 
Uncalled bet ($0.05) returned to CHRO8
yodzik joins the table at seat #2 
CHRO8 collected $0.10 from pot
*** SUMMARY ***
Total pot $0.10 | Rake $0 
Seat 4: ab260414 (button) folded before Flop (didn't bet)
Seat 5: KokoulinV (small blind) folded before Flop
Seat 6: CHRO8 (big blind) collected ($0.10)



PokerStars Hand #166667443481:  Hold'em No Limit ($0.05/$0.10 USD) - 2017/02/23 16:01:12 ET
Table 'Orthos III' 6-max Seat #6 is the button
Seat 1: sexy_seagull ($10.05 in chips) 
Seat 2: Xander188 ($16.18 in chips) 
Seat 3: koka4cs ($7.07 in chips) 
Seat 4: FlopsterGB ($14.79 in chips) 
Seat 5: Bird et al ($20.29 in chips) 
Seat 6: RoJ1 ($10.64 in chips) 
sexy_seagull: posts small blind $0.05
Xander188: posts big blind $0.10
*** HOLE CARDS ***
koka4cs: folds 
FlopsterGB: folds 
Bird et al: folds 
RoJ1: raises $0.12 to $0.22
sexy_seagull: folds 
Xander188: folds 
Uncalled bet ($0.12) returned to RoJ1
RoJ1 collected $0.25 from pot
*** SUMMARY ***
Total pot $0.25 | Rake $0 
Seat 1: sexy_seagull (small blind) folded before Flop
Seat 2: Xander188 (big blind) folded before Flop
Seat 3: koka4cs folded before Flop (didn't bet)
Seat 4: FlopsterGB folded before Flop (didn't bet)
Seat 5: Bird et al folded before Flop (didn't bet)
Seat 6: RoJ1 (button) collected ($0.25)



PokerStars Hand #166667443987:  Hold'em No Limit ($0.05/$0.10 USD) - 2017/02/23 16:01:13 ET
Table 'California II' 6-max Seat #2 is the button
Seat 1: fedorka rus ($10.23 in chips) 
Seat 2: homelessdan ($10 in chips) 
Seat 3: Bird et al ($10.25 in chips) 
Seat 5: bambolejro ($15.17 in chips) 
Seat 6: chiko4040 ($8.81 in chips) 
Bird et al: posts small blind $0.05
bambolejro: posts big blind $0.10
*** HOLE CARDS ***
chiko4040: folds 
fedorka rus: folds 
homelessdan: raises $0.15 to $0.25
Bird et al: folds 
bambolejro: folds 
Uncalled bet ($0.15) returned to homelessdan
homelessdan collected $0.25 from pot
*** SUMMARY ***
Total pot $0.25 | Rake $0 
Seat 1: fedorka rus folded before Flop (didn't bet)
Seat 2: homelessdan (button) collected ($0.25)
Seat 3: Bird et al (small blind) folded before Flop
Seat 5: bambolejro (big blind) folded before Flop
Seat 6: chiko4040 folded before Flop (didn't bet)



PokerStars Hand #166667444122:  Hold'em No Limit ($0.05/$0.10 USD) - 2017/02/23 16:01:13 ET
Table 'Armenia' 6-max Seat #2 is the button
Seat 1: tr41n3r12 ($12.17 in chips) 
Seat 2: Yabidooo ($10 in chips) 
Seat 3: CDestructivo ($12.18 in chips) 
Seat 4: x3ultimate ($11.25 in chips) 
Seat 5: boxer821 ($12 in chips) 
Seat 6: mega spasser ($5.22 in chips) 
CDestructivo: posts small blind $0.05
x3ultimate: posts big blind $0.10
*** HOLE CARDS ***
boxer821: raises $0.20 to $0.30
mega spasser: folds 
tr41n3r12: folds 
Yabidooo: folds 
CDestructivo: folds 
x3ultimate: folds 
Uncalled bet ($0.20) returned to boxer821
boxer821 collected $0.25 from pot
*** SUMMARY ***
Total pot $0.25 | Rake $0 
Seat 1: tr41n3r12 folded before Flop (didn't bet)
Seat 2: Yabidooo (button) folded before Flop (didn't bet)
Seat 3: CDestructivo (small blind) folded before Flop
Seat 4: x3ultimate (big blind) folded before Flop
Seat 5: boxer821 collected ($0.25)
Seat 6: mega spasser folded before Flop (didn't bet)



PokerStars Hand #166667444521:  Hold'em No Limit ($0.05/$0.10 USD) - 2017/02/23 16:01:14 ET
Table 'Arpola' 6-max Seat #5 is the button
Seat 1: dincimus ($10 in chips) 
Seat 2: patrick19111 ($10.28 in chips) 
Seat 3: simaryk ($2.48 in chips) 
Seat 4: Orlangoor ($19.20 in chips) 
Seat 5: truck1234 ($11.79 in chips) 
Seat 6: Andrei ProFF ($10 in chips) 
Andrei ProFF: posts small blind $0.05
dincimus: posts big blind $0.10
*** HOLE CARDS ***
patrick19111: folds 
simaryk: folds 
Orlangoor: folds 
truck1234: folds 
Andrei ProFF: folds 
Uncalled bet ($0.05) returned to dincimus
dincimus collected $0.10 from pot
*** SUMMARY ***
Total pot $0.10 | Rake $0 
Seat 1: dincimus (big blind) collected ($0.10)
Seat 2: patrick19111 folded before Flop (didn't bet)
Seat 3: simaryk folded before Flop (didn't bet)
Seat 4: Orlangoor folded before Flop (didn't bet)
Seat 5: truck1234 (button) folded before Flop (didn't bet)
Seat 6: Andrei ProFF (small blind) folded before Flop



PokerStars Hand #166667444603:  Hold'em No Limit ($0.05/$0.10 USD) - 2017/02/23 16:01:14 ET
Table 'Heka II' 6-max Seat #1 is the button
Seat 1: Mamm0nism ($14.27 in chips) 
Seat 2: oddshoff ($11.62 in chips) 
Seat 3: MühliJr ($10 in chips) 
Seat 4: theNot0r1ous ($10.07 in chips) 
Seat 5: ArcticBearDK ($12.78 in chips) 
Seat 6: MonteCris92 ($10 in chips) 
oddshoff: posts small blind $0.05
MühliJr: posts big blind $0.10
*** HOLE CARDS ***
theNot0r1ous: folds 
ArcticBearDK: folds 
MonteCris92 is disconnected 
MonteCris92 has timed out while disconnected
MonteCris92: folds 
Mamm0nism: raises $0.20 to $0.30
oddshoff: folds 
MühliJr: raises $0.70 to $1
Mamm0nism: folds 
Uncalled bet ($0.70) returned to MühliJr
MühliJr collected $0.65 from pot
*** SUMMARY ***
Total pot $0.65 | Rake $0 
Seat 1: Mamm0nism (button) folded before Flop
Seat 2: oddshoff (small blind) folded before Flop
Seat 3: MühliJr (big blind) collected ($0.65)
Seat 4: theNot0r1ous folded before Flop (didn't bet)
Seat 5: ArcticBearDK folded before Flop (didn't bet)
Seat 6: MonteCris92 folded before Flop (didn't bet)



PokerStars Hand #166667444825:  Hold'em No Limit ($0.05/$0.10 USD) - 2017/02/23 16:01:14 ET
Table 'Jokaste II' 6-max Seat #6 is the button
Seat 1: Hyd SK ($13.38 in chips) 
Seat 2: T9MS ($12.63 in chips) 
Seat 3: crazydevill ($10 in chips) 
Seat 4: FRAID358 ($14.86 in chips) 
Seat 5: Vrinni ($10 in chips) 
Seat 6: Adailton07 ($15.05 in chips) 
Hyd SK: posts small blind $0.05
T9MS: posts big blind $0.10
*** HOLE CARDS ***
crazydevill: folds 
FRAID358: folds 
Vrinni: raises $0.15 to $0.25
Adailton07: folds 
Hyd SK: folds 
T9MS: folds 
Uncalled bet ($0.15) returned to Vrinni
Vrinni collected $0.25 from pot
*** SUMMARY ***
Total pot $0.25 | Rake $0 
Seat 1: Hyd SK (small blind) folded before Flop
Seat 2: T9MS (big blind) folded before Flop
Seat 3: crazydevill folded before Flop (didn't bet)
Seat 4: FRAID358 folded before Flop (didn't bet)
Seat 5: Vrinni collected ($0.25)
Seat 6: Adailton07 (button) folded before Flop (didn't bet)



PokerStars Hand #166667444853:  Hold'em No Limit ($0.05/$0.10 USD) - 2017/02/23 16:01:14 ET
Table 'Goto II' 6-max Seat #4 is the button
Seat 1: FRAID358 ($13.13 in chips) 
Seat 2: 6ePeMeHHa9 ($11.09 in chips) 
Seat 3: Goroshkos88 ($10 in chips) 
Seat 4: KRZuff ($13.04 in chips) 
Seat 5: RoJ1 ($14.19 in chips) 
Seat 6: ermananb93 ($13.20 in chips) 
RoJ1: posts small blind $0.05
ermananb93: posts big blind $0.10
*** HOLE CARDS ***
FRAID358: folds 
6ePeMeHHa9: folds 
Goroshkos88: raises $0.20 to $0.30
KRZuff: folds 
RoJ1: folds 
ermananb93: calls $0.20
*** FLOP *** [2h 9c 2c]
ermananb93: bets $0.10
Goroshkos88: calls $0.10
*** TURN *** [2h 9c 2c] [6c]
ermananb93: bets $0.10
Goroshkos88: calls $0.10
*** RIVER *** [2h 9c 2c 6c] [4h]
ermananb93: bets $0.10
Goroshkos88: calls $0.10
*** SHOW DOWN ***
ermananb93: shows [Js Kd] (a pair of Deuces)
Goroshkos88: shows [Ks Qd] (a pair of Deuces - King+Queen kicker)
Goroshkos88 collected $1.19 from pot
*** SUMMARY ***
Total pot $1.25 | Rake $0.06 
Board [2h 9c 2c 6c 4h]
Seat 1: FRAID358 folded before Flop (didn't bet)
Seat 2: 6ePeMeHHa9 folded before Flop (didn't bet)
Seat 3: Goroshkos88 showed [Ks Qd] and won ($1.19) with a pair of Deuces
Seat 4: KRZuff (button) folded before Flop (didn't bet)
Seat 5: RoJ1 (small blind) folded before Flop
Seat 6: ermananb93 (big blind) showed [Js Kd] and lost with a pair of Deuces



PokerStars Hand #166667444986:  Hold'em No Limit ($0.05/$0.10 USD) - 2017/02/23 16:01:14 ET
Table 'Alzirr II' 6-max Seat #3 is the button
Seat 1: KA3AXCTAHEU, ($10.86 in chips) 
Seat 2: popypaleta ($10 in chips) 
Seat 3: Lucky HoBBiT ($10.53 in chips) 
Seat 4: Scanner17 ($18.94 in chips) 
Scanner17: posts small blind $0.05
Kosantin: is sitting out 
EggMayo: is sitting out 
EggMayo leaves the table
KA3AXCTAHEU,: posts big blind $0.10
*** HOLE CARDS ***
popypaleta: folds 
Lucky HoBBiT: folds 
Scanner17: folds 
Uncalled bet ($0.05) returned to KA3AXCTAHEU,
Kosantin leaves the table
KA3AXCTAHEU, collected $0.10 from pot
*** SUMMARY ***
Total pot $0.10 | Rake $0 
Seat 1: KA3AXCTAHEU, (big blind) collected ($0.10)
Seat 2: popypaleta folded before Flop (didn't bet)
Seat 3: Lucky HoBBiT (button) folded before Flop (didn't bet)
Seat 4: Scanner17 (small blind) folded before Flop



PokerStars Hand #166667445090:  Hold'em No Limit ($0.05/$0.10 USD) - 2017/02/23 16:01:14 ET
Table 'Wilkens II' 6-max Seat #2 is the button
Seat 1: Islamiq-GuRL ($12.15 in chips) 
Seat 2: manashov ($10.15 in chips) 
Seat 3: Namhkal ($10.85 in chips) 
Seat 4: myevc ($10 in chips) 
Seat 5: patrick19111 ($10 in chips) 
Seat 6: XaXaTyH4uK ($14.76 in chips) 
Namhkal: posts small blind $0.05
myevc: posts big blind $0.10
*** HOLE CARDS ***
patrick19111: folds 
XaXaTyH4uK: folds 
Islamiq-GuRL: raises $0.15 to $0.25
manashov: folds 
Namhkal: folds 
myevc: folds 
Uncalled bet ($0.15) returned to Islamiq-GuRL
Islamiq-GuRL collected $0.25 from pot
*** SUMMARY ***
Total pot $0.25 | Rake $0 
Seat 1: Islamiq-GuRL collected ($0.25)
Seat 2: manashov (button) folded before Flop (didn't bet)
Seat 3: Namhkal (small blind) folded before Flop
Seat 4: myevc (big blind) folded before Flop
Seat 5: patrick19111 folded before Flop (didn't bet)
Seat 6: XaXaTyH4uK folded before Flop (didn't bet)



PokerStars Hand #166667445094:  Hold'em No Limit ($0.05/$0.10 USD) - 2017/02/23 16:01:14 ET
Table 'Anhui II' 6-max Seat #2 is the button
Seat 1: kingartur222 ($11.99 in chips) 
Seat 2: kikus334 ($11.45 in chips) 
Seat 3: lochniak556 ($28.04 in chips) 
Seat 4: dragonste89 ($10 in chips) 
Seat 5: Bandyaev ($10 in chips) 
Seat 6: .BaRReL.1122 ($5.01 in chips) 
lochniak556: posts small blind $0.05
dragonste89: posts big blind $0.10
*** HOLE CARDS ***
Bandyaev: raises $0.15 to $0.25
.BaRReL.1122: folds 
kingartur222: folds 
kikus334: calls $0.25
lochniak556: calls $0.20
dragonste89: folds 
*** FLOP *** [7s 7c 3d]
lochniak556: checks 
Bandyaev: checks 
kikus334: checks 
*** TURN *** [7s 7c 3d] [Qc]
lochniak556: bets $0.40
Bandyaev: folds 
kikus334: folds 
Uncalled bet ($0.40) returned to lochniak556
lochniak556 collected $0.81 from pot
*** SUMMARY ***
Total pot $0.85 | Rake $0.04 
Board [7s 7c 3d Qc]
Seat 1: kingartur222 folded before Flop (didn't bet)
Seat 2: kikus334 (button) folded on the Turn
Seat 3: lochniak556 (small blind) collected ($0.81)
Seat 4: dragonste89 (big blind) folded before Flop
Seat 5: Bandyaev folded on the Turn
Seat 6: .BaRReL.1122 folded before Flop (didn't bet)



PokerStars Hand #166667445216:  Hold'em No Limit ($0.05/$0.10 USD) - 2017/02/23 16:01:15 ET
Table 'Thoas' 6-max Seat #2 is the button
Seat 1: Pekaml ($11.28 in chips) 
Seat 2: themacer24 ($8.20 in chips) 
Seat 3: by.y.y.y86 ($10 in chips) 
Seat 4: Morris_Chair ($18.16 in chips) 
Seat 5: Kow6oy ($10.17 in chips) 
Seat 6: takis nik ($10 in chips) 
by.y.y.y86: posts small blind $0.05
Morris_Chair: posts big blind $0.10
*** HOLE CARDS ***
Kow6oy: folds 
takis nik: folds 
Pekaml: folds 
themacer24: raises $0.20 to $0.30
by.y.y.y86: folds 
Morris_Chair: calls $0.20
*** FLOP *** [4h 5s Ac]
Morris_Chair: checks 
themacer24: checks 
*** TURN *** [4h 5s Ac] [4c]
Morris_Chair: checks 
themacer24: bets $0.62
Morris_Chair: folds 
Uncalled bet ($0.62) returned to themacer24
themacer24 collected $0.62 from pot
*** SUMMARY ***
Total pot $0.65 | Rake $0.03 
Board [4h 5s Ac 4c]
Seat 1: Pekaml folded before Flop (didn't bet)
Seat 2: themacer24 (button) collected ($0.62)
Seat 3: by.y.y.y86 (small blind) folded before Flop
Seat 4: Morris_Chair (big blind) folded on the Turn
Seat 5: Kow6oy folded before Flop (didn't bet)
Seat 6: takis nik folded before Flop (didn't bet)



PokerStars Hand #166667445407:  Hold'em No Limit ($0.05/$0.10 USD) - 2017/02/23 16:01:15 ET
Table 'Alnasl II' 6-max Seat #2 is the button
Seat 1: dragonste89 ($12.64 in chips) 
Seat 2: Therodorus ($11.91 in chips) 
Seat 3: ICBM-RS26 ($8.14 in chips) 
Seat 4: Eddys Edge ($10 in chips) 
Seat 5: mdelfin0 ($12.46 in chips) 
Seat 6: Bommer78 ($5.03 in chips) 
ICBM-RS26: posts small blind $0.05
Eddys Edge: posts big blind $0.10
*** HOLE CARDS ***
mdelfin0: folds 
Bommer78: calls $0.10
dragonste89: raises $0.30 to $0.40
Therodorus: folds 
ICBM-RS26: folds 
Eddys Edge: folds 
Bommer78: calls $0.30
*** FLOP *** [4c 4h Kd]
Bommer78: checks 
dragonste89: bets $0.46
Bommer78: folds 
Uncalled bet ($0.46) returned to dragonste89
dragonste89 collected $0.91 from pot
*** SUMMARY ***
Total pot $0.95 | Rake $0.04 
Board [4c 4h Kd]
Seat 1: dragonste89 collected ($0.91)
Seat 2: Therodorus (button) folded before Flop (didn't bet)
Seat 3: ICBM-RS26 (small blind) folded before Flop
Seat 4: Eddys Edge (big blind) folded before Flop
Seat 5: mdelfin0 folded before Flop (didn't bet)
Seat 6: Bommer78 folded on the Flop



PokerStars Hand #166667445493:  Hold'em No Limit ($0.05/$0.10 USD) - 2017/02/23 16:01:15 ET
Table 'Esperanto II' 6-max Seat #5 is the button
Seat 1: kurasd ($9.92 in chips) 
Seat 2: EggMayo ($10 in chips) 
Seat 3: Namhkal ($12.37 in chips) 
Seat 4: Andrei ProFF ($10.41 in chips) 
Seat 5: FRAID358 ($10 in chips) 
Seat 6: ArcticBearDK ($13.75 in chips) 
ArcticBearDK: posts small blind $0.05
kurasd: posts big blind $0.10
*** HOLE CARDS ***
EggMayo: folds 
EggMayo leaves the table
Namhkal: folds 
KRZuff joins the table at seat #2 
Andrei ProFF: folds 
KRZuff leaves the table
FRAID358: folds 
ArcticBearDK: raises $0.20 to $0.30
MihaGr joins the table at seat #2 
kurasd: calls $0.20
*** FLOP *** [2s Js 9d]
ArcticBearDK: checks 
kurasd: bets $0.30
ArcticBearDK: calls $0.30
*** TURN *** [2s Js 9d] [9s]
ArcticBearDK: checks 
kurasd: bets $0.50
ArcticBearDK: folds 
Uncalled bet ($0.50) returned to kurasd
kurasd collected $1.15 from pot
*** SUMMARY ***
Total pot $1.20 | Rake $0.05 
Board [2s Js 9d 9s]
Seat 1: kurasd (big blind) collected ($1.15)
Seat 2: EggMayo folded before Flop (didn't bet)
Seat 3: Namhkal folded before Flop (didn't bet)
Seat 4: Andrei ProFF folded before Flop (didn't bet)
Seat 5: FRAID358 (button) folded before Flop (didn't bet)
Seat 6: ArcticBearDK (small blind) folded on the Turn



PokerStars Hand #166667445592:  Hold'em No Limit ($0.05/$0.10 USD) - 2017/02/23 16:01:15 ET
Table 'Caupolican' 6-max Seat #2 is the button
Seat 1: kingartur222 ($10.08 in chips) 
Seat 2: garigura ($19.55 in chips) 
Seat 3: arturgalant ($4.82 in chips) 
Seat 4: mhonielsen ($11.46 in chips) 
Seat 5: Kazacha ($10.95 in chips) 
Seat 6: crazydevill ($11.02 in chips) 
arturgalant: posts small blind $0.05
mhonielsen: posts big blind $0.10
*** HOLE CARDS ***
Kazacha: folds 
crazydevill: folds 
kingartur222: raises $0.20 to $0.30
garigura: folds 
arturgalant: raises $0.20 to $0.50
mhonielsen: folds 
kingartur222: raises $9.58 to $10.08 and is all-in
arturgalant: folds 
Uncalled bet ($9.58) returned to kingartur222
kingartur222 collected $1.10 from pot
*** SUMMARY ***
Total pot $1.10 | Rake $0 
Seat 1: kingartur222 collected ($1.10)
Seat 2: garigura (button) folded before Flop (didn't bet)
Seat 3: arturgalant (small blind) folded before Flop
Seat 4: mhonielsen (big blind) folded before Flop
Seat 5: Kazacha folded before Flop (didn't bet)
Seat 6: crazydevill folded before Flop (didn't bet)



PokerStars Hand #166667445843:  Hold'em No Limit ($0.05/$0.10 USD) - 2017/02/23 16:01:15 ET
Table 'Landi II' 6-max Seat #3 is the button
Seat 1: dersiemer ($11.97 in chips) 
Seat 2: Aescul@pius ($11.10 in chips) 
Seat 3: dr.goofy ($18.56 in chips) 
Seat 4: alesi13 ($6.25 in chips) 
Seat 5: Bird et al ($10.63 in chips) 
Seat 6: arti192837 ($10 in chips) 
alesi13: posts small blind $0.05
Bird et al: posts big blind $0.10
*** HOLE CARDS ***
arti192837: folds 
dersiemer: folds 
Aescul@pius: folds 
dr.goofy: folds 
alesi13: folds 
Uncalled bet ($0.05) returned to Bird et al
Bird et al collected $0.10 from pot
*** SUMMARY ***
Total pot $0.10 | Rake $0 
Seat 1: dersiemer folded before Flop (didn't bet)
Seat 2: Aescul@pius folded before Flop (didn't bet)
Seat 3: dr.goofy (button) folded before Flop (didn't bet)
Seat 4: alesi13 (small blind) folded before Flop
Seat 5: Bird et al (big blind) collected ($0.10)
Seat 6: arti192837 folded before Flop (didn't bet)



PokerStars Hand #166667445957:  Hold'em No Limit ($0.05/$0.10 USD) - 2017/02/23 16:01:16 ET
Table 'Izar' 6-max Seat #5 is the button
Seat 1: bambolejro ($10.44 in chips) 
Seat 2: mvp0013 ($10.72 in chips) 
Seat 4: Matee92 ($6.96 in chips) 
Seat 5: fishhook5 ($10.10 in chips) 
bambolejro: posts small blind $0.05
mvp0013: posts big blind $0.10
Yspenyanin: sits out 
*** HOLE CARDS ***
yodzik joins the table at seat #6 
Matee92: calls $0.10
fishhook5: raises $0.23 to $0.33
bambolejro: folds 
mvp0013: folds 
Matee92: folds 
Uncalled bet ($0.23) returned to fishhook5
fishhook5 collected $0.35 from pot
*** SUMMARY ***
Total pot $0.35 | Rake $0 
Seat 1: bambolejro (small blind) folded before Flop
Seat 2: mvp0013 (big blind) folded before Flop
Seat 4: Matee92 folded before Flop
Seat 5: fishhook5 (button) collected ($0.35)



PokerStars Hand #166667445959:  Hold'em No Limit ($0.05/$0.10 USD) - 2017/02/23 16:01:16 ET
Table 'Amalia' 6-max Seat #3 is the button
Seat 1: voledy ($12.99 in chips) 
Seat 2: DamDatsAnAce ($10.70 in chips) 
Seat 3: kickereens ($10 in chips) 
Seat 4: Rodik002 ($16.43 in chips) 
Seat 5: coolisses111 ($10 in chips) 
Seat 6: oktomber778 ($24.29 in chips) 
Rodik002: posts small blind $0.05
coolisses111: posts big blind $0.10
*** HOLE CARDS ***
oktomber778: folds 
voledy: folds 
DamDatsAnAce: folds 
kickereens: raises $0.10 to $0.20
Rodik002: folds 
coolisses111: folds 
Uncalled bet ($0.10) returned to kickereens
kickereens collected $0.25 from pot
*** SUMMARY ***
Total pot $0.25 | Rake $0 
Seat 1: voledy folded before Flop (didn't bet)
Seat 2: DamDatsAnAce folded before Flop (didn't bet)
Seat 3: kickereens (button) collected ($0.25)
Seat 4: Rodik002 (small blind) folded before Flop
Seat 5: coolisses111 (big blind) folded before Flop
Seat 6: oktomber778 folded before Flop (didn't bet)



PokerStars Hand #166667446014:  Hold'em No Limit ($0.05/$0.10 USD) - 2017/02/23 16:01:16 ET
Table 'Atropos' 6-max Seat #6 is the button
Seat 1: ScorpionF39 ($1.33 in chips) 
Seat 3: NvR.m1nD ($10.99 in chips) 
Seat 4: iDecMate ($13.05 in chips) 
Seat 5: KokoulinV ($12.09 in chips) 
Seat 6: Iarlei ($10.29 in chips) 
ScorpionF39: posts small blind $0.05
Ice_Isayev: is sitting out 
NvR.m1nD: posts big blind $0.10
*** HOLE CARDS ***
Ice_Isayev leaves the table
yodzik joins the table at seat #2 
iDecMate: folds 
KokoulinV: folds 
Iarlei: raises $0.15 to $0.25
ScorpionF39: calls $0.20
NvR.m1nD: folds 
*** FLOP *** [Kh 4s 3s]
ScorpionF39: checks 
Iarlei: bets $0.20
ScorpionF39: calls $0.20
*** TURN *** [Kh 4s 3s] [Qc]
ScorpionF39: checks 
Iarlei: checks 
*** RIVER *** [Kh 4s 3s Qc] [Ts]
ScorpionF39: checks 
Iarlei: checks 
*** SHOW DOWN ***
ScorpionF39: shows [Ah 9c] (high card Ace)
Iarlei: shows [Jc Jh] (a pair of Jacks)
Iarlei collected $0.96 from pot
*** SUMMARY ***
Total pot $1 | Rake $0.04 
Board [Kh 4s 3s Qc Ts]
Seat 1: ScorpionF39 (small blind) showed [Ah 9c] and lost with high card Ace
Seat 3: NvR.m1nD (big blind) folded before Flop
Seat 4: iDecMate folded before Flop (didn't bet)
Seat 5: KokoulinV folded before Flop (didn't bet)
Seat 6: Iarlei (button) showed [Jc Jh] and won ($0.96) with a pair of Jacks



PokerStars Hand #166667446224:  Hold'em No Limit ($0.05/$0.10 USD) - 2017/02/23 16:01:16 ET
Table 'Martha' 6-max Seat #1 is the button
Seat 1: Peter0087 ($10.56 in chips) 
Seat 2: pauli95 ($7.59 in chips) 
Seat 3: Hyd SK ($12.11 in chips) 
Seat 4: dittoro ($10.84 in chips) 
Seat 6: 8th wonders ($10 in chips) 
pauli95: posts small blind $0.05
Hyd SK: posts big blind $0.10
MihaGr: sits out 
*** HOLE CARDS ***
dittoro: folds 
8th wonders: folds 
Peter0087: raises $0.20 to $0.30
pauli95: folds 
Hyd SK: raises $0.90 to $1.20
Peter0087: folds 
Uncalled bet ($0.90) returned to Hyd SK
Hyd SK collected $0.65 from pot
*** SUMMARY ***
Total pot $0.65 | Rake $0 
Seat 1: Peter0087 (button) folded before Flop
Seat 2: pauli95 (small blind) folded before Flop
Seat 3: Hyd SK (big blind) collected ($0.65)
Seat 4: dittoro folded before Flop (didn't bet)
Seat 6: 8th wonders folded before Flop (didn't bet)



PokerStars Hand #166667446240:  Hold'em No Limit ($0.05/$0.10 USD) - 2017/02/23 16:01:16 ET
Table 'Wil' 6-max Seat #3 is the button
Seat 1: jwhelan94 ($24.47 in chips) 
Seat 2: Vrinni ($22.36 in chips) 
Seat 3: Namhkal ($10 in chips) 
Seat 4: x3ultimate ($10.72 in chips) 
Seat 5: Feverhead ($11.36 in chips) 
Seat 6: Comeback3392 ($14.33 in chips) 
x3ultimate: posts small blind $0.05
Feverhead: posts big blind $0.10
*** HOLE CARDS ***
Comeback3392: folds 
jwhelan94: folds 
Vrinni: folds 
Namhkal: folds 
x3ultimate: raises $0.20 to $0.30
Feverhead: calls $0.20
*** FLOP *** [Kh 4s 7d]
x3ultimate: checks 
Feverhead: checks 
*** TURN *** [Kh 4s 7d] [6h]
x3ultimate: checks 
Feverhead: bets $0.40
x3ultimate: folds 
Uncalled bet ($0.40) returned to Feverhead
Feverhead collected $0.57 from pot
*** SUMMARY ***
Total pot $0.60 | Rake $0.03 
Board [Kh 4s 7d 6h]
Seat 1: jwhelan94 folded before Flop (didn't bet)
Seat 2: Vrinni folded before Flop (didn't bet)
Seat 3: Namhkal (button) folded before Flop (didn't bet)
Seat 4: x3ultimate (small blind) folded on the Turn
Seat 5: Feverhead (big blind) collected ($0.57)
Seat 6: Comeback3392 folded before Flop (didn't bet)



PokerStars Hand #166667446295:  Hold'em No Limit ($0.05/$0.10 USD) - 2017/02/23 16:01:16 ET
Table 'Pulcova II' 6-max Seat #3 is the button
Seat 1: sexy_seagull ($10 in chips) 
Seat 2: Kazacha ($10 in chips) 
Seat 3: Lao Tsy ($13.96 in chips) 
Seat 4: VioXion ($10.30 in chips) 
Seat 5: mdelfin0 ($12.94 in chips) 
Seat 6: Ice_Isayev ($10.61 in chips) 
VioXion: posts small blind $0.05
mdelfin0: posts big blind $0.10
*** HOLE CARDS ***
Ice_Isayev: folds 
sexy_seagull: raises $0.20 to $0.30
Kazacha: folds 
Lao Tsy: folds 
VioXion: folds 
mdelfin0: folds 
Uncalled bet ($0.20) returned to sexy_seagull
sexy_seagull collected $0.25 from pot
*** SUMMARY ***
Total pot $0.25 | Rake $0 
Seat 1: sexy_seagull collected ($0.25)
Seat 2: Kazacha folded before Flop (didn't bet)
Seat 3: Lao Tsy (button) folded before Flop (didn't bet)
Seat 4: VioXion (small blind) folded before Flop
Seat 5: mdelfin0 (big blind) folded before Flop
Seat 6: Ice_Isayev folded before Flop (didn't bet)



PokerStars Hand #166667446414:  Hold'em No Limit ($0.05/$0.10 USD) - 2017/02/23 16:01:16 ET
Table 'Pirola III' 6-max Seat #3 is the button
Seat 1: bdixon_5 ($9.92 in chips) 
Seat 2: gaHy_HaXeP ($10 in chips) 
Seat 3: kingartur222 ($10.22 in chips) 
Seat 4: McCleans ($10.20 in chips) 
Seat 6: T9MS ($10 in chips) 
McCleans: posts small blind $0.05
T9MS: posts big blind $0.10
*** HOLE CARDS ***
bdixon_5: folds 
gaHy_HaXeP: folds 
kingartur222: folds 
McCleans: raises $0.20 to $0.30
T9MS: folds 
Uncalled bet ($0.20) returned to McCleans
McCleans collected $0.20 from pot
*** SUMMARY ***
Total pot $0.20 | Rake $0 
Seat 1: bdixon_5 folded before Flop (didn't bet)
Seat 2: gaHy_HaXeP folded before Flop (didn't bet)
Seat 3: kingartur222 (button) folded before Flop (didn't bet)
Seat 4: McCleans (small blind) collected ($0.20)
Seat 6: T9MS (big blind) folded before Flop



PokerStars Hand #166667446432:  Hold'em No Limit ($0.05/$0.10 USD) - 2017/02/23 16:01:16 ET
Table 'Stroobantia' 6-max Seat #6 is the button
Seat 1: mam9zyc ($7.65 in chips) 
Seat 2: XwinX25 ($10.30 in chips) 
Seat 3: Namhkal ($10 in chips) 
Seat 5: boxer821 ($10.64 in chips) 
Seat 6: KokoulinV ($15.37 in chips) 
mam9zyc: posts small blind $0.05
XwinX25: posts big blind $0.10
Yspenyanin: sits out 
*** HOLE CARDS ***
Namhkal: folds 
boxer821: folds 
KokoulinV: folds 
mam9zyc: calls $0.05
XwinX25: checks 
*** FLOP *** [6s 4h Kd]
mam9zyc: checks 
XwinX25: bets $0.15
mam9zyc: folds 
Uncalled bet ($0.15) returned to XwinX25
XwinX25 collected $0.19 from pot
*** SUMMARY ***
Total pot $0.20 | Rake $0.01 
Board [6s 4h Kd]
Seat 1: mam9zyc (small blind) folded on the Flop
Seat 2: XwinX25 (big blind) collected ($0.19)
Seat 3: Namhkal folded before Flop (didn't bet)
Seat 5: boxer821 folded before Flop (didn't bet)
Seat 6: KokoulinV (button) folded before Flop (didn't bet)



PokerStars Hand #166667446508:  Hold'em No Limit ($0.05/$0.10 USD) - 2017/02/23 16:01:16 ET
Table 'Hercynia III' 6-max Seat #3 is the button
Seat 1: Bird et al ($14.73 in chips) 
Seat 2: Action_Gibi ($9.20 in chips) 
Seat 3: Dcaro31 ($20.39 in chips) 
Seat 4: Darkfrai ($16.26 in chips) 
Seat 5: THIMUCHIN ($14.94 in chips) 
Seat 6: bdixon_5 ($10.87 in chips) 
Darkfrai: posts small blind $0.05
THIMUCHIN: posts big blind $0.10
*** HOLE CARDS ***
bdixon_5: folds 
Bird et al: folds 
Action_Gibi: folds 
Dcaro31: raises $0.20 to $0.30
Darkfrai: folds 
THIMUCHIN: folds 
Uncalled bet ($0.20) returned to Dcaro31
Dcaro31 collected $0.25 from pot
*** SUMMARY ***
Total pot $0.25 | Rake $0 
Seat 1: Bird et al folded before Flop (didn't bet)
Seat 2: Action_Gibi folded before Flop (didn't bet)
Seat 3: Dcaro31 (button) collected ($0.25)
Seat 4: Darkfrai (small blind) folded before Flop
Seat 5: THIMUCHIN (big blind) folded before Flop
Seat 6: bdixon_5 folded before Flop (didn't bet)



PokerStars Hand #166667446565:  Hold'em No Limit ($0.05/$0.10 USD) - 2017/02/23 16:01:16 ET
Table 'Walpurga' 6-max Seat #4 is the button
Seat 1: chimera252 ($11.26 in chips) 
Seat 2: paxit71 ($8 in chips) 
Seat 4: oddshoff ($12.79 in chips) 
AIONCMA1988 will be allowed to play after the button
chimera252: posts small blind $0.05
paxit71: posts big blind $0.10
*** HOLE CARDS ***
oddshoff: folds 
chimera252: raises $0.20 to $0.30
paxit71: calls $0.20
*** FLOP *** [Tc Ks Kc]
chimera252: bets $0.38
paxit71: raises $0.38 to $0.76
chimera252: calls $0.38
*** TURN *** [Tc Ks Kc] [Qh]
chimera252: checks 
paxit71: checks 
*** RIVER *** [Tc Ks Kc Qh] [2c]
chimera252: checks 
paxit71: checks 
*** SHOW DOWN ***
chimera252: shows [Jd Qs] (two pair, Kings and Queens)
paxit71: mucks hand 
chimera252 collected $2.02 from pot
*** SUMMARY ***
Total pot $2.12 | Rake $0.10 
Board [Tc Ks Kc Qh 2c]
Seat 1: chimera252 (small blind) showed [Jd Qs] and won ($2.02) with two pair, Kings and Queens
Seat 2: paxit71 (big blind) mucked
Seat 4: oddshoff (button) folded before Flop (didn't bet)



PokerStars Hand #166667446847:  Hold'em No Limit ($0.05/$0.10 USD) - 2017/02/23 16:01:17 ET
Table 'Joella' 6-max Seat #6 is the button
Seat 1: Dcaro31 ($13.30 in chips) 
Seat 2: Kaelyns_Bark ($9.96 in chips) 
Seat 3: Joker51_wtf! ($10.20 in chips) 
Seat 5: Anestakis777 ($5.19 in chips) 
Seat 6: dr.goofy ($10 in chips) 
Dcaro31: posts small blind $0.05
Kaelyns_Bark: posts big blind $0.10
*** HOLE CARDS ***
Joker51_wtf!: raises $0.16 to $0.26
Anestakis777: calls $0.26
dr.goofy: raises $0.94 to $1.20
Dcaro31: folds 
Kaelyns_Bark: folds 
Joker51_wtf!: folds 
Anestakis777: calls $0.94
*** FLOP *** [Qh 8s Td]
Anestakis777: bets $0.30
dr.goofy: raises $3.30 to $3.60
Anestakis777: folds 
Uncalled bet ($3.30) returned to dr.goofy
dr.goofy collected $3.26 from pot
*** SUMMARY ***
Total pot $3.41 | Rake $0.15 
Board [Qh 8s Td]
Seat 1: Dcaro31 (small blind) folded before Flop
Seat 2: Kaelyns_Bark (big blind) folded before Flop
Seat 3: Joker51_wtf! folded before Flop
Seat 5: Anestakis777 folded on the Flop
Seat 6: dr.goofy (button) collected ($3.26)



PokerStars Hand #166667447150:  Hold'em No Limit ($0.05/$0.10 USD) - 2017/02/23 16:01:17 ET
Table 'Pandora III' 6-max Seat #1 is the button
Seat 1: Pokeaster ($10.99 in chips) 
Seat 2: garigura ($11.67 in chips) 
Seat 3: ChuikaPridi ($16.61 in chips) 
Seat 4: mhonielsen ($10 in chips) 
Seat 5: MühliJr ($10.15 in chips) 
garigura: posts small blind $0.05
ChuikaPridi: posts big blind $0.10
yodzik: sits out 
*** HOLE CARDS ***
mhonielsen: folds 
MühliJr: folds 
Pokeaster: folds 
garigura: raises $0.20 to $0.30
ChuikaPridi: folds 
Uncalled bet ($0.20) returned to garigura
garigura collected $0.20 from pot
*** SUMMARY ***
Total pot $0.20 | Rake $0 
Seat 1: Pokeaster (button) folded before Flop (didn't bet)
Seat 2: garigura (small blind) collected ($0.20)
Seat 3: ChuikaPridi (big blind) folded before Flop
Seat 4: mhonielsen folded before Flop (didn't bet)
Seat 5: MühliJr folded before Flop (didn't bet)



PokerStars Hand #166667447302:  Hold'em No Limit ($0.05/$0.10 USD) - 2017/02/23 16:01:17 ET
Table 'Geisha' 6-max Seat #4 is the button
Seat 1: facewald ($34.63 in chips) 
Seat 2: voledy ($10.15 in chips) 
Seat 4: jvstsayyes ($12.37 in chips) 
Seat 5: KRZuff ($15 in chips) 
Seat 6: Namhkal ($19.85 in chips) 
KRZuff: posts small blind $0.05
Namhkal: posts big blind $0.10
Eddys Edge: sits out 
*** HOLE CARDS ***
facewald: folds 
voledy: folds 
jvstsayyes: raises $0.10 to $0.20
KRZuff: calls $0.15
Namhkal: raises $0.70 to $0.90
jvstsayyes: calls $0.70
KRZuff: calls $0.70
*** FLOP *** [Js 5h Jd]
KRZuff: checks 
Namhkal: checks 
jvstsayyes: checks 
*** TURN *** [Js 5h Jd] [3s]
KRZuff: checks 
Namhkal: bets $1.29
jvstsayyes: folds 
KRZuff: folds 
Uncalled bet ($1.29) returned to Namhkal
Namhkal collected $2.58 from pot
*** SUMMARY ***
Total pot $2.70 | Rake $0.12 
Board [Js 5h Jd 3s]
Seat 1: facewald folded before Flop (didn't bet)
Seat 2: voledy folded before Flop (didn't bet)
Seat 4: jvstsayyes (button) folded on the Turn
Seat 5: KRZuff (small blind) folded on the Turn
Seat 6: Namhkal (big blind) collected ($2.58)



PokerStars Hand #166667447884:  Hold'em No Limit ($0.05/$0.10 USD) - 2017/02/23 16:01:18 ET
Table 'Lorbach' 6-max Seat #1 is the button
Seat 1: LarryTheStar ($11.12 in chips) 
Seat 2: fabadam ($12.38 in chips) 
Seat 3: ArcticBearDK ($11.20 in chips) 
Seat 4: McCleans ($10 in chips) 
Seat 5: Cluckh ($15.22 in chips) 
Seat 6: Worlz ($12.82 in chips) 
fabadam: posts small blind $0.05
ArcticBearDK: posts big blind $0.10
*** HOLE CARDS ***
McCleans: folds 
Cluckh: raises $0.20 to $0.30
Worlz: folds 
LarryTheStar: folds 
fabadam: folds 
ArcticBearDK: folds 
Uncalled bet ($0.20) returned to Cluckh
Cluckh collected $0.25 from pot
*** SUMMARY ***
Total pot $0.25 | Rake $0 
Seat 1: LarryTheStar (button) folded before Flop (didn't bet)
Seat 2: fabadam (small blind) folded before Flop
Seat 3: ArcticBearDK (big blind) folded before Flop
Seat 4: McCleans folded before Flop (didn't bet)
Seat 5: Cluckh collected ($0.25)
Seat 6: Worlz folded before Flop (didn't bet)



PokerStars Hand #166667448101:  Hold'em No Limit ($0.05/$0.10 USD) - 2017/02/23 16:01:18 ET
Table 'Brambilla II' 6-max Seat #6 is the button
Seat 1: Rodik002 ($11.68 in chips) 
Seat 2: dwonder75 ($16.88 in chips) 
Seat 3: BORIS_ENEV ($14.49 in chips) 
Seat 4: david_sara83 ($10.30 in chips) 
Seat 5: FRAID358 ($10 in chips) 
Seat 6: boxer821 ($10.48 in chips) 
Rodik002: posts small blind $0.05
dwonder75: posts big blind $0.10
*** HOLE CARDS ***
BORIS_ENEV: calls $0.10
david_sara83: raises $0.30 to $0.40
FRAID358: folds 
boxer821: folds 
Rodik002: calls $0.35
dwonder75: calls $0.30
BORIS_ENEV: folds 
*** FLOP *** [Kd Kc Tc]
Rodik002: checks 
dwonder75: checks 
david_sara83: checks 
*** TURN *** [Kd Kc Tc] [Kh]
Rodik002: bets $0.50
dwonder75: calls $0.50
david_sara83: calls $0.50
*** RIVER *** [Kd Kc Tc Kh] [4d]
Rodik002: checks 
dwonder75: checks 
david_sara83: bets $3
Rodik002: folds 
dwonder75: folds 
Uncalled bet ($3) returned to david_sara83
david_sara83 collected $2.67 from pot
*** SUMMARY ***
Total pot $2.80 | Rake $0.13 
Board [Kd Kc Tc Kh 4d]
Seat 1: Rodik002 (small blind) folded on the River
Seat 2: dwonder75 (big blind) folded on the River
Seat 3: BORIS_ENEV folded before Flop
Seat 4: david_sara83 collected ($2.67)
Seat 5: FRAID358 folded before Flop (didn't bet)
Seat 6: boxer821 (button) folded before Flop (didn't bet)



PokerStars Hand #166667448432:  Hold'em No Limit ($0.05/$0.10 USD) - 2017/02/23 16:01:19 ET
Table 'Brendelia II' 6-max Seat #2 is the button
Seat 2: Crimsonr ($6.74 in chips) 
Seat 3: ValdemorS ($17.86 in chips) 
Seat 6: luckyPositiv ($9.79 in chips) 
ValdemorS: posts small blind $0.05
Kupi007: is sitting out 
luckyPositiv: posts big blind $0.10
Crimsonr: posts the ante $0.02
ValdemorS: posts the ante $0.02
luckyPositiv: posts the ante $0.02
*** HOLE CARDS ***
Kupi007 leaves the table
Crimsonr: raises $0.20 to $0.30
ValdemorS: folds 
luckyPositiv: raises $0.70 to $1
Crimsonr: calls $0.70
*** FLOP *** [Ts 7c Ac]
luckyPositiv: checks 
Crimsonr: checks 
*** TURN *** [Ts 7c Ac] [Th]
luckyPositiv: bets $1.30
Crimsonr: folds 
Uncalled bet ($1.30) returned to luckyPositiv
luckyPositiv collected $2.02 from pot
*** SUMMARY ***
Total pot $2.11 | Rake $0.09 
Board [Ts 7c Ac Th]
Seat 2: Crimsonr (button) folded on the Turn
Seat 3: ValdemorS (small blind) folded before Flop
Seat 6: luckyPositiv (big blind) collected ($2.02)



PokerStars Hand #166667448565:  Hold'em No Limit ($0.05/$0.10 USD) - 2017/02/23 16:01:19 ET
Table 'Aegle' 6-max Seat #5 is the button
Seat 2: yodzik ($5 in chips) 
Seat 4: ab260414 ($11.32 in chips) 
Seat 5: KokoulinV ($11.13 in chips) 
Seat 6: CHRO8 ($20.64 in chips) 
CHRO8: posts small blind $0.05
yodzik: posts big blind $0.10
*** HOLE CARDS ***
ab260414: folds 
KokoulinV: folds 
DrejAtom joins the table at seat #3 
CHRO8: folds 
Uncalled bet ($0.05) returned to yodzik
yodzik collected $0.10 from pot
*** SUMMARY ***
Total pot $0.10 | Rake $0 
Seat 2: yodzik (big blind) collected ($0.10)
Seat 4: ab260414 folded before Flop (didn't bet)
Seat 5: KokoulinV (button) folded before Flop (didn't bet)
Seat 6: CHRO8 (small blind) folded before Flop



PokerStars Hand #166667448784:  Hold'em No Limit ($0.05/$0.10 USD) - 2017/02/23 16:01:19 ET
Table 'Reginhild' 6-max Seat #2 is the button
Seat 1: iamkakaroto ($11.40 in chips) 
Seat 2: Kow6oy ($10 in chips) 
Seat 3: ARCHITECT83 ($5.50 in chips) 
Seat 4: Raymondo21 ($23.66 in chips) 
Seat 5: XCarlos610 ($28.64 in chips) 
Seat 6: eniksenik ($10.79 in chips) 
ARCHITECT83: posts small blind $0.05
Raymondo21: posts big blind $0.10
*** HOLE CARDS ***
XCarlos610: folds 
eniksenik: folds 
iamkakaroto: folds 
Kow6oy: raises $0.15 to $0.25
ARCHITECT83: folds 
Raymondo21: folds 
Uncalled bet ($0.15) returned to Kow6oy
Kow6oy collected $0.25 from pot
*** SUMMARY ***
Total pot $0.25 | Rake $0 
Seat 1: iamkakaroto folded before Flop (didn't bet)
Seat 2: Kow6oy (button) collected ($0.25)
Seat 3: ARCHITECT83 (small blind) folded before Flop
Seat 4: Raymondo21 (big blind) folded before Flop
Seat 5: XCarlos610 folded before Flop (didn't bet)
Seat 6: eniksenik folded before Flop (didn't bet)



PokerStars Hand #166667448883:  Hold'em No Limit ($0.05/$0.10 USD) - 2017/02/23 16:01:19 ET
Table 'Ebella II' 6-max Seat #3 is the button
Seat 1: gaHy_HaXeP ($10 in chips) 
Seat 2: Therodorus ($10 in chips) 
Seat 3: Torften2 ($16.08 in chips) 
Seat 4: ValdemorS ($10.20 in chips) 
Seat 5: Bird et al ($10.15 in chips) 
ValdemorS: posts small blind $0.05
Bird et al: posts big blind $0.10
Joker51_wtf!: sits out 
*** HOLE CARDS ***
gaHy_HaXeP: folds 
Therodorus: folds 
Torften2: calls $0.10
ValdemorS: folds 
Bird et al: checks 
*** FLOP *** [3c Kh 3d]
Bird et al: checks 
Torften2: bets $0.20
Bird et al: folds 
Uncalled bet ($0.20) returned to Torften2
Torften2 collected $0.24 from pot
*** SUMMARY ***
Total pot $0.25 | Rake $0.01 
Board [3c Kh 3d]
Seat 1: gaHy_HaXeP folded before Flop (didn't bet)
Seat 2: Therodorus folded before Flop (didn't bet)
Seat 3: Torften2 (button) collected ($0.24)
Seat 4: ValdemorS (small blind) folded before Flop
Seat 5: Bird et al (big blind) folded on the Flop



PokerStars Hand #166667448954:  Hold'em No Limit ($0.05/$0.10 USD) - 2017/02/23 16:01:19 ET
Table 'Senta II' 6-max Seat #5 is the button
Seat 2: NvR.m1nD ($10.78 in chips) 
Seat 3: Aescul@pius ($21.25 in chips) 
Seat 4: fedorka rus ($21.67 in chips) 
Seat 5: Algarah ($6.04 in chips) 
Seat 6: T9MS ($11.97 in chips) 
T9MS: posts small blind $0.05
NvR.m1nD: posts big blind $0.10
*** HOLE CARDS ***
Aescul@pius: raises $0.20 to $0.30
fedorka rus: folds 
Algarah: folds 
T9MS: folds 
NvR.m1nD: folds 
Uncalled bet ($0.20) returned to Aescul@pius
Aescul@pius collected $0.25 from pot
*** SUMMARY ***
Total pot $0.25 | Rake $0 
Seat 2: NvR.m1nD (big blind) folded before Flop
Seat 3: Aescul@pius collected ($0.25)
Seat 4: fedorka rus folded before Flop (didn't bet)
Seat 5: Algarah (button) folded before Flop (didn't bet)
Seat 6: T9MS (small blind) folded before Flop



PokerStars Hand #166667449548:  Hold'em No Limit ($0.05/$0.10 USD) - 2017/02/23 16:01:20 ET
Table 'Vesta II' 6-max Seat #2 is the button
Seat 1: Yabidooo ($13.16 in chips) 
Seat 2: joewatson90 ($9.95 in chips) 
Seat 3: Pokeaster ($11.96 in chips) 
Seat 4: Dcaro31 ($10.42 in chips) 
Seat 5: Andy Wolf ($11.87 in chips) 
Seat 6: CDestructivo ($13.59 in chips) 
Pokeaster: posts small blind $0.05
Dcaro31: posts big blind $0.10
*** HOLE CARDS ***
Andy Wolf: raises $0.20 to $0.30
CDestructivo: calls $0.30
Yabidooo: folds 
joewatson90: folds 
Pokeaster: folds 
Dcaro31: calls $0.20
*** FLOP *** [7s Qd 5s]
Dcaro31: checks 
Andy Wolf: bets $0.30
CDestructivo: calls $0.30
Dcaro31: folds 
*** TURN *** [7s Qd 5s] [Th]
Andy Wolf: bets $1.10
CDestructivo: folds 
Uncalled bet ($1.10) returned to Andy Wolf
Andy Wolf collected $1.48 from pot
*** SUMMARY ***
Total pot $1.55 | Rake $0.07 
Board [7s Qd 5s Th]
Seat 1: Yabidooo folded before Flop (didn't bet)
Seat 2: joewatson90 (button) folded before Flop (didn't bet)
Seat 3: Pokeaster (small blind) folded before Flop
Seat 4: Dcaro31 (big blind) folded on the Flop
Seat 5: Andy Wolf collected ($1.48)
Seat 6: CDestructivo folded on the Turn



PokerStars Hand #166667449632:  Hold'em No Limit ($0.05/$0.10 USD) - 2017/02/23 16:01:20 ET
Table 'Hunnia' 6-max Seat #2 is the button
Seat 1: univibe68 ($20.86 in chips) 
Seat 2: mhonielsen ($10 in chips) 
Seat 3: crazydevill ($9.97 in chips) 
Seat 4: Jalida3 ($10.71 in chips) 
Seat 5: Smarkon ($15.23 in chips) 
Seat 6: ChuikaPridi ($9.22 in chips) 
crazydevill: posts small blind $0.05
Jalida3: posts big blind $0.10
*** HOLE CARDS ***
Smarkon: raises $0.30 to $0.40
ChuikaPridi: folds 
univibe68: raises $0.60 to $1
mhonielsen: folds 
crazydevill: folds 
Jalida3: folds 
Smarkon: folds 
Uncalled bet ($0.60) returned to univibe68
crazydevill leaves the table
univibe68 collected $0.95 from pot
*** SUMMARY ***
Total pot $0.95 | Rake $0 
Seat 1: univibe68 collected ($0.95)
Seat 2: mhonielsen (button) folded before Flop (didn't bet)
Seat 3: crazydevill (small blind) folded before Flop
Seat 4: Jalida3 (big blind) folded before Flop
Seat 5: Smarkon folded before Flop
Seat 6: ChuikaPridi folded before Flop (didn't bet)



PokerStars Hand #166667450147:  Hold'em No Limit ($0.05/$0.10 USD) - 2017/02/23 16:01:21 ET
Table 'Samitchell III' 6-max Seat #1 is the button
Seat 1: dr.goofy ($10.27 in chips) 
Seat 2: Orlangoor ($10 in chips) 
Seat 3: Kow6oy ($10.10 in chips) 
Seat 4: eniksenik ($10.10 in chips) 
Seat 5: boxer821 ($18.31 in chips) 
Seat 6: fedorka rus ($13.11 in chips) 
Orlangoor: posts small blind $0.05
Kow6oy: posts big blind $0.10
*** HOLE CARDS ***
eniksenik: raises $0.20 to $0.30
boxer821: folds 
fedorka rus: folds 
dr.goofy: folds 
Orlangoor: folds 
Kow6oy: folds 
Uncalled bet ($0.20) returned to eniksenik
eniksenik collected $0.25 from pot
*** SUMMARY ***
Total pot $0.25 | Rake $0 
Seat 1: dr.goofy (button) folded before Flop (didn't bet)
Seat 2: Orlangoor (small blind) folded before Flop
Seat 3: Kow6oy (big blind) folded before Flop
Seat 4: eniksenik collected ($0.25)
Seat 5: boxer821 folded before Flop (didn't bet)
Seat 6: fedorka rus folded before Flop (didn't bet)



PokerStars Hand #166667450247:  Hold'em No Limit ($0.05/$0.10 USD) - 2017/02/23 16:01:21 ET
Table 'Luanda' 6-max Seat #1 is the button
Seat 1: Kow6oy ($10.10 in chips) 
Seat 2: Xander188 ($10.05 in chips) 
Seat 3: DamDatsAnAce ($10 in chips) 
Seat 4: aapokerkot ($10.38 in chips) 
Seat 5: st4tion ($11.92 in chips) 
Seat 6: KA3AXCTAHEU, ($11.41 in chips) 
Xander188: posts small blind $0.05
DamDatsAnAce: posts big blind $0.10
*** HOLE CARDS ***
aapokerkot: folds 
st4tion: raises $0.15 to $0.25
KA3AXCTAHEU,: folds 
Kow6oy: folds 
Xander188: folds 
DamDatsAnAce: folds 
Uncalled bet ($0.15) returned to st4tion
st4tion collected $0.25 from pot
*** SUMMARY ***
Total pot $0.25 | Rake $0 
Seat 1: Kow6oy (button) folded before Flop (didn't bet)
Seat 2: Xander188 (small blind) folded before Flop
Seat 3: DamDatsAnAce (big blind) folded before Flop
Seat 4: aapokerkot folded before Flop (didn't bet)
Seat 5: st4tion collected ($0.25)
Seat 6: KA3AXCTAHEU, folded before Flop (didn't bet)



PokerStars Hand #166667450654:  Hold'em No Limit ($0.05/$0.10 USD) - 2017/02/23 16:01:22 ET
Table 'Sheragul III' 6-max Seat #6 is the button
Seat 1: danky24 ($17.69 in chips) 
Seat 2: Bird et al ($11.96 in chips) 
Seat 4: maxiv608 ($11.24 in chips) 
Seat 5: Bandyaev ($14.51 in chips) 
Seat 6: Andrei ProFF ($10 in chips) 
danky24: posts small blind $0.05
Bird et al: posts big blind $0.10
*** HOLE CARDS ***
maxiv608: folds 
Bandyaev: raises $0.20 to $0.30
Andrei ProFF: folds 
danky24: calls $0.25
Bird et al: folds 
*** FLOP *** [Ac 6d 7c]
danky24: bets $0.10
Bandyaev: folds 
Uncalled bet ($0.10) returned to danky24
danky24 collected $0.67 from pot
*** SUMMARY ***
Total pot $0.70 | Rake $0.03 
Board [Ac 6d 7c]
Seat 1: danky24 (small blind) collected ($0.67)
Seat 2: Bird et al (big blind) folded before Flop
Seat 4: maxiv608 folded before Flop (didn't bet)
Seat 5: Bandyaev folded on the Flop
Seat 6: Andrei ProFF (button) folded before Flop (didn't bet)



PokerStars Hand #166667450694:  Hold'em No Limit ($0.05/$0.10 USD) - 2017/02/23 16:01:22 ET
Table 'Ostara III' 6-max Seat #6 is the button
Seat 1: MühliJr ($10.82 in chips) 
Seat 2: Action_Gibi ($6.99 in chips) 
Seat 3: vtalian ($10.46 in chips) 
Seat 5: dzesio18 ($12.45 in chips) 
Seat 6: FlopsterGB ($11.90 in chips) 
MühliJr: posts small blind $0.05
Action_Gibi: posts big blind $0.10
*** HOLE CARDS ***
vtalian: raises $0.25 to $0.35
dzesio18: folds 
FlopsterGB: folds 
MühliJr: calls $0.30
Action_Gibi: calls $0.25
*** FLOP *** [4c 4h Th]
MühliJr: checks 
Action_Gibi: bets $0.50
vtalian: folds 
MühliJr: folds 
Uncalled bet ($0.50) returned to Action_Gibi
Action_Gibi collected $1 from pot
*** SUMMARY ***
Total pot $1.05 | Rake $0.05 
Board [4c 4h Th]
Seat 1: MühliJr (small blind) folded on the Flop
Seat 2: Action_Gibi (big blind) collected ($1)
Seat 3: vtalian folded on the Flop
Seat 5: dzesio18 folded before Flop (didn't bet)
Seat 6: FlopsterGB (button) folded before Flop (didn't bet)



PokerStars Hand #166667450696:  Hold'em No Limit ($0.05/$0.10 USD) - 2017/02/23 16:01:22 ET
Table 'Bengt' 6-max Seat #6 is the button
Seat 1: Lucky HoBBiT ($10.05 in chips) 
Seat 2: ChefRocco ($23.37 in chips) 
Seat 3: nantes15 ($12.51 in chips) 
Seat 4: 8th wonders ($10 in chips) 
Seat 5: RoJ1 ($10.46 in chips) 
Seat 6: Goroshkos88 ($10 in chips) 
Lucky HoBBiT: posts small blind $0.05
ChefRocco: posts big blind $0.10
*** HOLE CARDS ***
nantes15: folds 
8th wonders: folds 
RoJ1: folds 
Goroshkos88: folds 
Lucky HoBBiT: raises $0.20 to $0.30
ChefRocco: calls $0.20
*** FLOP *** [Ts 2d Jd]
Lucky HoBBiT: bets $0.34
ChefRocco: calls $0.34
*** TURN *** [Ts 2d Jd] [Td]
Lucky HoBBiT: bets $0.85
ChefRocco: calls $0.85
*** RIVER *** [Ts 2d Jd Td] [Qh]
Lucky HoBBiT: bets $1.64
ChefRocco: calls $1.64
*** SHOW DOWN ***
Lucky HoBBiT: shows [As Kh] (a straight, Ten to Ace)
ChefRocco: mucks hand 
Lucky HoBBiT collected $5.98 from pot
*** SUMMARY ***
Total pot $6.26 | Rake $0.28 
Board [Ts 2d Jd Td Qh]
Seat 1: Lucky HoBBiT (small blind) showed [As Kh] and won ($5.98) with a straight, Ten to Ace
Seat 2: ChefRocco (big blind) mucked
Seat 3: nantes15 folded before Flop (didn't bet)
Seat 4: 8th wonders folded before Flop (didn't bet)
Seat 5: RoJ1 folded before Flop (didn't bet)
Seat 6: Goroshkos88 (button) folded before Flop (didn't bet)



PokerStars Hand #166667450949:  Hold'em No Limit ($0.05/$0.10 USD) - 2017/02/23 16:01:22 ET
Table 'Wabash' 6-max Seat #6 is the button
Seat 1: pivanki11 ($8.85 in chips) 
Seat 2: ex3Lero86 ($21.82 in chips) 
Seat 3: sszabi28 ($6.87 in chips) 
Seat 4: Nr847 ($10 in chips) 
Seat 5: popypaleta ($10.10 in chips) 
Seat 6: weez3r ($10.44 in chips) 
pivanki11: posts small blind $0.05
ex3Lero86: posts big blind $0.10
*** HOLE CARDS ***
sszabi28: calls $0.10
Nr847: raises $0.30 to $0.40
popypaleta: folds 
weez3r: folds 
pivanki11: calls $0.35
ex3Lero86: raises $1 to $1.40
sszabi28: calls $1.30
Nr847: calls $1
pivanki11: calls $1
*** FLOP *** [Jd 4c Td]
pivanki11: bets $5.30
ex3Lero86: raises $15.12 to $20.42 and is all-in
sszabi28: folds 
Nr847: folds 
pivanki11: calls $2.15 and is all-in
Uncalled bet ($12.97) returned to ex3Lero86
*** TURN *** [Jd 4c Td] [7h]
*** RIVER *** [Jd 4c Td 7h] [7c]
*** SHOW DOWN ***
pivanki11: shows [Jc Ts] (two pair, Jacks and Tens)
ex3Lero86: shows [Kc Ks] (two pair, Kings and Sevens)
ex3Lero86 collected $19.58 from pot
*** SUMMARY ***
Total pot $20.50 | Rake $0.92 
Board [Jd 4c Td 7h 7c]
Seat 1: pivanki11 (small blind) showed [Jc Ts] and lost with two pair, Jacks and Tens
Seat 2: ex3Lero86 (big blind) showed [Kc Ks] and won ($19.58) with two pair, Kings and Sevens
Seat 3: sszabi28 folded on the Flop
Seat 4: Nr847 folded on the Flop
Seat 5: popypaleta folded before Flop (didn't bet)
Seat 6: weez3r (button) folded before Flop (didn't bet)



PokerStars Hand #166667451057:  Hold'em No Limit ($0.05/$0.10 USD) - 2017/02/23 16:01:22 ET
Table 'Gaika' 6-max Seat #3 is the button
Seat 1: oddshoff ($12.56 in chips) 
Seat 2: NvR.m1nD ($17.92 in chips) 
Seat 3: david_sara83 ($10.32 in chips) 
Seat 4: fortieth ($11.55 in chips) 
Seat 5: fedorka rus ($10.65 in chips) 
Seat 6: dr.goofy ($11.15 in chips) 
fortieth: posts small blind $0.05
fedorka rus: posts big blind $0.10
*** HOLE CARDS ***
dr.goofy: folds 
oddshoff: folds 
NvR.m1nD: raises $0.15 to $0.25
david_sara83: folds 
fortieth: folds 
fedorka rus: folds 
Uncalled bet ($0.15) returned to NvR.m1nD
NvR.m1nD collected $0.25 from pot
*** SUMMARY ***
Total pot $0.25 | Rake $0 
Seat 1: oddshoff folded before Flop (didn't bet)
Seat 2: NvR.m1nD collected ($0.25)
Seat 3: david_sara83 (button) folded before Flop (didn't bet)
Seat 4: fortieth (small blind) folded before Flop
Seat 5: fedorka rus (big blind) folded before Flop
Seat 6: dr.goofy folded before Flop (didn't bet)



PokerStars Hand #166667451176:  Hold'em No Limit ($0.05/$0.10 USD) - 2017/02/23 16:01:22 ET
Table 'Eurykleia' 6-max Seat #3 is the button
Seat 1: Giyorod ($11.20 in chips) 
Seat 2: x3ultimate ($10 in chips) 
Seat 3: boxer821 ($20.28 in chips) 
Seat 4: 6ePeMeHHa9 ($16.56 in chips) 
Seat 5: fishhook5 ($10 in chips) 
Seat 6: afca128 ($6.57 in chips) 
6ePeMeHHa9: posts small blind $0.05
fishhook5: posts big blind $0.10
*** HOLE CARDS ***
afca128: folds 
Giyorod: folds 
x3ultimate: folds 
boxer821: raises $0.15 to $0.25
6ePeMeHHa9: folds 
fishhook5: calls $0.15
*** FLOP *** [Th 9s 3s]
fishhook5: checks 
boxer821: bets $0.35
fishhook5: folds 
Uncalled bet ($0.35) returned to boxer821
boxer821 collected $0.53 from pot
*** SUMMARY ***
Total pot $0.55 | Rake $0.02 
Board [Th 9s 3s]
Seat 1: Giyorod folded before Flop (didn't bet)
Seat 2: x3ultimate folded before Flop (didn't bet)
Seat 3: boxer821 (button) collected ($0.53)
Seat 4: 6ePeMeHHa9 (small blind) folded before Flop
Seat 5: fishhook5 (big blind) folded on the Flop
Seat 6: afca128 folded before Flop (didn't bet)



PokerStars Hand #166667451466:  Hold'em No Limit ($0.05/$0.10 USD) - 2017/02/23 16:01:23 ET
Table 'Eurydome II' 6-max Seat #2 is the button
Seat 2: Elinaattor ($10.34 in chips) 
Seat 3: gaHy_HaXeP ($10 in chips) 
Seat 4: Smitty03300 ($10 in chips) 
Seat 5: kush-killa87 ($13.87 in chips) 
Seat 6: Jucatorul823 ($6.30 in chips) 
gaHy_HaXeP: posts small blind $0.05
Smitty03300: posts big blind $0.10
*** HOLE CARDS ***
kush-killa87: folds 
Jucatorul823: raises $0.20 to $0.30
Elinaattor: folds 
gaHy_HaXeP: folds 
Smitty03300: folds 
Uncalled bet ($0.20) returned to Jucatorul823
Jucatorul823 collected $0.25 from pot
*** SUMMARY ***
Total pot $0.25 | Rake $0 
Seat 2: Elinaattor (button) folded before Flop (didn't bet)
Seat 3: gaHy_HaXeP (small blind) folded before Flop
Seat 4: Smitty03300 (big blind) folded before Flop
Seat 5: kush-killa87 folded before Flop (didn't bet)
Seat 6: Jucatorul823 collected ($0.25)



PokerStars Hand #166667451516:  Hold'em No Limit ($0.05/$0.10 USD) - 2017/02/23 16:01:23 ET
Table 'Bootes' 6-max Seat #1 is the button
Seat 1: Namhkal ($13.45 in chips) 
Seat 2: Bird et al ($19.50 in chips) 
Seat 3: KA3AXCTAHEU, ($19.50 in chips) 
Seat 4: totonove ($4.71 in chips) 
Seat 5: Pekaml ($15.19 in chips) 
Seat 6: cherep61987 ($10 in chips) 
Bird et al: posts small blind $0.05
KA3AXCTAHEU,: posts big blind $0.10
*** HOLE CARDS ***
totonove: folds 
Pekaml: folds 
cherep61987: raises $0.15 to $0.25
Namhkal: calls $0.25
Bird et al: folds 
KA3AXCTAHEU,: folds 
*** FLOP *** [Qh Ac 5s]
cherep61987: bets $0.31
Namhkal: folds 
Uncalled bet ($0.31) returned to cherep61987
cherep61987 collected $0.62 from pot
*** SUMMARY ***
Total pot $0.65 | Rake $0.03 
Board [Qh Ac 5s]
Seat 1: Namhkal (button) folded on the Flop
Seat 2: Bird et al (small blind) folded before Flop
Seat 3: KA3AXCTAHEU, (big blind) folded before Flop
Seat 4: totonove folded before Flop (didn't bet)
Seat 5: Pekaml folded before Flop (didn't bet)
Seat 6: cherep61987 collected ($0.62)



PokerStars Hand #166667451591:  Hold'em No Limit ($0.05/$0.10 USD) - 2017/02/23 16:01:23 ET
Table 'Epimetheus' 6-max Seat #1 is the button
Seat 1: 6ePeMeHHa9 ($10.49 in chips) 
Seat 2: patrick19111 ($15.10 in chips) 
Seat 3: dineldidi ($9.67 in chips) 
Seat 5: afca128 ($24.63 in chips) 
Seat 6: voledy ($10 in chips) 
patrick19111: posts small blind $0.05
dineldidi: posts big blind $0.10
*** HOLE CARDS ***
afca128: folds 
voledy: folds 
6ePeMeHHa9: raises $0.14 to $0.24
patrick19111: folds 
dineldidi: folds 
Uncalled bet ($0.14) returned to 6ePeMeHHa9
6ePeMeHHa9 collected $0.25 from pot
*** SUMMARY ***
Total pot $0.25 | Rake $0 
Seat 1: 6ePeMeHHa9 (button) collected ($0.25)
Seat 2: patrick19111 (small blind) folded before Flop
Seat 3: dineldidi (big blind) folded before Flop
Seat 5: afca128 folded before Flop (didn't bet)
Seat 6: voledy folded before Flop (didn't bet)



PokerStars Hand #166667451773:  Hold'em No Limit ($0.05/$0.10 USD) - 2017/02/23 16:01:23 ET
Table 'Ophelia' 6-max Seat #4 is the button
Seat 1: ralfi37 ($11.01 in chips) 
Seat 2: popypaleta ($16.12 in chips) 
Seat 3: mvp0013 ($11.60 in chips) 
Seat 4: Cluckh ($11.65 in chips) 
Seat 5: truck1234 ($14.06 in chips) 
Seat 6: Yabidooo ($10.72 in chips) 
truck1234: posts small blind $0.05
Yabidooo: posts big blind $0.10
*** HOLE CARDS ***
ralfi37: folds 
popypaleta: folds 
mvp0013: folds 
Cluckh: folds 
truck1234: folds 
Uncalled bet ($0.05) returned to Yabidooo
Yabidooo collected $0.10 from pot
*** SUMMARY ***
Total pot $0.10 | Rake $0 
Seat 1: ralfi37 folded before Flop (didn't bet)
Seat 2: popypaleta folded before Flop (didn't bet)
Seat 3: mvp0013 folded before Flop (didn't bet)
Seat 4: Cluckh (button) folded before Flop (didn't bet)
Seat 5: truck1234 (small blind) folded before Flop
Seat 6: Yabidooo (big blind) collected ($0.10)



PokerStars Hand #166667451853:  Hold'em No Limit ($0.05/$0.10 USD) - 2017/02/23 16:01:23 ET
Table 'Glarona' 6-max Seat #2 is the button
Seat 1: LarryTheStar ($10.65 in chips) 
Seat 2: BookWorm78 ($10.02 in chips) 
Seat 3: hoedje72 ($4.11 in chips) 
Seat 4: CrippledGod ($6.87 in chips) 
Seat 5: david_sara83 ($10 in chips) 
Seat 6: Namhkal ($11.08 in chips) 
hoedje72: posts small blind $0.05
CrippledGod: posts big blind $0.10
*** HOLE CARDS ***
david_sara83: folds 
Namhkal: folds 
LarryTheStar: raises $0.20 to $0.30
BookWorm78: folds 
hoedje72: folds 
CrippledGod: folds 
Uncalled bet ($0.20) returned to LarryTheStar
LarryTheStar collected $0.25 from pot
*** SUMMARY ***
Total pot $0.25 | Rake $0 
Seat 1: LarryTheStar collected ($0.25)
Seat 2: BookWorm78 (button) folded before Flop (didn't bet)
Seat 3: hoedje72 (small blind) folded before Flop
Seat 4: CrippledGod (big blind) folded before Flop
Seat 5: david_sara83 folded before Flop (didn't bet)
Seat 6: Namhkal folded before Flop (didn't bet)



PokerStars Hand #166667452123:  Hold'em No Limit ($0.05/$0.10 USD) - 2017/02/23 16:01:23 ET
Table 'Nephthys II' 6-max Seat #6 is the button
Seat 1: DamDatsAnAce ($10.10 in chips) 
Seat 2: AC Evergreen ($10 in chips) 
Seat 3: Newqbrown ($20.44 in chips) 
Seat 4: RkaczoR ($11.50 in chips) 
Seat 5: kingartur222 ($9.01 in chips) 
Seat 6: CHRO8 ($14.49 in chips) 
DamDatsAnAce: posts small blind $0.05
AC Evergreen: posts big blind $0.10
*** HOLE CARDS ***
Newqbrown: folds 
RkaczoR: folds 
kingartur222: folds 
CHRO8: folds 
DamDatsAnAce: folds 
Uncalled bet ($0.05) returned to AC Evergreen
AC Evergreen collected $0.10 from pot
*** SUMMARY ***
Total pot $0.10 | Rake $0 
Seat 1: DamDatsAnAce (small blind) folded before Flop
Seat 2: AC Evergreen (big blind) collected ($0.10)
Seat 3: Newqbrown folded before Flop (didn't bet)
Seat 4: RkaczoR folded before Flop (didn't bet)
Seat 5: kingartur222 folded before Flop (didn't bet)
Seat 6: CHRO8 (button) folded before Flop (didn't bet)



PokerStars Hand #166667452424:  Hold'em No Limit ($0.05/$0.10 USD) - 2017/02/23 16:01:24 ET
Table 'Rotraut' 6-max Seat #5 is the button
Seat 1: Hypermetal ($13.49 in chips) 
Seat 2: Newqbrown ($10.78 in chips) 
Seat 3: FlackoD ($11.90 in chips) 
Seat 4: Darkfrai ($10 in chips) 
Seat 5: Bird et al ($11.75 in chips) 
Seat 6: KokoulinV ($13.04 in chips) 
KokoulinV: posts small blind $0.05
Hypermetal: posts big blind $0.10
*** HOLE CARDS ***
Newqbrown: folds 
FlackoD: raises $0.10 to $0.20
Darkfrai: folds 
Bird et al: folds 
KokoulinV: folds 
Hypermetal: folds 
Uncalled bet ($0.10) returned to FlackoD
FlackoD collected $0.25 from pot
*** SUMMARY ***
Total pot $0.25 | Rake $0 
Seat 1: Hypermetal (big blind) folded before Flop
Seat 2: Newqbrown folded before Flop (didn't bet)
Seat 3: FlackoD collected ($0.25)
Seat 4: Darkfrai folded before Flop (didn't bet)
Seat 5: Bird et al (button) folded before Flop (didn't bet)
Seat 6: KokoulinV (small blind) folded before Flop



PokerStars Hand #166667452598:  Hold'em No Limit ($0.05/$0.10 USD) - 2017/02/23 16:01:24 ET
Table 'Krethon' 6-max Seat #2 is the button
Seat 2: manashov ($10.48 in chips) 
Seat 3: Kow6oy ($14.91 in chips) 
Seat 4: chimera252 ($15.68 in chips) 
Seat 5: popypaleta ($10.55 in chips) 
Seat 6: fabadam ($18.98 in chips) 
Kow6oy: posts small blind $0.05
chimera252: posts big blind $0.10
*** HOLE CARDS ***
popypaleta: folds 
fabadam: folds 
manashov: folds 
Leda477 leaves the table
Kow6oy: folds 
Uncalled bet ($0.05) returned to chimera252
chimera252 collected $0.10 from pot
*** SUMMARY ***
Total pot $0.10 | Rake $0 
Seat 2: manashov (button) folded before Flop (didn't bet)
Seat 3: Kow6oy (small blind) folded before Flop
Seat 4: chimera252 (big blind) collected ($0.10)
Seat 5: popypaleta folded before Flop (didn't bet)
Seat 6: fabadam folded before Flop (didn't bet)



PokerStars Hand #166667452931:  Hold'em No Limit ($0.05/$0.10 USD) - 2017/02/23 16:01:24 ET
Table 'Apollonia' 6-max Seat #4 is the button
Seat 1: ex3Lero86 ($10.26 in chips) 
Seat 2: ibara000 ($18.84 in chips) 
Seat 3: derbesteojr ($9.20 in chips) 
Seat 4: Goroshkos88 ($17.46 in chips) 
Seat 5: EphemeralBen ($13.79 in chips) 
Seat 6: Namhkal ($10 in chips) 
EphemeralBen: posts small blind $0.05
Namhkal: posts big blind $0.10
*** HOLE CARDS ***
ex3Lero86: folds 
ibara000: folds 
derbesteojr: folds 
Goroshkos88: folds 
EphemeralBen: raises $0.20 to $0.30
Namhkal: raises $0.60 to $0.90
EphemeralBen: folds 
Uncalled bet ($0.60) returned to Namhkal
Namhkal collected $0.60 from pot
*** SUMMARY ***
Total pot $0.60 | Rake $0 
Seat 1: ex3Lero86 folded before Flop (didn't bet)
Seat 2: ibara000 folded before Flop (didn't bet)
Seat 3: derbesteojr folded before Flop (didn't bet)
Seat 4: Goroshkos88 (button) folded before Flop (didn't bet)
Seat 5: EphemeralBen (small blind) folded before Flop
Seat 6: Namhkal (big blind) collected ($0.60)



PokerStars Hand #166667453007:  Hold'em No Limit ($0.05/$0.10 USD) - 2017/02/23 16:01:25 ET
Table 'Union' 6-max Seat #5 is the button
Seat 1: Krumi1703 ($6.42 in chips) 
Seat 2: Zooplack ($10 in chips) 
Seat 3: Rodik002 ($12.16 in chips) 
Seat 4: Croplayer1 ($14.31 in chips) 
Seat 5: Chodemuncher ($10 in chips) 
Seat 6: bonyo71 ($3.90 in chips) 
bonyo71: posts small blind $0.05
Krumi1703: posts big blind $0.10
*** HOLE CARDS ***
Zooplack: folds 
Rodik002: folds 
Croplayer1: folds 
Chodemuncher: folds 
bonyo71: folds 
Uncalled bet ($0.05) returned to Krumi1703
Krumi1703 collected $0.10 from pot
*** SUMMARY ***
Total pot $0.10 | Rake $0 
Seat 1: Krumi1703 (big blind) collected ($0.10)
Seat 2: Zooplack folded before Flop (didn't bet)
Seat 3: Rodik002 folded before Flop (didn't bet)
Seat 4: Croplayer1 folded before Flop (didn't bet)
Seat 5: Chodemuncher (button) folded before Flop (didn't bet)
Seat 6: bonyo71 (small blind) folded before Flop



PokerStars Hand #166667453098:  Hold'em No Limit ($0.05/$0.10 USD) - 2017/02/23 16:01:25 ET
Table 'Tomita II' 6-max Seat #3 is the button
Seat 1: HARDCORE66RU ($22.78 in chips) 
Seat 2: mhonielsen ($10 in chips) 
Seat 3: Lucky HoBBiT ($12.01 in chips) 
Seat 4: Hyd SK ($10 in chips) 
Seat 6: Punzzzer ($12.36 in chips) 
Hyd SK: posts small blind $0.05
Punzzzer: posts big blind $0.10
*** HOLE CARDS ***
HARDCORE66RU: folds 
mhonielsen: folds 
Lucky HoBBiT: raises $0.15 to $0.25
Hyd SK: folds 
Punzzzer: folds 
Uncalled bet ($0.15) returned to Lucky HoBBiT
Lucky HoBBiT collected $0.25 from pot
*** SUMMARY ***
Total pot $0.25 | Rake $0 
Seat 1: HARDCORE66RU folded before Flop (didn't bet)
Seat 2: mhonielsen folded before Flop (didn't bet)
Seat 3: Lucky HoBBiT (button) collected ($0.25)
Seat 4: Hyd SK (small blind) folded before Flop
Seat 6: Punzzzer (big blind) folded before Flop



PokerStars Hand #166667453130:  Hold'em No Limit ($0.05/$0.10 USD) - 2017/02/23 16:01:25 ET
Table 'Tomyris II' 6-max Seat #3 is the button
Seat 1: ArcticBearDK ($22.13 in chips) 
Seat 3: robertsabb ($11.37 in chips) 
Seat 4: Dcaro31 ($10 in chips) 
Seat 5: joewatson90 ($12.05 in chips) 
Seat 6: StackSmakka ($12.37 in chips) 
Dcaro31: posts small blind $0.05
joewatson90: posts big blind $0.10
Yspenyanin: sits out 
*** HOLE CARDS ***
StackSmakka: folds 
ArcticBearDK: folds 
robertsabb: folds 
Dcaro31: folds 
Uncalled bet ($0.05) returned to joewatson90
joewatson90 collected $0.10 from pot
*** SUMMARY ***
Total pot $0.10 | Rake $0 
Seat 1: ArcticBearDK folded before Flop (didn't bet)
Seat 3: robertsabb (button) folded before Flop (didn't bet)
Seat 4: Dcaro31 (small blind) folded before Flop
Seat 5: joewatson90 (big blind) collected ($0.10)
Seat 6: StackSmakka folded before Flop (didn't bet)



PokerStars Hand #166667453161:  Hold'em No Limit ($0.05/$0.10 USD) - 2017/02/23 16:01:25 ET
Table 'Antinous' 6-max Seat #2 is the button
Seat 1: Andrei ProFF ($16.34 in chips) 
Seat 2: Nr847 ($10.61 in chips) 
Seat 3: dittoro ($10 in chips) 
Seat 4: Pekaml ($15.54 in chips) 
Seat 5: Covetsoles ($6.34 in chips) 
dittoro: posts small blind $0.05
Pekaml: posts big blind $0.10
coolisses111: sits out 
*** HOLE CARDS ***
Covetsoles: calls $0.10
Andrei ProFF: raises $0.30 to $0.40
Nr847: folds 
dittoro: folds 
Pekaml: folds 
Covetsoles: calls $0.30
*** FLOP *** [Kd 2h 3h]
Covetsoles: checks 
Andrei ProFF: checks 
*** TURN *** [Kd 2h 3h] [Td]
Covetsoles: bets $0.10
Andrei ProFF: folds 
Uncalled bet ($0.10) returned to Covetsoles
Covetsoles collected $0.91 from pot
*** SUMMARY ***
Total pot $0.95 | Rake $0.04 
Board [Kd 2h 3h Td]
Seat 1: Andrei ProFF folded on the Turn
Seat 2: Nr847 (button) folded before Flop (didn't bet)
Seat 3: dittoro (small blind) folded before Flop
Seat 4: Pekaml (big blind) folded before Flop
Seat 5: Covetsoles collected ($0.91)



PokerStars Hand #166667453247:  Hold'em No Limit ($0.05/$0.10 USD) - 2017/02/23 16:01:25 ET
Table 'Alzirr II' 6-max Seat #4 is the button
Seat 1: KA3AXCTAHEU, ($10.91 in chips) 
Seat 2: popypaleta ($10 in chips) 
Seat 3: Lucky HoBBiT ($10.53 in chips) 
Seat 4: Scanner17 ($18.89 in chips) 
KA3AXCTAHEU,: posts small blind $0.05
popypaleta: posts big blind $0.10
*** HOLE CARDS ***
Lucky HoBBiT: raises $0.20 to $0.30
Scanner17: calls $0.30
KA3AXCTAHEU,: folds 
yodzik joins the table at seat #5 
popypaleta: raises $0.90 to $1.20
JahSoldier69 joins the table at seat #6 
JahSoldier69 leaves the table
Lucky HoBBiT: calls $0.90
Scanner17: calls $0.90
*** FLOP *** [Ts 8c 9d]
popypaleta: bets $1.75
Lucky HoBBiT: calls $1.75
AM-L-SL joins the table at seat #6 
Scanner17: folds 
*** TURN *** [Ts 8c 9d] [4s]
popypaleta: checks 
Lucky HoBBiT: bets $2.30
popypaleta: folds 
Uncalled bet ($2.30) returned to Lucky HoBBiT
Lucky HoBBiT collected $6.83 from pot
*** SUMMARY ***
Total pot $7.15 | Rake $0.32 
Board [Ts 8c 9d 4s]
Seat 1: KA3AXCTAHEU, (small blind) folded before Flop
Seat 2: popypaleta (big blind) folded on the Turn
Seat 3: Lucky HoBBiT collected ($6.83)
Seat 4: Scanner17 (button) folded on the Flop



PokerStars Hand #166667453276:  Hold'em No Limit ($0.05/$0.10 USD) - 2017/02/23 16:01:25 ET
Table 'Rostia' 6-max Seat #6 is the button
Seat 1: paxit71 ($8.05 in chips) 
Seat 2: david_sara83 ($19.41 in chips) 
Seat 3: ImpAV ($10 in chips) 
Seat 4: Hyd SK ($11.68 in chips) 
Seat 5: Buddy8711 ($15.77 in chips) 
Seat 6: Giyorod ($10.85 in chips) 
paxit71: posts small blind $0.05
david_sara83: posts big blind $0.10
*** HOLE CARDS ***
ImpAV: raises $0.20 to $0.30
Hyd SK: folds 
Buddy8711: folds 
Giyorod: folds 
paxit71: folds 
david_sara83: folds 
Uncalled bet ($0.20) returned to ImpAV
ImpAV collected $0.25 from pot
*** SUMMARY ***
Total pot $0.25 | Rake $0 
Seat 1: paxit71 (small blind) folded before Flop
Seat 2: david_sara83 (big blind) folded before Flop
Seat 3: ImpAV collected ($0.25)
Seat 4: Hyd SK folded before Flop (didn't bet)
Seat 5: Buddy8711 folded before Flop (didn't bet)
Seat 6: Giyorod (button) folded before Flop (didn't bet)



PokerStars Hand #166667453351:  Hold'em No Limit ($0.05/$0.10 USD) - 2017/02/23 16:01:25 ET
Table 'Virginia II' 6-max Seat #4 is the button
Seat 1: Iarlei ($11.86 in chips) 
Seat 3: garigura ($14.71 in chips) 
Seat 4: onkelottoHH ($11.33 in chips) 
Seat 5: dr.goofy ($20.31 in chips) 
Seat 6: ab260414 ($10.15 in chips) 
dr.goofy: posts small blind $0.05
ab260414: posts big blind $0.10
Yspenyanin: sits out 
*** HOLE CARDS ***
Iarlei: raises $0.20 to $0.30
garigura: folds 
onkelottoHH: folds 
dr.goofy: folds 
ab260414: raises $0.60 to $0.90
Iarlei: folds 
Uncalled bet ($0.60) returned to ab260414
ab260414 collected $0.65 from pot
*** SUMMARY ***
Total pot $0.65 | Rake $0 
Seat 1: Iarlei folded before Flop
Seat 3: garigura folded before Flop (didn't bet)
Seat 4: onkelottoHH (button) folded before Flop (didn't bet)
Seat 5: dr.goofy (small blind) folded before Flop
Seat 6: ab260414 (big blind) collected ($0.65)



PokerStars Hand #166667453489:  Hold'em No Limit ($0.05/$0.10 USD) - 2017/02/23 16:01:25 ET
Table 'Ruvuma' 6-max Seat #3 is the button
Seat 1: FRAID358 ($10.25 in chips) 
Seat 2: Fab_1512 ($13.08 in chips) 
Seat 3: Spud014 ($11.26 in chips) 
Seat 4: DamDatsAnAce ($10.05 in chips) 
Seat 5: sexy_seagull ($10.15 in chips) 
Seat 6: Elinaattor ($9.60 in chips) 
DamDatsAnAce: posts small blind $0.05
sexy_seagull: posts big blind $0.10
*** HOLE CARDS ***
Elinaattor: folds 
FRAID358: folds 
Fab_1512: folds 
Spud014: folds 
DamDatsAnAce: raises $0.20 to $0.30
sexy_seagull: folds 
Uncalled bet ($0.20) returned to DamDatsAnAce
DamDatsAnAce collected $0.20 from pot
*** SUMMARY ***
Total pot $0.20 | Rake $0 
Seat 1: FRAID358 folded before Flop (didn't bet)
Seat 2: Fab_1512 folded before Flop (didn't bet)
Seat 3: Spud014 (button) folded before Flop (didn't bet)
Seat 4: DamDatsAnAce (small blind) collected ($0.20)
Seat 5: sexy_seagull (big blind) folded before Flop
Seat 6: Elinaattor folded before Flop (didn't bet)



PokerStars Hand #166667453621:  Hold'em No Limit ($0.05/$0.10 USD) - 2017/02/23 16:01:25 ET
Table 'Repsolda' 6-max Seat #1 is the button
Seat 1: fabadam ($10 in chips) 
Seat 2: MBen10 ($26.11 in chips) 
Seat 3: manashov ($12.47 in chips) 
Seat 4: jamalungma ($10 in chips) 
Seat 5: danky24 ($7.45 in chips) 
Seat 6: RkaczoR ($10.10 in chips) 
MBen10: posts small blind $0.05
manashov: posts big blind $0.10
*** HOLE CARDS ***
jamalungma: folds 
danky24: calls $0.10
RkaczoR: raises $0.30 to $0.40
fabadam: raises $0.90 to $1.30
MBen10: folds 
manashov: folds 
danky24: folds 
RkaczoR: folds 
Uncalled bet ($0.90) returned to fabadam
fabadam collected $1.05 from pot
*** SUMMARY ***
Total pot $1.05 | Rake $0 
Seat 1: fabadam (button) collected ($1.05)
Seat 2: MBen10 (small blind) folded before Flop
Seat 3: manashov (big blind) folded before Flop
Seat 4: jamalungma folded before Flop (didn't bet)
Seat 5: danky24 folded before Flop
Seat 6: RkaczoR folded before Flop



PokerStars Hand #166667453685:  Hold'em No Limit ($0.05/$0.10 USD) - 2017/02/23 16:01:25 ET
Table 'Cyane' 6-max Seat #6 is the button
Seat 1: KA3AXCTAHEU, ($10.37 in chips) 
Seat 2: Temniy Elf ($10.15 in chips) 
Seat 3: Mamm0nism ($14.09 in chips) 
Seat 4: truck1234 ($21.11 in chips) 
Seat 5: ChuikaPridi ($10.17 in chips) 
Seat 6: 8th wonders ($10 in chips) 
KA3AXCTAHEU,: posts small blind $0.05
Temniy Elf: posts big blind $0.10
*** HOLE CARDS ***
Mamm0nism: folds 
truck1234: folds 
ChuikaPridi: folds 
8th wonders: raises $0.20 to $0.30
KA3AXCTAHEU,: folds 
Temniy Elf: folds 
Uncalled bet ($0.20) returned to 8th wonders
8th wonders collected $0.25 from pot
*** SUMMARY ***
Total pot $0.25 | Rake $0 
Seat 1: KA3AXCTAHEU, (small blind) folded before Flop
Seat 2: Temniy Elf (big blind) folded before Flop
Seat 3: Mamm0nism folded before Flop (didn't bet)
Seat 4: truck1234 folded before Flop (didn't bet)
Seat 5: ChuikaPridi folded before Flop (didn't bet)
Seat 6: 8th wonders (button) collected ($0.25)



PokerStars Hand #166667453942:  Hold'em No Limit ($0.05/$0.10 USD) - 2017/02/23 16:01:26 ET
Table 'Vaisala' 6-max Seat #1 is the button
Seat 1: Pekaml ($10 in chips) 
Seat 2: XaXaTyH4uK ($10 in chips) 
Seat 3: x3ultimate ($10 in chips) 
Seat 4: sexy_seagull ($11.26 in chips) 
Seat 6: Aleksey K228 ($15.73 in chips) 
XaXaTyH4uK: posts small blind $0.05
x3ultimate: posts big blind $0.10
AIONCMA1988: sits out 
*** HOLE CARDS ***
sexy_seagull: folds 
Aleksey K228: folds 
Pekaml: folds 
XaXaTyH4uK: raises $0.20 to $0.30
x3ultimate: folds 
Uncalled bet ($0.20) returned to XaXaTyH4uK
XaXaTyH4uK collected $0.20 from pot
*** SUMMARY ***
Total pot $0.20 | Rake $0 
Seat 1: Pekaml (button) folded before Flop (didn't bet)
Seat 2: XaXaTyH4uK (small blind) collected ($0.20)
Seat 3: x3ultimate (big blind) folded before Flop
Seat 4: sexy_seagull folded before Flop (didn't bet)
Seat 6: Aleksey K228 folded before Flop (didn't bet)



PokerStars Hand #166667454195:  Hold'em No Limit ($0.05/$0.10 USD) - 2017/02/23 16:01:26 ET
Table 'Kanda' 6-max Seat #3 is the button
Seat 1: Andy Wolf ($10.24 in chips) 
Seat 2: Pelotín ($5.30 in chips) 
Seat 3: joewatson90 ($12.44 in chips) 
Seat 4: Orlangoor ($10.76 in chips) 
Seat 5: Temniy Elf ($10.15 in chips) 
Seat 6: oddshoff ($8.96 in chips) 
Orlangoor: posts small blind $0.05
Temniy Elf: posts big blind $0.10
*** HOLE CARDS ***
oddshoff: folds 
Andy Wolf: raises $0.20 to $0.30
Pelotín: folds 
joewatson90: folds 
Orlangoor: folds 
Temniy Elf: calls $0.20
*** FLOP *** [Jd 3h Ah]
Temniy Elf: checks 
Andy Wolf: checks 
*** TURN *** [Jd 3h Ah] [5c]
Temniy Elf: checks 
Andy Wolf: bets $0.30
Temniy Elf: folds 
Uncalled bet ($0.30) returned to Andy Wolf
Andy Wolf collected $0.62 from pot
*** SUMMARY ***
Total pot $0.65 | Rake $0.03 
Board [Jd 3h Ah 5c]
Seat 1: Andy Wolf collected ($0.62)
Seat 2: Pelotín folded before Flop (didn't bet)
Seat 3: joewatson90 (button) folded before Flop (didn't bet)
Seat 4: Orlangoor (small blind) folded before Flop
Seat 5: Temniy Elf (big blind) folded on the Turn
Seat 6: oddshoff folded before Flop (didn't bet)



PokerStars Hand #166667454244:  Hold'em No Limit ($0.05/$0.10 USD) - 2017/02/23 16:01:26 ET
Table 'Iapetus III' 6-max Seat #4 is the button
Seat 2: Pekaml ($10.15 in chips) 
Seat 3: takis nik ($10 in chips) 
Seat 4: XaXaTyH4uK ($10.30 in chips) 
Seat 5: homelessdan ($14.11 in chips) 
Seat 6: yodzik ($5 in chips) 
homelessdan: posts small blind $0.05
yodzik: posts big blind $0.10
Czezar Life: sits out 
*** HOLE CARDS ***
Pekaml: folds 
takis nik: folds 
XaXaTyH4uK: folds 
homelessdan: raises $0.10 to $0.20
yodzik: raises $0.70 to $0.90
homelessdan: folds 
Uncalled bet ($0.70) returned to yodzik
yodzik collected $0.40 from pot
*** SUMMARY ***
Total pot $0.40 | Rake $0 
Seat 2: Pekaml folded before Flop (didn't bet)
Seat 3: takis nik folded before Flop (didn't bet)
Seat 4: XaXaTyH4uK (button) folded before Flop (didn't bet)
Seat 5: homelessdan (small blind) folded before Flop
Seat 6: yodzik (big blind) collected ($0.40)



PokerStars Hand #166667454553:  Hold'em No Limit ($0.05/$0.10 USD) - 2017/02/23 16:01:26 ET
Table 'Kochera' 6-max Seat #6 is the button
Seat 1: chimera252 ($11.55 in chips) 
Seat 2: bartabs2 ($10.76 in chips) 
Seat 3: KA3AXCTAHEU, ($10 in chips) 
Seat 4: johkom ($5.46 in chips) 
Seat 5: univibe68 ($12 in chips) 
Seat 6: oddshoff ($9.33 in chips) 
chimera252: posts small blind $0.05
bartabs2: posts big blind $0.10
*** HOLE CARDS ***
KA3AXCTAHEU,: folds 
johkom: raises $0.20 to $0.30
univibe68: folds 
oddshoff: folds 
chimera252: folds 
bartabs2: folds 
Uncalled bet ($0.20) returned to johkom
johkom collected $0.25 from pot
*** SUMMARY ***
Total pot $0.25 | Rake $0 
Seat 1: chimera252 (small blind) folded before Flop
Seat 2: bartabs2 (big blind) folded before Flop
Seat 3: KA3AXCTAHEU, folded before Flop (didn't bet)
Seat 4: johkom collected ($0.25)
Seat 5: univibe68 folded before Flop (didn't bet)
Seat 6: oddshoff (button) folded before Flop (didn't bet)



PokerStars Hand #166667454582:  Hold'em No Limit ($0.05/$0.10 USD) - 2017/02/23 16:01:26 ET
Table 'Stroobantia II' 6-max Seat #3 is the button
Seat 1: XBrosh ($8.18 in chips) 
Seat 2: IAntikI ($10 in chips) 
Seat 3: 8th wonders ($10.88 in chips) 
Seat 4: Xander188 ($10.91 in chips) 
Seat 5: Zooplack ($12.48 in chips) 
Seat 6: CHRO8 ($11.52 in chips) 
Xander188: posts small blind $0.05
Zooplack: posts big blind $0.10
*** HOLE CARDS ***
CHRO8: raises $0.20 to $0.30
XBrosh: calls $0.30
IAntikI: folds 
8th wonders: folds 
Xander188: raises $0.90 to $1.20
Zooplack: folds 
CHRO8: raises $1.70 to $2.90
XBrosh: folds 
Xander188: folds 
Uncalled bet ($1.70) returned to CHRO8
CHRO8 collected $2.80 from pot
*** SUMMARY ***
Total pot $2.80 | Rake $0 
Seat 1: XBrosh folded before Flop
Seat 2: IAntikI folded before Flop (didn't bet)
Seat 3: 8th wonders (button) folded before Flop (didn't bet)
Seat 4: Xander188 (small blind) folded before Flop
Seat 5: Zooplack (big blind) folded before Flop
Seat 6: CHRO8 collected ($2.80)



PokerStars Hand #166667454750:  Hold'em No Limit ($0.05/$0.10 USD) - 2017/02/23 16:01:27 ET
Table 'Arpola' 6-max Seat #6 is the button
Seat 1: dincimus ($10.05 in chips) 
Seat 2: patrick19111 ($10.28 in chips) 
Seat 3: simaryk ($2.48 in chips) 
Seat 4: Orlangoor ($19.20 in chips) 
Seat 5: truck1234 ($11.79 in chips) 
Seat 6: Andrei ProFF ($10 in chips) 
dincimus: posts small blind $0.05
patrick19111: posts big blind $0.10
*** HOLE CARDS ***
simaryk: calls $0.10
Orlangoor: folds 
truck1234: raises $0.30 to $0.40
Andrei ProFF: folds 
dincimus: folds 
patrick19111: folds 
simaryk: calls $0.30
*** FLOP *** [9d 5h Th]
simaryk: bets $2.08 and is all-in
truck1234: folds 
Uncalled bet ($2.08) returned to simaryk
simaryk collected $0.91 from pot
*** SUMMARY ***
Total pot $0.95 | Rake $0.04 
Board [9d 5h Th]
Seat 1: dincimus (small blind) folded before Flop
Seat 2: patrick19111 (big blind) folded before Flop
Seat 3: simaryk collected ($0.91)
Seat 4: Orlangoor folded before Flop (didn't bet)
Seat 5: truck1234 folded on the Flop
Seat 6: Andrei ProFF (button) folded before Flop (didn't bet)



PokerStars Hand #166667454843:  Hold'em No Limit ($0.05/$0.10 USD) - 2017/02/23 16:01:27 ET
Table 'Xanthippe II' 6-max Seat #1 is the button
Seat 1: ade22345 ($4.48 in chips) 
Seat 2: Bird et al ($13.56 in chips) 
Seat 3: Dcaro31 ($10 in chips) 
Seat 4: Barcardi14 ($10 in chips) 
Seat 6: Orlangoor ($11.04 in chips) 
Bird et al: posts small blind $0.05
Dcaro31: posts big blind $0.10
Barcardi14: posts big blind $0.10
yodzik: sits out 
*** HOLE CARDS ***
Barcardi14: raises $9.90 to $10 and is all-in
Orlangoor: folds 
ade22345: folds 
Bird et al: folds 
Dcaro31: folds 
Uncalled bet ($9.90) returned to Barcardi14
Barcardi14 collected $0.25 from pot
*** SUMMARY ***
Total pot $0.25 | Rake $0 
Seat 1: ade22345 (button) folded before Flop (didn't bet)
Seat 2: Bird et al (small blind) folded before Flop
Seat 3: Dcaro31 (big blind) folded before Flop
Seat 4: Barcardi14 collected ($0.25)
Seat 6: Orlangoor folded before Flop (didn't bet)



PokerStars Hand #166667454862:  Hold'em No Limit ($0.05/$0.10 USD) - 2017/02/23 16:01:27 ET
Table 'Isberga' 6-max Seat #6 is the button
Seat 1: Feverhead ($17.32 in chips) 
Seat 2: GESPERIA ($10 in chips) 
Seat 3: HARDCORE66RU ($11.13 in chips) 
Seat 4: THIMUCHIN ($11.19 in chips) 
Seat 5: YoungGriff86 ($18.33 in chips) 
Seat 6: Goroshkos88 ($21.50 in chips) 
Feverhead: posts small blind $0.05
GESPERIA: posts big blind $0.10
*** HOLE CARDS ***
HARDCORE66RU: folds 
THIMUCHIN: folds 
YoungGriff86: folds 
Goroshkos88: raises $0.15 to $0.25
Feverhead: folds 
GESPERIA: folds 
Uncalled bet ($0.15) returned to Goroshkos88
Goroshkos88 collected $0.25 from pot
*** SUMMARY ***
Total pot $0.25 | Rake $0 
Seat 1: Feverhead (small blind) folded before Flop
Seat 2: GESPERIA (big blind) folded before Flop
Seat 3: HARDCORE66RU folded before Flop (didn't bet)
Seat 4: THIMUCHIN folded before Flop (didn't bet)
Seat 5: YoungGriff86 folded before Flop (didn't bet)
Seat 6: Goroshkos88 (button) collected ($0.25)



PokerStars Hand #166667455287:  Hold'em No Limit ($0.05/$0.10 USD) - 2017/02/23 16:01:27 ET
Table 'Duhr II' 6-max Seat #6 is the button
Seat 1: Lucky HoBBiT ($10 in chips) 
Seat 2: Feverhead ($37.76 in chips) 
Seat 3: Innerwuss ($12.06 in chips) 
Seat 4: CHRO8 ($14.61 in chips) 
Seat 5: Punzzzer ($12.11 in chips) 
Seat 6: townerz1991 ($10 in chips) 
Lucky HoBBiT: posts small blind $0.05
Feverhead: posts big blind $0.10
*** HOLE CARDS ***
Innerwuss: raises $0.20 to $0.30
CHRO8: raises $0.75 to $1.05
Punzzzer: folds 
townerz1991: folds 
Lucky HoBBiT: folds 
Feverhead: folds 
Innerwuss: raises $1.95 to $3
CHRO8: calls $1.95
*** FLOP *** [Qc 8d Ad]
Innerwuss: checks 
CHRO8: checks 
*** TURN *** [Qc 8d Ad] [9c]
Innerwuss: checks 
CHRO8: checks 
*** RIVER *** [Qc 8d Ad 9c] [6c]
Innerwuss: checks 
CHRO8: bets $11.61 and is all-in
Innerwuss: calls $9.06 and is all-in
Uncalled bet ($2.55) returned to CHRO8
*** SHOW DOWN ***
CHRO8: shows [Jh Jc] (a pair of Jacks)
Innerwuss: shows [Tc Ac] (a flush, Ace high)
Innerwuss collected $23.18 from pot
*** SUMMARY ***
Total pot $24.27 | Rake $1.09 
Board [Qc 8d Ad 9c 6c]
Seat 1: Lucky HoBBiT (small blind) folded before Flop
Seat 2: Feverhead (big blind) folded before Flop
Seat 3: Innerwuss showed [Tc Ac] and won ($23.18) with a flush, Ace high
Seat 4: CHRO8 showed [Jh Jc] and lost with a pair of Jacks
Seat 5: Punzzzer folded before Flop (didn't bet)
Seat 6: townerz1991 (button) folded before Flop (didn't bet)



PokerStars Hand #166667455841:  Hold'em No Limit ($0.05/$0.10 USD) - 2017/02/23 16:01:28 ET
Table 'Wesselink II' 6-max Seat #4 is the button
Seat 1: vladcol ($6.44 in chips) 
Seat 2: jamalungma ($11.26 in chips) 
Seat 3: Wargolandros ($9.07 in chips) 
Seat 4: BahiaMinhaP ($10 in chips) 
Seat 5: xdjango07x ($18.43 in chips) 
Seat 6: bambolejro ($10 in chips) 
xdjango07x: posts small blind $0.05
bambolejro: posts big blind $0.10
*** HOLE CARDS ***
vladcol: calls $0.10
jamalungma: folds 
Wargolandros: folds 
BahiaMinhaP: raises $0.20 to $0.30
xdjango07x: folds 
bambolejro: folds 
vladcol: calls $0.20
*** FLOP *** [Jd 9s 3c]
vladcol: checks 
BahiaMinhaP: checks 
*** TURN *** [Jd 9s 3c] [Ac]
vladcol: bets $0.20
BahiaMinhaP: calls $0.20
*** RIVER *** [Jd 9s 3c Ac] [Kh]
vladcol: bets $0.20
BahiaMinhaP: calls $0.20
*** SHOW DOWN ***
vladcol: shows [8h Jh] (a pair of Jacks)
BahiaMinhaP: shows [As 7c] (a pair of Aces)
BahiaMinhaP collected $1.48 from pot
*** SUMMARY ***
Total pot $1.55 | Rake $0.07 
Board [Jd 9s 3c Ac Kh]
Seat 1: vladcol showed [8h Jh] and lost with a pair of Jacks
Seat 2: jamalungma folded before Flop (didn't bet)
Seat 3: Wargolandros folded before Flop (didn't bet)
Seat 4: BahiaMinhaP (button) showed [As 7c] and won ($1.48) with a pair of Aces
Seat 5: xdjango07x (small blind) folded before Flop
Seat 6: bambolejro (big blind) folded before Flop



PokerStars Hand #166667455929:  Hold'em No Limit ($0.05/$0.10 USD) - 2017/02/23 16:01:28 ET
Table 'Fechtig III' 6-max Seat #3 is the button
Seat 1: Scanner17 ($10 in chips) 
Seat 2: GV82 ($15.81 in chips) 
Seat 3: eniksenik ($10 in chips) 
Seat 4: kickereens ($11.28 in chips) 
Seat 5: ksandr_hom ($10 in chips) 
Seat 6: Glatzemandse ($20.20 in chips) 
kickereens: posts small blind $0.05
ksandr_hom: posts big blind $0.10
*** HOLE CARDS ***
Glatzemandse: folds 
Scanner17: folds 
GV82: raises $0.10 to $0.20
eniksenik: folds 
kickereens: folds 
ksandr_hom: folds 
Uncalled bet ($0.10) returned to GV82
GV82 collected $0.25 from pot
*** SUMMARY ***
Total pot $0.25 | Rake $0 
Seat 1: Scanner17 folded before Flop (didn't bet)
Seat 2: GV82 collected ($0.25)
Seat 3: eniksenik (button) folded before Flop (didn't bet)
Seat 4: kickereens (small blind) folded before Flop
Seat 5: ksandr_hom (big blind) folded before Flop
Seat 6: Glatzemandse folded before Flop (didn't bet)



PokerStars Hand #166667456154:  Hold'em No Limit ($0.05/$0.10 USD) - 2017/02/23 16:01:28 ET
Table 'Thia' 6-max Seat #2 is the button
Seat 1: Eddys Edge ($10.18 in chips) 
Seat 2: sugrob86 ($20.67 in chips) 
Seat 3: northug18 ($7.61 in chips) 
Seat 4: Bandyaev ($10 in chips) 
Seat 5: ab260414 ($10.72 in chips) 
Seat 6: ex3Lero86 ($15.21 in chips) 
northug18: posts small blind $0.05
Bandyaev: posts big blind $0.10
*** HOLE CARDS ***
ab260414: folds 
ex3Lero86: raises $0.17 to $0.27
Eddys Edge: folds 
sugrob86: calls $0.27
northug18: folds 
Bandyaev: folds 
*** FLOP *** [6s 3h 8d]
ex3Lero86: checks 
sugrob86: checks 
*** TURN *** [6s 3h 8d] [Ah]
ex3Lero86: bets $0.44
sugrob86: folds 
Uncalled bet ($0.44) returned to ex3Lero86
ex3Lero86 collected $0.66 from pot
*** SUMMARY ***
Total pot $0.69 | Rake $0.03 
Board [6s 3h 8d Ah]
Seat 1: Eddys Edge folded before Flop (didn't bet)
Seat 2: sugrob86 (button) folded on the Turn
Seat 3: northug18 (small blind) folded before Flop
Seat 4: Bandyaev (big blind) folded before Flop
Seat 5: ab260414 folded before Flop (didn't bet)
Seat 6: ex3Lero86 collected ($0.66)



PokerStars Hand #166667456411:  Hold'em No Limit ($0.05/$0.10 USD) - 2017/02/23 16:01:29 ET
Table 'Clavel' 6-max Seat #6 is the button
Seat 1: KRZuff ($14.63 in chips) 
Seat 2: RoJ1 ($12.37 in chips) 
Seat 3: Darkfrai ($10.17 in chips) 
Seat 4: Dcaro31 ($11.96 in chips) 
Seat 5: Vrinni ($10.54 in chips) 
Seat 6: Gra_anD77 ($3.86 in chips) 
KRZuff: posts small blind $0.05
RoJ1: posts big blind $0.10
*** HOLE CARDS ***
Darkfrai: folds 
Dcaro31: folds 
Vrinni: folds 
Gra_anD77: folds 
KRZuff: raises $0.20 to $0.30
RoJ1: folds 
Uncalled bet ($0.20) returned to KRZuff
KRZuff collected $0.20 from pot
*** SUMMARY ***
Total pot $0.20 | Rake $0 
Seat 1: KRZuff (small blind) collected ($0.20)
Seat 2: RoJ1 (big blind) folded before Flop
Seat 3: Darkfrai folded before Flop (didn't bet)
Seat 4: Dcaro31 folded before Flop (didn't bet)
Seat 5: Vrinni folded before Flop (didn't bet)
Seat 6: Gra_anD77 (button) folded before Flop (didn't bet)



PokerStars Hand #166667456433:  Hold'em No Limit ($0.05/$0.10 USD) - 2017/02/23 16:01:29 ET
Table 'Aegle' 6-max Seat #6 is the button
Seat 2: yodzik ($5.05 in chips) 
Seat 3: DrejAtom ($10 in chips) 
Seat 4: ab260414 ($11.32 in chips) 
Seat 5: KokoulinV ($11.13 in chips) 
Seat 6: CHRO8 ($20.59 in chips) 
yodzik: posts small blind $0.05
DrejAtom: posts big blind $0.10
*** HOLE CARDS ***
ab260414: folds 
KokoulinV: folds 
CHRO8: folds 
phatts76 joins the table at seat #1 
yodzik: raises $0.20 to $0.30
DrejAtom: calls $0.20
*** FLOP *** [5d Ah 4s]
yodzik: bets $0.43
DrejAtom: calls $0.43
*** TURN *** [5d Ah 4s] [Kc]
yodzik: checks 
DrejAtom: bets $0.70
yodzik: folds 
Uncalled bet ($0.70) returned to DrejAtom
DrejAtom collected $1.39 from pot
*** SUMMARY ***
Total pot $1.46 | Rake $0.07 
Board [5d Ah 4s Kc]
Seat 2: yodzik (small blind) folded on the Turn
Seat 3: DrejAtom (big blind) collected ($1.39)
Seat 4: ab260414 folded before Flop (didn't bet)
Seat 5: KokoulinV folded before Flop (didn't bet)
Seat 6: CHRO8 (button) folded before Flop (didn't bet)



PokerStars Hand #166667456519:  Hold'em No Limit ($0.05/$0.10 USD) - 2017/02/23 16:01:29 ET
Table 'Huberta II' 6-max Seat #5 is the button
Seat 1: tr41n3r12 ($10.05 in chips) 
Seat 2: Ice_Isayev ($12.48 in chips) 
Seat 3: patrick19111 ($10.90 in chips) 
Seat 4: VAD21 ($11.38 in chips) 
Seat 5: Feverhead ($27.38 in chips) 
tr41n3r12: posts small blind $0.05
Ice_Isayev: posts big blind $0.10
*** HOLE CARDS ***
patrick19111: folds 
VAD21: folds 
Feverhead: folds 
tr41n3r12: folds 
Uncalled bet ($0.05) returned to Ice_Isayev
Ice_Isayev collected $0.10 from pot
*** SUMMARY ***
Total pot $0.10 | Rake $0 
Seat 1: tr41n3r12 (small blind) folded before Flop
Seat 2: Ice_Isayev (big blind) collected ($0.10)
Seat 3: patrick19111 folded before Flop (didn't bet)
Seat 4: VAD21 folded before Flop (didn't bet)
Seat 5: Feverhead (button) folded before Flop (didn't bet)



PokerStars Hand #166667456748:  Hold'em No Limit ($0.05/$0.10 USD) - 2017/02/23 16:01:29 ET
Table 'Armenia' 6-max Seat #4 is the button
Seat 1: tr41n3r12 ($12.17 in chips) 
Seat 2: Yabidooo ($10 in chips) 
Seat 4: x3ultimate ($11.15 in chips) 
Seat 5: boxer821 ($12.15 in chips) 
Seat 6: mega spasser ($5.22 in chips) 
boxer821: posts small blind $0.05
mega spasser: posts big blind $0.10
*** HOLE CARDS ***
tr41n3r12: folds 
Yabidooo: raises $0.20 to $0.30
x3ultimate: raises $0.60 to $0.90
boxer821: folds 
mega spasser: folds 
Yabidooo: calls $0.60
*** FLOP *** [9s 7s Tc]
Yabidooo: checks 
CDestructivo leaves the table
x3ultimate: bets $1
Namhkal joins the table at seat #3 
Yabidooo: raises $2.40 to $3.40
Namhkal leaves the table
x3ultimate: folds 
Uncalled bet ($2.40) returned to Yabidooo
XwinX25 joins the table at seat #3 
Yabidooo collected $3.77 from pot
*** SUMMARY ***
Total pot $3.95 | Rake $0.18 
Board [9s 7s Tc]
Seat 1: tr41n3r12 folded before Flop (didn't bet)
Seat 2: Yabidooo collected ($3.77)
Seat 4: x3ultimate (button) folded on the Flop
Seat 5: boxer821 (small blind) folded before Flop
Seat 6: mega spasser (big blind) folded before Flop



PokerStars Hand #166667456964:  Hold'em No Limit ($0.05/$0.10 USD) - 2017/02/23 16:01:29 ET
Table 'Azelfafage' 6-max Seat #2 is the button
Seat 1: Sbozzz ($15.76 in chips) 
Seat 2: tr41n3r12 ($10.30 in chips) 
Seat 3: todor1711 ($20.23 in chips) 
Seat 4: fedorka rus ($11.57 in chips) 
Seat 5: 8th wonders ($11.35 in chips) 
Seat 6: KA3AXCTAHEU, ($10 in chips) 
todor1711: posts small blind $0.05
fedorka rus: posts big blind $0.10
*** HOLE CARDS ***
8th wonders: raises $0.20 to $0.30
KA3AXCTAHEU,: folds 
Sbozzz: folds 
tr41n3r12: folds 
todor1711: calls $0.25
fedorka rus: calls $0.20
*** FLOP *** [7c 2d 4d]
todor1711: checks 
fedorka rus: checks 
8th wonders: bets $0.90
todor1711: folds 
fedorka rus: calls $0.90
*** TURN *** [7c 2d 4d] [Qs]
fedorka rus: checks 
8th wonders: bets $1.94
fedorka rus: folds 
Uncalled bet ($1.94) returned to 8th wonders
8th wonders collected $2.58 from pot
*** SUMMARY ***
Total pot $2.70 | Rake $0.12 
Board [7c 2d 4d Qs]
Seat 1: Sbozzz folded before Flop (didn't bet)
Seat 2: tr41n3r12 (button) folded before Flop (didn't bet)
Seat 3: todor1711 (small blind) folded on the Flop
Seat 4: fedorka rus (big blind) folded on the Turn
Seat 5: 8th wonders collected ($2.58)
Seat 6: KA3AXCTAHEU, folded before Flop (didn't bet)



PokerStars Hand #166667457129:  Hold'em No Limit ($0.05/$0.10 USD) - 2017/02/23 16:01:29 ET
Table 'Mesarthim' 6-max Seat #6 is the button
Seat 1: Mancuso2010 ($17.15 in chips) 
Seat 2: MühliJr ($10.93 in chips) 
Seat 3: Damage514 ($8.74 in chips) 
Seat 4: Strelok1974 ($10 in chips) 
Seat 5: Iarlei ($11.05 in chips) 
Seat 6: bdixon_5 ($8.96 in chips) 
Mancuso2010: posts small blind $0.05
MühliJr: posts big blind $0.10
*** HOLE CARDS ***
Damage514: calls $0.10
Strelok1974: raises $0.30 to $0.40
Iarlei: folds 
bdixon_5: folds 
Mancuso2010: folds 
MühliJr: folds 
Damage514: calls $0.30
*** FLOP *** [6c 3d 9s]
Damage514: checks 
Strelok1974: bets $0.68
Damage514: folds 
Uncalled bet ($0.68) returned to Strelok1974
Strelok1974 collected $0.91 from pot
*** SUMMARY ***
Total pot $0.95 | Rake $0.04 
Board [6c 3d 9s]
Seat 1: Mancuso2010 (small blind) folded before Flop
Seat 2: MühliJr (big blind) folded before Flop
Seat 3: Damage514 folded on the Flop
Seat 4: Strelok1974 collected ($0.91)
Seat 5: Iarlei folded before Flop (didn't bet)
Seat 6: bdixon_5 (button) folded before Flop (didn't bet)



PokerStars Hand #166667457131:  Hold'em No Limit ($0.05/$0.10 USD) - 2017/02/23 16:01:29 ET
Table 'Juliet II' 6-max Seat #5 is the button
Seat 1: alexpolevaja ($11.38 in chips) 
Seat 2: KA3AXCTAHEU, ($15.15 in chips) 
Seat 3: patrick19111 ($11.72 in chips) 
Seat 4: x3ultimate ($10 in chips) 
Seat 5: Dcaro31 ($19.32 in chips) 
Seat 6: BookWorm78 ($31.87 in chips) 
BookWorm78: posts small blind $0.05
alexpolevaja: posts big blind $0.10
*** HOLE CARDS ***
KA3AXCTAHEU,: folds 
patrick19111: folds 
x3ultimate: raises $0.20 to $0.30
Dcaro31: calls $0.30
BookWorm78: calls $0.25
alexpolevaja: folds 
*** FLOP *** [6h 2c Kc]
BookWorm78: checks 
x3ultimate: bets $0.63
Dcaro31: folds 
BookWorm78: calls $0.63
*** TURN *** [6h 2c Kc] [4d]
BookWorm78: checks 
x3ultimate: checks 
*** RIVER *** [6h 2c Kc 4d] [5h]
BookWorm78: checks 
x3ultimate: checks 
*** SHOW DOWN ***
BookWorm78: shows [Jd Ks] (a pair of Kings)
x3ultimate: mucks hand 
BookWorm78 collected $2.16 from pot
*** SUMMARY ***
Total pot $2.26 | Rake $0.10 
Board [6h 2c Kc 4d 5h]
Seat 1: alexpolevaja (big blind) folded before Flop
Seat 2: KA3AXCTAHEU, folded before Flop (didn't bet)
Seat 3: patrick19111 folded before Flop (didn't bet)
Seat 4: x3ultimate mucked
Seat 5: Dcaro31 (button) folded on the Flop
Seat 6: BookWorm78 (small blind) showed [Jd Ks] and won ($2.16) with a pair of Kings



PokerStars Hand #166667457398:  Hold'em No Limit ($0.05/$0.10 USD) - 2017/02/23 16:01:30 ET
Table 'Serpens' 6-max Seat #2 is the button
Seat 1: Namhkal ($10 in chips) 
Seat 2: KA3AXCTAHEU, ($10 in chips) 
Seat 3: homelessdan ($28.40 in chips) 
Seat 4: Ragazzi3 ($17.64 in chips) 
Seat 5: XwinX25 ($11.81 in chips) 
Seat 6: Croplayer1 ($10.15 in chips) 
homelessdan: posts small blind $0.05
Ragazzi3: posts big blind $0.10
*** HOLE CARDS ***
XwinX25: folds 
Croplayer1: raises $0.20 to $0.30
Namhkal: raises $0.60 to $0.90
KA3AXCTAHEU,: folds 
homelessdan: folds 
Ragazzi3: folds 
Croplayer1: folds 
Uncalled bet ($0.60) returned to Namhkal
Namhkal collected $0.75 from pot
*** SUMMARY ***
Total pot $0.75 | Rake $0 
Seat 1: Namhkal collected ($0.75)
Seat 2: KA3AXCTAHEU, (button) folded before Flop (didn't bet)
Seat 3: homelessdan (small blind) folded before Flop
Seat 4: Ragazzi3 (big blind) folded before Flop
Seat 5: XwinX25 folded before Flop (didn't bet)
Seat 6: Croplayer1 folded before Flop



PokerStars Hand #166667457467:  Hold'em No Limit ($0.05/$0.10 USD) - 2017/02/23 16:01:30 ET
Table 'Tyndareus II' 6-max Seat #3 is the button
Seat 1: Makc1705 ($3.65 in chips) 
Seat 2: Therodorus ($11.30 in chips) 
Seat 3: McCleans ($11.21 in chips) 
Seat 4: gaHy_HaXeP ($11.26 in chips) 
Seat 5: vtalian ($8.55 in chips) 
Seat 6: sexy_seagull ($10 in chips) 
gaHy_HaXeP: posts small blind $0.05
vtalian: posts big blind $0.10
*** HOLE CARDS ***
sexy_seagull: folds 
Makc1705: folds 
Therodorus: raises $0.20 to $0.30
McCleans: folds 
gaHy_HaXeP: folds 
vtalian: calls $0.20
*** FLOP *** [Kd Kh Th]
vtalian: checks 
Therodorus: bets $0.40
vtalian: folds 
Uncalled bet ($0.40) returned to Therodorus
Therodorus collected $0.62 from pot
*** SUMMARY ***
Total pot $0.65 | Rake $0.03 
Board [Kd Kh Th]
Seat 1: Makc1705 folded before Flop (didn't bet)
Seat 2: Therodorus collected ($0.62)
Seat 3: McCleans (button) folded before Flop (didn't bet)
Seat 4: gaHy_HaXeP (small blind) folded before Flop
Seat 5: vtalian (big blind) folded on the Flop
Seat 6: sexy_seagull folded before Flop (didn't bet)



PokerStars Hand #166667457632:  Hold'em No Limit ($0.05/$0.10 USD) - 2017/02/23 16:01:30 ET
Table 'Unitas II' 6-max Seat #1 is the button
Seat 1: Peter0087 ($9.20 in chips) 
Seat 2: dragonste89 ($10.81 in chips) 
Seat 3: CallByValue ($10 in chips) 
Seat 4: truck1234 ($10.72 in chips) 
Seat 5: chimera252 ($26.06 in chips) 
dragonste89: posts small blind $0.05
CallByValue: posts big blind $0.10
paxit71: sits out 
*** HOLE CARDS ***
truck1234: folds 
chimera252: folds 
Peter0087: folds 
dragonste89: raises $0.15 to $0.25
CallByValue: folds 
Uncalled bet ($0.15) returned to dragonste89
dragonste89 collected $0.20 from pot
*** SUMMARY ***
Total pot $0.20 | Rake $0 
Seat 1: Peter0087 (button) folded before Flop (didn't bet)
Seat 2: dragonste89 (small blind) collected ($0.20)
Seat 3: CallByValue (big blind) folded before Flop
Seat 4: truck1234 folded before Flop (didn't bet)
Seat 5: chimera252 folded before Flop (didn't bet)



PokerStars Hand #166667457696:  Hold'em No Limit ($0.05/$0.10 USD) - 2017/02/23 16:01:30 ET
Table 'Risha II' 6-max Seat #1 is the button
Seat 1: R. Lemonte ($10.73 in chips) 
Seat 2: KA3AXCTAHEU, ($12.70 in chips) 
Seat 3: steepfell ($10 in chips) 
Seat 4: Comeback3392 ($23.33 in chips) 
Seat 5: m.c-alkatraz ($10.20 in chips) 
Seat 6: univibe68 ($10.61 in chips) 
KA3AXCTAHEU,: posts small blind $0.05
steepfell: posts big blind $0.10
*** HOLE CARDS ***
Comeback3392: folds 
m.c-alkatraz: folds 
univibe68: raises $0.15 to $0.25
R. Lemonte: folds 
KA3AXCTAHEU,: folds 
steepfell: folds 
Uncalled bet ($0.15) returned to univibe68
univibe68 collected $0.25 from pot
*** SUMMARY ***
Total pot $0.25 | Rake $0 
Seat 1: R. Lemonte (button) folded before Flop (didn't bet)
Seat 2: KA3AXCTAHEU, (small blind) folded before Flop
Seat 3: steepfell (big blind) folded before Flop
Seat 4: Comeback3392 folded before Flop (didn't bet)
Seat 5: m.c-alkatraz folded before Flop (didn't bet)
Seat 6: univibe68 collected ($0.25)



PokerStars Hand #166667457738:  Hold'em No Limit ($0.05/$0.10 USD) - 2017/02/23 16:01:30 ET
Table 'Aconcagua' 6-max Seat #6 is the button
Seat 4: pivanki11 ($9.02 in chips) 
Seat 5: frazaunch ($6.81 in chips) 
Seat 6: coolisses111 ($9.72 in chips) 
pivanki11: posts small blind $0.05
frazaunch: posts big blind $0.10
pivanki11: posts the ante $0.02
frazaunch: posts the ante $0.02
coolisses111: posts the ante $0.02
*** HOLE CARDS ***
coolisses111: raises $0.20 to $0.30
pivanki11: raises $0.40 to $0.70
frazaunch: folds 
coolisses111: folds 
Uncalled bet ($0.40) returned to pivanki11
pivanki11 collected $0.76 from pot
*** SUMMARY ***
Total pot $0.76 | Rake $0 
Seat 4: pivanki11 (small blind) collected ($0.76)
Seat 5: frazaunch (big blind) folded before Flop
Seat 6: coolisses111 (button) folded before Flop



PokerStars Hand #166667458179:  Hold'em No Limit ($0.05/$0.10 USD) - 2017/02/23 16:01:31 ET
Table 'Tyndareus III' 6-max Seat #5 is the button
Seat 1: MBen10 ($10 in chips) 
Seat 2: MihaGr ($10.15 in chips) 
Seat 3: XaXaTyH4uK ($10.60 in chips) 
Seat 4: Therodorus ($11.61 in chips) 
Seat 5: Chodemuncher ($10 in chips) 
Seat 6: Elinaattor ($9.42 in chips) 
Elinaattor: posts small blind $0.05
MBen10: posts big blind $0.10
*** HOLE CARDS ***
MihaGr: folds 
XaXaTyH4uK: folds 
Therodorus: folds 
Chodemuncher: folds 
Elinaattor: raises $0.15 to $0.25
MBen10: calls $0.15
*** FLOP *** [7c Qs 5d]
Elinaattor: bets $0.36
MBen10: folds 
Uncalled bet ($0.36) returned to Elinaattor
Elinaattor collected $0.48 from pot
*** SUMMARY ***
Total pot $0.50 | Rake $0.02 
Board [7c Qs 5d]
Seat 1: MBen10 (big blind) folded on the Flop
Seat 2: MihaGr folded before Flop (didn't bet)
Seat 3: XaXaTyH4uK folded before Flop (didn't bet)
Seat 4: Therodorus folded before Flop (didn't bet)
Seat 5: Chodemuncher (button) folded before Flop (didn't bet)
Seat 6: Elinaattor (small blind) collected ($0.48)



PokerStars Hand #166667458307:  Hold'em No Limit ($0.05/$0.10 USD) - 2017/02/23 16:01:31 ET
Table 'Sham' 6-max Seat #4 is the button
Seat 1: pancernik21 ($10 in chips) 
Seat 2: ex3Lero86 ($10.15 in chips) 
Seat 3: weez3r ($22.83 in chips) 
Seat 4: VAD21 ($12.80 in chips) 
Seat 5: T9MS ($10 in chips) 
Seat 6: bdixon_5 ($9.70 in chips) 
T9MS: posts small blind $0.05
bdixon_5: posts big blind $0.10
*** HOLE CARDS ***
pancernik21: folds 
ex3Lero86: raises $0.17 to $0.27
weez3r: folds 
VAD21: folds 
T9MS: folds 
bdixon_5: folds 
Uncalled bet ($0.17) returned to ex3Lero86
ex3Lero86 collected $0.25 from pot
*** SUMMARY ***
Total pot $0.25 | Rake $0 
Seat 1: pancernik21 folded before Flop (didn't bet)
Seat 2: ex3Lero86 collected ($0.25)
Seat 3: weez3r folded before Flop (didn't bet)
Seat 4: VAD21 (button) folded before Flop (didn't bet)
Seat 5: T9MS (small blind) folded before Flop
Seat 6: bdixon_5 (big blind) folded before Flop



PokerStars Hand #166667458488:  Hold'em No Limit ($0.05/$0.10 USD) - 2017/02/23 16:01:31 ET
Table 'Lederle' 6-max Seat #3 is the button
Seat 1: D3NyA ($10 in chips) 
Seat 2: truck1234 ($16 in chips) 
Seat 3: Kazacha ($10.35 in chips) 
Seat 4: Pokeaster ($13.66 in chips) 
Seat 5: 8th wonders ($13.06 in chips) 
Pokeaster: posts small blind $0.05
8th wonders: posts big blind $0.10
pokekrk: sits out 
*** HOLE CARDS ***
D3NyA: folds 
truck1234: folds 
Kazacha: folds 
Pokeaster: folds 
Uncalled bet ($0.05) returned to 8th wonders
8th wonders collected $0.10 from pot
*** SUMMARY ***
Total pot $0.10 | Rake $0 
Seat 1: D3NyA folded before Flop (didn't bet)
Seat 2: truck1234 folded before Flop (didn't bet)
Seat 3: Kazacha (button) folded before Flop (didn't bet)
Seat 4: Pokeaster (small blind) folded before Flop
Seat 5: 8th wonders (big blind) collected ($0.10)



PokerStars Hand #166667458801:  Hold'em No Limit ($0.05/$0.10 USD) - 2017/02/23 16:01:31 ET
Table 'Nekkar' 6-max Seat #5 is the button
Seat 2: Bird et al ($10 in chips) 
Seat 3: Zemz_Ru ($17.06 in chips) 
Seat 4: kingartur222 ($12.33 in chips) 
Seat 5: Vrinni ($12.10 in chips) 
Seat 6: Eddys Edge ($10.55 in chips) 
Eddys Edge: posts small blind $0.05
aapokerkot: is sitting out 
Bird et al: posts big blind $0.10
*** HOLE CARDS ***
Zemz_Ru: calls $0.10
kingartur222: raises $0.40 to $0.50
Vrinni: folds 
Eddys Edge: folds 
Bird et al: folds 
Zemz_Ru: calls $0.40
*** FLOP *** [Js As Jc]
Zemz_Ru: checks 
kingartur222: bets $0.82
Zemz_Ru: calls $0.82
*** TURN *** [Js As Jc] [8d]
Zemz_Ru: checks 
kingartur222: bets $1.99
Zemz_Ru: calls $1.99
*** RIVER *** [Js As Jc 8d] [Ks]
Zemz_Ru: checks 
kingartur222: checks 
*** SHOW DOWN ***
Zemz_Ru: shows [Tc Ah] (two pair, Aces and Jacks)
kingartur222: shows [Qd Ad] (two pair, Aces and Jacks)
Zemz_Ru collected $3.24 from pot
kingartur222 collected $3.23 from pot
*** SUMMARY ***
Total pot $6.77 | Rake $0.30 
Board [Js As Jc 8d Ks]
Seat 2: Bird et al (big blind) folded before Flop
Seat 3: Zemz_Ru showed [Tc Ah] and won ($3.24) with two pair, Aces and Jacks
Seat 4: kingartur222 showed [Qd Ad] and won ($3.23) with two pair, Aces and Jacks
Seat 5: Vrinni (button) folded before Flop (didn't bet)
Seat 6: Eddys Edge (small blind) folded before Flop



PokerStars Hand #166667458855:  Hold'em No Limit ($0.05/$0.10 USD) - 2017/02/23 16:01:31 ET
Table 'Gyldenia II' 6-max Seat #3 is the button
Seat 1: KokoulinV ($10.01 in chips) 
Seat 2: Bandyaev ($10 in chips) 
Seat 3: ex3Lero86 ($23.37 in chips) 
Seat 5: CHRO8 ($17.76 in chips) 
Seat 6: 8th wonders ($10.79 in chips) 
CHRO8: posts small blind $0.05
8th wonders: posts big blind $0.10
*** HOLE CARDS ***
KokoulinV: folds 
Bandyaev: folds 
ex3Lero86: folds 
CHRO8: folds 
Uncalled bet ($0.05) returned to 8th wonders
8th wonders collected $0.10 from pot
*** SUMMARY ***
Total pot $0.10 | Rake $0 
Seat 1: KokoulinV folded before Flop (didn't bet)
Seat 2: Bandyaev folded before Flop (didn't bet)
Seat 3: ex3Lero86 (button) folded before Flop (didn't bet)
Seat 5: CHRO8 (small blind) folded before Flop
Seat 6: 8th wonders (big blind) collected ($0.10)



PokerStars Hand #166667459090:  Hold'em No Limit ($0.05/$0.10 USD) - 2017/02/23 16:01:32 ET
Table 'Siebohme II' 6-max Seat #2 is the button
Seat 1: homelessdan ($18.22 in chips) 
Seat 2: townerz1991 ($14.17 in chips) 
Seat 3: D3NyA ($10.23 in chips) 
Seat 4: POT_TRADER ($12.14 in chips) 
Seat 5: NvR.m1nD ($10.15 in chips) 
D3NyA: posts small blind $0.05
POT_TRADER: posts big blind $0.10
Fozzy690: sits out 
*** HOLE CARDS ***
NvR.m1nD: folds 
homelessdan: folds 
townerz1991: folds 
D3NyA: raises $0.20 to $0.30
POT_TRADER: folds 
Uncalled bet ($0.20) returned to D3NyA
D3NyA collected $0.20 from pot
*** SUMMARY ***
Total pot $0.20 | Rake $0 
Seat 1: homelessdan folded before Flop (didn't bet)
Seat 2: townerz1991 (button) folded before Flop (didn't bet)
Seat 3: D3NyA (small blind) collected ($0.20)
Seat 4: POT_TRADER (big blind) folded before Flop
Seat 5: NvR.m1nD folded before Flop (didn't bet)



PokerStars Hand #166667459155:  Hold'em No Limit ($0.05/$0.10 USD) - 2017/02/23 16:01:32 ET
Table 'Alnasl' 6-max Seat #1 is the button
Seat 1: KA3AXCTAHEU, ($11.07 in chips) 
Seat 2: XaXaTyH4uK ($10.25 in chips) 
Seat 3: david_sara83 ($22.84 in chips) 
Seat 4: oddshoff ($10.18 in chips) 
Seat 5: steepfell ($10.23 in chips) 
Seat 6: Zooplack ($13.68 in chips) 
XaXaTyH4uK: posts small blind $0.05
david_sara83: posts big blind $0.10
*** HOLE CARDS ***
oddshoff: folds 
steepfell: folds 
Zooplack: raises $0.15 to $0.25
KA3AXCTAHEU,: folds 
XaXaTyH4uK: raises $0.75 to $1
david_sara83: folds 
Zooplack: folds 
Uncalled bet ($0.75) returned to XaXaTyH4uK
XaXaTyH4uK collected $0.60 from pot
*** SUMMARY ***
Total pot $0.60 | Rake $0 
Seat 1: KA3AXCTAHEU, (button) folded before Flop (didn't bet)
Seat 2: XaXaTyH4uK (small blind) collected ($0.60)
Seat 3: david_sara83 (big blind) folded before Flop
Seat 4: oddshoff folded before Flop (didn't bet)
Seat 5: steepfell folded before Flop (didn't bet)
Seat 6: Zooplack folded before Flop



PokerStars Hand #166667459939:  Hold'em No Limit ($0.05/$0.10 USD) - 2017/02/23 16:01:32 ET
Table 'Gelria' 6-max Seat #2 is the button
Seat 1: ab260414 ($10 in chips) 
Seat 2: fishhook5 ($10 in chips) 
Seat 3: Orlangoor ($11.02 in chips) 
Seat 5: apenvel ($7.64 in chips) 
Seat 6: Andrei ProFF ($10.57 in chips) 
Orlangoor: posts small blind $0.05
apenvel: posts big blind $0.10
*** HOLE CARDS ***
Andrei ProFF: folds 
ab260414: folds 
fishhook5: raises $0.14 to $0.24
Orlangoor: folds 
apenvel: raises $0.14 to $0.38
fishhook5: calls $0.14
*** FLOP *** [Ah 4s 3c]
apenvel: checks 
fishhook5: checks 
*** TURN *** [Ah 4s 3c] [Jh]
apenvel: checks 
fishhook5: bets $0.40
apenvel: calls $0.40
*** RIVER *** [Ah 4s 3c Jh] [Qs]
apenvel: checks 
fishhook5: checks 
*** SHOW DOWN ***
apenvel: shows [Ad As] (three of a kind, Aces)
fishhook5: mucks hand 
apenvel collected $1.54 from pot
*** SUMMARY ***
Total pot $1.61 | Rake $0.07 
Board [Ah 4s 3c Jh Qs]
Seat 1: ab260414 folded before Flop (didn't bet)
Seat 2: fishhook5 (button) mucked
Seat 3: Orlangoor (small blind) folded before Flop
Seat 5: apenvel (big blind) showed [Ad As] and won ($1.54) with three of a kind, Aces
Seat 6: Andrei ProFF folded before Flop (didn't bet)



PokerStars Hand #166667460098:  Hold'em No Limit ($0.05/$0.10 USD) - 2017/02/23 16:01:33 ET
Table 'Deflotte' 6-max Seat #3 is the button
Seat 1: Zooplack ($15.54 in chips) 
Seat 3: Croplayer1 ($10 in chips) 
Seat 4: 8th wonders ($10.20 in chips) 
Seat 5: Pokeaster ($11.52 in chips) 
Seat 6: Iarlei ($11.39 in chips) 
8th wonders: posts small blind $0.05
Pokeaster: posts big blind $0.10
MonteCris92 is disconnected 
MonteCris92 has timed out while disconnected
MonteCris92: is sitting out 
*** HOLE CARDS ***
Iarlei: folds 
Zooplack: folds 
Croplayer1: raises $0.10 to $0.20
8th wonders: folds 
Pokeaster: folds 
Uncalled bet ($0.10) returned to Croplayer1
Croplayer1 collected $0.25 from pot
*** SUMMARY ***
Total pot $0.25 | Rake $0 
Seat 1: Zooplack folded before Flop (didn't bet)
Seat 3: Croplayer1 (button) collected ($0.25)
Seat 4: 8th wonders (small blind) folded before Flop
Seat 5: Pokeaster (big blind) folded before Flop
Seat 6: Iarlei folded before Flop (didn't bet)



PokerStars Hand #166667460218:  Hold'em No Limit ($0.05/$0.10 USD) - 2017/02/23 16:01:33 ET
Table 'Wilkens II' 6-max Seat #3 is the button
Seat 1: Islamiq-GuRL ($12.30 in chips) 
Seat 2: manashov ($10.15 in chips) 
Seat 3: Namhkal ($10.80 in chips) 
Seat 4: myevc ($10 in chips) 
Seat 5: patrick19111 ($10 in chips) 
Seat 6: XaXaTyH4uK ($14.76 in chips) 
myevc: posts small blind $0.05
patrick19111: posts big blind $0.10
*** HOLE CARDS ***
XaXaTyH4uK: folds 
Islamiq-GuRL: folds 
manashov: folds 
Namhkal: folds 
myevc: folds 
Uncalled bet ($0.05) returned to patrick19111
patrick19111 collected $0.10 from pot
*** SUMMARY ***
Total pot $0.10 | Rake $0 
Seat 1: Islamiq-GuRL folded before Flop (didn't bet)
Seat 2: manashov folded before Flop (didn't bet)
Seat 3: Namhkal (button) folded before Flop (didn't bet)
Seat 4: myevc (small blind) folded before Flop
Seat 5: patrick19111 (big blind) collected ($0.10)
Seat 6: XaXaTyH4uK folded before Flop (didn't bet)



PokerStars Hand #166667460333:  Hold'em No Limit ($0.05/$0.10 USD) - 2017/02/23 16:01:33 ET
Table 'Nehalennia III' 6-max Seat #2 is the button
Seat 1: boxer821 ($13.24 in chips) 
Seat 2: fortieth ($9.81 in chips) 
Seat 3: ValdemorS ($18.02 in chips) 
Seat 4: eniksenik ($10 in chips) 
Seat 5: wulffboy ($34.72 in chips) 
Seat 6: valzeny ($20.61 in chips) 
ValdemorS: posts small blind $0.05
eniksenik: posts big blind $0.10
boxer821: posts the ante $0.02
fortieth: posts the ante $0.02
ValdemorS: posts the ante $0.02
eniksenik: posts the ante $0.02
wulffboy: posts the ante $0.02
valzeny: posts the ante $0.02
*** HOLE CARDS ***
wulffboy: calls $0.10
valzeny: folds 
boxer821: folds 
fortieth: folds 
ValdemorS: folds 
eniksenik: checks 
*** FLOP *** [7s 5d 8c]
eniksenik: checks 
wulffboy: bets $0.30
eniksenik: calls $0.30
*** TURN *** [7s 5d 8c] [Js]
eniksenik: checks 
wulffboy: checks 
*** RIVER *** [7s 5d 8c Js] [Td]
eniksenik: checks 
wulffboy: checks 
*** SHOW DOWN ***
eniksenik: shows [As 5h] (a pair of Fives)
wulffboy: shows [Qh Tc] (a pair of Tens)
wulffboy collected $0.93 from pot
*** SUMMARY ***
Total pot $0.97 | Rake $0.04 
Board [7s 5d 8c Js Td]
Seat 1: boxer821 folded before Flop (didn't bet)
Seat 2: fortieth (button) folded before Flop (didn't bet)
Seat 3: ValdemorS (small blind) folded before Flop
Seat 4: eniksenik (big blind) showed [As 5h] and lost with a pair of Fives
Seat 5: wulffboy showed [Qh Tc] and won ($0.93) with a pair of Tens
Seat 6: valzeny folded before Flop (didn't bet)



PokerStars Hand #166667460441:  Hold'em No Limit ($0.05/$0.10 USD) - 2017/02/23 16:01:33 ET
Table 'Peiroos III' 6-max Seat #1 is the button
Seat 1: tequila_joop ($10.11 in chips) 
Seat 3: nabatov.m ($6.12 in chips) 
Seat 4: pivanki11 ($11.13 in chips) 
Seat 5: ChuikaPridi ($9.66 in chips) 
Seat 6: CHRO8 ($9.57 in chips) 
nabatov.m: posts small blind $0.05
pivanki11: posts big blind $0.10
tequila_joop: posts the ante $0.02
nabatov.m: posts the ante $0.02
pivanki11: posts the ante $0.02
ChuikaPridi: posts the ante $0.02
CHRO8: posts the ante $0.02
*** HOLE CARDS ***
ChuikaPridi: folds 
CHRO8: raises $0.20 to $0.30
tequila_joop: folds 
nabatov.m: folds 
pivanki11: folds 
Uncalled bet ($0.20) returned to CHRO8
CHRO8 collected $0.35 from pot
*** SUMMARY ***
Total pot $0.35 | Rake $0 
Seat 1: tequila_joop (button) folded before Flop (didn't bet)
Seat 3: nabatov.m (small blind) folded before Flop
Seat 4: pivanki11 (big blind) folded before Flop
Seat 5: ChuikaPridi folded before Flop (didn't bet)
Seat 6: CHRO8 collected ($0.35)



PokerStars Hand #166667460541:  Hold'em No Limit ($0.05/$0.10 USD) - 2017/02/23 16:01:33 ET
Table 'Markab II' 6-max Seat #3 is the button
Seat 1: david_sara83 ($10.17 in chips) 
Seat 2: truck1234 ($11.05 in chips) 
Seat 3: sexy_seagull ($10 in chips) 
Seat 4: Crafty23@PS ($11.59 in chips) 
Seat 5: Rodik002 ($19.17 in chips) 
Seat 6: Comeback3392 ($10.64 in chips) 
Crafty23@PS: posts small blind $0.05
Rodik002: posts big blind $0.10
*** HOLE CARDS ***
Comeback3392: folds 
david_sara83: folds 
truck1234: folds 
sexy_seagull: folds 
Crafty23@PS: folds 
Uncalled bet ($0.05) returned to Rodik002
Rodik002 collected $0.10 from pot
*** SUMMARY ***
Total pot $0.10 | Rake $0 
Seat 1: david_sara83 folded before Flop (didn't bet)
Seat 2: truck1234 folded before Flop (didn't bet)
Seat 3: sexy_seagull (button) folded before Flop (didn't bet)
Seat 4: Crafty23@PS (small blind) folded before Flop
Seat 5: Rodik002 (big blind) collected ($0.10)
Seat 6: Comeback3392 folded before Flop (didn't bet)



PokerStars Hand #166667460643:  Hold'em No Limit ($0.05/$0.10 USD) - 2017/02/23 16:01:33 ET
Table 'Caprera III' 6-max Seat #4 is the button
Seat 2: hg123454321 ($8.70 in chips) 
Seat 3: Darkfrai ($10 in chips) 
Seat 4: oddshoff ($9.71 in chips) 
Seat 5: fedorka rus ($50.63 in chips) 
Seat 6: GESPERIA ($17.99 in chips) 
fedorka rus: posts small blind $0.05
GESPERIA: posts big blind $0.10
Vrinni: sits out 
*** HOLE CARDS ***
hg123454321: folds 
Darkfrai: folds 
oddshoff: raises $0.20 to $0.30
fedorka rus: folds 
GESPERIA: calls $0.20
*** FLOP *** [5h Ad 8c]
GESPERIA: checks 
oddshoff: bets $0.41
GESPERIA: raises $0.99 to $1.40
oddshoff: folds 
Uncalled bet ($0.99) returned to GESPERIA
GESPERIA collected $1.40 from pot
*** SUMMARY ***
Total pot $1.47 | Rake $0.07 
Board [5h Ad 8c]
Seat 2: hg123454321 folded before Flop (didn't bet)
Seat 3: Darkfrai folded before Flop (didn't bet)
Seat 4: oddshoff (button) folded on the Flop
Seat 5: fedorka rus (small blind) folded before Flop
Seat 6: GESPERIA (big blind) collected ($1.40)



PokerStars Hand #166667461195:  Hold'em No Limit ($0.05/$0.10 USD) - 2017/02/23 16:01:34 ET
Table 'Amalia' 6-max Seat #4 is the button
Seat 1: voledy ($12.99 in chips) 
Seat 2: DamDatsAnAce ($10.70 in chips) 
Seat 3: kickereens ($10.15 in chips) 
Seat 4: Rodik002 ($16.38 in chips) 
Seat 5: coolisses111 ($9.90 in chips) 
Seat 6: oktomber778 ($24.29 in chips) 
coolisses111: posts small blind $0.05
oktomber778: posts big blind $0.10
*** HOLE CARDS ***
voledy: folds 
DamDatsAnAce: folds 
kickereens: folds 
Rodik002: folds 
coolisses111: folds 
Uncalled bet ($0.05) returned to oktomber778
oktomber778 collected $0.10 from pot
*** SUMMARY ***
Total pot $0.10 | Rake $0 
Seat 1: voledy folded before Flop (didn't bet)
Seat 2: DamDatsAnAce folded before Flop (didn't bet)
Seat 3: kickereens folded before Flop (didn't bet)
Seat 4: Rodik002 (button) folded before Flop (didn't bet)
Seat 5: coolisses111 (small blind) folded before Flop
Seat 6: oktomber778 (big blind) collected ($0.10)



PokerStars Hand #166667461615:  Hold'em No Limit ($0.05/$0.10 USD) - 2017/02/23 16:01:34 ET
Table 'Peiroos' 6-max Seat #3 is the button
Seat 1: ksandr_hom ($10 in chips) 
Seat 2: Nr847 ($10 in chips) 
Seat 3: atlx0711 ($21.82 in chips) 
Seat 4: Peter0087 ($7.98 in chips) 
Seat 5: sergio-cb164 ($9.55 in chips) 
Seat 6: DevonMiles88 ($9.32 in chips) 
Peter0087: posts small blind $0.05
sergio-cb164: posts big blind $0.10
*** HOLE CARDS ***
DevonMiles88: raises $0.40 to $0.50
ksandr_hom: folds 
Nr847: folds 
atlx0711: folds 
Peter0087: folds 
sergio-cb164: folds 
Uncalled bet ($0.40) returned to DevonMiles88
DevonMiles88 collected $0.25 from pot
*** SUMMARY ***
Total pot $0.25 | Rake $0 
Seat 1: ksandr_hom folded before Flop (didn't bet)
Seat 2: Nr847 folded before Flop (didn't bet)
Seat 3: atlx0711 (button) folded before Flop (didn't bet)
Seat 4: Peter0087 (small blind) folded before Flop
Seat 5: sergio-cb164 (big blind) folded before Flop
Seat 6: DevonMiles88 collected ($0.25)



PokerStars Hand #166667461936:  Hold'em No Limit ($0.05/$0.10 USD) - 2017/02/23 16:01:35 ET
Table 'Nata II' 6-max Seat #4 is the button
Seat 1: luisantrs ($9.34 in chips) 
Seat 2: CHRO8 ($15.85 in chips) 
Seat 3: 8th wonders ($10.72 in chips) 
Seat 4: Comeback3392 ($10 in chips) 
Seat 5: RoJ1 ($10 in chips) 
Seat 6: IAntikI ($10 in chips) 
RoJ1: posts small blind $0.05
IAntikI: posts big blind $0.10
*** HOLE CARDS ***
luisantrs: folds 
CHRO8: folds 
8th wonders: raises $0.20 to $0.30
Comeback3392: folds 
RoJ1: folds 
IAntikI: calls $0.20
*** FLOP *** [8h Qs 3d]
IAntikI: checks 
8th wonders: bets $0.40
IAntikI: calls $0.40
*** TURN *** [8h Qs 3d] [Ts]
IAntikI: checks 
8th wonders: bets $0.80
IAntikI: calls $0.80
*** RIVER *** [8h Qs 3d Ts] [8s]
IAntikI: checks 
8th wonders: checks 
*** SHOW DOWN ***
IAntikI: shows [Jh Qh] (two pair, Queens and Eights)
8th wonders: mucks hand 
IAntikI collected $2.91 from pot
*** SUMMARY ***
Total pot $3.05 | Rake $0.14 
Board [8h Qs 3d Ts 8s]
Seat 1: luisantrs folded before Flop (didn't bet)
Seat 2: CHRO8 folded before Flop (didn't bet)
Seat 3: 8th wonders mucked
Seat 4: Comeback3392 (button) folded before Flop (didn't bet)
Seat 5: RoJ1 (small blind) folded before Flop
Seat 6: IAntikI (big blind) showed [Jh Qh] and won ($2.91) with two pair, Queens and Eights



PokerStars Hand #166667462097:  Hold'em No Limit ($0.05/$0.10 USD) - 2017/02/23 16:01:35 ET
Table 'Landi II' 6-max Seat #4 is the button
Seat 1: dersiemer ($11.97 in chips) 
Seat 2: Aescul@pius ($11.10 in chips) 
Seat 3: dr.goofy ($18.56 in chips) 
Seat 4: alesi13 ($6.20 in chips) 
Seat 5: Bird et al ($10.68 in chips) 
Bird et al: posts small blind $0.05
arti192837: is sitting out 
dersiemer: posts big blind $0.10
*** HOLE CARDS ***
Aescul@pius has timed out
Aescul@pius: folds 
dr.goofy: raises $0.20 to $0.30
alesi13: folds 
Bird et al: raises $0.90 to $1.20
dersiemer: folds 
dr.goofy: calls $0.90
*** FLOP *** [6s 6h 5h]
Bird et al: bets $2.03
dr.goofy: raises $3.87 to $5.90
Bird et al: folds 
Uncalled bet ($3.87) returned to dr.goofy
dr.goofy collected $6.26 from pot
*** SUMMARY ***
Total pot $6.56 | Rake $0.30 
Board [6s 6h 5h]
Seat 1: dersiemer (big blind) folded before Flop
Seat 2: Aescul@pius folded before Flop (didn't bet)
Seat 3: dr.goofy collected ($6.26)
Seat 4: alesi13 (button) folded before Flop (didn't bet)
Seat 5: Bird et al (small blind) folded on the Flop



PokerStars Hand #166667462107:  Hold'em No Limit ($0.05/$0.10 USD) - 2017/02/23 16:01:35 ET
Table 'Camilla II' 6-max Seat #4 is the button
Seat 2: Giyorod ($15.81 in chips) 
Seat 4: chimera252 ($12.66 in chips) 
Seat 5: LarryTheStar ($11.17 in chips) 
Seat 6: david_sara83 ($10.15 in chips) 
LarryTheStar: posts small blind $0.05
david_sara83: posts big blind $0.10
paxit71: sits out 
Andy Wolf: sits out 
*** HOLE CARDS ***
Giyorod: folds 
chimera252: raises $0.15 to $0.25
LarryTheStar: calls $0.20
david_sara83: folds 
*** FLOP *** [6h Kc Td]
LarryTheStar: checks 
chimera252: checks 
*** TURN *** [6h Kc Td] [Qc]
LarryTheStar: checks 
chimera252: checks 
*** RIVER *** [6h Kc Td Qc] [3d]
LarryTheStar: checks 
chimera252: checks 
*** SHOW DOWN ***
LarryTheStar: shows [8h 8s] (a pair of Eights)
chimera252: mucks hand 
LarryTheStar collected $0.57 from pot
*** SUMMARY ***
Total pot $0.60 | Rake $0.03 
Board [6h Kc Td Qc 3d]
Seat 2: Giyorod folded before Flop (didn't bet)
Seat 4: chimera252 (button) mucked
Seat 5: LarryTheStar (small blind) showed [8h 8s] and won ($0.57) with a pair of Eights
Seat 6: david_sara83 (big blind) folded before Flop



PokerStars Hand #166667462505:  Hold'em No Limit ($0.05/$0.10 USD) - 2017/02/23 16:01:35 ET
Table 'Hamal II' 6-max Seat #1 is the button
Seat 1: saxoalto2011 ($8.49 in chips) 
Seat 2: pancernik21 ($10 in chips) 
Seat 3: Cluckh ($11.69 in chips) 
Seat 4: ArcticBearDK ($10.96 in chips) 
Seat 6: LarryTheStar ($11.09 in chips) 
pancernik21: posts small blind $0.05
Cluckh: posts big blind $0.10
eniksenik: sits out 
*** HOLE CARDS ***
ArcticBearDK: folds 
LarryTheStar: raises $0.20 to $0.30
saxoalto2011: folds 
pancernik21: folds 
Cluckh: folds 
Uncalled bet ($0.20) returned to LarryTheStar
LarryTheStar collected $0.25 from pot
*** SUMMARY ***
Total pot $0.25 | Rake $0 
Seat 1: saxoalto2011 (button) folded before Flop (didn't bet)
Seat 2: pancernik21 (small blind) folded before Flop
Seat 3: Cluckh (big blind) folded before Flop
Seat 4: ArcticBearDK folded before Flop (didn't bet)
Seat 6: LarryTheStar collected ($0.25)



PokerStars Hand #166667462577:  Hold'em No Limit ($0.05/$0.10 USD) - 2017/02/23 16:01:35 ET
Table 'Reginhild' 6-max Seat #3 is the button
Seat 1: iamkakaroto ($11.40 in chips) 
Seat 2: Kow6oy ($10.15 in chips) 
Seat 3: ARCHITECT83 ($5.45 in chips) 
Seat 4: Raymondo21 ($23.56 in chips) 
Seat 5: XCarlos610 ($28.64 in chips) 
Seat 6: eniksenik ($10.79 in chips) 
Raymondo21: posts small blind $0.05
XCarlos610: posts big blind $0.10
*** HOLE CARDS ***
eniksenik: folds 
iamkakaroto: folds 
Kow6oy: folds 
ARCHITECT83: folds 
Raymondo21: raises $0.10 to $0.20
XCarlos610: raises $0.40 to $0.60
Raymondo21: folds 
Uncalled bet ($0.40) returned to XCarlos610
XCarlos610 collected $0.40 from pot
*** SUMMARY ***
Total pot $0.40 | Rake $0 
Seat 1: iamkakaroto folded before Flop (didn't bet)
Seat 2: Kow6oy folded before Flop (didn't bet)
Seat 3: ARCHITECT83 (button) folded before Flop (didn't bet)
Seat 4: Raymondo21 (small blind) folded before Flop
Seat 5: XCarlos610 (big blind) collected ($0.40)
Seat 6: eniksenik folded before Flop (didn't bet)



PokerStars Hand #166667462642:  Hold'em No Limit ($0.05/$0.10 USD) - 2017/02/23 16:01:35 ET
Table 'Euryalos II' 6-max Seat #2 is the button
Seat 2: Yspenyanin ($10 in chips) 
Seat 3: Hyd SK ($10.30 in chips) 
Seat 4: popypaleta ($15.87 in chips) 
Seat 5: voledy ($12.86 in chips) 
Seat 6: MihaGr ($10 in chips) 
Hyd SK: posts small blind $0.05
popypaleta: posts big blind $0.10
*** HOLE CARDS ***
acekid403 joins the table at seat #1 
voledy: folds 
MihaGr: folds 
Yspenyanin: raises $0.15 to $0.25
Hyd SK: folds 
popypaleta: folds 
Uncalled bet ($0.15) returned to Yspenyanin
Yspenyanin collected $0.25 from pot
*** SUMMARY ***
Total pot $0.25 | Rake $0 
Seat 2: Yspenyanin (button) collected ($0.25)
Seat 3: Hyd SK (small blind) folded before Flop
Seat 4: popypaleta (big blind) folded before Flop
Seat 5: voledy folded before Flop (didn't bet)
Seat 6: MihaGr folded before Flop (didn't bet)



PokerStars Hand #166667462963:  Hold'em No Limit ($0.05/$0.10 USD) - 2017/02/23 16:01:36 ET
Table 'Persephone' 6-max Seat #5 is the button
Seat 1: FRAID358 ($10 in chips) 
Seat 2: Kupi007 ($15.73 in chips) 
Seat 3: Kow6oy ($11.88 in chips) 
Seat 4: 2G28 ($10 in chips) 
Seat 5: D3NyA ($10 in chips) 
Seat 6: popypaleta ($11.87 in chips) 
popypaleta: posts small blind $0.05
FRAID358: posts big blind $0.10
*** HOLE CARDS ***
Kupi007: folds 
Kow6oy: folds 
Kupi007 leaves the table
RoJ1 joins the table at seat #2 
2G28: folds 
D3NyA: raises $0.10 to $0.20
popypaleta: calls $0.15
FRAID358: folds 
*** FLOP *** [6d Kh 5d]
popypaleta: checks 
D3NyA: bets $0.34
popypaleta: raises $0.66 to $1
D3NyA: calls $0.66
*** TURN *** [6d Kh 5d] [8c]
RoJ1 leaves the table
popypaleta: bets $1.90
D3NyA: calls $1.90
*** RIVER *** [6d Kh 5d 8c] [Kd]
popypaleta: bets $6.02
AM-L-SL joins the table at seat #2 
D3NyA: folds 
Uncalled bet ($6.02) returned to popypaleta
popypaleta collected $6.02 from pot
*** SUMMARY ***
Total pot $6.30 | Rake $0.28 
Board [6d Kh 5d 8c Kd]
Seat 1: FRAID358 (big blind) folded before Flop
Seat 2: Kupi007 folded before Flop (didn't bet)
Seat 3: Kow6oy folded before Flop (didn't bet)
Seat 4: 2G28 folded before Flop (didn't bet)
Seat 5: D3NyA (button) folded on the River
Seat 6: popypaleta (small blind) collected ($6.02)



PokerStars Hand #166667462987:  Hold'em No Limit ($0.05/$0.10 USD) - 2017/02/23 16:01:36 ET
Table 'Girtab II' 6-max Seat #4 is the button
Seat 1: Kow6oy ($10 in chips) 
Seat 2: Pokeaster ($14.07 in chips) 
Seat 4: Hyd SK ($27.33 in chips) 
Seat 5: dzesio18 ($11.53 in chips) 
Seat 6: DamDatsAnAce ($10 in chips) 
dzesio18: posts small blind $0.05
DamDatsAnAce: posts big blind $0.10
chimera252: sits out 
*** HOLE CARDS ***
Kow6oy: folds 
Pokeaster: raises $0.20 to $0.30
Hyd SK: calls $0.30
dzesio18: calls $0.25
DamDatsAnAce: folds 
*** FLOP *** [2s 2h Qs]
dzesio18: bets $0.60
Pokeaster: folds 
Hyd SK: folds 
Uncalled bet ($0.60) returned to dzesio18
dzesio18 collected $0.96 from pot
*** SUMMARY ***
Total pot $1 | Rake $0.04 
Board [2s 2h Qs]
Seat 1: Kow6oy folded before Flop (didn't bet)
Seat 2: Pokeaster folded on the Flop
Seat 4: Hyd SK (button) folded on the Flop
Seat 5: dzesio18 (small blind) collected ($0.96)
Seat 6: DamDatsAnAce (big blind) folded before Flop



PokerStars Hand #166667463358:  Hold'em No Limit ($0.05/$0.10 USD) - 2017/02/23 16:01:36 ET
Table 'Pallas II' 6-max Seat #1 is the button
Seat 1: mdelfin0 ($15.88 in chips) 
Seat 2: FRAID358 ($10.05 in chips) 
Seat 4: Mr. Bluff 34 ($10.94 in chips) 
Seat 6: xdjango07x ($12.38 in chips) 
FRAID358: posts small blind $0.05
jamalungma: is sitting out 
Mr. Bluff 34: posts big blind $0.10
jamalungma leaves the table
Yspenyanin: sits out 
*** HOLE CARDS ***
Namhkal joins the table at seat #3 
Namhkal leaves the table
KRZuff joins the table at seat #3 
xdjango07x: folds 
mdelfin0: folds 
FRAID358: raises $0.15 to $0.25
Mr. Bluff 34: calls $0.15
*** FLOP *** [5h Td Kc]
FRAID358: checks 
Mr. Bluff 34: bets $0.30
FRAID358: folds 
Uncalled bet ($0.30) returned to Mr. Bluff 34
Mr. Bluff 34 collected $0.48 from pot
*** SUMMARY ***
Total pot $0.50 | Rake $0.02 
Board [5h Td Kc]
Seat 1: mdelfin0 (button) folded before Flop (didn't bet)
Seat 2: FRAID358 (small blind) folded on the Flop
Seat 4: Mr. Bluff 34 (big blind) collected ($0.48)
Seat 6: xdjango07x folded before Flop (didn't bet)



PokerStars Hand #166667463453:  Hold'em No Limit ($0.05/$0.10 USD) - 2017/02/23 16:01:36 ET
Table 'Hestia' 6-max Seat #3 is the button
Seat 2: RoJ1 ($11.97 in chips) 
Seat 3: MBen10 ($12.86 in chips) 
Seat 4: Lucky HoBBiT ($10 in chips) 
Seat 5: CiisCi ($16.20 in chips) 
Seat 6: MihaGr ($10 in chips) 
Lucky HoBBiT: posts small blind $0.05
CiisCi: posts big blind $0.10
Pekaml: sits out 
*** HOLE CARDS ***
MihaGr: raises $0.20 to $0.30
RoJ1: folds 
MBen10: folds 
Lucky HoBBiT: folds 
CiisCi: folds 
Uncalled bet ($0.20) returned to MihaGr
MihaGr collected $0.25 from pot
*** SUMMARY ***
Total pot $0.25 | Rake $0 
Seat 2: RoJ1 folded before Flop (didn't bet)
Seat 3: MBen10 (button) folded before Flop (didn't bet)
Seat 4: Lucky HoBBiT (small blind) folded before Flop
Seat 5: CiisCi (big blind) folded before Flop
Seat 6: MihaGr collected ($0.25)



PokerStars Hand #166667463814:  Hold'em No Limit ($0.05/$0.10 USD) - 2017/02/23 16:01:37 ET
Table 'Gaika II' 6-max Seat #2 is the button
Seat 1: Ice_Isayev ($10 in chips) 
Seat 2: steepfell ($10.32 in chips) 
Seat 3: iDecMate ($16.35 in chips) 
Seat 4: Hyd SK ($11.82 in chips) 
Seat 5: KokoulinV ($14.75 in chips) 
Seat 6: bartabs2 ($8.75 in chips) 
iDecMate: posts small blind $0.05
Hyd SK: posts big blind $0.10
*** HOLE CARDS ***
KokoulinV: raises $0.20 to $0.30
bartabs2: folds 
Ice_Isayev: raises $0.60 to $0.90
steepfell: folds 
iDecMate: folds 
Hyd SK: folds 
KokoulinV: raises $1.50 to $2.40
Ice_Isayev: folds 
Uncalled bet ($1.50) returned to KokoulinV
KokoulinV collected $1.95 from pot
*** SUMMARY ***
Total pot $1.95 | Rake $0 
Seat 1: Ice_Isayev folded before Flop
Seat 2: steepfell (button) folded before Flop (didn't bet)
Seat 3: iDecMate (small blind) folded before Flop
Seat 4: Hyd SK (big blind) folded before Flop
Seat 5: KokoulinV collected ($1.95)
Seat 6: bartabs2 folded before Flop (didn't bet)



PokerStars Hand #166667463819:  Hold'em No Limit ($0.05/$0.10 USD) - 2017/02/23 16:01:37 ET
Table 'Crocus' 6-max Seat #2 is the button
Seat 1: truck1234 ($24.76 in chips) 
Seat 2: garigura ($11.53 in chips) 
Seat 3: Limpa Meza ($0.34 in chips) 
Seat 4: patrick19111 ($12.53 in chips) 
Seat 5: Golsuorsi ($10 in chips) 
Seat 6: Rodik002 ($10 in chips) 
Limpa Meza: posts small blind $0.05
patrick19111: posts big blind $0.10
*** HOLE CARDS ***
Golsuorsi: folds 
Rodik002: folds 
truck1234: folds 
garigura: raises $0.12 to $0.22
Limpa Meza: calls $0.17
patrick19111: calls $0.12
*** FLOP *** [Kc Kd Tc]
Limpa Meza: bets $0.12 and is all-in
patrick19111: folds 
garigura: calls $0.12
*** TURN *** [Kc Kd Tc] [7s]
*** RIVER *** [Kc Kd Tc 7s] [2d]
*** SHOW DOWN ***
Limpa Meza: shows [Ac Ts] (two pair, Kings and Tens)
garigura: shows [Ah 6s] (a pair of Kings)
Limpa Meza collected $0.86 from pot
*** SUMMARY ***
Total pot $0.90 | Rake $0.04 
Board [Kc Kd Tc 7s 2d]
Seat 1: truck1234 folded before Flop (didn't bet)
Seat 2: garigura (button) showed [Ah 6s] and lost with a pair of Kings
Seat 3: Limpa Meza (small blind) showed [Ac Ts] and won ($0.86) with two pair, Kings and Tens
Seat 4: patrick19111 (big blind) folded on the Flop
Seat 5: Golsuorsi folded before Flop (didn't bet)
Seat 6: Rodik002 folded before Flop (didn't bet)



PokerStars Hand #166667464017:  Hold'em No Limit ($0.05/$0.10 USD) - 2017/02/23 16:01:37 ET
Table 'Crommelin II' 6-max Seat #6 is the button
Seat 1: THIMUCHIN ($11.12 in chips) 
Seat 2: Bird et al ($10 in chips) 
Seat 3: Strelok1974 ($21.15 in chips) 
Seat 4: Pequeño Clau ($10.15 in chips) 
Seat 5: Action_Gibi ($20.19 in chips) 
Seat 6: Darkfrai ($10.67 in chips) 
THIMUCHIN: posts small blind $0.05
Bird et al: posts big blind $0.10
*** HOLE CARDS ***
Strelok1974: raises $0.20 to $0.30
Pequeño Clau: folds 
Action_Gibi: folds 
Darkfrai: folds 
THIMUCHIN: folds 
Bird et al: folds 
Uncalled bet ($0.20) returned to Strelok1974
Strelok1974 collected $0.25 from pot
*** SUMMARY ***
Total pot $0.25 | Rake $0 
Seat 1: THIMUCHIN (small blind) folded before Flop
Seat 2: Bird et al (big blind) folded before Flop
Seat 3: Strelok1974 collected ($0.25)
Seat 4: Pequeño Clau folded before Flop (didn't bet)
Seat 5: Action_Gibi folded before Flop (didn't bet)
Seat 6: Darkfrai (button) folded before Flop (didn't bet)



PokerStars Hand #166667464019:  Hold'em No Limit ($0.05/$0.10 USD) - 2017/02/23 16:01:37 ET
Table 'Krethon' 6-max Seat #3 is the button
Seat 2: manashov ($10.48 in chips) 
Seat 3: Kow6oy ($14.86 in chips) 
Seat 4: chimera252 ($15.73 in chips) 
Seat 5: popypaleta ($10.55 in chips) 
Seat 6: fabadam ($18.98 in chips) 
chimera252: posts small blind $0.05
boxer821 joins the table at seat #1 
popypaleta: posts big blind $0.10
*** HOLE CARDS ***
fabadam: folds 
manashov: raises $0.20 to $0.30
Kow6oy: folds 
chimera252: folds 
popypaleta: calls $0.20
*** FLOP *** [Td 9d 6d]
popypaleta: checks 
manashov: bets $0.30
popypaleta: folds 
Uncalled bet ($0.30) returned to manashov
manashov collected $0.62 from pot
*** SUMMARY ***
Total pot $0.65 | Rake $0.03 
Board [Td 9d 6d]
Seat 2: manashov collected ($0.62)
Seat 3: Kow6oy (button) folded before Flop (didn't bet)
Seat 4: chimera252 (small blind) folded before Flop
Seat 5: popypaleta (big blind) folded on the Flop
Seat 6: fabadam folded before Flop (didn't bet)



PokerStars Hand #166667464527:  Hold'em No Limit ($0.05/$0.10 USD) - 2017/02/23 16:01:38 ET
Table 'Hajek III' 6-max Seat #1 is the button
Seat 1: MBen10 ($10.75 in chips) 
Seat 2: fortieth ($12.71 in chips) 
Seat 3: fedorka rus ($10.61 in chips) 
Seat 4: NvR.m1nD ($10 in chips) 
Seat 5: Croplayer1 ($15.56 in chips) 
Seat 6: fabadam ($22.46 in chips) 
fortieth: posts small blind $0.05
fedorka rus: posts big blind $0.10
*** HOLE CARDS ***
NvR.m1nD: raises $0.15 to $0.25
Croplayer1: folds 
fabadam: folds 
MBen10: folds 
fortieth: calls $0.20
fedorka rus: folds 
*** FLOP *** [Jh Tc 4d]
fortieth: checks 
NvR.m1nD: bets $0.38
fortieth: calls $0.38
*** TURN *** [Jh Tc 4d] [6c]
fortieth: checks 
NvR.m1nD: bets $0.86
fortieth: folds 
Uncalled bet ($0.86) returned to NvR.m1nD
NvR.m1nD collected $1.30 from pot
*** SUMMARY ***
Total pot $1.36 | Rake $0.06 
Board [Jh Tc 4d 6c]
Seat 1: MBen10 (button) folded before Flop (didn't bet)
Seat 2: fortieth (small blind) folded on the Turn
Seat 3: fedorka rus (big blind) folded before Flop
Seat 4: NvR.m1nD collected ($1.30)
Seat 5: Croplayer1 folded before Flop (didn't bet)
Seat 6: fabadam folded before Flop (didn't bet)



PokerStars Hand #166667464619:  Hold'em No Limit ($0.05/$0.10 USD) - 2017/02/23 16:01:38 ET
Table 'Ushakaron II' 6-max Seat #4 is the button
Seat 1: Kow6oy ($10.30 in chips) 
Seat 2: Iarlei ($10.23 in chips) 
Seat 3: Rodik002 ($10 in chips) 
Seat 4: avintage176 ($28.66 in chips) 
Seat 5: 1limewax1 ($17.39 in chips) 
Seat 6: eniksenik ($10 in chips) 
1limewax1: posts small blind $0.05
eniksenik: posts big blind $0.10
*** HOLE CARDS ***
Kow6oy: folds 
Iarlei: folds 
Rodik002: folds 
avintage176: raises $0.20 to $0.30
1limewax1: calls $0.25
eniksenik: calls $0.20
*** FLOP *** [9d 5d 4c]
1limewax1: checks 
eniksenik: checks 
avintage176: bets $0.50
1limewax1: raises $0.70 to $1.20
eniksenik: folds 
avintage176: folds 
Uncalled bet ($0.70) returned to 1limewax1
1limewax1 collected $1.81 from pot
*** SUMMARY ***
Total pot $1.90 | Rake $0.09 
Board [9d 5d 4c]
Seat 1: Kow6oy folded before Flop (didn't bet)
Seat 2: Iarlei folded before Flop (didn't bet)
Seat 3: Rodik002 folded before Flop (didn't bet)
Seat 4: avintage176 (button) folded on the Flop
Seat 5: 1limewax1 (small blind) collected ($1.81)
Seat 6: eniksenik (big blind) folded on the Flop



PokerStars Hand #166667464813:  Hold'em No Limit ($0.05/$0.10 USD) - 2017/02/23 16:01:38 ET
Table 'Isberga' 6-max Seat #1 is the button
Seat 1: Feverhead ($17.27 in chips) 
Seat 2: GESPERIA ($10 in chips) 
Seat 4: THIMUCHIN ($11.19 in chips) 
Seat 5: YoungGriff86 ($18.33 in chips) 
Seat 6: Goroshkos88 ($21.65 in chips) 
GESPERIA: posts small blind $0.05
HARDCORE66RU: is sitting out 
THIMUCHIN: posts big blind $0.10
*** HOLE CARDS ***
YoungGriff86: raises $0.20 to $0.30
Goroshkos88: calls $0.30
Feverhead: folds 
GESPERIA: folds 
THIMUCHIN: folds 
*** FLOP *** [Jh 7s Ts]
YoungGriff86: checks 
Goroshkos88: checks 
*** TURN *** [Jh 7s Ts] [3h]
YoungGriff86: bets $0.36
Goroshkos88: folds 
Uncalled bet ($0.36) returned to YoungGriff86
YoungGriff86 collected $0.72 from pot
*** SUMMARY ***
Total pot $0.75 | Rake $0.03 
Board [Jh 7s Ts 3h]
Seat 1: Feverhead (button) folded before Flop (didn't bet)
Seat 2: GESPERIA (small blind) folded before Flop
Seat 4: THIMUCHIN (big blind) folded before Flop
Seat 5: YoungGriff86 collected ($0.72)
Seat 6: Goroshkos88 folded on the Turn



PokerStars Hand #166667464870:  Hold'em No Limit ($0.05/$0.10 USD) - 2017/02/23 16:01:38 ET
Table 'Stroobantia' 6-max Seat #1 is the button
Seat 1: mam9zyc ($7.55 in chips) 
Seat 2: XwinX25 ($10.39 in chips) 
Seat 3: Namhkal ($10 in chips) 
Seat 5: boxer821 ($10.64 in chips) 
Seat 6: KokoulinV ($15.37 in chips) 
XwinX25: posts small blind $0.05
Namhkal: posts big blind $0.10
Yspenyanin: sits out 
*** HOLE CARDS ***
boxer821: folds 
KokoulinV: folds 
mam9zyc: folds 
XwinX25: folds 
Uncalled bet ($0.05) returned to Namhkal
Namhkal collected $0.10 from pot
*** SUMMARY ***
Total pot $0.10 | Rake $0 
Seat 1: mam9zyc (button) folded before Flop (didn't bet)
Seat 2: XwinX25 (small blind) folded before Flop
Seat 3: Namhkal (big blind) collected ($0.10)
Seat 5: boxer821 folded before Flop (didn't bet)
Seat 6: KokoulinV folded before Flop (didn't bet)



PokerStars Hand #166667464876:  Hold'em No Limit ($0.05/$0.10 USD) - 2017/02/23 16:01:38 ET
Table 'Nymphe II' 6-max Seat #2 is the button
Seat 1: jacktayra ($3.67 in chips) 
Seat 2: Newqbrown ($10 in chips) 
Seat 3: THIMUCHIN ($14.30 in chips) 
Seat 4: coolisses111 ($19.15 in chips) 
Seat 6: Xander188 ($18.23 in chips) 
THIMUCHIN: posts small blind $0.05
coolisses111: posts big blind $0.10
Yspenyanin: sits out 
*** HOLE CARDS ***
Xander188: folds 
jacktayra: folds 
Newqbrown: raises $0.20 to $0.30
THIMUCHIN: folds 
coolisses111: folds 
Uncalled bet ($0.20) returned to Newqbrown
Newqbrown collected $0.25 from pot
*** SUMMARY ***
Total pot $0.25 | Rake $0 
Seat 1: jacktayra folded before Flop (didn't bet)
Seat 2: Newqbrown (button) collected ($0.25)
Seat 3: THIMUCHIN (small blind) folded before Flop
Seat 4: coolisses111 (big blind) folded before Flop
Seat 6: Xander188 folded before Flop (didn't bet)



PokerStars Hand #166667465147:  Hold'em No Limit ($0.05/$0.10 USD) - 2017/02/23 16:01:38 ET
Table 'Vaisala' 6-max Seat #2 is the button
Seat 1: Pekaml ($10 in chips) 
Seat 2: XaXaTyH4uK ($10.10 in chips) 
Seat 3: x3ultimate ($10 in chips) 
Seat 4: sexy_seagull ($11.26 in chips) 
Seat 6: Aleksey K228 ($15.73 in chips) 
x3ultimate: posts small blind $0.05
sexy_seagull: posts big blind $0.10
AIONCMA1988: sits out 
*** HOLE CARDS ***
Aleksey K228: folds 
Pekaml: raises $0.15 to $0.25
XaXaTyH4uK: folds 
x3ultimate: folds 
sexy_seagull: folds 
Uncalled bet ($0.15) returned to Pekaml
Pekaml collected $0.25 from pot
*** SUMMARY ***
Total pot $0.25 | Rake $0 
Seat 1: Pekaml collected ($0.25)
Seat 2: XaXaTyH4uK (button) folded before Flop (didn't bet)
Seat 3: x3ultimate (small blind) folded before Flop
Seat 4: sexy_seagull (big blind) folded before Flop
Seat 6: Aleksey K228 folded before Flop (didn't bet)



PokerStars Hand #166667465490:  Hold'em No Limit ($0.05/$0.10 USD) - 2017/02/23 16:01:39 ET
Table 'Selinur' 6-max Seat #4 is the button
Seat 1: KA3AXCTAHEU, ($10 in chips) 
Seat 2: jamalungma ($10.23 in chips) 
Seat 3: bambolejro ($10.52 in chips) 
Seat 4: freezing666 ($11.63 in chips) 
Seat 5: IAntikI ($10.27 in chips) 
Seat 6: homelessdan ($17.30 in chips) 
IAntikI: posts small blind $0.05
homelessdan: posts big blind $0.10
*** HOLE CARDS ***
KA3AXCTAHEU,: folds 
jamalungma: raises $0.15 to $0.25
bambolejro: folds 
freezing666: folds 
IAntikI: folds 
homelessdan: calls $0.15
*** FLOP *** [5c 4s 9c]
homelessdan: checks 
jamalungma: bets $0.27
homelessdan: raises $0.73 to $1
jamalungma: folds 
Uncalled bet ($0.73) returned to homelessdan
homelessdan collected $1.04 from pot
*** SUMMARY ***
Total pot $1.09 | Rake $0.05 
Board [5c 4s 9c]
Seat 1: KA3AXCTAHEU, folded before Flop (didn't bet)
Seat 2: jamalungma folded on the Flop
Seat 3: bambolejro folded before Flop (didn't bet)
Seat 4: freezing666 (button) folded before Flop (didn't bet)
Seat 5: IAntikI (small blind) folded before Flop
Seat 6: homelessdan (big blind) collected ($1.04)



PokerStars Hand #166667465491:  Hold'em No Limit ($0.05/$0.10 USD) - 2017/02/23 16:01:39 ET
Table 'Tomyris II' 6-max Seat #4 is the button
Seat 1: ArcticBearDK ($22.13 in chips) 
Seat 3: robertsabb ($11.37 in chips) 
Seat 4: Dcaro31 ($10 in chips) 
Seat 5: joewatson90 ($12.10 in chips) 
Seat 6: StackSmakka ($12.37 in chips) 
joewatson90: posts small blind $0.05
StackSmakka: posts big blind $0.10
Yspenyanin: sits out 
*** HOLE CARDS ***
ArcticBearDK: folds 
robertsabb: raises $0.20 to $0.30
Dcaro31: folds 
joewatson90: folds 
StackSmakka: folds 
Uncalled bet ($0.20) returned to robertsabb
robertsabb collected $0.25 from pot
*** SUMMARY ***
Total pot $0.25 | Rake $0 
Seat 1: ArcticBearDK folded before Flop (didn't bet)
Seat 3: robertsabb collected ($0.25)
Seat 4: Dcaro31 (button) folded before Flop (didn't bet)
Seat 5: joewatson90 (small blind) folded before Flop
Seat 6: StackSmakka (big blind) folded before Flop



PokerStars Hand #166667465886:  Hold'em No Limit ($0.05/$0.10 USD) - 2017/02/23 16:01:39 ET
Table 'Rosalia' 6-max Seat #1 is the button
Seat 1: Hyd SK ($10 in chips) 
Seat 2: Bandyaev ($11.61 in chips) 
Seat 3: Andy Wolf ($12.48 in chips) 
Seat 5: miron762 ($7.75 in chips) 
Seat 6: facewald ($18.74 in chips) 
Bandyaev: posts small blind $0.05
Andy Wolf: posts big blind $0.10
THIMUCHIN: sits out 
*** HOLE CARDS ***
miron762: folds 
facewald: folds 
Hyd SK: folds 
Bandyaev: raises $0.15 to $0.25
Andy Wolf: calls $0.15
*** FLOP *** [3d 5c 3h]
Bandyaev: checks 
Andy Wolf: checks 
*** TURN *** [3d 5c 3h] [Jd]
Bandyaev: bets $0.32
Andy Wolf: folds 
Uncalled bet ($0.32) returned to Bandyaev
Bandyaev collected $0.48 from pot
*** SUMMARY ***
Total pot $0.50 | Rake $0.02 
Board [3d 5c 3h Jd]
Seat 1: Hyd SK (button) folded before Flop (didn't bet)
Seat 2: Bandyaev (small blind) collected ($0.48)
Seat 3: Andy Wolf (big blind) folded on the Turn
Seat 5: miron762 folded before Flop (didn't bet)
Seat 6: facewald folded before Flop (didn't bet)



PokerStars Hand #166667465892:  Hold'em No Limit ($0.05/$0.10 USD) - 2017/02/23 16:01:39 ET
Table 'Arkab' 6-max Seat #1 is the button
Seat 1: iamkakaroto ($10 in chips) 
Seat 2: aktion4ik ($12.29 in chips) 
Seat 3: sexy_seagull ($10 in chips) 
Seat 4: donkucallme ($17.55 in chips) 
Seat 5: OrionYusupov ($9.29 in chips) 
aktion4ik: posts small blind $0.05
sexy_seagull: posts big blind $0.10
MihaGr: sits out 
*** HOLE CARDS ***
donkucallme: folds 
OrionYusupov: folds 
iamkakaroto: folds 
aktion4ik: raises $0.20 to $0.30
sexy_seagull: folds 
Uncalled bet ($0.20) returned to aktion4ik
aktion4ik collected $0.20 from pot
*** SUMMARY ***
Total pot $0.20 | Rake $0 
Seat 1: iamkakaroto (button) folded before Flop (didn't bet)
Seat 2: aktion4ik (small blind) collected ($0.20)
Seat 3: sexy_seagull (big blind) folded before Flop
Seat 4: donkucallme folded before Flop (didn't bet)
Seat 5: OrionYusupov folded before Flop (didn't bet)



PokerStars Hand #166667465965:  Hold'em No Limit ($0.05/$0.10 USD) - 2017/02/23 16:01:39 ET
Table 'Lorbach' 6-max Seat #2 is the button
Seat 1: LarryTheStar ($11.12 in chips) 
Seat 2: fabadam ($12.33 in chips) 
Seat 3: ArcticBearDK ($11.10 in chips) 
Seat 4: McCleans ($10 in chips) 
Seat 5: Cluckh ($15.37 in chips) 
Seat 6: Worlz ($12.82 in chips) 
ArcticBearDK: posts small blind $0.05
McCleans: posts big blind $0.10
*** HOLE CARDS ***
Cluckh: raises $0.20 to $0.30
Worlz: folds 
LarryTheStar: folds 
fabadam: folds 
ArcticBearDK: folds 
McCleans: calls $0.20
*** FLOP *** [5h Ad Kc]
McCleans: checks 
Cluckh: bets $0.30
McCleans: calls $0.30
*** TURN *** [5h Ad Kc] [4h]
McCleans: checks 
Cluckh: checks 
*** RIVER *** [5h Ad Kc 4h] [Kh]
McCleans: bets $0.50
Cluckh: folds 
Uncalled bet ($0.50) returned to McCleans
McCleans collected $1.19 from pot
*** SUMMARY ***
Total pot $1.25 | Rake $0.06 
Board [5h Ad Kc 4h Kh]
Seat 1: LarryTheStar folded before Flop (didn't bet)
Seat 2: fabadam (button) folded before Flop (didn't bet)
Seat 3: ArcticBearDK (small blind) folded before Flop
Seat 4: McCleans (big blind) collected ($1.19)
Seat 5: Cluckh folded on the River
Seat 6: Worlz folded before Flop (didn't bet)



PokerStars Hand #166667466069:  Hold'em No Limit ($0.05/$0.10 USD) - 2017/02/23 16:01:39 ET
Table 'Torrence II' 6-max Seat #4 is the button
Seat 1: Starbooks ($4 in chips) 
Seat 2: scorpionfish ($16.25 in chips) 
Seat 3: coolisses111 ($9.55 in chips) 
Seat 4: Zooplack ($10.23 in chips) 
Seat 5: Kow6oy ($12.63 in chips) 
Kow6oy: posts small blind $0.05
Andy Wolf: is sitting out 
Starbooks: posts big blind $0.10
*** HOLE CARDS ***
scorpionfish: folds 
coolisses111: folds 
Zooplack: folds 
Kow6oy: raises $0.20 to $0.30
Andy Wolf leaves the table
mhonielsen joins the table at seat #6 
Starbooks: calls $0.20
*** FLOP *** [Ac 7c Tc]
Kow6oy: checks 
Starbooks: checks 
*** TURN *** [Ac 7c Tc] [Th]
Kow6oy: checks 
Starbooks: bets $0.30
Kow6oy: folds 
Uncalled bet ($0.30) returned to Starbooks
Starbooks collected $0.57 from pot
*** SUMMARY ***
Total pot $0.60 | Rake $0.03 
Board [Ac 7c Tc Th]
Seat 1: Starbooks (big blind) collected ($0.57)
Seat 2: scorpionfish folded before Flop (didn't bet)
Seat 3: coolisses111 folded before Flop (didn't bet)
Seat 4: Zooplack (button) folded before Flop (didn't bet)
Seat 5: Kow6oy (small blind) folded on the Turn



PokerStars Hand #166667466206:  Hold'em No Limit ($0.05/$0.10 USD) - 2017/02/23 16:01:39 ET
Table 'Pirola III' 6-max Seat #4 is the button
Seat 1: bdixon_5 ($9.92 in chips) 
Seat 2: gaHy_HaXeP ($10 in chips) 
Seat 3: kingartur222 ($10.22 in chips) 
Seat 4: McCleans ($10.30 in chips) 
Seat 6: T9MS ($10 in chips) 
tequila_joop will be allowed to play after the button
T9MS: posts small blind $0.05
bdixon_5: posts big blind $0.10
*** HOLE CARDS ***
gaHy_HaXeP: folds 
kingartur222: folds 
McCleans: raises $0.15 to $0.25
T9MS: folds 
bdixon_5: folds 
Uncalled bet ($0.15) returned to McCleans
McCleans collected $0.25 from pot
*** SUMMARY ***
Total pot $0.25 | Rake $0 
Seat 1: bdixon_5 (big blind) folded before Flop
Seat 2: gaHy_HaXeP folded before Flop (didn't bet)
Seat 3: kingartur222 folded before Flop (didn't bet)
Seat 4: McCleans (button) collected ($0.25)
Seat 6: T9MS (small blind) folded before Flop



PokerStars Hand #166667466215:  Hold'em No Limit ($0.05/$0.10 USD) - 2017/02/23 16:01:39 ET
Table 'Rotraut' 6-max Seat #6 is the button
Seat 1: Hypermetal ($13.39 in chips) 
Seat 2: Newqbrown ($10.78 in chips) 
Seat 3: FlackoD ($12.05 in chips) 
Seat 4: Darkfrai ($10 in chips) 
Seat 5: Bird et al ($11.75 in chips) 
Seat 6: KokoulinV ($12.99 in chips) 
Hypermetal: posts small blind $0.05
Newqbrown: posts big blind $0.10
*** HOLE CARDS ***
FlackoD: raises $0.10 to $0.20
Darkfrai: calls $0.20
Bird et al: folds 
KokoulinV: folds 
Hypermetal: folds 
Newqbrown: calls $0.10
*** FLOP *** [9h Ks Js]
Newqbrown: checks 
FlackoD: bets $0.40
Darkfrai: folds 
Newqbrown: folds 
Uncalled bet ($0.40) returned to FlackoD
FlackoD collected $0.62 from pot
*** SUMMARY ***
Total pot $0.65 | Rake $0.03 
Board [9h Ks Js]
Seat 1: Hypermetal (small blind) folded before Flop
Seat 2: Newqbrown (big blind) folded on the Flop
Seat 3: FlackoD collected ($0.62)
Seat 4: Darkfrai folded on the Flop
Seat 5: Bird et al folded before Flop (didn't bet)
Seat 6: KokoulinV (button) folded before Flop (didn't bet)



PokerStars Hand #166667466385:  Hold'em No Limit ($0.05/$0.10 USD) - 2017/02/23 16:01:40 ET
Table 'Caupolican II' 6-max Seat #6 is the button
Seat 1: Strelok1974 ($10 in chips) 
Seat 2: MBen10 ($19.15 in chips) 
Seat 3: fedorka rus ($13.08 in chips) 
Seat 4: GESPERIA ($22.77 in chips) 
Seat 5: ArcticBearDK ($14.44 in chips) 
Seat 6: pancernik21 ($14.07 in chips) 
Strelok1974: posts small blind $0.05
MBen10: posts big blind $0.10
*** HOLE CARDS ***
fedorka rus: raises $0.20 to $0.30
GESPERIA: folds 
ArcticBearDK: folds 
pancernik21: folds 
Strelok1974: folds 
MBen10: calls $0.20
*** FLOP *** [Jc 5h Jd]
MBen10: checks 
fedorka rus: checks 
*** TURN *** [Jc 5h Jd] [Ac]
MBen10: checks 
fedorka rus: checks 
*** RIVER *** [Jc 5h Jd Ac] [4c]
MBen10: bets $0.25
fedorka rus: calls $0.25
*** SHOW DOWN ***
MBen10: shows [9d As] (two pair, Aces and Jacks)
fedorka rus: mucks hand 
MBen10 collected $1.10 from pot
*** SUMMARY ***
Total pot $1.15 | Rake $0.05 
Board [Jc 5h Jd Ac 4c]
Seat 1: Strelok1974 (small blind) folded before Flop
Seat 2: MBen10 (big blind) showed [9d As] and won ($1.10) with two pair, Aces and Jacks
Seat 3: fedorka rus mucked
Seat 4: GESPERIA folded before Flop (didn't bet)
Seat 5: ArcticBearDK folded before Flop (didn't bet)
Seat 6: pancernik21 (button) folded before Flop (didn't bet)



PokerStars Hand #166667466404:  Hold'em No Limit ($0.05/$0.10 USD) - 2017/02/23 16:01:40 ET
Table 'Lesath III' 6-max Seat #2 is the button
Seat 1: Gogeta26 ($6.97 in chips) 
Seat 2: WinninBikini ($10.03 in chips) 
Seat 3: Giyorod ($10.05 in chips) 
Seat 4: Eddys Edge ($10 in chips) 
Seat 5: eniksenik ($15.49 in chips) 
Seat 6: patrick19111 ($10.71 in chips) 
Giyorod: posts small blind $0.05
Eddys Edge: posts big blind $0.10
*** HOLE CARDS ***
eniksenik: raises $0.20 to $0.30
patrick19111: folds 
Gogeta26: folds 
WinninBikini: folds 
Giyorod: folds 
Eddys Edge: folds 
Uncalled bet ($0.20) returned to eniksenik
eniksenik collected $0.25 from pot
*** SUMMARY ***
Total pot $0.25 | Rake $0 
Seat 1: Gogeta26 folded before Flop (didn't bet)
Seat 2: WinninBikini (button) folded before Flop (didn't bet)
Seat 3: Giyorod (small blind) folded before Flop
Seat 4: Eddys Edge (big blind) folded before Flop
Seat 5: eniksenik collected ($0.25)
Seat 6: patrick19111 folded before Flop (didn't bet)



PokerStars Hand #166667466599:  Hold'em No Limit ($0.05/$0.10 USD) - 2017/02/23 16:01:40 ET
Table 'Lederle' 6-max Seat #4 is the button
Seat 1: D3NyA ($10 in chips) 
Seat 2: truck1234 ($16 in chips) 
Seat 3: Kazacha ($10.35 in chips) 
Seat 4: Pokeaster ($13.61 in chips) 
Seat 5: 8th wonders ($13.11 in chips) 
Seat 6: pokekrk ($10.15 in chips) 
8th wonders: posts small blind $0.05
pokekrk: posts big blind $0.10
*** HOLE CARDS ***
D3NyA: folds 
truck1234: folds 
Kazacha: folds 
Pokeaster: folds 
8th wonders: raises $0.20 to $0.30
pokekrk: raises $0.75 to $1.05
8th wonders: raises $2.10 to $3.15
pokekrk: folds 
Uncalled bet ($2.10) returned to 8th wonders
8th wonders collected $2.10 from pot
*** SUMMARY ***
Total pot $2.10 | Rake $0 
Seat 1: D3NyA folded before Flop (didn't bet)
Seat 2: truck1234 folded before Flop (didn't bet)
Seat 3: Kazacha folded before Flop (didn't bet)
Seat 4: Pokeaster (button) folded before Flop (didn't bet)
Seat 5: 8th wonders (small blind) collected ($2.10)
Seat 6: pokekrk (big blind) folded before Flop



PokerStars Hand #166667466767:  Hold'em No Limit ($0.05/$0.10 USD) - 2017/02/23 16:01:40 ET
Table 'Samitchell III' 6-max Seat #2 is the button
Seat 1: dr.goofy ($10.27 in chips) 
Seat 2: Orlangoor ($10 in chips) 
Seat 3: Kow6oy ($10 in chips) 
Seat 4: eniksenik ($10.25 in chips) 
Seat 5: boxer821 ($18.31 in chips) 
Seat 6: fedorka rus ($13.11 in chips) 
Kow6oy: posts small blind $0.05
eniksenik: posts big blind $0.10
*** HOLE CARDS ***
boxer821: folds 
fedorka rus: folds 
dr.goofy: folds 
Orlangoor: folds 
Kow6oy: raises $0.20 to $0.30
eniksenik: calls $0.20
*** FLOP *** [7d 7c Jh]
Kow6oy: checks 
eniksenik: checks 
*** TURN *** [7d 7c Jh] [6c]
Kow6oy: checks 
eniksenik: bets $0.31
Kow6oy: folds 
Uncalled bet ($0.31) returned to eniksenik
eniksenik collected $0.57 from pot
*** SUMMARY ***
Total pot $0.60 | Rake $0.03 
Board [7d 7c Jh 6c]
Seat 1: dr.goofy folded before Flop (didn't bet)
Seat 2: Orlangoor (button) folded before Flop (didn't bet)
Seat 3: Kow6oy (small blind) folded on the Turn
Seat 4: eniksenik (big blind) collected ($0.57)
Seat 5: boxer821 folded before Flop (didn't bet)
Seat 6: fedorka rus folded before Flop (didn't bet)



PokerStars Hand #166667467377:  Hold'em No Limit ($0.05/$0.10 USD) - 2017/02/23 16:01:41 ET
Table 'Scabiosa III' 6-max Seat #1 is the button
Seat 1: Feverhead ($13.26 in chips) 
Seat 2: kinaó ($13 in chips) 
Seat 3: Goroshkos88 ($11.40 in chips) 
Seat 4: voledy ($10 in chips) 
Seat 5: patrick19111 ($24.75 in chips) 
Seat 6: Smitty03300 ($10 in chips) 
kinaó: posts small blind $0.05
Goroshkos88: posts big blind $0.10
*** HOLE CARDS ***
voledy: folds 
patrick19111: folds 
Smitty03300: folds 
Feverhead: folds 
kinaó: folds 
Uncalled bet ($0.05) returned to Goroshkos88
Goroshkos88 collected $0.10 from pot
*** SUMMARY ***
Total pot $0.10 | Rake $0 
Seat 1: Feverhead (button) folded before Flop (didn't bet)
Seat 2: kinaó (small blind) folded before Flop
Seat 3: Goroshkos88 (big blind) collected ($0.10)
Seat 4: voledy folded before Flop (didn't bet)
Seat 5: patrick19111 folded before Flop (didn't bet)
Seat 6: Smitty03300 folded before Flop (didn't bet)



PokerStars Hand #166667467633:  Hold'em No Limit ($0.05/$0.10 USD) - 2017/02/23 16:01:41 ET
Table 'Union' 6-max Seat #6 is the button
Seat 1: Krumi1703 ($6.47 in chips) 
Seat 2: Zooplack ($10 in chips) 
Seat 3: Rodik002 ($12.16 in chips) 
Seat 4: Croplayer1 ($14.31 in chips) 
Seat 5: Chodemuncher ($10 in chips) 
Seat 6: bonyo71 ($3.85 in chips) 
Krumi1703: posts small blind $0.05
Zooplack: posts big blind $0.10
*** HOLE CARDS ***
Rodik002: folds 
Croplayer1: raises $0.20 to $0.30
Chodemuncher: folds 
bonyo71: folds 
Krumi1703: calls $0.25
Zooplack: folds 
*** FLOP *** [5d 2s 7s]
Krumi1703: bets $0.30
Croplayer1: raises $0.64 to $0.94
Krumi1703: folds 
Uncalled bet ($0.64) returned to Croplayer1
Croplayer1 collected $1.24 from pot
*** SUMMARY ***
Total pot $1.30 | Rake $0.06 
Board [5d 2s 7s]
Seat 1: Krumi1703 (small blind) folded on the Flop
Seat 2: Zooplack (big blind) folded before Flop
Seat 3: Rodik002 folded before Flop (didn't bet)
Seat 4: Croplayer1 collected ($1.24)
Seat 5: Chodemuncher folded before Flop (didn't bet)
Seat 6: bonyo71 (button) folded before Flop (didn't bet)



PokerStars Hand #166667467657:  Hold'em No Limit ($0.05/$0.10 USD) - 2017/02/23 16:01:41 ET
Table 'Pandora III' 6-max Seat #2 is the button
Seat 1: Pokeaster ($10.99 in chips) 
Seat 2: garigura ($11.77 in chips) 
Seat 3: ChuikaPridi ($16.51 in chips) 
Seat 4: mhonielsen ($10 in chips) 
Seat 5: MühliJr ($10.15 in chips) 
ChuikaPridi: posts small blind $0.05
mhonielsen: posts big blind $0.10
yodzik: sits out 
*** HOLE CARDS ***
MühliJr: folds 
Pokeaster: folds 
garigura: folds 
ChuikaPridi: raises $0.20 to $0.30
mhonielsen: calls $0.20
*** FLOP *** [5s As 2d]
ChuikaPridi: bets $0.30
mhonielsen: folds 
Uncalled bet ($0.30) returned to ChuikaPridi
ChuikaPridi collected $0.57 from pot
*** SUMMARY ***
Total pot $0.60 | Rake $0.03 
Board [5s As 2d]
Seat 1: Pokeaster folded before Flop (didn't bet)
Seat 2: garigura (button) folded before Flop (didn't bet)
Seat 3: ChuikaPridi (small blind) collected ($0.57)
Seat 4: mhonielsen (big blind) folded on the Flop
Seat 5: MühliJr folded before Flop (didn't bet)



PokerStars Hand #166667468241:  Hold'em No Limit ($0.05/$0.10 USD) - 2017/02/23 16:01:42 ET
Table 'Atalante' 6-max Seat #1 is the button
Seat 1: OceanBlue100 ($5.09 in chips) 
Seat 2: CiisCi ($24.42 in chips) 
Seat 3: Kow6oy ($10 in chips) 
Seat 4: Dcaro31 ($25.22 in chips) 
Seat 5: eniksenik ($10.29 in chips) 
Seat 6: FlopsterGB ($25.90 in chips) 
CiisCi: posts small blind $0.05
Kow6oy: posts big blind $0.10
*** HOLE CARDS ***
Dcaro31: folds 
eniksenik: folds 
FlopsterGB: raises $0.20 to $0.30
OceanBlue100: folds 
CiisCi: raises $0.70 to $1
Kow6oy: folds 
FlopsterGB: raises $1.40 to $2.40
CiisCi: calls $1.40
*** FLOP *** [2s 3h 4h]
CiisCi: checks 
FlopsterGB: bets $2.25
CiisCi: calls $2.25
*** TURN *** [2s 3h 4h] [Jd]
CiisCi: checks 
FlopsterGB: checks 
*** RIVER *** [2s 3h 4h Jd] [Ks]
CiisCi: checks 
FlopsterGB: checks 
*** SHOW DOWN ***
CiisCi: shows [6h 6d] (a pair of Sixes)
FlopsterGB: shows [Qh Qs] (a pair of Queens)
FlopsterGB collected $8.98 from pot
*** SUMMARY ***
Total pot $9.40 | Rake $0.42 
Board [2s 3h 4h Jd Ks]
Seat 1: OceanBlue100 (button) folded before Flop (didn't bet)
Seat 2: CiisCi (small blind) showed [6h 6d] and lost with a pair of Sixes
Seat 3: Kow6oy (big blind) folded before Flop
Seat 4: Dcaro31 folded before Flop (didn't bet)
Seat 5: eniksenik folded before Flop (didn't bet)
Seat 6: FlopsterGB showed [Qh Qs] and won ($8.98) with a pair of Queens



PokerStars Hand #166667468243:  Hold'em No Limit ($0.05/$0.10 USD) - 2017/02/23 16:01:42 ET
Table 'Izar' 6-max Seat #1 is the button
Seat 1: bambolejro ($10.39 in chips) 
Seat 2: mvp0013 ($10.62 in chips) 
Seat 3: Yspenyanin ($11.05 in chips) 
Seat 4: Matee92 ($6.86 in chips) 
Seat 5: fishhook5 ($10.35 in chips) 
mvp0013: posts small blind $0.05
Yspenyanin: posts big blind $0.10
yodzik: sits out 
*** HOLE CARDS ***
Matee92: folds 
fishhook5: folds 
bambolejro: raises $0.15 to $0.25
mvp0013: folds 
Yspenyanin: folds 
Uncalled bet ($0.15) returned to bambolejro
bambolejro collected $0.25 from pot
*** SUMMARY ***
Total pot $0.25 | Rake $0 
Seat 1: bambolejro (button) collected ($0.25)
Seat 2: mvp0013 (small blind) folded before Flop
Seat 3: Yspenyanin (big blind) folded before Flop
Seat 4: Matee92 folded before Flop (didn't bet)
Seat 5: fishhook5 folded before Flop (didn't bet)



PokerStars Hand #166667468310:  Hold'em No Limit ($0.05/$0.10 USD) - 2017/02/23 16:01:42 ET
Table 'Kunigunde II' 6-max Seat #2 is the button
Seat 1: facewald ($10.11 in chips) 
Seat 2: dragonste89 ($14.88 in chips) 
Seat 3: pancernik21 ($14.81 in chips) 
Seat 4: david_sara83 ($12.83 in chips) 
Seat 5: mdelfin0 ($11.59 in chips) 
Seat 6: Zooplack ($10 in chips) 
pancernik21: posts small blind $0.05
david_sara83: posts big blind $0.10
*** HOLE CARDS ***
mdelfin0: folds 
Zooplack: folds 
facewald: folds 
dragonste89: folds 
pancernik21: folds 
Uncalled bet ($0.05) returned to david_sara83
david_sara83 collected $0.10 from pot
*** SUMMARY ***
Total pot $0.10 | Rake $0 
Seat 1: facewald folded before Flop (didn't bet)
Seat 2: dragonste89 (button) folded before Flop (didn't bet)
Seat 3: pancernik21 (small blind) folded before Flop
Seat 4: david_sara83 (big blind) collected ($0.10)
Seat 5: mdelfin0 folded before Flop (didn't bet)
Seat 6: Zooplack folded before Flop (didn't bet)



PokerStars Hand #166667468660:  Hold'em No Limit ($0.05/$0.10 USD) - 2017/02/23 16:01:42 ET
Table 'Eudora' 6-max Seat #1 is the button
Seat 1: archer2511 ($10.63 in chips) 
Seat 2: popypaleta ($10 in chips) 
Seat 3: Ice_Isayev ($10 in chips) 
Seat 4: ZZPAWN ($10.95 in chips) 
Seat 5: chimera252 ($11.52 in chips) 
Seat 6: HARDCORE66RU ($10 in chips) 
popypaleta: posts small blind $0.05
Ice_Isayev: posts big blind $0.10
*** HOLE CARDS ***
ZZPAWN: folds 
chimera252: folds 
HARDCORE66RU: folds 
archer2511: raises $0.20 to $0.30
ZZPAWN leaves the table
popypaleta: folds 
Ice_Isayev: raises $0.70 to $1
archer2511: folds 
Uncalled bet ($0.70) returned to Ice_Isayev
Ice_Isayev collected $0.65 from pot
*** SUMMARY ***
Total pot $0.65 | Rake $0 
Seat 1: archer2511 (button) folded before Flop
Seat 2: popypaleta (small blind) folded before Flop
Seat 3: Ice_Isayev (big blind) collected ($0.65)
Seat 4: ZZPAWN folded before Flop (didn't bet)
Seat 5: chimera252 folded before Flop (didn't bet)
Seat 6: HARDCORE66RU folded before Flop (didn't bet)



PokerStars Hand #166667468741:  Hold'em No Limit ($0.05/$0.10 USD) - 2017/02/23 16:01:42 ET
Table 'Oongaq' 6-max Seat #2 is the button
Seat 1: Dmitrij218 ($13.60 in chips) 
Seat 2: homelessdan ($19.05 in chips) 
Seat 3: iDecMate ($10 in chips) 
Seat 4: Bird et al ($10 in chips) 
Seat 5: Dizzler1991 ($4.27 in chips) 
Seat 6: boxer821 ($10 in chips) 
iDecMate: posts small blind $0.05
Bird et al: posts big blind $0.10
*** HOLE CARDS ***
Dizzler1991: calls $0.10
boxer821: folds 
Dmitrij218: folds 
homelessdan: folds 
iDecMate: folds 
Bird et al: checks 
*** FLOP *** [Qd 5s 4h]
Bird et al: checks 
Dizzler1991: checks 
*** TURN *** [Qd 5s 4h] [8d]
Bird et al: checks 
Dizzler1991: checks 
*** RIVER *** [Qd 5s 4h 8d] [3h]
Bird et al: checks 
Dizzler1991: checks 
*** SHOW DOWN ***
Bird et al: shows [Js 9c] (high card Queen)
Dizzler1991: shows [Kh Th] (high card King)
Dizzler1991 collected $0.24 from pot
*** SUMMARY ***
Total pot $0.25 | Rake $0.01 
Board [Qd 5s 4h 8d 3h]
Seat 1: Dmitrij218 folded before Flop (didn't bet)
Seat 2: homelessdan (button) folded before Flop (didn't bet)
Seat 3: iDecMate (small blind) folded before Flop
Seat 4: Bird et al (big blind) showed [Js 9c] and lost with high card Queen
Seat 5: Dizzler1991 showed [Kh Th] and won ($0.24) with high card King
Seat 6: boxer821 folded before Flop (didn't bet)



PokerStars Hand #166667468991:  Hold'em No Limit ($0.05/$0.10 USD) - 2017/02/23 16:01:43 ET
Table 'Tristan III' 6-max Seat #3 is the button
Seat 1: CHRO8 ($20.35 in chips) 
Seat 2: Hyd SK ($15.38 in chips) 
Seat 3: fedorka rus ($13.05 in chips) 
Seat 4: Feverhead ($11.58 in chips) 
Seat 5: david_sara83 ($10.76 in chips) 
Seat 6: joewatson90 ($10 in chips) 
Feverhead: posts small blind $0.05
david_sara83: posts big blind $0.10
*** HOLE CARDS ***
joewatson90: raises $0.20 to $0.30
CHRO8: calls $0.30
Hyd SK: raises $1.05 to $1.35
fedorka rus: calls $1.35
Feverhead: folds 
david_sara83: folds 
joewatson90: calls $1.05
CHRO8: calls $1.05
*** FLOP *** [9c 5h Ad]
joewatson90: bets $2.86
joewatson90 said, "shi.t"
CHRO8: folds 
Hyd SK: folds 
fedorka rus: calls $2.86
*** TURN *** [9c 5h Ad] [Th]
joewatson90: bets $5.79 and is all-in
fedorka rus: calls $5.79
*** RIVER *** [9c 5h Ad Th] [2d]
*** SHOW DOWN ***
joewatson90: shows [7s 6s] (high card Ace)
fedorka rus: shows [As Ac] (three of a kind, Aces)
fedorka rus collected $21.82 from pot
*** SUMMARY ***
Total pot $22.85 | Rake $1.03 
Board [9c 5h Ad Th 2d]
Seat 1: CHRO8 folded on the Flop
Seat 2: Hyd SK folded on the Flop
Seat 3: fedorka rus (button) showed [As Ac] and won ($21.82) with three of a kind, Aces
Seat 4: Feverhead (small blind) folded before Flop
Seat 5: david_sara83 (big blind) folded before Flop
Seat 6: joewatson90 showed [7s 6s] and lost with high card Ace



PokerStars Hand #166667469408:  Hold'em No Limit ($0.05/$0.10 USD) - 2017/02/23 16:01:43 ET
Table 'Kobresia II' 6-max Seat #6 is the button
Seat 1: RoJ1 ($14.01 in chips) 
Seat 2: Dcaro31 ($13.44 in chips) 
Seat 3: FRAID358 ($10.84 in chips) 
Seat 4: armstv ($10.87 in chips) 
Seat 5: Goroshkos88 ($11.89 in chips) 
Seat 6: WinninBikini ($10 in chips) 
RoJ1: posts small blind $0.05
Dcaro31: posts big blind $0.10
*** HOLE CARDS ***
FRAID358: folds 
armstv: folds 
Goroshkos88: folds 
WinninBikini: folds 
RoJ1: folds 
Uncalled bet ($0.05) returned to Dcaro31
Dcaro31 collected $0.10 from pot
*** SUMMARY ***
Total pot $0.10 | Rake $0 
Seat 1: RoJ1 (small blind) folded before Flop
Seat 2: Dcaro31 (big blind) collected ($0.10)
Seat 3: FRAID358 folded before Flop (didn't bet)
Seat 4: armstv folded before Flop (didn't bet)
Seat 5: Goroshkos88 folded before Flop (didn't bet)
Seat 6: WinninBikini (button) folded before Flop (didn't bet)



PokerStars Hand #166667469435:  Hold'em No Limit ($0.05/$0.10 USD) - 2017/02/23 16:01:43 ET
Table 'Hercynia III' 6-max Seat #4 is the button
Seat 1: Bird et al ($14.73 in chips) 
Seat 2: Action_Gibi ($9.20 in chips) 
Seat 3: Dcaro31 ($20.54 in chips) 
Seat 4: Darkfrai ($16.21 in chips) 
Seat 5: THIMUCHIN ($14.84 in chips) 
Seat 6: bdixon_5 ($10.87 in chips) 
THIMUCHIN: posts small blind $0.05
bdixon_5: posts big blind $0.10
*** HOLE CARDS ***
Bird et al: folds 
Action_Gibi: folds 
Dcaro31: folds 
Darkfrai: raises $0.15 to $0.25
THIMUCHIN: folds 
bdixon_5: folds 
Uncalled bet ($0.15) returned to Darkfrai
Darkfrai collected $0.25 from pot
*** SUMMARY ***
Total pot $0.25 | Rake $0 
Seat 1: Bird et al folded before Flop (didn't bet)
Seat 2: Action_Gibi folded before Flop (didn't bet)
Seat 3: Dcaro31 folded before Flop (didn't bet)
Seat 4: Darkfrai (button) collected ($0.25)
Seat 5: THIMUCHIN (small blind) folded before Flop
Seat 6: bdixon_5 (big blind) folded before Flop



PokerStars Hand #166667469515:  Hold'em No Limit ($0.05/$0.10 USD) - 2017/02/23 16:01:43 ET
Table 'Girtab' 6-max Seat #2 is the button
Seat 2: MühliJr ($11.36 in chips) 
Seat 3: kingartur222 ($11.70 in chips) 
Seat 4: Hyd SK ($11.65 in chips) 
Seat 5: sexy_seagull ($10.87 in chips) 
Seat 6: BahiaMinhaP ($10 in chips) 
kingartur222: posts small blind $0.05
Hyd SK: posts big blind $0.10
pokekrk: sits out 
*** HOLE CARDS ***
sexy_seagull: folds 
BahiaMinhaP: raises $0.20 to $0.30
MühliJr: folds 
kingartur222: folds 
Hyd SK: folds 
Uncalled bet ($0.20) returned to BahiaMinhaP
BahiaMinhaP collected $0.25 from pot
*** SUMMARY ***
Total pot $0.25 | Rake $0 
Seat 2: MühliJr (button) folded before Flop (didn't bet)
Seat 3: kingartur222 (small blind) folded before Flop
Seat 4: Hyd SK (big blind) folded before Flop
Seat 5: sexy_seagull folded before Flop (didn't bet)
Seat 6: BahiaMinhaP collected ($0.25)



PokerStars Hand #166667470163:  Hold'em No Limit ($0.05/$0.10 USD) - 2017/02/23 16:01:44 ET
Table 'Clavel' 6-max Seat #1 is the button
Seat 1: KRZuff ($14.73 in chips) 
Seat 2: RoJ1 ($12.27 in chips) 
Seat 4: Dcaro31 ($11.96 in chips) 
Seat 5: Vrinni ($10.54 in chips) 
Seat 6: Gra_anD77 ($3.86 in chips) 
RoJ1: posts small blind $0.05
Darkfrai: is sitting out 
Dcaro31: posts big blind $0.10
*** HOLE CARDS ***
Vrinni: folds 
Gra_anD77: folds 
KRZuff: folds 
RoJ1: raises $0.15 to $0.25
Dcaro31: folds 
Uncalled bet ($0.15) returned to RoJ1
RoJ1 collected $0.20 from pot
*** SUMMARY ***
Total pot $0.20 | Rake $0 
Seat 1: KRZuff (button) folded before Flop (didn't bet)
Seat 2: RoJ1 (small blind) collected ($0.20)
Seat 4: Dcaro31 (big blind) folded before Flop
Seat 5: Vrinni folded before Flop (didn't bet)
Seat 6: Gra_anD77 folded before Flop (didn't bet)



PokerStars Hand #166667470248:  Hold'em No Limit ($0.05/$0.10 USD) - 2017/02/23 16:01:44 ET
Table 'Lehigh' 6-max Seat #4 is the button
Seat 1: kowe4ka565 ($10.30 in chips) 
Seat 2: EggMayo ($10.19 in chips) 
Seat 3: Therodorus ($10 in chips) 
Seat 4: Chodemuncher ($10.20 in chips) 
Seat 5: Xander188 ($10 in chips) 
Seat 6: CallByValue ($9.60 in chips) 
Xander188: posts small blind $0.05
CallByValue: posts big blind $0.10
*** HOLE CARDS ***
kowe4ka565: folds 
EggMayo: raises $0.20 to $0.30
Therodorus: raises $0.60 to $0.90
Chodemuncher: folds 
Xander188: folds 
CallByValue: folds 
EggMayo: folds 
Uncalled bet ($0.60) returned to Therodorus
Therodorus collected $0.75 from pot
*** SUMMARY ***
Total pot $0.75 | Rake $0 
Seat 1: kowe4ka565 folded before Flop (didn't bet)
Seat 2: EggMayo folded before Flop
Seat 3: Therodorus collected ($0.75)
Seat 4: Chodemuncher (button) folded before Flop (didn't bet)
Seat 5: Xander188 (small blind) folded before Flop
Seat 6: CallByValue (big blind) folded before Flop



PokerStars Hand #166667470396:  Hold'em No Limit ($0.05/$0.10 USD) - 2017/02/23 16:01:44 ET
Table 'Nauheima II' 6-max Seat #3 is the button
Seat 1: HARDCORE66RU ($17.89 in chips) 
Seat 2: Peter0087 ($9.59 in chips) 
Seat 3: KokoulinV ($13.74 in chips) 
Seat 4: Innerwuss ($10.17 in chips) 
Seat 5: Kow6oy ($10.60 in chips) 
Seat 6: bonyo71 ($5.04 in chips) 
Innerwuss: posts small blind $0.05
Kow6oy: posts big blind $0.10
*** HOLE CARDS ***
bonyo71: raises $0.20 to $0.30
HARDCORE66RU: folds 
Peter0087: folds 
KokoulinV: folds 
Innerwuss: folds 
Kow6oy: folds 
Uncalled bet ($0.20) returned to bonyo71
bonyo71 collected $0.25 from pot
*** SUMMARY ***
Total pot $0.25 | Rake $0 
Seat 1: HARDCORE66RU folded before Flop (didn't bet)
Seat 2: Peter0087 folded before Flop (didn't bet)
Seat 3: KokoulinV (button) folded before Flop (didn't bet)
Seat 4: Innerwuss (small blind) folded before Flop
Seat 5: Kow6oy (big blind) folded before Flop
Seat 6: bonyo71 collected ($0.25)



PokerStars Hand #166667470426:  Hold'em No Limit ($0.05/$0.10 USD) - 2017/02/23 16:01:44 ET
Table 'Huberta II' 6-max Seat #1 is the button
Seat 1: tr41n3r12 ($10 in chips) 
Seat 2: Ice_Isayev ($12.53 in chips) 
Seat 3: patrick19111 ($10.90 in chips) 
Seat 4: VAD21 ($11.38 in chips) 
Seat 5: Feverhead ($27.38 in chips) 
Ice_Isayev: posts small blind $0.05
patrick19111: posts big blind $0.10
*** HOLE CARDS ***
VAD21: folds 
Feverhead: raises $0.15 to $0.25
tr41n3r12: folds 
Ice_Isayev: raises $0.65 to $0.90
patrick19111: folds 
Feverhead: folds 
Uncalled bet ($0.65) returned to Ice_Isayev
Ice_Isayev collected $0.60 from pot
*** SUMMARY ***
Total pot $0.60 | Rake $0 
Seat 1: tr41n3r12 (button) folded before Flop (didn't bet)
Seat 2: Ice_Isayev (small blind) collected ($0.60)
Seat 3: patrick19111 (big blind) folded before Flop
Seat 4: VAD21 folded before Flop (didn't bet)
Seat 5: Feverhead folded before Flop



PokerStars Hand #166667470615:  Hold'em No Limit ($0.05/$0.10 USD) - 2017/02/23 16:01:45 ET
Table 'Antielus II' 6-max Seat #5 is the button
Seat 1: Dcaro31 ($17.30 in chips) 
Seat 2: Orlangoor ($10.80 in chips) 
Seat 3: mcyi3at2 ($12.89 in chips) 
Seat 5: Hyd SK ($10 in chips) 
Seat 6: GiveTwoMe ($12.13 in chips) 
GiveTwoMe: posts small blind $0.05
Dcaro31: posts big blind $0.10
XwinX25: sits out 
*** HOLE CARDS ***
Orlangoor: folds 
mcyi3at2: folds 
Hyd SK: folds 
GiveTwoMe: folds 
Uncalled bet ($0.05) returned to Dcaro31
Dcaro31 collected $0.10 from pot
*** SUMMARY ***
Total pot $0.10 | Rake $0 
Seat 1: Dcaro31 (big blind) collected ($0.10)
Seat 2: Orlangoor folded before Flop (didn't bet)
Seat 3: mcyi3at2 folded before Flop (didn't bet)
Seat 5: Hyd SK (button) folded before Flop (didn't bet)
Seat 6: GiveTwoMe (small blind) folded before Flop



PokerStars Hand #166667470648:  Hold'em No Limit ($0.05/$0.10 USD) - 2017/02/23 16:01:45 ET
Table 'Klotho II' 6-max Seat #5 is the button
Seat 1: Alexey74516 ($7.67 in chips) 
Seat 3: Zooplack ($10.41 in chips) 
Seat 4: Lucky HoBBiT ($10.83 in chips) 
Seat 5: david_sara83 ($15.64 in chips) 
Seat 6: D3NyA ($11.62 in chips) 
D3NyA: posts small blind $0.05
Alexey74516: posts big blind $0.10
kickereens: sits out 
*** HOLE CARDS ***
Zooplack: raises $0.20 to $0.30
Lucky HoBBiT: folds 
david_sara83: folds 
D3NyA: folds 
Alexey74516: calls $0.20
*** FLOP *** [2d 8d Qs]
Alexey74516: checks 
Zooplack: bets $0.37
Alexey74516: folds 
Uncalled bet ($0.37) returned to Zooplack
Zooplack collected $0.62 from pot
*** SUMMARY ***
Total pot $0.65 | Rake $0.03 
Board [2d 8d Qs]
Seat 1: Alexey74516 (big blind) folded on the Flop
Seat 3: Zooplack collected ($0.62)
Seat 4: Lucky HoBBiT folded before Flop (didn't bet)
Seat 5: david_sara83 (button) folded before Flop (didn't bet)
Seat 6: D3NyA (small blind) folded before Flop



PokerStars Hand #166667470703:  Hold'em No Limit ($0.05/$0.10 USD) - 2017/02/23 16:01:45 ET
Table 'Manto II' 6-max Seat #3 is the button
Seat 2: voledy ($10 in chips) 
Seat 3: Komap511 ($9.15 in chips) 
Seat 4: dr.goofy ($10.87 in chips) 
Seat 5: ArcticBearDK ($22.35 in chips) 
Seat 6: pancernik21 ($16.85 in chips) 
dr.goofy: posts small blind $0.05
ArcticBearDK: posts big blind $0.10
MihaGr: sits out 
*** HOLE CARDS ***
pancernik21: folds 
voledy: folds 
Komap511: folds 
dr.goofy: folds 
Uncalled bet ($0.05) returned to ArcticBearDK
ArcticBearDK collected $0.10 from pot
*** SUMMARY ***
Total pot $0.10 | Rake $0 
Seat 2: voledy folded before Flop (didn't bet)
Seat 3: Komap511 (button) folded before Flop (didn't bet)
Seat 4: dr.goofy (small blind) folded before Flop
Seat 5: ArcticBearDK (big blind) collected ($0.10)
Seat 6: pancernik21 folded before Flop (didn't bet)



PokerStars Hand #166667470777:  Hold'em No Limit ($0.05/$0.10 USD) - 2017/02/23 16:01:45 ET
Table 'Eurydome II' 6-max Seat #3 is the button
Seat 2: Elinaattor ($10.34 in chips) 
Seat 3: gaHy_HaXeP ($10 in chips) 
Seat 4: Smitty03300 ($10 in chips) 
Seat 5: kush-killa87 ($13.87 in chips) 
Seat 6: Jucatorul823 ($6.45 in chips) 
Smitty03300: posts small blind $0.05
kush-killa87: posts big blind $0.10
*** HOLE CARDS ***
Jucatorul823: folds 
Elinaattor: folds 
gaHy_HaXeP: folds 
Smitty03300: raises $0.15 to $0.25
kush-killa87: calls $0.15
*** FLOP *** [Kc 3d 2s]
Smitty03300: bets $0.40
kush-killa87: folds [Jh]
Uncalled bet ($0.40) returned to Smitty03300
Smitty03300 collected $0.48 from pot
*** SUMMARY ***
Total pot $0.50 | Rake $0.02 
Board [Kc 3d 2s]
Seat 2: Elinaattor folded before Flop (didn't bet)
Seat 3: gaHy_HaXeP (button) folded before Flop (didn't bet)
Seat 4: Smitty03300 (small blind) collected ($0.48)
Seat 5: kush-killa87 (big blind) folded on the Flop
Seat 6: Jucatorul823 folded before Flop (didn't bet)



PokerStars Hand #166667470778:  Hold'em No Limit ($0.05/$0.10 USD) - 2017/02/23 16:01:45 ET
Table 'Ophelia' 6-max Seat #5 is the button
Seat 1: ralfi37 ($11.01 in chips) 
Seat 2: popypaleta ($16.12 in chips) 
Seat 3: mvp0013 ($11.60 in chips) 
Seat 4: Cluckh ($11.65 in chips) 
Seat 5: truck1234 ($14.01 in chips) 
Seat 6: Yabidooo ($10.77 in chips) 
Yabidooo: posts small blind $0.05
ralfi37: posts big blind $0.10
*** HOLE CARDS ***
popypaleta: folds 
mvp0013: folds 
Cluckh: folds 
truck1234: folds 
Yabidooo: calls $0.05
ralfi37: checks 
*** FLOP *** [Jh 5c 6d]
Yabidooo: bets $0.10
ralfi37: folds 
Uncalled bet ($0.10) returned to Yabidooo
Yabidooo collected $0.19 from pot
*** SUMMARY ***
Total pot $0.20 | Rake $0.01 
Board [Jh 5c 6d]
Seat 1: ralfi37 (big blind) folded on the Flop
Seat 2: popypaleta folded before Flop (didn't bet)
Seat 3: mvp0013 folded before Flop (didn't bet)
Seat 4: Cluckh folded before Flop (didn't bet)
Seat 5: truck1234 (button) folded before Flop (didn't bet)
Seat 6: Yabidooo (small blind) collected ($0.19)



PokerStars Hand #166667470918:  Hold'em No Limit ($0.05/$0.10 USD) - 2017/02/23 16:01:45 ET
Table 'Hunnia' 6-max Seat #4 is the button
Seat 1: univibe68 ($21.41 in chips) 
Seat 2: mhonielsen ($10 in chips) 
Seat 4: Jalida3 ($10.61 in chips) 
Seat 5: Smarkon ($14.83 in chips) 
Seat 6: ChuikaPridi ($9.22 in chips) 
Smarkon: posts small blind $0.05
ChuikaPridi: posts big blind $0.10
*** HOLE CARDS ***
iamkakaroto joins the table at seat #3 
univibe68: raises $0.20 to $0.30
mhonielsen: folds 
Jalida3: calls $0.30
Smarkon: folds 
ChuikaPridi: folds 
*** FLOP *** [3d 5d 2h]
iamkakaroto leaves the table
univibe68: bets $0.50
6ePeMeHHa9 joins the table at seat #3 
Jalida3: folds 
Uncalled bet ($0.50) returned to univibe68
univibe68 collected $0.72 from pot
*** SUMMARY ***
Total pot $0.75 | Rake $0.03 
Board [3d 5d 2h]
Seat 1: univibe68 collected ($0.72)
Seat 2: mhonielsen folded before Flop (didn't bet)
Seat 4: Jalida3 (button) folded on the Flop
Seat 5: Smarkon (small blind) folded before Flop
Seat 6: ChuikaPridi (big blind) folded before Flop



PokerStars Hand #166667470984:  Hold'em No Limit ($0.05/$0.10 USD) - 2017/02/23 16:01:45 ET
Table 'Luanda' 6-max Seat #2 is the button
Seat 1: Kow6oy ($10.10 in chips) 
Seat 2: Xander188 ($10 in chips) 
Seat 3: DamDatsAnAce ($10 in chips) 
Seat 5: st4tion ($12.07 in chips) 
Seat 6: KA3AXCTAHEU, ($11.41 in chips) 
DamDatsAnAce: posts small blind $0.05
aapokerkot: is sitting out 
st4tion: posts big blind $0.10
*** HOLE CARDS ***
KA3AXCTAHEU,: folds 
Kow6oy: folds 
Xander188: folds 
DamDatsAnAce: folds 
Uncalled bet ($0.05) returned to st4tion
st4tion collected $0.10 from pot
*** SUMMARY ***
Total pot $0.10 | Rake $0 
Seat 1: Kow6oy folded before Flop (didn't bet)
Seat 2: Xander188 (button) folded before Flop (didn't bet)
Seat 3: DamDatsAnAce (small blind) folded before Flop
Seat 5: st4tion (big blind) collected ($0.10)
Seat 6: KA3AXCTAHEU, folded before Flop (didn't bet)



PokerStars Hand #166667471190:  Hold'em No Limit ($0.05/$0.10 USD) - 2017/02/23 16:01:45 ET
Table 'Risha II' 6-max Seat #2 is the button
Seat 1: R. Lemonte ($10.73 in chips) 
Seat 2: KA3AXCTAHEU, ($12.65 in chips) 
Seat 3: steepfell ($10 in chips) 
Seat 4: Comeback3392 ($23.33 in chips) 
Seat 5: m.c-alkatraz ($10.20 in chips) 
Seat 6: univibe68 ($10.76 in chips) 
steepfell: posts small blind $0.05
Comeback3392: posts big blind $0.10
*** HOLE CARDS ***
m.c-alkatraz: raises $0.20 to $0.30
univibe68: folds 
R. Lemonte: folds 
KA3AXCTAHEU,: folds 
steepfell: folds 
Comeback3392: folds 
Uncalled bet ($0.20) returned to m.c-alkatraz
m.c-alkatraz collected $0.25 from pot
*** SUMMARY ***
Total pot $0.25 | Rake $0 
Seat 1: R. Lemonte folded before Flop (didn't bet)
Seat 2: KA3AXCTAHEU, (button) folded before Flop (didn't bet)
Seat 3: steepfell (small blind) folded before Flop
Seat 4: Comeback3392 (big blind) folded before Flop
Seat 5: m.c-alkatraz collected ($0.25)
Seat 6: univibe68 folded before Flop (didn't bet)



PokerStars Hand #166667471303:  Hold'em No Limit ($0.05/$0.10 USD) - 2017/02/23 16:01:45 ET
Table 'Lacroute' 6-max Seat #2 is the button
Seat 1: johnnyPieper ($8.70 in chips) 
Seat 2: Andy Wolf ($10.05 in chips) 
Seat 3: Croplayer1 ($11.84 in chips) 
Seat 4: st4tion ($16.06 in chips) 
Seat 5: steepfell ($11.12 in chips) 
Seat 6: IAntikI ($10 in chips) 
Croplayer1: posts small blind $0.05
st4tion: posts big blind $0.10
*** HOLE CARDS ***
steepfell: folds 
IAntikI: folds 
johnnyPieper: calls $0.10
Andy Wolf: raises $0.20 to $0.30
Croplayer1: folds 
st4tion: folds 
johnnyPieper: calls $0.20
*** FLOP *** [Kd 4h 2h]
johnnyPieper: bets $0.40
Andy Wolf: folds 
Uncalled bet ($0.40) returned to johnnyPieper
johnnyPieper collected $0.72 from pot
*** SUMMARY ***
Total pot $0.75 | Rake $0.03 
Board [Kd 4h 2h]
Seat 1: johnnyPieper collected ($0.72)
Seat 2: Andy Wolf (button) folded on the Flop
Seat 3: Croplayer1 (small blind) folded before Flop
Seat 4: st4tion (big blind) folded before Flop
Seat 5: steepfell folded before Flop (didn't bet)
Seat 6: IAntikI folded before Flop (didn't bet)



PokerStars Hand #166667471344:  Hold'em No Limit ($0.05/$0.10 USD) - 2017/02/23 16:01:45 ET
Table 'Aconcagua' 6-max Seat #4 is the button
Seat 4: pivanki11 ($9.46 in chips) 
Seat 5: frazaunch ($6.69 in chips) 
Seat 6: coolisses111 ($9.40 in chips) 
frazaunch: posts small blind $0.05
coolisses111: posts big blind $0.10
pivanki11: posts the ante $0.02
frazaunch: posts the ante $0.02
coolisses111: posts the ante $0.02
*** HOLE CARDS ***
pivanki11: folds 
frazaunch: calls $0.05
coolisses111: checks 
*** FLOP *** [Jc 2c 9h]
frazaunch: checks 
coolisses111: checks 
*** TURN *** [Jc 2c 9h] [4c]
frazaunch: bets $0.10
coolisses111: folds 
Uncalled bet ($0.10) returned to frazaunch
frazaunch collected $0.25 from pot
*** SUMMARY ***
Total pot $0.26 | Rake $0.01 
Board [Jc 2c 9h 4c]
Seat 4: pivanki11 (button) folded before Flop (didn't bet)
Seat 5: frazaunch (small blind) collected ($0.25)
Seat 6: coolisses111 (big blind) folded on the Turn



PokerStars Hand #166667471493:  Hold'em No Limit ($0.05/$0.10 USD) - 2017/02/23 16:01:45 ET
Table 'Hyakutake' 6-max Seat #4 is the button
Seat 1: Asilvagoat ($11.22 in chips) 
Seat 2: boxer821 ($10.66 in chips) 
Seat 3: lenboysprite ($7.40 in chips) 
Seat 4: eniksenik ($13.55 in chips) 
Seat 5: RoJ1 ($11.49 in chips) 
Seat 6: maxiv608 ($13.42 in chips) 
RoJ1: posts small blind $0.05
maxiv608: posts big blind $0.10
*** HOLE CARDS ***
Asilvagoat: folds 
boxer821: folds 
lenboysprite: folds 
eniksenik: folds 
RoJ1: raises $0.15 to $0.25
maxiv608: folds 
Uncalled bet ($0.15) returned to RoJ1
RoJ1 collected $0.20 from pot
*** SUMMARY ***
Total pot $0.20 | Rake $0 
Seat 1: Asilvagoat folded before Flop (didn't bet)
Seat 2: boxer821 folded before Flop (didn't bet)
Seat 3: lenboysprite folded before Flop (didn't bet)
Seat 4: eniksenik (button) folded before Flop (didn't bet)
Seat 5: RoJ1 (small blind) collected ($0.20)
Seat 6: maxiv608 (big blind) folded before Flop



PokerStars Hand #166667471772:  Hold'em No Limit ($0.05/$0.10 USD) - 2017/02/23 16:01:46 ET
Table 'Ruvuma' 6-max Seat #4 is the button
Seat 1: FRAID358 ($10.25 in chips) 
Seat 2: Fab_1512 ($13.08 in chips) 
Seat 3: Spud014 ($11.26 in chips) 
Seat 4: DamDatsAnAce ($10.15 in chips) 
Seat 5: sexy_seagull ($10.05 in chips) 
Seat 6: Elinaattor ($9.60 in chips) 
sexy_seagull: posts small blind $0.05
Elinaattor: posts big blind $0.10
*** HOLE CARDS ***
FRAID358: raises $0.20 to $0.30
Fab_1512: folds 
Spud014: folds 
DamDatsAnAce: folds 
sexy_seagull: folds 
Elinaattor: folds 
Uncalled bet ($0.20) returned to FRAID358
FRAID358 collected $0.25 from pot
*** SUMMARY ***
Total pot $0.25 | Rake $0 
Seat 1: FRAID358 collected ($0.25)
Seat 2: Fab_1512 folded before Flop (didn't bet)
Seat 3: Spud014 folded before Flop (didn't bet)
Seat 4: DamDatsAnAce (button) folded before Flop (didn't bet)
Seat 5: sexy_seagull (small blind) folded before Flop
Seat 6: Elinaattor (big blind) folded before Flop



PokerStars Hand #166667471773:  Hold'em No Limit ($0.05/$0.10 USD) - 2017/02/23 16:01:46 ET
Table 'Virginia II' 6-max Seat #5 is the button
Seat 1: Iarlei ($11.56 in chips) 
Seat 3: garigura ($14.71 in chips) 
Seat 4: onkelottoHH ($11.33 in chips) 
Seat 5: dr.goofy ($20.26 in chips) 
Seat 6: ab260414 ($10.50 in chips) 
ab260414: posts small blind $0.05
Iarlei: posts big blind $0.10
Yspenyanin: sits out 
*** HOLE CARDS ***
garigura: folds 
onkelottoHH: raises $0.20 to $0.30
dr.goofy: folds 
ab260414: folds 
Iarlei: folds 
Uncalled bet ($0.20) returned to onkelottoHH
onkelottoHH collected $0.25 from pot
*** SUMMARY ***
Total pot $0.25 | Rake $0 
Seat 1: Iarlei (big blind) folded before Flop
Seat 3: garigura folded before Flop (didn't bet)
Seat 4: onkelottoHH collected ($0.25)
Seat 5: dr.goofy (button) folded before Flop (didn't bet)
Seat 6: ab260414 (small blind) folded before Flop



PokerStars Hand #166667471823:  Hold'em No Limit ($0.05/$0.10 USD) - 2017/02/23 16:01:46 ET
Table 'Halawe II' 6-max Seat #3 is the button
Seat 1: DIGOR100 ($6.50 in chips) 
Seat 2: Darkfrai ($10 in chips) 
Seat 3: cherep61987 ($10.72 in chips) 
Seat 4: voledy ($12.60 in chips) 
Seat 5: takis nik ($12.83 in chips) 
Seat 6: Rodik002 ($20.52 in chips) 
voledy: posts small blind $0.05
takis nik: posts big blind $0.10
*** HOLE CARDS ***
Rodik002: folds 
DIGOR100: raises $0.25 to $0.35
Darkfrai: folds 
cherep61987: folds 
voledy: folds 
takis nik: calls $0.25
*** FLOP *** [9h 5h Js]
takis nik: checks 
DIGOR100: bets $0.36
takis nik: folds 
Uncalled bet ($0.36) returned to DIGOR100
DIGOR100 collected $0.72 from pot
*** SUMMARY ***
Total pot $0.75 | Rake $0.03 
Board [9h 5h Js]
Seat 1: DIGOR100 collected ($0.72)
Seat 2: Darkfrai folded before Flop (didn't bet)
Seat 3: cherep61987 (button) folded before Flop (didn't bet)
Seat 4: voledy (small blind) folded before Flop
Seat 5: takis nik (big blind) folded on the Flop
Seat 6: Rodik002 folded before Flop (didn't bet)



PokerStars Hand #166667472186:  Hold'em No Limit ($0.05/$0.10 USD) - 2017/02/23 16:01:46 ET
Table 'Orthos III' 6-max Seat #1 is the button
Seat 1: sexy_seagull ($10 in chips) 
Seat 2: Xander188 ($16.08 in chips) 
Seat 3: koka4cs ($7.07 in chips) 
Seat 4: FlopsterGB ($14.79 in chips) 
Seat 5: Bird et al ($20.29 in chips) 
Seat 6: RoJ1 ($10.79 in chips) 
Xander188: posts small blind $0.05
koka4cs: posts big blind $0.10
*** HOLE CARDS ***
FlopsterGB: folds 
Bird et al: raises $0.21 to $0.31
RoJ1: folds 
sexy_seagull: folds 
Xander188: folds 
koka4cs: calls $0.21
*** FLOP *** [Kd Jh 4c]
koka4cs: checks 
Bird et al: checks 
*** TURN *** [Kd Jh 4c] [Qc]
koka4cs: checks 
Bird et al: checks 
*** RIVER *** [Kd Jh 4c Qc] [Jd]
koka4cs: checks 
Bird et al: checks 
*** SHOW DOWN ***
koka4cs: shows [Ts 8d] (a pair of Jacks)
Bird et al: shows [5h 5d] (two pair, Jacks and Fives)
Bird et al collected $0.64 from pot
*** SUMMARY ***
Cruger: !!???????!!??!!??
Total pot $0.67 | Rake $0.03 
Board [Kd Jh 4c Qc Jd]
Seat 1: sexy_seagull (button) folded before Flop (didn't bet)
Seat 2: Xander188 (small blind) folded before Flop
Seat 3: koka4cs (big blind) showed [Ts 8d] and lost with a pair of Jacks
Seat 4: FlopsterGB folded before Flop (didn't bet)
Seat 5: Bird et al showed [5h 5d] and won ($0.64) with two pair, Jacks and Fives
Seat 6: RoJ1 folded before Flop (didn't bet)



PokerStars Hand #166667472285:  Hold'em No Limit ($0.05/$0.10 USD) - 2017/02/23 16:01:46 ET
Table 'Nuki' 6-max Seat #5 is the button
Seat 1: bdixon_5 ($8.05 in chips) 
Seat 2: ArcticBearDK ($18.58 in chips) 
Seat 3: david_sara83 ($13.77 in chips) 
Seat 4: GESPERIA ($28.61 in chips) 
Seat 5: fabadam ($11.23 in chips) 
Seat 6: Zooplack ($25.32 in chips) 
Zooplack: posts small blind $0.05
bdixon_5: posts big blind $0.10
*** HOLE CARDS ***
ArcticBearDK: folds 
david_sara83: folds 
GESPERIA: folds 
fabadam: raises $0.25 to $0.35
Zooplack: folds 
bdixon_5: folds 
Uncalled bet ($0.25) returned to fabadam
fabadam collected $0.25 from pot
*** SUMMARY ***
Total pot $0.25 | Rake $0 
Seat 1: bdixon_5 (big blind) folded before Flop
Seat 2: ArcticBearDK folded before Flop (didn't bet)
Seat 3: david_sara83 folded before Flop (didn't bet)
Seat 4: GESPERIA folded before Flop (didn't bet)
Seat 5: fabadam (button) collected ($0.25)
Seat 6: Zooplack (small blind) folded before Flop



PokerStars Hand #166667472320:  Hold'em No Limit ($0.05/$0.10 USD) - 2017/02/23 16:01:46 ET
Table 'Ebella II' 6-max Seat #4 is the button
Seat 1: gaHy_HaXeP ($10 in chips) 
Seat 2: Therodorus ($10 in chips) 
Seat 3: Torften2 ($16.22 in chips) 
Seat 4: ValdemorS ($10.15 in chips) 
Seat 5: Bird et al ($10.05 in chips) 
Seat 6: Joker51_wtf! ($10 in chips) 
Bird et al: posts small blind $0.05
Joker51_wtf!: posts big blind $0.10
*** HOLE CARDS ***
gaHy_HaXeP: folds 
Therodorus: folds 
Torften2: folds 
ValdemorS: folds 
Bird et al: folds 
Uncalled bet ($0.05) returned to Joker51_wtf!
Joker51_wtf! collected $0.10 from pot
*** SUMMARY ***
Total pot $0.10 | Rake $0 
Seat 1: gaHy_HaXeP folded before Flop (didn't bet)
Seat 2: Therodorus folded before Flop (didn't bet)
Seat 3: Torften2 folded before Flop (didn't bet)
Seat 4: ValdemorS (button) folded before Flop (didn't bet)
Seat 5: Bird et al (small blind) folded before Flop
Seat 6: Joker51_wtf! (big blind) collected ($0.10)



PokerStars Hand #166667472360:  Hold'em No Limit ($0.05/$0.10 USD) - 2017/02/23 16:01:46 ET
Table 'Sham' 6-max Seat #5 is the button
Seat 1: pancernik21 ($10 in chips) 
Seat 2: ex3Lero86 ($10.30 in chips) 
Seat 3: weez3r ($22.83 in chips) 
Seat 4: VAD21 ($12.80 in chips) 
Seat 5: T9MS ($10 in chips) 
Seat 6: bdixon_5 ($9.60 in chips) 
bdixon_5: posts small blind $0.05
pancernik21: posts big blind $0.10
*** HOLE CARDS ***
ex3Lero86: folds 
weez3r: folds 
VAD21: folds 
T9MS: raises $0.15 to $0.25
bdixon_5: folds 
pancernik21: calls $0.15
*** FLOP *** [Qd 7s 3s]
pancernik21: checks 
T9MS: bets $0.40
pancernik21: folds 
Uncalled bet ($0.40) returned to T9MS
T9MS collected $0.53 from pot
*** SUMMARY ***
Total pot $0.55 | Rake $0.02 
Board [Qd 7s 3s]
Seat 1: pancernik21 (big blind) folded on the Flop
Seat 2: ex3Lero86 folded before Flop (didn't bet)
Seat 3: weez3r folded before Flop (didn't bet)
Seat 4: VAD21 folded before Flop (didn't bet)
Seat 5: T9MS (button) collected ($0.53)
Seat 6: bdixon_5 (small blind) folded before Flop



PokerStars Hand #166667472402:  Hold'em No Limit ($0.05/$0.10 USD) - 2017/02/23 16:01:46 ET
Table 'Senta II' 6-max Seat #6 is the button
Seat 2: NvR.m1nD ($10.68 in chips) 
Seat 3: Aescul@pius ($21.40 in chips) 
Seat 4: fedorka rus ($21.67 in chips) 
Seat 5: Algarah ($6.04 in chips) 
Seat 6: T9MS ($11.92 in chips) 
NvR.m1nD: posts small blind $0.05
Aescul@pius: posts big blind $0.10
*** HOLE CARDS ***
fedorka rus: raises $0.20 to $0.30
Algarah: folds 
T9MS: folds 
NvR.m1nD: folds 
Aescul@pius: folds 
Uncalled bet ($0.20) returned to fedorka rus
fedorka rus collected $0.25 from pot
*** SUMMARY ***
Total pot $0.25 | Rake $0 
Seat 2: NvR.m1nD (small blind) folded before Flop
Seat 3: Aescul@pius (big blind) folded before Flop
Seat 4: fedorka rus collected ($0.25)
Seat 5: Algarah folded before Flop (didn't bet)
Seat 6: T9MS (button) folded before Flop (didn't bet)



PokerStars Hand #166667472456:  Hold'em No Limit ($0.05/$0.10 USD) - 2017/02/23 16:01:47 ET
Table 'Cyane' 6-max Seat #1 is the button
Seat 1: KA3AXCTAHEU, ($10.32 in chips) 
Seat 2: Temniy Elf ($10.05 in chips) 
Seat 3: Mamm0nism ($14.09 in chips) 
Seat 4: truck1234 ($21.11 in chips) 
Seat 5: ChuikaPridi ($10.17 in chips) 
Seat 6: 8th wonders ($10.15 in chips) 
Temniy Elf: posts small blind $0.05
Mamm0nism: posts big blind $0.10
*** HOLE CARDS ***
truck1234: folds 
ChuikaPridi: raises $0.20 to $0.30
8th wonders: folds 
KA3AXCTAHEU,: folds 
Temniy Elf: folds 
Mamm0nism: folds 
Uncalled bet ($0.20) returned to ChuikaPridi
ChuikaPridi collected $0.25 from pot
*** SUMMARY ***
Total pot $0.25 | Rake $0 
Seat 1: KA3AXCTAHEU, (button) folded before Flop (didn't bet)
Seat 2: Temniy Elf (small blind) folded before Flop
Seat 3: Mamm0nism (big blind) folded before Flop
Seat 4: truck1234 folded before Flop (didn't bet)
Seat 5: ChuikaPridi collected ($0.25)
Seat 6: 8th wonders folded before Flop (didn't bet)



PokerStars Hand #166667472877:  Hold'em No Limit ($0.05/$0.10 USD) - 2017/02/23 16:01:47 ET
Table 'Siebohme' 6-max Seat #4 is the button
Seat 1: kusa4ki ($11.38 in chips) 
Seat 2: el toro 1507 ($11.68 in chips) 
Seat 3: ex3Lero86 ($10.15 in chips) 
Seat 4: Innerwuss ($10.09 in chips) 
Seat 5: Kazacha ($10.15 in chips) 
Seat 6: townerz1991 ($10.53 in chips) 
Kazacha: posts small blind $0.05
townerz1991: posts big blind $0.10
*** HOLE CARDS ***
kusa4ki: folds 
el toro 1507: folds 
ex3Lero86: folds 
Innerwuss: folds 
Kazacha: folds 
Uncalled bet ($0.05) returned to townerz1991
townerz1991 collected $0.10 from pot
*** SUMMARY ***
Total pot $0.10 | Rake $0 
Seat 1: kusa4ki folded before Flop (didn't bet)
Seat 2: el toro 1507 folded before Flop (didn't bet)
Seat 3: ex3Lero86 folded before Flop (didn't bet)
Seat 4: Innerwuss (button) folded before Flop (didn't bet)
Seat 5: Kazacha (small blind) folded before Flop
Seat 6: townerz1991 (big blind) collected ($0.10)



PokerStars Hand #166667472913:  Hold'em No Limit ($0.05/$0.10 USD) - 2017/02/23 16:01:47 ET
Table 'Siebohme II' 6-max Seat #3 is the button
Seat 1: homelessdan ($18.22 in chips) 
Seat 2: townerz1991 ($14.17 in chips) 
Seat 3: D3NyA ($10.33 in chips) 
Seat 4: POT_TRADER ($12.04 in chips) 
Seat 5: NvR.m1nD ($10.15 in chips) 
POT_TRADER: posts small blind $0.05
NvR.m1nD: posts big blind $0.10
Fozzy690: sits out 
*** HOLE CARDS ***
homelessdan: folds 
townerz1991: folds 
D3NyA: folds 
POT_TRADER: folds 
Uncalled bet ($0.05) returned to NvR.m1nD
NvR.m1nD collected $0.10 from pot
*** SUMMARY ***
Total pot $0.10 | Rake $0 
Seat 1: homelessdan folded before Flop (didn't bet)
Seat 2: townerz1991 folded before Flop (didn't bet)
Seat 3: D3NyA (button) folded before Flop (didn't bet)
Seat 4: POT_TRADER (small blind) folded before Flop
Seat 5: NvR.m1nD (big blind) collected ($0.10)



PokerStars Hand #166667472946:  Hold'em No Limit ($0.05/$0.10 USD) - 2017/02/23 16:01:47 ET
Table 'Nephthys II' 6-max Seat #1 is the button
Seat 1: DamDatsAnAce ($10.05 in chips) 
Seat 2: AC Evergreen ($10.05 in chips) 
Seat 3: Newqbrown ($20.44 in chips) 
Seat 4: RkaczoR ($11.50 in chips) 
Seat 5: kingartur222 ($9.01 in chips) 
Seat 6: CHRO8 ($14.49 in chips) 
AC Evergreen: posts small blind $0.05
Newqbrown: posts big blind $0.10
*** HOLE CARDS ***
RkaczoR: folds 
kingartur222: raises $0.20 to $0.30
CHRO8: folds 
DamDatsAnAce: folds 
AC Evergreen: folds 
Newqbrown: folds 
Uncalled bet ($0.20) returned to kingartur222
kingartur222 collected $0.25 from pot
*** SUMMARY ***
Total pot $0.25 | Rake $0 
Seat 1: DamDatsAnAce (button) folded before Flop (didn't bet)
Seat 2: AC Evergreen (small blind) folded before Flop
Seat 3: Newqbrown (big blind) folded before Flop
Seat 4: RkaczoR folded before Flop (didn't bet)
Seat 5: kingartur222 collected ($0.25)
Seat 6: CHRO8 folded before Flop (didn't bet)



PokerStars Hand #166667473616:  Hold'em No Limit ($0.05/$0.10 USD) - 2017/02/23 16:01:48 ET
Table 'Jokaste II' 6-max Seat #1 is the button
Seat 1: Hyd SK ($13.33 in chips) 
Seat 2: T9MS ($12.53 in chips) 
Seat 3: crazydevill ($10 in chips) 
Seat 4: FRAID358 ($14.86 in chips) 
Seat 5: Vrinni ($10.15 in chips) 
Seat 6: Adailton07 ($15.05 in chips) 
T9MS: posts small blind $0.05
crazydevill: posts big blind $0.10
*** HOLE CARDS ***
FRAID358: folds 
Vrinni: folds 
Adailton07: folds 
Hyd SK: raises $0.15 to $0.25
T9MS: folds 
crazydevill: folds 
Uncalled bet ($0.15) returned to Hyd SK
Hyd SK collected $0.25 from pot
*** SUMMARY ***
Total pot $0.25 | Rake $0 
Seat 1: Hyd SK (button) collected ($0.25)
Seat 2: T9MS (small blind) folded before Flop
Seat 3: crazydevill (big blind) folded before Flop
Seat 4: FRAID358 folded before Flop (didn't bet)
Seat 5: Vrinni folded before Flop (didn't bet)
Seat 6: Adailton07 folded before Flop (didn't bet)



PokerStars Hand #166667474074:  Hold'em No Limit ($0.05/$0.10 USD) - 2017/02/23 16:01:48 ET
Table 'Pompeja III' 6-max Seat #2 is the button
Seat 1: Iarlei ($12.04 in chips) 
Seat 2: steepfell ($10.54 in chips) 
Seat 3: Yspenyanin ($12.05 in chips) 
Seat 4: Cluckh ($12.06 in chips) 
Seat 5: Spud014 ($12.14 in chips) 
Seat 6: mega spasser ($5.10 in chips) 
Yspenyanin: posts small blind $0.05
Cluckh: posts big blind $0.10
*** HOLE CARDS ***
Spud014: folds 
mega spasser: folds 
Iarlei: folds 
steepfell: raises $0.15 to $0.25
Yspenyanin: folds 
Cluckh: folds 
Uncalled bet ($0.15) returned to steepfell
steepfell collected $0.25 from pot
*** SUMMARY ***
Total pot $0.25 | Rake $0 
Seat 1: Iarlei folded before Flop (didn't bet)
Seat 2: steepfell (button) collected ($0.25)
Seat 3: Yspenyanin (small blind) folded before Flop
Seat 4: Cluckh (big blind) folded before Flop
Seat 5: Spud014 folded before Flop (didn't bet)
Seat 6: mega spasser folded before Flop (didn't bet)



PokerStars Hand #166667474222:  Hold'em No Limit ($0.05/$0.10 USD) - 2017/02/23 16:01:49 ET
Table 'California II' 6-max Seat #3 is the button
Seat 1: fedorka rus ($10.23 in chips) 
Seat 2: homelessdan ($10.15 in chips) 
Seat 3: Bird et al ($10.20 in chips) 
Seat 5: bambolejro ($15.07 in chips) 
Seat 6: chiko4040 ($8.81 in chips) 
pokekrk will be allowed to play after the button
bambolejro: posts small blind $0.05
chiko4040: posts big blind $0.10
*** HOLE CARDS ***
fedorka rus: folds 
homelessdan: folds 
Bird et al: raises $0.15 to $0.25
bambolejro: folds 
chiko4040: folds 
Uncalled bet ($0.15) returned to Bird et al
Bird et al collected $0.25 from pot
*** SUMMARY ***
Total pot $0.25 | Rake $0 
Seat 1: fedorka rus folded before Flop (didn't bet)
Seat 2: homelessdan folded before Flop (didn't bet)
Seat 3: Bird et al (button) collected ($0.25)
Seat 5: bambolejro (small blind) folded before Flop
Seat 6: chiko4040 (big blind) folded before Flop



PokerStars Hand #166667474449:  Hold'em No Limit ($0.05/$0.10 USD) - 2017/02/23 16:01:49 ET
Table 'Iapetus III' 6-max Seat #5 is the button
Seat 3: takis nik ($10 in chips) 
Seat 4: XaXaTyH4uK ($10.30 in chips) 
Seat 5: homelessdan ($13.91 in chips) 
Seat 6: yodzik ($5.20 in chips) 
yodzik: posts small blind $0.05
Pekaml: is sitting out 
takis nik: posts big blind $0.10
*** HOLE CARDS ***
Pekaml leaves the table
XaXaTyH4uK: folds 
homelessdan: folds 
Crafty23@PS joins the table at seat #2 
yodzik: raises $0.20 to $0.30
takis nik: raises $0.60 to $0.90
yodzik: raises $4.30 to $5.20 and is all-in
takis nik: calls $4.30
*** FLOP *** [6c Ks 8c]
*** TURN *** [6c Ks 8c] [8s]
*** RIVER *** [6c Ks 8c 8s] [7c]
*** SHOW DOWN ***
yodzik: shows [Ah Kh] (two pair, Kings and Eights)
takis nik: shows [Qd Qh] (two pair, Queens and Eights)
yodzik collected $9.93 from pot
*** SUMMARY ***
Total pot $10.40 | Rake $0.47 
Board [6c Ks 8c 8s 7c]
Seat 3: takis nik (big blind) showed [Qd Qh] and lost with two pair, Queens and Eights
Seat 4: XaXaTyH4uK folded before Flop (didn't bet)
Seat 5: homelessdan (button) folded before Flop (didn't bet)
Seat 6: yodzik (small blind) showed [Ah Kh] and won ($9.93) with two pair, Kings and Eights



PokerStars Hand #166667474496:  Hold'em No Limit ($0.05/$0.10 USD) - 2017/02/23 16:01:49 ET
Table 'Scabiosa III' 6-max Seat #2 is the button
Seat 1: Feverhead ($13.26 in chips) 
Seat 2: kinaó ($12.95 in chips) 
Seat 3: Goroshkos88 ($11.45 in chips) 
Seat 4: voledy ($10 in chips) 
Seat 5: patrick19111 ($24.75 in chips) 
Seat 6: Smitty03300 ($10 in chips) 
Goroshkos88: posts small blind $0.05
voledy: posts big blind $0.10
*** HOLE CARDS ***
patrick19111: folds 
Smitty03300: raises $0.20 to $0.30
Feverhead: folds 
kinaó: calls $0.30
Goroshkos88: folds 
voledy: folds 
*** FLOP *** [4d Th Ks]
Smitty03300: bets $0.54
kinaó: calls $0.54
*** TURN *** [4d Th Ks] [6s]
Smitty03300: bets $1.31
kinaó: folds 
Uncalled bet ($1.31) returned to Smitty03300
Smitty03300 collected $1.75 from pot
*** SUMMARY ***
Total pot $1.83 | Rake $0.08 
Board [4d Th Ks 6s]
Seat 1: Feverhead folded before Flop (didn't bet)
Seat 2: kinaó (button) folded on the Turn
Seat 3: Goroshkos88 (small blind) folded before Flop
Seat 4: voledy (big blind) folded before Flop
Seat 5: patrick19111 folded before Flop (didn't bet)
Seat 6: Smitty03300 collected ($1.75)



PokerStars Hand #166667474525:  Hold'em No Limit ($0.05/$0.10 USD) - 2017/02/23 16:01:49 ET
Table 'Cassini' 6-max Seat #1 is the button
Seat 1: Pokeaster ($10 in chips) 
Seat 2: mhonielsen ($13.14 in chips) 
Seat 4: fortieth ($13.72 in chips) 
Seat 5: johkom ($7.90 in chips) 
Seat 6: JahSoldier69 ($10 in chips) 
mhonielsen: posts small blind $0.05
fortieth: posts big blind $0.10
*** HOLE CARDS ***
johkom: folds 
JahSoldier69: folds 
Pokeaster: raises $0.15 to $0.25
mhonielsen: folds 
fortieth: folds 
Uncalled bet ($0.15) returned to Pokeaster
Pokeaster collected $0.25 from pot
*** SUMMARY ***
Total pot $0.25 | Rake $0 
Seat 1: Pokeaster (button) collected ($0.25)
Seat 2: mhonielsen (small blind) folded before Flop
Seat 4: fortieth (big blind) folded before Flop
Seat 5: johkom folded before Flop (didn't bet)
Seat 6: JahSoldier69 folded before Flop (didn't bet)



PokerStars Hand #166667474825:  Hold'em No Limit ($0.05/$0.10 USD) - 2017/02/23 16:01:49 ET
Table 'Sheragul III' 6-max Seat #1 is the button
Seat 1: danky24 ($18.06 in chips) 
Seat 2: Bird et al ($11.86 in chips) 
Seat 4: maxiv608 ($11.24 in chips) 
Seat 5: Bandyaev ($14.21 in chips) 
Seat 6: Andrei ProFF ($10 in chips) 
Bird et al: posts small blind $0.05
maxiv608: posts big blind $0.10
*** HOLE CARDS ***
Bandyaev: folds 
Andrei ProFF: folds 
danky24: folds 
Bird et al: raises $0.20 to $0.30
maxiv608: folds 
Uncalled bet ($0.20) returned to Bird et al
Bird et al collected $0.20 from pot
*** SUMMARY ***
Total pot $0.20 | Rake $0 
Seat 1: danky24 (button) folded before Flop (didn't bet)
Seat 2: Bird et al (small blind) collected ($0.20)
Seat 4: maxiv608 (big blind) folded before Flop
Seat 5: Bandyaev folded before Flop (didn't bet)
Seat 6: Andrei ProFF folded before Flop (didn't bet)



PokerStars Hand #166667475073:  Hold'em No Limit ($0.05/$0.10 USD) - 2017/02/23 16:01:49 ET
Table 'Phereclos II' 6-max Seat #6 is the button
Seat 1: Croplayer1 ($10 in chips) 
Seat 2: Kazacha ($10.28 in chips) 
Seat 3: kickereens ($21.31 in chips) 
Seat 4: DamDatsAnAce ($10.38 in chips) 
Seat 5: Smitty03300 ($10 in chips) 
Seat 6: mhonielsen ($16.07 in chips) 
Croplayer1: posts small blind $0.05
Kazacha: posts big blind $0.10
*** HOLE CARDS ***
kickereens: folds 
DamDatsAnAce: folds 
Smitty03300: raises $0.15 to $0.25
mhonielsen: folds 
Croplayer1: folds 
Kazacha: folds 
Uncalled bet ($0.15) returned to Smitty03300
Smitty03300 collected $0.25 from pot
*** SUMMARY ***
Total pot $0.25 | Rake $0 
Seat 1: Croplayer1 (small blind) folded before Flop
Seat 2: Kazacha (big blind) folded before Flop
Seat 3: kickereens folded before Flop (didn't bet)
Seat 4: DamDatsAnAce folded before Flop (didn't bet)
Seat 5: Smitty03300 collected ($0.25)
Seat 6: mhonielsen (button) folded before Flop (didn't bet)



PokerStars Hand #166667475205:  Hold'em No Limit ($0.05/$0.10 USD) - 2017/02/23 16:01:50 ET
Table 'Syringa' 6-max Seat #5 is the button
Seat 1: bdixon_5 ($8.10 in chips) 
Seat 2: Goroshkos88 ($10 in chips) 
Seat 4: tangler19 ($15.38 in chips) 
Seat 5: Andrei ProFF ($12.44 in chips) 
Seat 6: ibara000 ($16.74 in chips) 
ibara000: posts small blind $0.05
bdixon_5: posts big blind $0.10
Yspenyanin: sits out 
*** HOLE CARDS ***
Goroshkos88: folds 
tangler19: raises $0.10 to $0.20
Andrei ProFF: raises $0.60 to $0.80
ibara000: folds 
bdixon_5: folds 
tangler19: calls $0.60
*** FLOP *** [2s 5d 3c]
tangler19: checks 
Andrei ProFF: bets $0.70
tangler19: folds 
Uncalled bet ($0.70) returned to Andrei ProFF
Andrei ProFF collected $1.67 from pot
*** SUMMARY ***
Total pot $1.75 | Rake $0.08 
Board [2s 5d 3c]
Seat 1: bdixon_5 (big blind) folded before Flop
Seat 2: Goroshkos88 folded before Flop (didn't bet)
Seat 4: tangler19 folded on the Flop
Seat 5: Andrei ProFF (button) collected ($1.67)
Seat 6: ibara000 (small blind) folded before Flop



PokerStars Hand #166667475345:  Hold'em No Limit ($0.05/$0.10 USD) - 2017/02/23 16:01:50 ET
Table 'Hamal II' 6-max Seat #2 is the button
Seat 1: saxoalto2011 ($8.49 in chips) 
Seat 2: pancernik21 ($10 in chips) 
Seat 3: Cluckh ($11.59 in chips) 
Seat 4: ArcticBearDK ($10.96 in chips) 
Seat 6: LarryTheStar ($11.24 in chips) 
Cluckh: posts small blind $0.05
ArcticBearDK: posts big blind $0.10
eniksenik: sits out 
*** HOLE CARDS ***
LarryTheStar: folds 
saxoalto2011: folds 
pancernik21: folds 
Cluckh: raises $0.20 to $0.30
ArcticBearDK: folds 
Uncalled bet ($0.20) returned to Cluckh
Cluckh collected $0.20 from pot
Cluckh: doesn't show hand 
*** SUMMARY ***
Total pot $0.20 | Rake $0 
Seat 1: saxoalto2011 folded before Flop (didn't bet)
Seat 2: pancernik21 (button) folded before Flop (didn't bet)
Seat 3: Cluckh (small blind) collected ($0.20)
Seat 4: ArcticBearDK (big blind) folded before Flop
Seat 6: LarryTheStar folded before Flop (didn't bet)



PokerStars Hand #166667475510:  Hold'em No Limit ($0.05/$0.10 USD) - 2017/02/23 16:01:50 ET
Table 'Arkab' 6-max Seat #2 is the button
Seat 1: iamkakaroto ($10 in chips) 
Seat 2: aktion4ik ($12.39 in chips) 
Seat 3: sexy_seagull ($10 in chips) 
Seat 4: donkucallme ($17.55 in chips) 
Seat 5: OrionYusupov ($9.29 in chips) 
sexy_seagull: posts small blind $0.05
donkucallme: posts big blind $0.10
MihaGr: sits out 
*** HOLE CARDS ***
OrionYusupov: calls $0.10
iamkakaroto: folds 
aktion4ik: folds 
sexy_seagull: folds 
donkucallme: checks 
*** FLOP *** [Ks 8s Tc]
donkucallme: bets $0.50
OrionYusupov: raises $0.50 to $1
donkucallme: calls $0.50
*** TURN *** [Ks 8s Tc] [As]
donkucallme: checks 
OrionYusupov: bets $2.50
donkucallme: folds 
Uncalled bet ($2.50) returned to OrionYusupov
OrionYusupov collected $2.15 from pot
*** SUMMARY ***
Total pot $2.25 | Rake $0.10 
Board [Ks 8s Tc As]
Seat 1: iamkakaroto folded before Flop (didn't bet)
Seat 2: aktion4ik (button) folded before Flop (didn't bet)
Seat 3: sexy_seagull (small blind) folded before Flop
Seat 4: donkucallme (big blind) folded on the Turn
Seat 5: OrionYusupov collected ($2.15)



PokerStars Hand #166667475556:  Hold'em No Limit ($0.05/$0.10 USD) - 2017/02/23 16:01:50 ET
Table 'Repsolda' 6-max Seat #2 is the button
Seat 1: fabadam ($10.65 in chips) 
Seat 2: MBen10 ($26.06 in chips) 
Seat 3: manashov ($12.37 in chips) 
Seat 5: danky24 ($7.35 in chips) 
Seat 6: RkaczoR ($10 in chips) 
manashov: posts small blind $0.05
jamalungma: is sitting out 
jamalungma leaves the table
danky24: posts big blind $0.10
*** HOLE CARDS ***
RkaczoR: folds 
fabadam: folds 
MBen10: folds 
manashov: folds 
Uncalled bet ($0.05) returned to danky24
danky24 collected $0.10 from pot
*** SUMMARY ***
Total pot $0.10 | Rake $0 
Seat 1: fabadam folded before Flop (didn't bet)
Seat 2: MBen10 (button) folded before Flop (didn't bet)
Seat 3: manashov (small blind) folded before Flop
Seat 5: danky24 (big blind) collected ($0.10)
Seat 6: RkaczoR folded before Flop (didn't bet)



PokerStars Hand #166667475657:  Hold'em No Limit ($0.05/$0.10 USD) - 2017/02/23 16:01:50 ET
Table 'Lagrula' 6-max Seat #5 is the button
Seat 1: Ice_Isayev ($10 in chips) 
Seat 2: jamalungma ($10.96 in chips) 
Seat 3: micke667 ($16.28 in chips) 
Seat 4: Calimero2408 ($4.67 in chips) 
Seat 5: Iarlei ($10 in chips) 
Seat 6: Spud014 ($11 in chips) 
Spud014: posts small blind $0.05
Ice_Isayev: posts big blind $0.10
*** HOLE CARDS ***
jamalungma: raises $0.15 to $0.25
micke667: folds 
Calimero2408: folds 
Iarlei: folds 
Spud014: folds 
Ice_Isayev: folds 
Uncalled bet ($0.15) returned to jamalungma
jamalungma collected $0.25 from pot
*** SUMMARY ***
Total pot $0.25 | Rake $0 
Seat 1: Ice_Isayev (big blind) folded before Flop
Seat 2: jamalungma collected ($0.25)
Seat 3: micke667 folded before Flop (didn't bet)
Seat 4: Calimero2408 folded before Flop (didn't bet)
Seat 5: Iarlei (button) folded before Flop (didn't bet)
Seat 6: Spud014 (small blind) folded before Flop



PokerStars Hand #166667475949:  Hold'em No Limit ($0.05/$0.10 USD) - 2017/02/23 16:01:50 ET
Table 'Rostia' 6-max Seat #1 is the button
Seat 1: paxit71 ($8 in chips) 
Seat 2: david_sara83 ($19.31 in chips) 
Seat 3: ImpAV ($10.15 in chips) 
Seat 4: Hyd SK ($11.68 in chips) 
Seat 5: Buddy8711 ($15.77 in chips) 
Seat 6: Giyorod ($10.85 in chips) 
david_sara83: posts small blind $0.05
ImpAV: posts big blind $0.10
*** HOLE CARDS ***
Hyd SK: folds 
Buddy8711: folds 
Giyorod: folds 
paxit71: folds 
david_sara83: folds 
Uncalled bet ($0.05) returned to ImpAV
ImpAV collected $0.10 from pot
*** SUMMARY ***
Total pot $0.10 | Rake $0 
Seat 1: paxit71 (button) folded before Flop (didn't bet)
Seat 2: david_sara83 (small blind) folded before Flop
Seat 3: ImpAV (big blind) collected ($0.10)
Seat 4: Hyd SK folded before Flop (didn't bet)
Seat 5: Buddy8711 folded before Flop (didn't bet)
Seat 6: Giyorod folded before Flop (didn't bet)



PokerStars Hand #166667476018:  Hold'em No Limit ($0.05/$0.10 USD) - 2017/02/23 16:01:50 ET
Table 'Martha' 6-max Seat #2 is the button
Seat 1: Peter0087 ($10.26 in chips) 
Seat 2: pauli95 ($7.54 in chips) 
Seat 3: Hyd SK ($12.46 in chips) 
Seat 4: dittoro ($10.84 in chips) 
Seat 6: 8th wonders ($10 in chips) 
Hyd SK: posts small blind $0.05
dittoro: posts big blind $0.10
MihaGr: sits out 
*** HOLE CARDS ***
8th wonders: folds 
Peter0087: folds 
pauli95: raises $0.20 to $0.30
Hyd SK: calls $0.25
dittoro: calls $0.20
*** FLOP *** [3d 2d 3s]
Hyd SK: checks 
dittoro: checks 
pauli95: bets $0.86
Hyd SK: folds 
dittoro: folds 
Uncalled bet ($0.86) returned to pauli95
pauli95 collected $0.86 from pot
*** SUMMARY ***
Total pot $0.90 | Rake $0.04 
Board [3d 2d 3s]
Seat 1: Peter0087 folded before Flop (didn't bet)
Seat 2: pauli95 (button) collected ($0.86)
Seat 3: Hyd SK (small blind) folded on the Flop
Seat 4: dittoro (big blind) folded on the Flop
Seat 6: 8th wonders folded before Flop (didn't bet)



PokerStars Hand #166667476111:  Hold'em No Limit ($0.05/$0.10 USD) - 2017/02/23 16:01:51 ET
Table 'Kochera' 6-max Seat #1 is the button
Seat 1: chimera252 ($11.50 in chips) 
Seat 2: bartabs2 ($10.66 in chips) 
Seat 3: KA3AXCTAHEU, ($10 in chips) 
Seat 4: johkom ($5.61 in chips) 
Seat 5: univibe68 ($12 in chips) 
Seat 6: oddshoff ($9.33 in chips) 
bartabs2: posts small blind $0.05
KA3AXCTAHEU,: posts big blind $0.10
*** HOLE CARDS ***
johkom: folds 
univibe68: folds 
oddshoff: raises $0.15 to $0.25
chimera252: folds 
bartabs2: folds 
KA3AXCTAHEU,: folds 
Uncalled bet ($0.15) returned to oddshoff
oddshoff collected $0.25 from pot
*** SUMMARY ***
Total pot $0.25 | Rake $0 
Seat 1: chimera252 (button) folded before Flop (didn't bet)
Seat 2: bartabs2 (small blind) folded before Flop
Seat 3: KA3AXCTAHEU, (big blind) folded before Flop
Seat 4: johkom folded before Flop (didn't bet)
Seat 5: univibe68 folded before Flop (didn't bet)
Seat 6: oddshoff collected ($0.25)



PokerStars Hand #166667476148:  Hold'em No Limit ($0.05/$0.10 USD) - 2017/02/23 16:01:51 ET
Table 'Emma II' 6-max Seat #6 is the button
Seat 1: LarryTheStar ($10 in chips) 
Seat 2: T9MS ($10 in chips) 
Seat 3: oddshoff ($9.97 in chips) 
Seat 4: Jucatorul823 ($5.97 in chips) 
Seat 5: Scanner17 ($10.79 in chips) 
Seat 6: CHRO8 ($14.82 in chips) 
LarryTheStar: posts small blind $0.05
T9MS: posts big blind $0.10
*** HOLE CARDS ***
oddshoff: raises $0.20 to $0.30
Jucatorul823: folds 
Scanner17: calls $0.30
CHRO8: folds 
LarryTheStar: folds 
T9MS: folds 
*** FLOP *** [4c 7d 8c]
oddshoff: checks 
Scanner17: checks 
*** TURN *** [4c 7d 8c] [Th]
oddshoff: checks 
Scanner17: bets $0.70
oddshoff: folds 
Uncalled bet ($0.70) returned to Scanner17
Scanner17 collected $0.72 from pot
*** SUMMARY ***
Total pot $0.75 | Rake $0.03 
Board [4c 7d 8c Th]
Seat 1: LarryTheStar (small blind) folded before Flop
Seat 2: T9MS (big blind) folded before Flop
Seat 3: oddshoff folded on the Turn
Seat 4: Jucatorul823 folded before Flop (didn't bet)
Seat 5: Scanner17 collected ($0.72)
Seat 6: CHRO8 (button) folded before Flop (didn't bet)



PokerStars Hand #166667476258:  Hold'em No Limit ($0.05/$0.10 USD) - 2017/02/23 16:01:51 ET
Table 'Hirons' 6-max Seat #1 is the button
Seat 1: RoJ1 ($10 in chips) 
Seat 2: coolisses111 ($8.69 in chips) 
Seat 3: czeczen7 ($14.88 in chips) 
Seat 4: Smitty03300 ($10 in chips) 
Seat 5: Pekaml ($10 in chips) 
Seat 6: garigura ($14.61 in chips) 
coolisses111: posts small blind $0.05
czeczen7: posts big blind $0.10
*** HOLE CARDS ***
Smitty03300 has timed out
Smitty03300: folds 
Pekaml: folds 
garigura: folds 
RoJ1: raises $0.12 to $0.22
coolisses111: raises $0.68 to $0.90
czeczen7: calls $0.80
RoJ1: calls $0.68
*** FLOP *** [6d Tc 2h]
coolisses111: checks 
czeczen7: checks 
RoJ1: checks 
*** TURN *** [6d Tc 2h] [Kh]
coolisses111: checks 
czeczen7: checks 
RoJ1: checks 
*** RIVER *** [6d Tc 2h Kh] [9c]
coolisses111: checks 
czeczen7: checks 
RoJ1: checks 
*** SHOW DOWN ***
coolisses111: shows [Qs As] (high card Ace)
czeczen7: mucks hand 
RoJ1: shows [3s 3d] (a pair of Threes)
RoJ1 collected $2.58 from pot
*** SUMMARY ***
Total pot $2.70 | Rake $0.12 
Board [6d Tc 2h Kh 9c]
Seat 1: RoJ1 (button) showed [3s 3d] and won ($2.58) with a pair of Threes
Seat 2: coolisses111 (small blind) showed [Qs As] and lost with high card Ace
Seat 3: czeczen7 (big blind) mucked
Seat 4: Smitty03300 folded before Flop (didn't bet)
Seat 5: Pekaml folded before Flop (didn't bet)
Seat 6: garigura folded before Flop (didn't bet)



PokerStars Hand #166667476327:  Hold'em No Limit ($0.05/$0.10 USD) - 2017/02/23 16:01:51 ET
Table 'Laetitia II' 6-max Seat #5 is the button
Seat 1: Cluckh ($12.47 in chips) 
Seat 2: manashov ($10.37 in chips) 
Seat 3: 6ePeMeHHa9 ($10.29 in chips) 
Seat 4: Feverhead ($16.81 in chips) 
Seat 5: D3NyA ($16.93 in chips) 
Seat 6: Dima91360 ($2.96 in chips) 
Dima91360: posts small blind $0.05
Cluckh: posts big blind $0.10
*** HOLE CARDS ***
manashov: folds 
6ePeMeHHa9: folds 
Feverhead: folds 
D3NyA: folds 
Dima91360: calls $0.05
Cluckh: checks 
*** FLOP *** [7c 7h 8c]
Dima91360: checks 
Cluckh: bets $0.10
Dima91360: calls $0.10
*** TURN *** [7c 7h 8c] [3s]
Dima91360: checks 
Cluckh: bets $0.20
Dima91360: calls $0.20
*** RIVER *** [7c 7h 8c 3s] [Th]
Dima91360: checks 
Cluckh: bets $0.60
Dima91360: calls $0.60
*** SHOW DOWN ***
Cluckh: shows [5h 9c] (a pair of Sevens)
Dima91360: shows [8s 4c] (two pair, Eights and Sevens)
Dima91360 collected $1.91 from pot
*** SUMMARY ***
Total pot $2 | Rake $0.09 
Board [7c 7h 8c 3s Th]
Seat 1: Cluckh (big blind) showed [5h 9c] and lost with a pair of Sevens
Seat 2: manashov folded before Flop (didn't bet)
Seat 3: 6ePeMeHHa9 folded before Flop (didn't bet)
Seat 4: Feverhead folded before Flop (didn't bet)
Seat 5: D3NyA (button) folded before Flop (didn't bet)
Seat 6: Dima91360 (small blind) showed [8s 4c] and won ($1.91) with two pair, Eights and Sevens



PokerStars Hand #166667476764:  Hold'em No Limit ($0.05/$0.10 USD) - 2017/02/23 16:01:51 ET
Table 'Xanthippe II' 6-max Seat #2 is the button
Seat 1: ade22345 ($4.48 in chips) 
Seat 2: Bird et al ($13.51 in chips) 
Seat 3: Dcaro31 ($10 in chips) 
Seat 4: Barcardi14 ($10.15 in chips) 
Seat 6: Orlangoor ($11.04 in chips) 
Dcaro31: posts small blind $0.05
Barcardi14: posts big blind $0.10
yodzik: sits out 
*** HOLE CARDS ***
Orlangoor: folds 
ade22345: folds 
Bird et al: folds 
Dcaro31: folds 
Uncalled bet ($0.05) returned to Barcardi14
Barcardi14 collected $0.10 from pot
*** SUMMARY ***
Total pot $0.10 | Rake $0 
Seat 1: ade22345 folded before Flop (didn't bet)
Seat 2: Bird et al (button) folded before Flop (didn't bet)
Seat 3: Dcaro31 (small blind) folded before Flop
Seat 4: Barcardi14 (big blind) collected ($0.10)
Seat 6: Orlangoor folded before Flop (didn't bet)



PokerStars Hand #166667477186:  Hold'em No Limit ($0.05/$0.10 USD) - 2017/02/23 16:01:52 ET
Table 'Goto II' 6-max Seat #5 is the button
Seat 1: FRAID358 ($13.13 in chips) 
Seat 2: 6ePeMeHHa9 ($11.09 in chips) 
Seat 3: Goroshkos88 ($10.59 in chips) 
Seat 4: KRZuff ($13.04 in chips) 
Seat 5: RoJ1 ($14.14 in chips) 
Seat 6: ermananb93 ($12.60 in chips) 
ermananb93: posts small blind $0.05
FRAID358: posts big blind $0.10
*** HOLE CARDS ***
6ePeMeHHa9: folds 
Goroshkos88: folds 
KRZuff: folds 
RoJ1: raises $0.12 to $0.22
ermananb93: calls $0.17
FRAID358: calls $0.12
*** FLOP *** [Qs 8s 8h]
ermananb93: bets $0.10
FRAID358: calls $0.10
RoJ1: calls $0.10
*** TURN *** [Qs 8s 8h] [4d]
ermananb93: bets $0.10
FRAID358: folds 
RoJ1: calls $0.10
*** RIVER *** [Qs 8s 8h 4d] [7s]
ermananb93: bets $0.40
RoJ1: folds 
Uncalled bet ($0.40) returned to ermananb93
ermananb93 collected $1.11 from pot
*** SUMMARY ***
Total pot $1.16 | Rake $0.05 
Board [Qs 8s 8h 4d 7s]
Seat 1: FRAID358 (big blind) folded on the Turn
Seat 2: 6ePeMeHHa9 folded before Flop (didn't bet)
Seat 3: Goroshkos88 folded before Flop (didn't bet)
Seat 4: KRZuff folded before Flop (didn't bet)
Seat 5: RoJ1 (button) folded on the River
Seat 6: ermananb93 (small blind) collected ($1.11)



PokerStars Hand #166667477635:  Hold'em No Limit ($0.05/$0.10 USD) - 2017/02/23 16:01:52 ET
Table 'Pirola' 6-max Seat #1 is the button
Seat 1: Rodik002 ($12.78 in chips) 
Seat 2: lmlmlmlm90 ($18.45 in chips) 
Seat 3: XaXaTyH4uK ($11.77 in chips) 
Seat 4: barons89 ($8.50 in chips) 
Seat 5: Iarlei ($14.39 in chips) 
Seat 6: Hyd SK ($10 in chips) 
lmlmlmlm90: posts small blind $0.05
XaXaTyH4uK: posts big blind $0.10
*** HOLE CARDS ***
barons89: folds 
Iarlei: folds 
Hyd SK: folds 
Rodik002: folds 
lmlmlmlm90: calls $0.05
XaXaTyH4uK: checks 
*** FLOP *** [9s 6h 8c]
lmlmlmlm90: checks 
XaXaTyH4uK: checks 
*** TURN *** [9s 6h 8c] [8d]
lmlmlmlm90: checks 
XaXaTyH4uK: checks 
*** RIVER *** [9s 6h 8c 8d] [7c]
lmlmlmlm90: checks 
XaXaTyH4uK: checks 
*** SHOW DOWN ***
lmlmlmlm90: shows [As 7s] (two pair, Eights and Sevens)
XaXaTyH4uK: mucks hand 
lmlmlmlm90 collected $0.19 from pot
*** SUMMARY ***
Total pot $0.20 | Rake $0.01 
Board [9s 6h 8c 8d 7c]
Seat 1: Rodik002 (button) folded before Flop (didn't bet)
Seat 2: lmlmlmlm90 (small blind) showed [As 7s] and won ($0.19) with two pair, Eights and Sevens
Seat 3: XaXaTyH4uK (big blind) mucked
Seat 4: barons89 folded before Flop (didn't bet)
Seat 5: Iarlei folded before Flop (didn't bet)
Seat 6: Hyd SK folded before Flop (didn't bet)



PokerStars Hand #166667477783:  Hold'em No Limit ($0.05/$0.10 USD) - 2017/02/23 16:01:52 ET
Table 'Unitas II' 6-max Seat #2 is the button
Seat 1: Peter0087 ($9.20 in chips) 
Seat 2: dragonste89 ($10.91 in chips) 
Seat 3: CallByValue ($9.90 in chips) 
Seat 4: truck1234 ($10.72 in chips) 
Seat 5: chimera252 ($26.06 in chips) 
CallByValue: posts small blind $0.05
truck1234: posts big blind $0.10
paxit71: sits out 
*** HOLE CARDS ***
chimera252: raises $0.20 to $0.30
Peter0087: folds 
dragonste89: folds 
CallByValue: folds 
truck1234: calls $0.20
*** FLOP *** [7c 4h 9s]
truck1234: bets $0.40
chimera252: folds 
Uncalled bet ($0.40) returned to truck1234
truck1234 collected $0.62 from pot
*** SUMMARY ***
Total pot $0.65 | Rake $0.03 
Board [7c 4h 9s]
Seat 1: Peter0087 folded before Flop (didn't bet)
Seat 2: dragonste89 (button) folded before Flop (didn't bet)
Seat 3: CallByValue (small blind) folded before Flop
Seat 4: truck1234 (big blind) collected ($0.62)
Seat 5: chimera252 folded on the Flop



PokerStars Hand #166667478374:  Hold'em No Limit ($0.05/$0.10 USD) - 2017/02/23 16:01:53 ET
Table 'Aludra II' 6-max Seat #6 is the button
Seat 1: voledy ($10.05 in chips) 
Seat 2: JahSoldier69 ($10.28 in chips) 
Seat 3: 2G28 ($13 in chips) 
Seat 4: MihaGr ($10 in chips) 
Seat 5: kingartur222 ($15.85 in chips) 
Seat 6: call me haaa ($13.90 in chips) 
voledy: posts small blind $0.05
JahSoldier69: posts big blind $0.10
*** HOLE CARDS ***
2G28: folds 
MihaGr: folds 
kingartur222: folds 
call me haaa: raises $0.20 to $0.30
voledy: folds 
JahSoldier69: folds 
Uncalled bet ($0.20) returned to call me haaa
call me haaa collected $0.25 from pot
*** SUMMARY ***
Total pot $0.25 | Rake $0 
Seat 1: voledy (small blind) folded before Flop
Seat 2: JahSoldier69 (big blind) folded before Flop
Seat 3: 2G28 folded before Flop (didn't bet)
Seat 4: MihaGr folded before Flop (didn't bet)
Seat 5: kingartur222 folded before Flop (didn't bet)
Seat 6: call me haaa (button) collected ($0.25)



PokerStars Hand #166667478485:  Hold'em No Limit ($0.05/$0.10 USD) - 2017/02/23 16:01:53 ET
Table 'Marbachia II' 6-max Seat #6 is the button
Seat 1: AC Evergreen ($10 in chips) 
Seat 2: Yabidooo ($10 in chips) 
Seat 4: BahiaMinhaP ($10 in chips) 
Seat 5: Kow6oy ($10 in chips) 
Seat 6: DamDatsAnAce ($10 in chips) 
AC Evergreen: posts small blind $0.05
Yabidooo: posts big blind $0.10
*** HOLE CARDS ***
BahiaMinhaP: folds 
Kow6oy: folds 
CDestructivo leaves the table
DamDatsAnAce: raises $0.15 to $0.25
AC Evergreen: folds 
Yabidooo: raises $0.55 to $0.80
DamDatsAnAce: folds 
Uncalled bet ($0.55) returned to Yabidooo
Yabidooo collected $0.55 from pot
*** SUMMARY ***
Total pot $0.55 | Rake $0 
Seat 1: AC Evergreen (small blind) folded before Flop
Seat 2: Yabidooo (big blind) collected ($0.55)
Seat 4: BahiaMinhaP folded before Flop (didn't bet)
Seat 5: Kow6oy folded before Flop (didn't bet)
Seat 6: DamDatsAnAce (button) folded before Flop



PokerStars Hand #166667478798:  Hold'em No Limit ($0.05/$0.10 USD) - 2017/02/23 16:01:54 ET
Table 'Nymphe II' 6-max Seat #3 is the button
Seat 1: jacktayra ($3.67 in chips) 
Seat 2: Newqbrown ($10.15 in chips) 
Seat 3: THIMUCHIN ($14.25 in chips) 
Seat 4: coolisses111 ($19.05 in chips) 
Seat 5: Yspenyanin ($11.09 in chips) 
Seat 6: Xander188 ($18.23 in chips) 
coolisses111: posts small blind $0.05
Yspenyanin: posts big blind $0.10
*** HOLE CARDS ***
Xander188: folds 
jacktayra: raises $0.10 to $0.20
Newqbrown: folds 
THIMUCHIN: calls $0.20
coolisses111: raises $1 to $1.20
Yspenyanin: folds 
jacktayra: folds 
THIMUCHIN: folds 
Uncalled bet ($1) returned to coolisses111
coolisses111 collected $0.70 from pot
*** SUMMARY ***
Total pot $0.70 | Rake $0 
Seat 1: jacktayra folded before Flop
Seat 2: Newqbrown folded before Flop (didn't bet)
Seat 3: THIMUCHIN (button) folded before Flop
Seat 4: coolisses111 (small blind) collected ($0.70)
Seat 5: Yspenyanin (big blind) folded before Flop
Seat 6: Xander188 folded before Flop (didn't bet)



PokerStars Hand #166667479004:  Hold'em No Limit ($0.05/$0.10 USD) - 2017/02/23 16:01:54 ET
Table 'Peiroos III' 6-max Seat #3 is the button
Seat 1: tequila_joop ($10.09 in chips) 
Seat 3: nabatov.m ($6.05 in chips) 
Seat 4: pivanki11 ($11.01 in chips) 
Seat 5: ChuikaPridi ($9.64 in chips) 
Seat 6: CHRO8 ($9.80 in chips) 
pivanki11: posts small blind $0.05
ChuikaPridi: posts big blind $0.10
tequila_joop: posts the ante $0.02
nabatov.m: posts the ante $0.02
pivanki11: posts the ante $0.02
ChuikaPridi: posts the ante $0.02
CHRO8: posts the ante $0.02
*** HOLE CARDS ***
CHRO8: folds 
tequila_joop: folds 
nabatov.m: folds 
pivanki11: calls $0.05
ChuikaPridi: checks 
*** FLOP *** [Ac 7d Qh]
pivanki11: checks 
ChuikaPridi: bets $0.50
pivanki11: folds 
Uncalled bet ($0.50) returned to ChuikaPridi
ChuikaPridi collected $0.29 from pot
*** SUMMARY ***
Total pot $0.30 | Rake $0.01 
Board [Ac 7d Qh]
Seat 1: tequila_joop folded before Flop (didn't bet)
Seat 3: nabatov.m (button) folded before Flop (didn't bet)
Seat 4: pivanki11 (small blind) folded on the Flop
Seat 5: ChuikaPridi (big blind) collected ($0.29)
Seat 6: CHRO8 folded before Flop (didn't bet)



PokerStars Hand #166667479205:  Hold'em No Limit ($0.05/$0.10 USD) - 2017/02/23 16:01:54 ET
Table 'Peiroos' 6-max Seat #4 is the button
Seat 1: ksandr_hom ($10 in chips) 
Seat 2: Nr847 ($10 in chips) 
Seat 3: atlx0711 ($21.82 in chips) 
Seat 4: Peter0087 ($10 in chips) 
Seat 5: sergio-cb164 ($9.45 in chips) 
Seat 6: DevonMiles88 ($9.47 in chips) 
sergio-cb164: posts small blind $0.05
DevonMiles88: posts big blind $0.10
*** HOLE CARDS ***
ksandr_hom: folds 
Nr847: folds 
atlx0711: raises $0.20 to $0.30
Peter0087: folds 
sergio-cb164: folds 
DevonMiles88: calls $0.20
*** FLOP *** [8h Js 8d]
DevonMiles88: bets $0.50
atlx0711: calls $0.50
*** TURN *** [8h Js 8d] [Th]
DevonMiles88: bets $1.10
atlx0711: calls $1.10
*** RIVER *** [8h Js 8d Th] [Ad]
DevonMiles88: bets $3.60
atlx0711: raises $5.30 to $8.90
DevonMiles88: folds 
Uncalled bet ($5.30) returned to atlx0711
atlx0711 collected $10.55 from pot
*** SUMMARY ***
Total pot $11.05 | Rake $0.50 
Board [8h Js 8d Th Ad]
Seat 1: ksandr_hom folded before Flop (didn't bet)
Seat 2: Nr847 folded before Flop (didn't bet)
Seat 3: atlx0711 collected ($10.55)
Seat 4: Peter0087 (button) folded before Flop (didn't bet)
Seat 5: sergio-cb164 (small blind) folded before Flop
Seat 6: DevonMiles88 (big blind) folded on the River



PokerStars Hand #166667479437:  Hold'em No Limit ($0.05/$0.10 USD) - 2017/02/23 16:01:54 ET
Table 'Lampetia III' 6-max Seat #4 is the button
Seat 1: gaHy_HaXeP ($10.30 in chips) 
Seat 2: DamDatsAnAce ($10.10 in chips) 
Seat 3: Therodorus ($10.30 in chips) 
Seat 4: IAntikI ($10.91 in chips) 
Seat 5: robson1235 ($19.45 in chips) 
Seat 6: bdixon_5 ($9.50 in chips) 
robson1235: posts small blind $0.05
bdixon_5: posts big blind $0.10
*** HOLE CARDS ***
gaHy_HaXeP: folds 
DamDatsAnAce: folds 
Therodorus: folds 
IAntikI: folds 
robson1235: raises $0.10 to $0.20
bdixon_5: folds 
Uncalled bet ($0.10) returned to robson1235
robson1235 collected $0.20 from pot
*** SUMMARY ***
Total pot $0.20 | Rake $0 
Seat 1: gaHy_HaXeP folded before Flop (didn't bet)
Seat 2: DamDatsAnAce folded before Flop (didn't bet)
Seat 3: Therodorus folded before Flop (didn't bet)
Seat 4: IAntikI (button) folded before Flop (didn't bet)
Seat 5: robson1235 (small blind) collected ($0.20)
Seat 6: bdixon_5 (big blind) folded before Flop



PokerStars Hand #166667479528:  Hold'em No Limit ($0.05/$0.10 USD) - 2017/02/23 16:01:55 ET
Table 'Stroobantia' 6-max Seat #2 is the button
Seat 1: mam9zyc ($7.55 in chips) 
Seat 2: XwinX25 ($10.34 in chips) 
Seat 3: Namhkal ($10.05 in chips) 
Seat 4: Yspenyanin ($10.28 in chips) 
Seat 5: boxer821 ($10.64 in chips) 
Seat 6: KokoulinV ($15.37 in chips) 
Namhkal: posts small blind $0.05
Yspenyanin: posts big blind $0.10
*** HOLE CARDS ***
boxer821: folds 
KokoulinV: raises $0.20 to $0.30
mam9zyc: folds 
XwinX25: folds 
Namhkal: folds 
Yspenyanin: folds 
Uncalled bet ($0.20) returned to KokoulinV
KokoulinV collected $0.25 from pot
*** SUMMARY ***
Total pot $0.25 | Rake $0 
Seat 1: mam9zyc folded before Flop (didn't bet)
Seat 2: XwinX25 (button) folded before Flop (didn't bet)
Seat 3: Namhkal (small blind) folded before Flop
Seat 4: Yspenyanin (big blind) folded before Flop
Seat 5: boxer821 folded before Flop (didn't bet)
Seat 6: KokoulinV collected ($0.25)



PokerStars Hand #166667479823:  Hold'em No Limit ($0.05/$0.10 USD) - 2017/02/23 16:01:55 ET
Table 'Crommelin II' 6-max Seat #1 is the button
Seat 1: THIMUCHIN ($11.07 in chips) 
Seat 2: Bird et al ($10 in chips) 
Seat 3: Strelok1974 ($21.30 in chips) 
Seat 4: Pequeño Clau ($10.15 in chips) 
Seat 5: Action_Gibi ($20.19 in chips) 
Seat 6: Darkfrai ($10.67 in chips) 
Bird et al: posts small blind $0.05
Strelok1974: posts big blind $0.10
*** HOLE CARDS ***
Pequeño Clau: folds 
Action_Gibi: folds 
Darkfrai: raises $0.15 to $0.25
THIMUCHIN: folds 
Bird et al: folds 
Strelok1974: calls $0.15
*** FLOP *** [4h 8d Kd]
Strelok1974: checks 
Darkfrai: bets $0.29
Strelok1974: folds 
Uncalled bet ($0.29) returned to Darkfrai
Darkfrai collected $0.53 from pot
*** SUMMARY ***
Total pot $0.55 | Rake $0.02 
Board [4h 8d Kd]
Seat 1: THIMUCHIN (button) folded before Flop (didn't bet)
Seat 2: Bird et al (small blind) folded before Flop
Seat 3: Strelok1974 (big blind) folded on the Flop
Seat 4: Pequeño Clau folded before Flop (didn't bet)
Seat 5: Action_Gibi folded before Flop (didn't bet)
Seat 6: Darkfrai collected ($0.53)



PokerStars Hand #166667480020:  Hold'em No Limit ($0.05/$0.10 USD) - 2017/02/23 16:01:55 ET
Table 'Manto II' 6-max Seat #4 is the button
Seat 2: voledy ($10 in chips) 
Seat 3: Komap511 ($9.15 in chips) 
Seat 4: dr.goofy ($10.82 in chips) 
Seat 5: ArcticBearDK ($22.40 in chips) 
Seat 6: pancernik21 ($16.85 in chips) 
ArcticBearDK: posts small blind $0.05
pancernik21: posts big blind $0.10
MihaGr: sits out 
*** HOLE CARDS ***
voledy: folds 
Komap511: folds 
dr.goofy: raises $0.15 to $0.25
ArcticBearDK: folds 
pancernik21: calls $0.15
*** FLOP *** [Tc 3d 2h]
pancernik21: checks 
dr.goofy: bets $0.30
pancernik21: calls $0.30
*** TURN *** [Tc 3d 2h] [Ks]
pancernik21: checks 
dr.goofy: checks 
*** RIVER *** [Tc 3d 2h Ks] [Jh]
pancernik21: bets $0.57
dr.goofy: folds 
Uncalled bet ($0.57) returned to pancernik21
pancernik21 collected $1.10 from pot
*** SUMMARY ***
Total pot $1.15 | Rake $0.05 
Board [Tc 3d 2h Ks Jh]
Seat 2: voledy folded before Flop (didn't bet)
Seat 3: Komap511 folded before Flop (didn't bet)
Seat 4: dr.goofy (button) folded on the River
Seat 5: ArcticBearDK (small blind) folded before Flop
Seat 6: pancernik21 (big blind) collected ($1.10)



PokerStars Hand #166667480100:  Hold'em No Limit ($0.05/$0.10 USD) - 2017/02/23 16:01:55 ET
Table 'Reginhild' 6-max Seat #4 is the button
Seat 1: iamkakaroto ($11.40 in chips) 
Seat 2: Kow6oy ($10.15 in chips) 
Seat 3: ARCHITECT83 ($5.45 in chips) 
Seat 4: Raymondo21 ($23.36 in chips) 
Seat 5: XCarlos610 ($28.84 in chips) 
Seat 6: eniksenik ($10.79 in chips) 
XCarlos610: posts small blind $0.05
eniksenik: posts big blind $0.10
*** HOLE CARDS ***
iamkakaroto: folds 
Kow6oy: folds 
ARCHITECT83: calls $0.10
Raymondo21: folds 
XCarlos610: calls $0.05
eniksenik: raises $0.30 to $0.40
ARCHITECT83: raises $0.30 to $0.70
XCarlos610: folds 
eniksenik: calls $0.30
*** FLOP *** [9d 5d 5h]
eniksenik: checks 
ARCHITECT83: bets $0.40
eniksenik: folds 
Uncalled bet ($0.40) returned to ARCHITECT83
ARCHITECT83 collected $1.43 from pot
*** SUMMARY ***
Total pot $1.50 | Rake $0.07 
Board [9d 5d 5h]
Seat 1: iamkakaroto folded before Flop (didn't bet)
Seat 2: Kow6oy folded before Flop (didn't bet)
Seat 3: ARCHITECT83 collected ($1.43)
Seat 4: Raymondo21 (button) folded before Flop (didn't bet)
Seat 5: XCarlos610 (small blind) folded before Flop
Seat 6: eniksenik (big blind) folded on the Flop



PokerStars Hand #166667480186:  Hold'em No Limit ($0.05/$0.10 USD) - 2017/02/23 16:01:55 ET
Table 'Apollonia' 6-max Seat #5 is the button
Seat 1: ex3Lero86 ($10.26 in chips) 
Seat 2: ibara000 ($18.84 in chips) 
Seat 3: derbesteojr ($9.20 in chips) 
Seat 4: Goroshkos88 ($17.46 in chips) 
Seat 5: EphemeralBen ($13.49 in chips) 
Seat 6: Namhkal ($10.30 in chips) 
Namhkal: posts small blind $0.05
ex3Lero86: posts big blind $0.10
*** HOLE CARDS ***
ibara000: folds 
derbesteojr: raises $0.20 to $0.30
Goroshkos88: folds 
EphemeralBen: folds 
Namhkal: folds 
ex3Lero86: folds 
Uncalled bet ($0.20) returned to derbesteojr
derbesteojr collected $0.25 from pot
*** SUMMARY ***
Total pot $0.25 | Rake $0 
Seat 1: ex3Lero86 (big blind) folded before Flop
Seat 2: ibara000 folded before Flop (didn't bet)
Seat 3: derbesteojr collected ($0.25)
Seat 4: Goroshkos88 folded before Flop (didn't bet)
Seat 5: EphemeralBen (button) folded before Flop (didn't bet)
Seat 6: Namhkal (small blind) folded before Flop



PokerStars Hand #166667480321:  Hold'em No Limit ($0.05/$0.10 USD) - 2017/02/23 16:01:55 ET
Table 'Fechtig III' 6-max Seat #4 is the button
Seat 1: Scanner17 ($10 in chips) 
Seat 2: GV82 ($15.96 in chips) 
Seat 3: eniksenik ($10 in chips) 
Seat 4: kickereens ($11.23 in chips) 
Seat 5: ksandr_hom ($10 in chips) 
Seat 6: Glatzemandse ($20.20 in chips) 
ksandr_hom: posts small blind $0.05
Glatzemandse: posts big blind $0.10
*** HOLE CARDS ***
Scanner17: folds 
GV82: folds 
eniksenik: folds 
kickereens: folds 
ksandr_hom: raises $0.20 to $0.30
Glatzemandse: folds 
Uncalled bet ($0.20) returned to ksandr_hom
ksandr_hom collected $0.20 from pot
*** SUMMARY ***
Total pot $0.20 | Rake $0 
Seat 1: Scanner17 folded before Flop (didn't bet)
Seat 2: GV82 folded before Flop (didn't bet)
Seat 3: eniksenik folded before Flop (didn't bet)
Seat 4: kickereens (button) folded before Flop (didn't bet)
Seat 5: ksandr_hom (small blind) collected ($0.20)
Seat 6: Glatzemandse (big blind) folded before Flop



PokerStars Hand #166667480449:  Hold'em No Limit ($0.05/$0.10 USD) - 2017/02/23 16:01:56 ET
Table 'Alnasl' 6-max Seat #2 is the button
Seat 1: KA3AXCTAHEU, ($11.07 in chips) 
Seat 2: XaXaTyH4uK ($10.60 in chips) 
Seat 3: david_sara83 ($22.74 in chips) 
Seat 4: oddshoff ($10.18 in chips) 
Seat 5: steepfell ($10.23 in chips) 
Seat 6: Zooplack ($13.43 in chips) 
david_sara83: posts small blind $0.05
oddshoff: posts big blind $0.10
*** HOLE CARDS ***
steepfell: folds 
Zooplack: folds 
KA3AXCTAHEU,: raises $0.15 to $0.25
XaXaTyH4uK: folds 
david_sara83: folds 
oddshoff: folds 
Uncalled bet ($0.15) returned to KA3AXCTAHEU,
KA3AXCTAHEU, collected $0.25 from pot
*** SUMMARY ***
Total pot $0.25 | Rake $0 
Seat 1: KA3AXCTAHEU, collected ($0.25)
Seat 2: XaXaTyH4uK (button) folded before Flop (didn't bet)
Seat 3: david_sara83 (small blind) folded before Flop
Seat 4: oddshoff (big blind) folded before Flop
Seat 5: steepfell folded before Flop (didn't bet)
Seat 6: Zooplack folded before Flop (didn't bet)



PokerStars Hand #166667480461:  Hold'em No Limit ($0.05/$0.10 USD) - 2017/02/23 16:01:56 ET
Table 'Tomita II' 6-max Seat #4 is the button
Seat 2: mhonielsen ($10 in chips) 
Seat 3: Lucky HoBBiT ($12.16 in chips) 
Seat 4: Hyd SK ($10 in chips) 
Seat 6: Punzzzer ($12.26 in chips) 
Punzzzer: posts small blind $0.05
HARDCORE66RU: is sitting out 
mhonielsen: posts big blind $0.10
*** HOLE CARDS ***
Lucky HoBBiT: folds 
Hyd SK: folds 
Punzzzer: raises $0.10 to $0.20
mhonielsen: folds 
Uncalled bet ($0.10) returned to Punzzzer
Punzzzer collected $0.20 from pot
*** SUMMARY ***
Total pot $0.20 | Rake $0 
Seat 2: mhonielsen (big blind) folded before Flop
Seat 3: Lucky HoBBiT folded before Flop (didn't bet)
Seat 4: Hyd SK (button) folded before Flop (didn't bet)
Seat 6: Punzzzer (small blind) collected ($0.20)



PokerStars Hand #166667480664:  Hold'em No Limit ($0.05/$0.10 USD) - 2017/02/23 16:01:56 ET
Table 'Alnasl II' 6-max Seat #3 is the button
Seat 1: dragonste89 ($13.15 in chips) 
Seat 2: Therodorus ($11.91 in chips) 
Seat 3: ICBM-RS26 ($8.09 in chips) 
Seat 4: Eddys Edge ($10 in chips) 
Seat 5: mdelfin0 ($12.46 in chips) 
Seat 6: Bommer78 ($4.63 in chips) 
Eddys Edge: posts small blind $0.05
mdelfin0: posts big blind $0.10
*** HOLE CARDS ***
Bommer78: calls $0.10
dragonste89: folds 
Therodorus: folds 
ICBM-RS26: folds 
Eddys Edge: folds 
mdelfin0: checks 
*** FLOP *** [2h 9s 6h]
mdelfin0: checks 
Bommer78: bets $0.10
mdelfin0: folds 
Uncalled bet ($0.10) returned to Bommer78
Bommer78 collected $0.24 from pot
*** SUMMARY ***
Total pot $0.25 | Rake $0.01 
Board [2h 9s 6h]
Seat 1: dragonste89 folded before Flop (didn't bet)
Seat 2: Therodorus folded before Flop (didn't bet)
Seat 3: ICBM-RS26 (button) folded before Flop (didn't bet)
Seat 4: Eddys Edge (small blind) folded before Flop
Seat 5: mdelfin0 (big blind) folded on the Flop
Seat 6: Bommer78 collected ($0.24)



PokerStars Hand #166667480895:  Hold'em No Limit ($0.05/$0.10 USD) - 2017/02/23 16:01:56 ET
Table 'Kunigunde II' 6-max Seat #3 is the button
Seat 1: facewald ($10.11 in chips) 
Seat 2: dragonste89 ($14.88 in chips) 
Seat 3: pancernik21 ($14.76 in chips) 
Seat 4: david_sara83 ($12.88 in chips) 
Seat 5: mdelfin0 ($11.59 in chips) 
Seat 6: Zooplack ($10 in chips) 
david_sara83: posts small blind $0.05
mdelfin0: posts big blind $0.10
*** HOLE CARDS ***
Zooplack: folds 
facewald: folds 
dragonste89: folds 
pancernik21: folds 
david_sara83: folds 
Uncalled bet ($0.05) returned to mdelfin0
mdelfin0 collected $0.10 from pot
*** SUMMARY ***
Total pot $0.10 | Rake $0 
Seat 1: facewald folded before Flop (didn't bet)
Seat 2: dragonste89 folded before Flop (didn't bet)
Seat 3: pancernik21 (button) folded before Flop (didn't bet)
Seat 4: david_sara83 (small blind) folded before Flop
Seat 5: mdelfin0 (big blind) collected ($0.10)
Seat 6: Zooplack folded before Flop (didn't bet)



PokerStars Hand #166667481035:  Hold'em No Limit ($0.05/$0.10 USD) - 2017/02/23 16:01:56 ET
Table 'Pulcova II' 6-max Seat #4 is the button
Seat 1: sexy_seagull ($10.15 in chips) 
Seat 2: Kazacha ($10 in chips) 
Seat 3: Lao Tsy ($13.96 in chips) 
Seat 4: VioXion ($10.25 in chips) 
Seat 5: mdelfin0 ($12.84 in chips) 
Seat 6: Ice_Isayev ($10.61 in chips) 
mdelfin0: posts small blind $0.05
Ice_Isayev: posts big blind $0.10
*** HOLE CARDS ***
sexy_seagull: folds 
Kazacha: folds 
Lao Tsy: folds 
VioXion: folds 
mdelfin0: calls $0.05
Ice_Isayev: checks 
*** FLOP *** [4h Qh 7h]
mdelfin0: checks 
Ice_Isayev: bets $0.19
mdelfin0: folds 
Uncalled bet ($0.19) returned to Ice_Isayev
Ice_Isayev collected $0.19 from pot
*** SUMMARY ***
Total pot $0.20 | Rake $0.01 
Board [4h Qh 7h]
Seat 1: sexy_seagull folded before Flop (didn't bet)
Seat 2: Kazacha folded before Flop (didn't bet)
Seat 3: Lao Tsy folded before Flop (didn't bet)
Seat 4: VioXion (button) folded before Flop (didn't bet)
Seat 5: mdelfin0 (small blind) folded on the Flop
Seat 6: Ice_Isayev (big blind) collected ($0.19)



PokerStars Hand #166667481054:  Hold'em No Limit ($0.05/$0.10 USD) - 2017/02/23 16:01:56 ET
Table 'Aisakos II' 6-max Seat #4 is the button
Seat 1: Crafty23@PS ($10 in chips) 
Seat 2: svaika24 ($17.03 in chips) 
Seat 3: iamkakaroto ($10.69 in chips) 
Seat 4: T9MS ($10 in chips) 
Seat 5: KokoulinV ($11.46 in chips) 
Seat 6: LarryTheStar ($10.15 in chips) 
KokoulinV: posts small blind $0.05
LarryTheStar: posts big blind $0.10
*** HOLE CARDS ***
Crafty23@PS: folds 
svaika24: calls $0.10
iamkakaroto: folds 
T9MS: folds 
KokoulinV: raises $0.30 to $0.40
LarryTheStar: folds 
svaika24: folds 
Uncalled bet ($0.30) returned to KokoulinV
KokoulinV collected $0.30 from pot
*** SUMMARY ***
Total pot $0.30 | Rake $0 
Seat 1: Crafty23@PS folded before Flop (didn't bet)
Seat 2: svaika24 folded before Flop
Seat 3: iamkakaroto folded before Flop (didn't bet)
Seat 4: T9MS (button) folded before Flop (didn't bet)
Seat 5: KokoulinV (small blind) collected ($0.30)
Seat 6: LarryTheStar (big blind) folded before Flop



PokerStars Hand #166667481194:  Hold'em No Limit ($0.05/$0.10 USD) - 2017/02/23 16:01:56 ET
Table 'Grietje' 6-max Seat #4 is the button
Seat 1: WinninBikini ($14.98 in chips) 
Seat 2: Feverhead ($13.17 in chips) 
Seat 3: a_tonis6 ($9.73 in chips) 
Seat 4: 6ePeMeHHa9 ($10 in chips) 
Seat 5: sbalass ($9.84 in chips) 
Seat 6: Prometheu$8 ($11.01 in chips) 
sbalass: posts small blind $0.05
Prometheu$8: posts big blind $0.10
*** HOLE CARDS ***
WinninBikini: folds 
Feverhead: folds 
a_tonis6: folds 
a_tonis6 leaves the table
6ePeMeHHa9: raises $0.14 to $0.24
iamkakaroto joins the table at seat #3 
sbalass: folds 
Prometheu$8: calls $0.14
*** FLOP *** [6c Qc Jd]
Prometheu$8: checks 
6ePeMeHHa9: bets $0.25
Prometheu$8: raises $0.55 to $0.80
6ePeMeHHa9: calls $0.55
*** TURN *** [6c Qc Jd] [4h]
Prometheu$8: bets $2.03
6ePeMeHHa9: folds 
Uncalled bet ($2.03) returned to Prometheu$8
Prometheu$8 collected $2.03 from pot
*** SUMMARY ***
Total pot $2.13 | Rake $0.10 
Board [6c Qc Jd 4h]
Seat 1: WinninBikini folded before Flop (didn't bet)
Seat 2: Feverhead folded before Flop (didn't bet)
Seat 3: a_tonis6 folded before Flop (didn't bet)
Seat 4: 6ePeMeHHa9 (button) folded on the Turn
Seat 5: sbalass (small blind) folded before Flop
Seat 6: Prometheu$8 (big blind) collected ($2.03)



PokerStars Hand #166667481235:  Hold'em No Limit ($0.05/$0.10 USD) - 2017/02/23 16:01:56 ET
Table 'Luanda' 6-max Seat #3 is the button
Seat 1: Kow6oy ($10.10 in chips) 
Seat 2: Xander188 ($10 in chips) 
Seat 3: DamDatsAnAce ($10 in chips) 
Seat 5: st4tion ($12.12 in chips) 
Seat 6: KA3AXCTAHEU, ($11.41 in chips) 
st4tion: posts small blind $0.05
KA3AXCTAHEU,: posts big blind $0.10
*** HOLE CARDS ***
Kow6oy: folds 
Xander188: folds 
Kow6oy leaves the table
DamDatsAnAce: raises $0.15 to $0.25
JahSoldier69 joins the table at seat #1 
JahSoldier69 leaves the table
st4tion: calls $0.20
AM-L-SL joins the table at seat #1 
KA3AXCTAHEU,: folds 
*** FLOP *** [7c 4h 7h]
st4tion: checks 
DamDatsAnAce: checks 
*** TURN *** [7c 4h 7h] [Ah]
st4tion: bets $0.21
DamDatsAnAce: calls $0.21
*** RIVER *** [7c 4h 7h Ah] [Kc]
st4tion: checks 
DamDatsAnAce: checks 
*** SHOW DOWN ***
st4tion: shows [Ac 2h] (two pair, Aces and Sevens)
DamDatsAnAce: mucks hand 
st4tion collected $0.97 from pot
*** SUMMARY ***
Total pot $1.02 | Rake $0.05 
Board [7c 4h 7h Ah Kc]
Seat 1: Kow6oy folded before Flop (didn't bet)
Seat 2: Xander188 folded before Flop (didn't bet)
Seat 3: DamDatsAnAce (button) mucked
Seat 5: st4tion (small blind) showed [Ac 2h] and won ($0.97) with two pair, Aces and Sevens
Seat 6: KA3AXCTAHEU, (big blind) folded before Flop



PokerStars Hand #166667481391:  Hold'em No Limit ($0.05/$0.10 USD) - 2017/02/23 16:01:57 ET
Table 'Kanda' 6-max Seat #4 is the button
Seat 1: Andy Wolf ($10.56 in chips) 
Seat 2: Pelotín ($5.30 in chips) 
Seat 3: joewatson90 ($12.44 in chips) 
Seat 4: Orlangoor ($10.71 in chips) 
Seat 5: Temniy Elf ($10 in chips) 
Seat 6: oddshoff ($8.96 in chips) 
Temniy Elf: posts small blind $0.05
oddshoff: posts big blind $0.10
*** HOLE CARDS ***
Andy Wolf: folds 
Pelotín: raises $0.20 to $0.30
joewatson90: folds 
Orlangoor: folds 
Temniy Elf: folds 
oddshoff: folds 
Uncalled bet ($0.20) returned to Pelotín
Pelotín collected $0.25 from pot
*** SUMMARY ***
Total pot $0.25 | Rake $0 
Seat 1: Andy Wolf folded before Flop (didn't bet)
Seat 2: Pelotín collected ($0.25)
Seat 3: joewatson90 folded before Flop (didn't bet)
Seat 4: Orlangoor (button) folded before Flop (didn't bet)
Seat 5: Temniy Elf (small blind) folded before Flop
Seat 6: oddshoff (big blind) folded before Flop



PokerStars Hand #166667481455:  Hold'em No Limit ($0.05/$0.10 USD) - 2017/02/23 16:01:57 ET
Table 'Kraz II' 6-max Seat #6 is the button
Seat 1: bdixon_5 ($9.75 in chips) 
Seat 2: Smok3008 ($8.43 in chips) 
Seat 3: Eddys Edge ($10 in chips) 
Seat 4: WinninBikini ($10.22 in chips) 
Seat 6: tr41n3r12 ($10.15 in chips) 
bdixon_5: posts small blind $0.05
Smok3008: posts big blind $0.10
Joker51_wtf!: sits out 
*** HOLE CARDS ***
Eddys Edge: raises $0.20 to $0.30
WinninBikini: folds 
tr41n3r12: folds 
bdixon_5: folds 
Smok3008: calls $0.20
*** FLOP *** [3s 9s 2c]
Smok3008: checks 
Eddys Edge: bets $0.47
Smok3008: folds 
Uncalled bet ($0.47) returned to Eddys Edge
Eddys Edge collected $0.62 from pot
*** SUMMARY ***
Total pot $0.65 | Rake $0.03 
Board [3s 9s 2c]
Seat 1: bdixon_5 (small blind) folded before Flop
Seat 2: Smok3008 (big blind) folded on the Flop
Seat 3: Eddys Edge collected ($0.62)
Seat 4: WinninBikini folded before Flop (didn't bet)
Seat 6: tr41n3r12 (button) folded before Flop (didn't bet)



PokerStars Hand #166667481516:  Hold'em No Limit ($0.05/$0.10 USD) - 2017/02/23 16:01:57 ET
Table 'Esperanto II' 6-max Seat #6 is the button
Seat 1: kurasd ($10.47 in chips) 
Seat 2: MihaGr ($10 in chips) 
Seat 3: Namhkal ($12.37 in chips) 
Seat 4: Andrei ProFF ($10.41 in chips) 
Seat 5: FRAID358 ($10 in chips) 
Seat 6: ArcticBearDK ($13.15 in chips) 
kurasd: posts small blind $0.05
MihaGr: posts big blind $0.10
*** HOLE CARDS ***
Namhkal: folds 
Andrei ProFF: folds 
FRAID358: folds 
ArcticBearDK: folds 
kurasd: calls $0.05
MihaGr: checks 
*** FLOP *** [Jh Td 3h]
kurasd: checks 
MihaGr: bets $0.15
kurasd: folds 
Uncalled bet ($0.15) returned to MihaGr
MihaGr collected $0.19 from pot
*** SUMMARY ***
Total pot $0.20 | Rake $0.01 
Board [Jh Td 3h]
Seat 1: kurasd (small blind) folded on the Flop
Seat 2: MihaGr (big blind) collected ($0.19)
Seat 3: Namhkal folded before Flop (didn't bet)
Seat 4: Andrei ProFF folded before Flop (didn't bet)
Seat 5: FRAID358 folded before Flop (didn't bet)
Seat 6: ArcticBearDK (button) folded before Flop (didn't bet)



PokerStars Hand #166667481644:  Hold'em No Limit ($0.05/$0.10 USD) - 2017/02/23 16:01:57 ET
Table 'Girtab' 6-max Seat #3 is the button
Seat 2: MühliJr ($11.36 in chips) 
Seat 3: kingartur222 ($11.65 in chips) 
Seat 4: Hyd SK ($11.55 in chips) 
Seat 5: sexy_seagull ($10.87 in chips) 
Seat 6: BahiaMinhaP ($10.15 in chips) 
Hyd SK: posts small blind $0.05
sexy_seagull: posts big blind $0.10
pokekrk: sits out 
*** HOLE CARDS ***
BahiaMinhaP: raises $0.20 to $0.30
MühliJr: calls $0.30
kingartur222: raises $1 to $1.30
Hyd SK: folds 
sexy_seagull: folds 
BahiaMinhaP: calls $1
MühliJr: calls $1
*** FLOP *** [4c Qd Th]
BahiaMinhaP: checks 
MühliJr: checks 
kingartur222: checks 
*** TURN *** [4c Qd Th] [5s]
BahiaMinhaP: checks 
MühliJr: checks 
kingartur222: checks 
*** RIVER *** [4c Qd Th 5s] [9d]
BahiaMinhaP: checks 
MühliJr: checks 
kingartur222: checks 
*** SHOW DOWN ***
BahiaMinhaP: shows [Td Ad] (a pair of Tens)
MühliJr: mucks hand 
kingartur222: mucks hand 
BahiaMinhaP collected $3.87 from pot
*** SUMMARY ***
Total pot $4.05 | Rake $0.18 
Board [4c Qd Th 5s 9d]
Seat 2: MühliJr mucked
Seat 3: kingartur222 (button) mucked
Seat 4: Hyd SK (small blind) folded before Flop
Seat 5: sexy_seagull (big blind) folded before Flop
Seat 6: BahiaMinhaP showed [Td Ad] and won ($3.87) with a pair of Tens



PokerStars Hand #166667481753:  Hold'em No Limit ($0.05/$0.10 USD) - 2017/02/23 16:01:57 ET
Table 'Epimetheus' 6-max Seat #2 is the button
Seat 1: 6ePeMeHHa9 ($10.64 in chips) 
Seat 2: patrick19111 ($15.05 in chips) 
Seat 3: dineldidi ($9.57 in chips) 
Seat 5: afca128 ($24.63 in chips) 
Seat 6: voledy ($10 in chips) 
dineldidi: posts small blind $0.05
afca128: posts big blind $0.10
*** HOLE CARDS ***
voledy: folds 
6ePeMeHHa9: folds 
patrick19111: folds 
dineldidi: raises $0.20 to $0.30
afca128: calls $0.20
*** FLOP *** [7s 5s 2h]
dineldidi: bets $0.57
afca128: folds 
Uncalled bet ($0.57) returned to dineldidi
dineldidi collected $0.57 from pot
*** SUMMARY ***
Total pot $0.60 | Rake $0.03 
Board [7s 5s 2h]
Seat 1: 6ePeMeHHa9 folded before Flop (didn't bet)
Seat 2: patrick19111 (button) folded before Flop (didn't bet)
Seat 3: dineldidi (small blind) collected ($0.57)
Seat 5: afca128 (big blind) folded on the Flop
Seat 6: voledy folded before Flop (didn't bet)



PokerStars Hand #166667481993:  Hold'em No Limit ($0.05/$0.10 USD) - 2017/02/23 16:01:57 ET
Table 'Lobelia II' 6-max Seat #6 is the button
Seat 1: facewald ($29 in chips) 
Seat 2: Dcaro31 ($18.29 in chips) 
Seat 3: oddshoff ($11.54 in chips) 
Seat 5: Feverhead ($20.43 in chips) 
Seat 6: NvR.m1nD ($10 in chips) 
facewald: posts small blind $0.05
Dcaro31: posts big blind $0.10
*** HOLE CARDS ***
oddshoff: raises $0.20 to $0.30
Feverhead: folds 
NvR.m1nD: folds 
facewald: folds 
Dcaro31: folds 
Uncalled bet ($0.20) returned to oddshoff
oddshoff collected $0.25 from pot
*** SUMMARY ***
Total pot $0.25 | Rake $0 
Seat 1: facewald (small blind) folded before Flop
Seat 2: Dcaro31 (big blind) folded before Flop
Seat 3: oddshoff collected ($0.25)
Seat 5: Feverhead folded before Flop (didn't bet)
Seat 6: NvR.m1nD (button) folded before Flop (didn't bet)



PokerStars Hand #166667482022:  Hold'em No Limit ($0.05/$0.10 USD) - 2017/02/23 16:01:57 ET
Table 'Carina' 6-max Seat #4 is the button
Seat 2: kickereens ($24.24 in chips) 
Seat 4: crazydevill ($10 in chips) 
Seat 6: alexweezer ($10 in chips) 
alexweezer: posts small blind $0.05
kickereens: posts big blind $0.10
*** HOLE CARDS ***
crazydevill: raises $0.20 to $0.30
LarryTheStar joins the table at seat #3 
alexweezer: folds 
IAntikI joins the table at seat #5 
kickereens: folds 
Uncalled bet ($0.20) returned to crazydevill
crazydevill collected $0.25 from pot
*** SUMMARY ***
Total pot $0.25 | Rake $0 
Seat 2: kickereens (big blind) folded before Flop
Seat 4: crazydevill (button) collected ($0.25)
Seat 6: alexweezer (small blind) folded before Flop



PokerStars Hand #166667482288:  Hold'em No Limit ($0.05/$0.10 USD) - 2017/02/23 16:01:58 ET
Table 'Tomyris II' 6-max Seat #5 is the button
Seat 1: ArcticBearDK ($22.13 in chips) 
Seat 3: robertsabb ($11.52 in chips) 
Seat 4: Dcaro31 ($10 in chips) 
Seat 5: joewatson90 ($12.05 in chips) 
Seat 6: StackSmakka ($12.27 in chips) 
StackSmakka: posts small blind $0.05
ArcticBearDK: posts big blind $0.10
Yspenyanin: sits out 
*** HOLE CARDS ***
robertsabb: calls $0.10
Dcaro31: folds 
joewatson90: folds 
StackSmakka: folds 
ArcticBearDK: checks 
*** FLOP *** [4d 9s 3h]
ArcticBearDK: checks 
robertsabb: bets $0.20
ArcticBearDK: folds 
Uncalled bet ($0.20) returned to robertsabb
robertsabb collected $0.24 from pot
*** SUMMARY ***
Total pot $0.25 | Rake $0.01 
Board [4d 9s 3h]
Seat 1: ArcticBearDK (big blind) folded on the Flop
Seat 3: robertsabb collected ($0.24)
Seat 4: Dcaro31 folded before Flop (didn't bet)
Seat 5: joewatson90 (button) folded before Flop (didn't bet)
Seat 6: StackSmakka (small blind) folded before Flop



PokerStars Hand #166667482675:  Hold'em No Limit ($0.05/$0.10 USD) - 2017/02/23 16:01:58 ET
Table 'Pirola III' 6-max Seat #6 is the button
Seat 1: bdixon_5 ($9.82 in chips) 
Seat 2: gaHy_HaXeP ($10 in chips) 
Seat 3: kingartur222 ($10.22 in chips) 
Seat 4: McCleans ($10.45 in chips) 
Seat 6: T9MS ($10 in chips) 
bdixon_5: posts small blind $0.05
gaHy_HaXeP: posts big blind $0.10
tequila_joop: sits out 
*** HOLE CARDS ***
kingartur222: raises $0.20 to $0.30
McCleans: folds 
T9MS: folds 
bdixon_5: folds 
gaHy_HaXeP: folds 
Uncalled bet ($0.20) returned to kingartur222
kingartur222 collected $0.25 from pot
*** SUMMARY ***
Total pot $0.25 | Rake $0 
Seat 1: bdixon_5 (small blind) folded before Flop
Seat 2: gaHy_HaXeP (big blind) folded before Flop
Seat 3: kingartur222 collected ($0.25)
Seat 4: McCleans folded before Flop (didn't bet)
Seat 6: T9MS (button) folded before Flop (didn't bet)



PokerStars Hand #166667482757:  Hold'em No Limit ($0.05/$0.10 USD) - 2017/02/23 16:01:58 ET
Table 'Caupolican' 6-max Seat #3 is the button
Seat 1: kingartur222 ($10.68 in chips) 
Seat 2: garigura ($19.55 in chips) 
Seat 3: arturgalant ($4.32 in chips) 
Seat 4: mhonielsen ($11.36 in chips) 
Seat 5: Kazacha ($10.95 in chips) 
Seat 6: crazydevill ($11.02 in chips) 
mhonielsen: posts small blind $0.05
Kazacha: posts big blind $0.10
*** HOLE CARDS ***
crazydevill: folds 
kingartur222: folds 
garigura: folds 
arturgalant: folds 
mhonielsen: raises $0.10 to $0.20
Kazacha: folds 
Uncalled bet ($0.10) returned to mhonielsen
mhonielsen collected $0.20 from pot
*** SUMMARY ***
Total pot $0.20 | Rake $0 
Seat 1: kingartur222 folded before Flop (didn't bet)
Seat 2: garigura folded before Flop (didn't bet)
Seat 3: arturgalant (button) folded before Flop (didn't bet)
Seat 4: mhonielsen (small blind) collected ($0.20)
Seat 5: Kazacha (big blind) folded before Flop
Seat 6: crazydevill folded before Flop (didn't bet)



PokerStars Hand #166667482929:  Hold'em No Limit ($0.05/$0.10 USD) - 2017/02/23 16:01:58 ET
Table 'Lesath III' 6-max Seat #3 is the button
Seat 1: Gogeta26 ($6.97 in chips) 
Seat 2: WinninBikini ($10.03 in chips) 
Seat 3: Giyorod ($10 in chips) 
Seat 4: Eddys Edge ($10 in chips) 
Seat 5: eniksenik ($15.64 in chips) 
Seat 6: patrick19111 ($10.71 in chips) 
Eddys Edge: posts small blind $0.05
eniksenik: posts big blind $0.10
*** HOLE CARDS ***
patrick19111: folds 
Gogeta26: calls $0.10
WinninBikini: folds 
Giyorod: folds 
Eddys Edge: folds 
eniksenik: checks 
*** FLOP *** [7d Kd 2s]
eniksenik: checks 
Gogeta26: checks 
*** TURN *** [7d Kd 2s] [5s]
eniksenik: bets $0.20
Gogeta26: calls $0.20
*** RIVER *** [7d Kd 2s 5s] [Kc]
eniksenik: bets $0.10
Gogeta26: calls $0.10
*** SHOW DOWN ***
eniksenik: shows [8d 5d] (two pair, Kings and Fives)
Gogeta26: mucks hand 
eniksenik collected $0.81 from pot
*** SUMMARY ***
Total pot $0.85 | Rake $0.04 
Board [7d Kd 2s 5s Kc]
Seat 1: Gogeta26 mucked
Seat 2: WinninBikini folded before Flop (didn't bet)
Seat 3: Giyorod (button) folded before Flop (didn't bet)
Seat 4: Eddys Edge (small blind) folded before Flop
Seat 5: eniksenik (big blind) showed [8d 5d] and won ($0.81) with two pair, Kings and Fives
Seat 6: patrick19111 folded before Flop (didn't bet)



PokerStars Hand #166667483299:  Hold'em No Limit ($0.05/$0.10 USD) - 2017/02/23 16:01:59 ET
Table 'Iduberga II' 6-max Seat #1 is the button
Seat 1: mhonielsen ($10 in chips) 
Seat 2: popypaleta ($12.17 in chips) 
Seat 3: scorpionfish ($11.73 in chips) 
Seat 4: Peter0087 ($10.03 in chips) 
Seat 5: Pokeaster ($10.62 in chips) 
Seat 6: tblocos ($13.47 in chips) 
popypaleta: posts small blind $0.05
scorpionfish: posts big blind $0.10
*** HOLE CARDS ***
Peter0087: folds 
Pokeaster: folds 
tblocos: calls $0.10
mhonielsen: raises $0.30 to $0.40
popypaleta: folds 
scorpionfish: folds 
tblocos: folds 
Uncalled bet ($0.30) returned to mhonielsen
mhonielsen collected $0.35 from pot
*** SUMMARY ***
Total pot $0.35 | Rake $0 
Seat 1: mhonielsen (button) collected ($0.35)
Seat 2: popypaleta (small blind) folded before Flop
Seat 3: scorpionfish (big blind) folded before Flop
Seat 4: Peter0087 folded before Flop (didn't bet)
Seat 5: Pokeaster folded before Flop (didn't bet)
Seat 6: tblocos folded before Flop



PokerStars Hand #166667483516:  Hold'em No Limit ($0.05/$0.10 USD) - 2017/02/23 16:01:59 ET
Table 'Amalia' 6-max Seat #5 is the button
Seat 1: voledy ($12.99 in chips) 
Seat 2: DamDatsAnAce ($10.70 in chips) 
Seat 3: kickereens ($10.15 in chips) 
Seat 4: Rodik002 ($16.38 in chips) 
Seat 5: coolisses111 ($9.85 in chips) 
Seat 6: oktomber778 ($24.34 in chips) 
oktomber778: posts small blind $0.05
voledy: posts big blind $0.10
*** HOLE CARDS ***
DamDatsAnAce: folds 
kickereens: raises $0.20 to $0.30
Rodik002: folds 
coolisses111: folds 
oktomber778: folds 
voledy: folds 
Uncalled bet ($0.20) returned to kickereens
kickereens collected $0.25 from pot
*** SUMMARY ***
Total pot $0.25 | Rake $0 
Seat 1: voledy (big blind) folded before Flop
Seat 2: DamDatsAnAce folded before Flop (didn't bet)
Seat 3: kickereens collected ($0.25)
Seat 4: Rodik002 folded before Flop (didn't bet)
Seat 5: coolisses111 (button) folded before Flop (didn't bet)
Seat 6: oktomber778 (small blind) folded before Flop



PokerStars Hand #166667483807:  Hold'em No Limit ($0.05/$0.10 USD) - 2017/02/23 16:01:59 ET
Table 'Joella' 6-max Seat #1 is the button
Seat 1: Dcaro31 ($13.25 in chips) 
Seat 2: Kaelyns_Bark ($9.86 in chips) 
Seat 3: Joker51_wtf! ($10 in chips) 
Seat 5: Anestakis777 ($3.69 in chips) 
Seat 6: dr.goofy ($11.76 in chips) 
Kaelyns_Bark: posts small blind $0.05
Joker51_wtf!: posts big blind $0.10
*** HOLE CARDS ***
Anestakis777: calls $0.10
dr.goofy: folds 
Dcaro31: folds 
Kaelyns_Bark: folds 
Joker51_wtf!: checks 
*** FLOP *** [4h 5s 2h]
Joker51_wtf!: checks 
Anestakis777: bets $0.20
Joker51_wtf!: folds 
Uncalled bet ($0.20) returned to Anestakis777
Anestakis777 collected $0.24 from pot
*** SUMMARY ***
Total pot $0.25 | Rake $0.01 
Board [4h 5s 2h]
Seat 1: Dcaro31 (button) folded before Flop (didn't bet)
Seat 2: Kaelyns_Bark (small blind) folded before Flop
Seat 3: Joker51_wtf! (big blind) folded on the Flop
Seat 5: Anestakis777 collected ($0.24)
Seat 6: dr.goofy folded before Flop (didn't bet)



PokerStars Hand #166667484315:  Hold'em No Limit ($0.05/$0.10 USD) - 2017/02/23 16:02:00 ET
Table 'Bootes' 6-max Seat #2 is the button
Seat 1: Namhkal ($13.20 in chips) 
Seat 2: Bird et al ($19.45 in chips) 
Seat 3: KA3AXCTAHEU, ($19.40 in chips) 
Seat 4: totonove ($4.71 in chips) 
Seat 5: Pekaml ($15.19 in chips) 
Seat 6: cherep61987 ($10.37 in chips) 
KA3AXCTAHEU,: posts small blind $0.05
totonove: posts big blind $0.10
*** HOLE CARDS ***
Pekaml: folds 
cherep61987: folds 
Namhkal: folds 
Bird et al: folds 
KA3AXCTAHEU,: raises $0.15 to $0.25
totonove: calls $0.15
*** FLOP *** [Kc Ah Jd]
KA3AXCTAHEU,: bets $0.36
totonove: folds 
Uncalled bet ($0.36) returned to KA3AXCTAHEU,
KA3AXCTAHEU, collected $0.48 from pot
*** SUMMARY ***
Total pot $0.50 | Rake $0.02 
Board [Kc Ah Jd]
Seat 1: Namhkal folded before Flop (didn't bet)
Seat 2: Bird et al (button) folded before Flop (didn't bet)
Seat 3: KA3AXCTAHEU, (small blind) collected ($0.48)
Seat 4: totonove (big blind) folded on the Flop
Seat 5: Pekaml folded before Flop (didn't bet)
Seat 6: cherep61987 folded before Flop (didn't bet)



PokerStars Hand #166667484556:  Hold'em No Limit ($0.05/$0.10 USD) - 2017/02/23 16:02:00 ET
Table 'Clavel' 6-max Seat #2 is the button
Seat 1: KRZuff ($14.73 in chips) 
Seat 2: RoJ1 ($12.37 in chips) 
Seat 4: Dcaro31 ($11.86 in chips) 
Seat 5: Vrinni ($10.54 in chips) 
Seat 6: Gra_anD77 ($3.86 in chips) 
Dcaro31: posts small blind $0.05
Vrinni: posts big blind $0.10
*** HOLE CARDS ***
Gra_anD77: raises $0.20 to $0.30
KRZuff: folds 
RoJ1: folds 
Dcaro31: folds 
Vrinni: folds 
Uncalled bet ($0.20) returned to Gra_anD77
Gra_anD77 collected $0.25 from pot
*** SUMMARY ***
Total pot $0.25 | Rake $0 
Seat 1: KRZuff folded before Flop (didn't bet)
Seat 2: RoJ1 (button) folded before Flop (didn't bet)
Seat 4: Dcaro31 (small blind) folded before Flop
Seat 5: Vrinni (big blind) folded before Flop
Seat 6: Gra_anD77 collected ($0.25)



PokerStars Hand #166667484557:  Hold'em No Limit ($0.05/$0.10 USD) - 2017/02/23 16:02:00 ET
Table 'Tirela' 6-max Seat #2 is the button
Seat 1: Smitty03300 ($10 in chips) 
Seat 2: Andrei ProFF ($17.79 in chips) 
Seat 3: aim444 ($15.35 in chips) 
Seat 4: ArcticBearDK ($10.16 in chips) 
Seat 5: KRZuff ($10.10 in chips) 
Seat 6: coolisses111 ($9.05 in chips) 
aim444: posts small blind $0.05
ArcticBearDK: posts big blind $0.10
*** HOLE CARDS ***
KRZuff: raises $0.20 to $0.30
coolisses111: folds 
Smitty03300: folds 
Andrei ProFF: folds 
aim444: calls $0.25
ArcticBearDK: folds 
*** FLOP *** [Qh Tc 2d]
aim444: checks 
KRZuff: bets $0.45
aim444: folds 
Uncalled bet ($0.45) returned to KRZuff
KRZuff collected $0.67 from pot
*** SUMMARY ***
Total pot $0.70 | Rake $0.03 
Board [Qh Tc 2d]
Seat 1: Smitty03300 folded before Flop (didn't bet)
Seat 2: Andrei ProFF (button) folded before Flop (didn't bet)
Seat 3: aim444 (small blind) folded on the Flop
Seat 4: ArcticBearDK (big blind) folded before Flop
Seat 5: KRZuff collected ($0.67)
Seat 6: coolisses111 folded before Flop (didn't bet)



PokerStars Hand #166667484837:  Hold'em No Limit ($0.05/$0.10 USD) - 2017/02/23 16:02:01 ET
Table 'Cyane' 6-max Seat #2 is the button
Seat 1: KA3AXCTAHEU, ($10.32 in chips) 
Seat 2: Temniy Elf ($10 in chips) 
Seat 3: Mamm0nism ($13.99 in chips) 
Seat 4: truck1234 ($21.11 in chips) 
Seat 5: ChuikaPridi ($10.32 in chips) 
Seat 6: 8th wonders ($10.15 in chips) 
Mamm0nism: posts small blind $0.05
truck1234: posts big blind $0.10
*** HOLE CARDS ***
ChuikaPridi: folds 
8th wonders: folds 
KA3AXCTAHEU,: folds 
Temniy Elf: raises $0.15 to $0.25
Mamm0nism: folds 
truck1234: folds 
Uncalled bet ($0.15) returned to Temniy Elf
Temniy Elf collected $0.25 from pot
*** SUMMARY ***
Total pot $0.25 | Rake $0 
Seat 1: KA3AXCTAHEU, folded before Flop (didn't bet)
Seat 2: Temniy Elf (button) collected ($0.25)
Seat 3: Mamm0nism (small blind) folded before Flop
Seat 4: truck1234 (big blind) folded before Flop
Seat 5: ChuikaPridi folded before Flop (didn't bet)
Seat 6: 8th wonders folded before Flop (didn't bet)



PokerStars Hand #166667485938:  Hold'em No Limit ($0.05/$0.10 USD) - 2017/02/23 16:02:02 ET
Table 'Bengt' 6-max Seat #1 is the button
Seat 1: Lucky HoBBiT ($12.90 in chips) 
Seat 2: ChefRocco ($20.24 in chips) 
Seat 3: nantes15 ($12.51 in chips) 
Seat 4: 8th wonders ($10 in chips) 
Seat 5: RoJ1 ($10.46 in chips) 
Seat 6: Goroshkos88 ($10 in chips) 
ChefRocco: posts small blind $0.05
nantes15: posts big blind $0.10
*** HOLE CARDS ***
8th wonders: folds 
RoJ1: folds 
Goroshkos88: folds 
Lucky HoBBiT: raises $0.15 to $0.25
ChefRocco: raises $0.15 to $0.40
nantes15: folds 
Lucky HoBBiT: calls $0.15
*** FLOP *** [5d 2c 9h]
ChefRocco: bets $0.20
Lucky HoBBiT: folds 
Uncalled bet ($0.20) returned to ChefRocco
ChefRocco collected $0.86 from pot
*** SUMMARY ***
Total pot $0.90 | Rake $0.04 
Board [5d 2c 9h]
Seat 1: Lucky HoBBiT (button) folded on the Flop
Seat 2: ChefRocco (small blind) collected ($0.86)
Seat 3: nantes15 (big blind) folded before Flop
Seat 4: 8th wonders folded before Flop (didn't bet)
Seat 5: RoJ1 folded before Flop (didn't bet)
Seat 6: Goroshkos88 folded before Flop (didn't bet)



PokerStars Hand #166667486060:  Hold'em No Limit ($0.05/$0.10 USD) - 2017/02/23 16:02:02 ET
Table 'Sheragul III' 6-max Seat #2 is the button
Seat 1: danky24 ($18.06 in chips) 
Seat 2: Bird et al ($11.96 in chips) 
Seat 4: maxiv608 ($11.14 in chips) 
Seat 5: Bandyaev ($14.21 in chips) 
Seat 6: Andrei ProFF ($10 in chips) 
maxiv608: posts small blind $0.05
Bandyaev: posts big blind $0.10
*** HOLE CARDS ***
Andrei ProFF: folds 
danky24: raises $0.10 to $0.20
Bird et al: folds 
maxiv608: folds 
Bandyaev: calls $0.10
*** FLOP *** [8h Qc 2d]
Bandyaev: checks 
danky24: bets $0.20
Bandyaev: raises $0.82 to $1.02
danky24: folds 
Uncalled bet ($0.82) returned to Bandyaev
Bandyaev collected $0.81 from pot
*** SUMMARY ***
Total pot $0.85 | Rake $0.04 
Board [8h Qc 2d]
Seat 1: danky24 folded on the Flop
Seat 2: Bird et al (button) folded before Flop (didn't bet)
Seat 4: maxiv608 (small blind) folded before Flop
Seat 5: Bandyaev (big blind) collected ($0.81)
Seat 6: Andrei ProFF folded before Flop (didn't bet)



PokerStars Hand #166667486222:  Hold'em No Limit ($0.05/$0.10 USD) - 2017/02/23 16:02:02 ET
Table 'Gyldenia II' 6-max Seat #5 is the button
Seat 1: KokoulinV ($10.01 in chips) 
Seat 2: Bandyaev ($10 in chips) 
Seat 3: ex3Lero86 ($23.37 in chips) 
Seat 5: CHRO8 ($17.71 in chips) 
Seat 6: 8th wonders ($10.84 in chips) 
8th wonders: posts small blind $0.05
KokoulinV: posts big blind $0.10
*** HOLE CARDS ***
Bandyaev: raises $0.20 to $0.30
ex3Lero86: folds 
CHRO8: calls $0.30
8th wonders: calls $0.25
KokoulinV: folds 
*** FLOP *** [7c Jd 4c]
8th wonders: checks 
Bandyaev: bets $0.64
CHRO8: folds 
8th wonders: calls $0.64
*** TURN *** [7c Jd 4c] [4d]
8th wonders: checks 
Bandyaev: bets $1.46
8th wonders: folds 
Uncalled bet ($1.46) returned to Bandyaev
Bandyaev collected $2.18 from pot
*** SUMMARY ***
Total pot $2.28 | Rake $0.10 
Board [7c Jd 4c 4d]
Seat 1: KokoulinV (big blind) folded before Flop
Seat 2: Bandyaev collected ($2.18)
Seat 3: ex3Lero86 folded before Flop (didn't bet)
Seat 5: CHRO8 (button) folded on the Flop
Seat 6: 8th wonders (small blind) folded on the Turn



PokerStars Hand #166667486376:  Hold'em No Limit ($0.05/$0.10 USD) - 2017/02/23 16:02:02 ET
Table 'Cassini' 6-max Seat #2 is the button
Seat 1: Pokeaster ($10.15 in chips) 
Seat 2: mhonielsen ($13.09 in chips) 
Seat 4: fortieth ($13.62 in chips) 
Seat 5: johkom ($7.90 in chips) 
Seat 6: JahSoldier69 ($10 in chips) 
fortieth: posts small blind $0.05
johkom: posts big blind $0.10
*** HOLE CARDS ***
JahSoldier69: folds 
Pokeaster: folds 
mhonielsen: folds 
fortieth: raises $0.25 to $0.35
johkom: folds 
Uncalled bet ($0.25) returned to fortieth
fortieth collected $0.20 from pot
*** SUMMARY ***
Total pot $0.20 | Rake $0 
Seat 1: Pokeaster folded before Flop (didn't bet)
Seat 2: mhonielsen (button) folded before Flop (didn't bet)
Seat 4: fortieth (small blind) collected ($0.20)
Seat 5: johkom (big blind) folded before Flop
Seat 6: JahSoldier69 folded before Flop (didn't bet)



PokerStars Hand #166667486563:  Hold'em No Limit ($0.05/$0.10 USD) - 2017/02/23 16:02:03 ET
Table 'Aconcagua' 6-max Seat #5 is the button
Seat 4: pivanki11 ($9.44 in chips) 
Seat 5: frazaunch ($6.82 in chips) 
Seat 6: coolisses111 ($9.28 in chips) 
coolisses111: posts small blind $0.05
pivanki11: posts big blind $0.10
pivanki11: posts the ante $0.02
frazaunch: posts the ante $0.02
coolisses111: posts the ante $0.02
*** HOLE CARDS ***
frazaunch: folds 
coolisses111: folds 
Uncalled bet ($0.05) returned to pivanki11
pivanki11 collected $0.16 from pot
*** SUMMARY ***
Total pot $0.16 | Rake $0 
Seat 4: pivanki11 (big blind) collected ($0.16)
Seat 5: frazaunch (button) folded before Flop (didn't bet)
Seat 6: coolisses111 (small blind) folded before Flop



PokerStars Hand #166667486580:  Hold'em No Limit ($0.05/$0.10 USD) - 2017/02/23 16:02:03 ET
Table 'Antinous' 6-max Seat #3 is the button
Seat 1: Andrei ProFF ($15.94 in chips) 
Seat 2: Nr847 ($10.61 in chips) 
Seat 3: dittoro ($10 in chips) 
Seat 4: Pekaml ($15.44 in chips) 
Seat 5: Covetsoles ($6.85 in chips) 
Pekaml: posts small blind $0.05
Covetsoles: posts big blind $0.10
coolisses111: sits out 
*** HOLE CARDS ***
Andrei ProFF: folds 
Nr847: folds 
dittoro: folds 
Pekaml: raises $0.10 to $0.20
Covetsoles: calls $0.10
*** FLOP *** [Jh 7s 8h]
Pekaml: bets $0.19
Covetsoles: folds 
Uncalled bet ($0.19) returned to Pekaml
Pekaml collected $0.38 from pot
*** SUMMARY ***
Total pot $0.40 | Rake $0.02 
Board [Jh 7s 8h]
Seat 1: Andrei ProFF folded before Flop (didn't bet)
Seat 2: Nr847 folded before Flop (didn't bet)
Seat 3: dittoro (button) folded before Flop (didn't bet)
Seat 4: Pekaml (small blind) collected ($0.38)
Seat 5: Covetsoles (big blind) folded on the Flop



PokerStars Hand #166667486676:  Hold'em No Limit ($0.05/$0.10 USD) - 2017/02/23 16:02:03 ET
Table 'Hunnia' 6-max Seat #5 is the button
Seat 1: univibe68 ($21.83 in chips) 
Seat 2: mhonielsen ($10 in chips) 
Seat 4: Jalida3 ($10.31 in chips) 
Seat 5: Smarkon ($14.78 in chips) 
Seat 6: ChuikaPridi ($9.12 in chips) 
ChuikaPridi: posts small blind $0.05
univibe68: posts big blind $0.10
6ePeMeHHa9: sits out 
*** HOLE CARDS ***
mhonielsen: folds 
Jalida3: raises $0.20 to $0.30
Smarkon: folds 
ChuikaPridi: folds 
univibe68: raises $0.60 to $0.90
Jalida3: calls $0.60
*** FLOP *** [4h 6h 6d]
univibe68: bets $1.24
Jalida3: folds 
Uncalled bet ($1.24) returned to univibe68
univibe68 collected $1.77 from pot
*** SUMMARY ***
Total pot $1.85 | Rake $0.08 
Board [4h 6h 6d]
Seat 1: univibe68 (big blind) collected ($1.77)
Seat 2: mhonielsen folded before Flop (didn't bet)
Seat 4: Jalida3 folded on the Flop
Seat 5: Smarkon (button) folded before Flop (didn't bet)
Seat 6: ChuikaPridi (small blind) folded before Flop



PokerStars Hand #166667486808:  Hold'em No Limit ($0.05/$0.10 USD) - 2017/02/23 16:02:03 ET
Table 'Siebohme' 6-max Seat #5 is the button
Seat 1: kusa4ki ($11.38 in chips) 
Seat 2: el toro 1507 ($11.68 in chips) 
Seat 3: ex3Lero86 ($10.15 in chips) 
Seat 4: Innerwuss ($10.09 in chips) 
Seat 5: Kazacha ($10.10 in chips) 
Seat 6: townerz1991 ($10.58 in chips) 
townerz1991: posts small blind $0.05
kusa4ki: posts big blind $0.10
*** HOLE CARDS ***
el toro 1507: folds 
ex3Lero86: folds 
Innerwuss: folds 
Kazacha: folds 
townerz1991: folds 
Uncalled bet ($0.05) returned to kusa4ki
kusa4ki collected $0.10 from pot
*** SUMMARY ***
Total pot $0.10 | Rake $0 
Seat 1: kusa4ki (big blind) collected ($0.10)
Seat 2: el toro 1507 folded before Flop (didn't bet)
Seat 3: ex3Lero86 folded before Flop (didn't bet)
Seat 4: Innerwuss folded before Flop (didn't bet)
Seat 5: Kazacha (button) folded before Flop (didn't bet)
Seat 6: townerz1991 (small blind) folded before Flop



PokerStars Hand #166667486812:  Hold'em No Limit ($0.05/$0.10 USD) - 2017/02/23 16:02:03 ET
Table 'Wilkens II' 6-max Seat #4 is the button
Seat 1: Islamiq-GuRL ($12.30 in chips) 
Seat 2: manashov ($10.15 in chips) 
Seat 3: Namhkal ($10.80 in chips) 
Seat 4: myevc ($10 in chips) 
Seat 5: patrick19111 ($10.05 in chips) 
Seat 6: XaXaTyH4uK ($14.76 in chips) 
patrick19111: posts small blind $0.05
XaXaTyH4uK: posts big blind $0.10
*** HOLE CARDS ***
Islamiq-GuRL: folds 
manashov: raises $0.20 to $0.30
Namhkal: folds 
myevc: folds 
patrick19111: folds 
XaXaTyH4uK: folds 
Uncalled bet ($0.20) returned to manashov
manashov collected $0.25 from pot
*** SUMMARY ***
Total pot $0.25 | Rake $0 
Seat 1: Islamiq-GuRL folded before Flop (didn't bet)
Seat 2: manashov collected ($0.25)
Seat 3: Namhkal folded before Flop (didn't bet)
Seat 4: myevc (button) folded before Flop (didn't bet)
Seat 5: patrick19111 (small blind) folded before Flop
Seat 6: XaXaTyH4uK (big blind) folded before Flop



PokerStars Hand #166667486813:  Hold'em No Limit ($0.05/$0.10 USD) - 2017/02/23 16:02:03 ET
Table 'Siebohme II' 6-max Seat #4 is the button
Seat 1: homelessdan ($18.22 in chips) 
Seat 2: townerz1991 ($14.17 in chips) 
Seat 3: D3NyA ($10.33 in chips) 
Seat 4: POT_TRADER ($11.99 in chips) 
Seat 5: NvR.m1nD ($10.20 in chips) 
Seat 6: Fozzy690 ($10 in chips) 
NvR.m1nD: posts small blind $0.05
Fozzy690: posts big blind $0.10
*** HOLE CARDS ***
homelessdan: folds 
townerz1991: folds 
D3NyA: folds 
POT_TRADER: folds 
NvR.m1nD: raises $0.15 to $0.25
Fozzy690: raises $0.15 to $0.40
NvR.m1nD: calls $0.15
*** FLOP *** [As 4s 6h]
NvR.m1nD: checks 
Fozzy690: bets $0.30
NvR.m1nD: folds 
Uncalled bet ($0.30) returned to Fozzy690
Fozzy690 collected $0.76 from pot
*** SUMMARY ***
Total pot $0.80 | Rake $0.04 
Board [As 4s 6h]
Seat 1: homelessdan folded before Flop (didn't bet)
Seat 2: townerz1991 folded before Flop (didn't bet)
Seat 3: D3NyA folded before Flop (didn't bet)
Seat 4: POT_TRADER (button) folded before Flop (didn't bet)
Seat 5: NvR.m1nD (small blind) folded on the Flop
Seat 6: Fozzy690 (big blind) collected ($0.76)



PokerStars Hand #166667486966:  Hold'em No Limit ($0.05/$0.10 USD) - 2017/02/23 16:02:03 ET
Table 'Hyakutake' 6-max Seat #5 is the button
Seat 1: Asilvagoat ($11.22 in chips) 
Seat 2: boxer821 ($10.66 in chips) 
Seat 3: lenboysprite ($7.40 in chips) 
Seat 4: eniksenik ($13.55 in chips) 
Seat 5: RoJ1 ($11.59 in chips) 
Seat 6: maxiv608 ($13.32 in chips) 
maxiv608: posts small blind $0.05
Asilvagoat: posts big blind $0.10
*** HOLE CARDS ***
boxer821: folds 
lenboysprite: calls $0.10
eniksenik: folds 
RoJ1: folds 
maxiv608: folds 
Asilvagoat: checks 
*** FLOP *** [Ac 4s Ad]
Asilvagoat: checks 
lenboysprite: checks 
*** TURN *** [Ac 4s Ad] [Td]
Asilvagoat: bets $0.10
lenboysprite: calls $0.10
*** RIVER *** [Ac 4s Ad Td] [Qh]
Asilvagoat: bets $0.20
lenboysprite: calls $0.20
*** SHOW DOWN ***
Asilvagoat: shows [Jh Qc] (two pair, Aces and Queens)
lenboysprite: mucks hand 
Asilvagoat collected $0.81 from pot
*** SUMMARY ***
Total pot $0.85 | Rake $0.04 
Board [Ac 4s Ad Td Qh]
Seat 1: Asilvagoat (big blind) showed [Jh Qc] and won ($0.81) with two pair, Aces and Queens
Seat 2: boxer821 folded before Flop (didn't bet)
Seat 3: lenboysprite mucked
Seat 4: eniksenik folded before Flop (didn't bet)
Seat 5: RoJ1 (button) folded before Flop (didn't bet)
Seat 6: maxiv608 (small blind) folded before Flop



PokerStars Hand #166667487273:  Hold'em No Limit ($0.05/$0.10 USD) - 2017/02/23 16:02:03 ET
Table 'Xanthippe II' 6-max Seat #3 is the button
Seat 1: ade22345 ($4.48 in chips) 
Seat 2: Bird et al ($13.51 in chips) 
Seat 3: Dcaro31 ($10 in chips) 
Seat 4: Barcardi14 ($10.20 in chips) 
Seat 5: yodzik ($5 in chips) 
Seat 6: Orlangoor ($11.04 in chips) 
Barcardi14: posts small blind $0.05
yodzik: posts big blind $0.10
*** HOLE CARDS ***
Orlangoor: folds 
ade22345: folds 
Bird et al: folds 
Dcaro31: folds 
Barcardi14: calls $0.05
yodzik: checks 
*** FLOP *** [Js 8c 7d]
Barcardi14: checks 
yodzik: checks 
*** TURN *** [Js 8c 7d] [5h]
Barcardi14: bets $0.70
yodzik: folds 
Uncalled bet ($0.70) returned to Barcardi14
Barcardi14 collected $0.19 from pot
*** SUMMARY ***
Total pot $0.20 | Rake $0.01 
Board [Js 8c 7d 5h]
Seat 1: ade22345 folded before Flop (didn't bet)
Seat 2: Bird et al folded before Flop (didn't bet)
Seat 3: Dcaro31 (button) folded before Flop (didn't bet)
Seat 4: Barcardi14 (small blind) collected ($0.19)
Seat 5: yodzik (big blind) folded on the Turn
Seat 6: Orlangoor folded before Flop (didn't bet)



PokerStars Hand #166667487457:  Hold'em No Limit ($0.05/$0.10 USD) - 2017/02/23 16:02:04 ET
Table 'Serpens' 6-max Seat #3 is the button
Seat 1: Namhkal ($10.45 in chips) 
Seat 2: KA3AXCTAHEU, ($10 in chips) 
Seat 3: homelessdan ($28.35 in chips) 
Seat 4: Ragazzi3 ($17.54 in chips) 
Seat 5: XwinX25 ($11.81 in chips) 
Seat 6: Croplayer1 ($10 in chips) 
Ragazzi3: posts small blind $0.05
XwinX25: posts big blind $0.10
*** HOLE CARDS ***
Croplayer1: folds 
Namhkal: folds 
KA3AXCTAHEU,: raises $0.20 to $0.30
homelessdan: folds 
Ragazzi3: folds 
XwinX25: folds 
Uncalled bet ($0.20) returned to KA3AXCTAHEU,
KA3AXCTAHEU, collected $0.25 from pot
*** SUMMARY ***
Total pot $0.25 | Rake $0 
Seat 1: Namhkal folded before Flop (didn't bet)
Seat 2: KA3AXCTAHEU, collected ($0.25)
Seat 3: homelessdan (button) folded before Flop (didn't bet)
Seat 4: Ragazzi3 (small blind) folded before Flop
Seat 5: XwinX25 (big blind) folded before Flop
Seat 6: Croplayer1 folded before Flop (didn't bet)



PokerStars Hand #166667487556:  Hold'em No Limit ($0.05/$0.10 USD) - 2017/02/23 16:02:04 ET
Table 'Gaika' 6-max Seat #4 is the button
Seat 1: oddshoff ($12.56 in chips) 
Seat 2: NvR.m1nD ($18.07 in chips) 
Seat 3: david_sara83 ($10.32 in chips) 
Seat 4: fortieth ($11.50 in chips) 
Seat 5: fedorka rus ($10.55 in chips) 
Seat 6: dr.goofy ($11.15 in chips) 
fedorka rus: posts small blind $0.05
dr.goofy: posts big blind $0.10
*** HOLE CARDS ***
oddshoff: folds 
NvR.m1nD: raises $0.15 to $0.25
david_sara83: folds 
fortieth: folds 
fedorka rus: folds 
dr.goofy: folds 
Uncalled bet ($0.15) returned to NvR.m1nD
NvR.m1nD collected $0.25 from pot
*** SUMMARY ***
Total pot $0.25 | Rake $0 
Seat 1: oddshoff folded before Flop (didn't bet)
Seat 2: NvR.m1nD collected ($0.25)
Seat 3: david_sara83 folded before Flop (didn't bet)
Seat 4: fortieth (button) folded before Flop (didn't bet)
Seat 5: fedorka rus (small blind) folded before Flop
Seat 6: dr.goofy (big blind) folded before Flop



PokerStars Hand #166667487698:  Hold'em No Limit ($0.05/$0.10 USD) - 2017/02/23 16:02:04 ET
Table 'Giclas' 6-max Seat #6 is the button
Seat 1: david_sara83 ($10 in chips) 
Seat 2: Crafty23@PS ($10 in chips) 
Seat 3: fidas1972 ($11.16 in chips) 
Seat 4: Eddys Edge ($10 in chips) 
Seat 5: dedea1989 ($25.98 in chips) 
Seat 6: eniksenik ($13.09 in chips) 
david_sara83: posts small blind $0.05
Crafty23@PS: posts big blind $0.10
*** HOLE CARDS ***
fidas1972: raises $0.10 to $0.20
Eddys Edge: folds 
dedea1989: calls $0.20
eniksenik: calls $0.20
david_sara83: folds 
Crafty23@PS: folds 
*** FLOP *** [3d 8c 6s]
fidas1972: bets $0.10
dedea1989: calls $0.10
eniksenik: calls $0.10
*** TURN *** [3d 8c 6s] [Jh]
fidas1972: checks 
dedea1989: checks 
eniksenik: checks 
*** RIVER *** [3d 8c 6s Jh] [7s]
fidas1972: bets $0.10
dedea1989: calls $0.10
eniksenik: raises $0.72 to $0.82
fidas1972: folds 
dedea1989: calls $0.72
*** SHOW DOWN ***
eniksenik: shows [Js Kc] (a pair of Jacks)
dedea1989: mucks hand 
eniksenik collected $2.66 from pot
*** SUMMARY ***
Total pot $2.79 | Rake $0.13 
Board [3d 8c 6s Jh 7s]
Seat 1: david_sara83 (small blind) folded before Flop
Seat 2: Crafty23@PS (big blind) folded before Flop
Seat 3: fidas1972 folded on the River
Seat 4: Eddys Edge folded before Flop (didn't bet)
Seat 5: dedea1989 mucked
Seat 6: eniksenik (button) showed [Js Kc] and won ($2.66) with a pair of Jacks



PokerStars Hand #166667487837:  Hold'em No Limit ($0.05/$0.10 USD) - 2017/02/23 16:02:04 ET
Table 'Izar' 6-max Seat #2 is the button
Seat 1: bambolejro ($10.54 in chips) 
Seat 2: mvp0013 ($10.57 in chips) 
Seat 3: Yspenyanin ($10.95 in chips) 
Seat 4: Matee92 ($6.86 in chips) 
Seat 5: fishhook5 ($10.35 in chips) 
Yspenyanin: posts small blind $0.05
Matee92: posts big blind $0.10
yodzik: sits out 
*** HOLE CARDS ***
fishhook5: folds 
bambolejro: folds 
mvp0013: raises $0.20 to $0.30
Yspenyanin: folds 
Matee92: calls $0.20
*** FLOP *** [7c 9s 2c]
Matee92: checks 
mvp0013: bets $0.40
Matee92: folds 
Uncalled bet ($0.40) returned to mvp0013
mvp0013 collected $0.62 from pot
*** SUMMARY ***
Total pot $0.65 | Rake $0.03 
Board [7c 9s 2c]
Seat 1: bambolejro folded before Flop (didn't bet)
Seat 2: mvp0013 (button) collected ($0.62)
Seat 3: Yspenyanin (small blind) folded before Flop
Seat 4: Matee92 (big blind) folded on the Flop
Seat 5: fishhook5 folded before Flop (didn't bet)



PokerStars Hand #166667487948:  Hold'em No Limit ($0.05/$0.10 USD) - 2017/02/23 16:02:04 ET
Table 'Hamal II' 6-max Seat #3 is the button
Seat 1: saxoalto2011 ($8.49 in chips) 
Seat 2: pancernik21 ($10 in chips) 
Seat 3: Cluckh ($11.69 in chips) 
Seat 4: ArcticBearDK ($10.86 in chips) 
Seat 5: eniksenik ($10 in chips) 
Seat 6: LarryTheStar ($11.24 in chips) 
ArcticBearDK: posts small blind $0.05
eniksenik: posts big blind $0.10
*** HOLE CARDS ***
LarryTheStar: folds 
saxoalto2011: folds 
pancernik21: folds 
Cluckh: raises $0.15 to $0.25
ArcticBearDK: folds 
eniksenik: calls $0.15
*** FLOP *** [Kh 2d 4h]
eniksenik: checks 
Cluckh: bets $0.20
eniksenik: raises $0.60 to $0.80
Cluckh: folds 
Uncalled bet ($0.60) returned to eniksenik
eniksenik collected $0.91 from pot
*** SUMMARY ***
Total pot $0.95 | Rake $0.04 
Board [Kh 2d 4h]
Seat 1: saxoalto2011 folded before Flop (didn't bet)
Seat 2: pancernik21 folded before Flop (didn't bet)
Seat 3: Cluckh (button) folded on the Flop
Seat 4: ArcticBearDK (small blind) folded before Flop
Seat 5: eniksenik (big blind) collected ($0.91)
Seat 6: LarryTheStar folded before Flop (didn't bet)



PokerStars Hand #166667488156:  Hold'em No Limit ($0.05/$0.10 USD) - 2017/02/23 16:02:04 ET
Table 'Krethon' 6-max Seat #4 is the button
Seat 1: boxer821 ($10 in chips) 
Seat 2: manashov ($10.80 in chips) 
Seat 3: Kow6oy ($14.86 in chips) 
Seat 4: chimera252 ($15.68 in chips) 
Seat 5: popypaleta ($10.25 in chips) 
popypaleta: posts small blind $0.05
fabadam: is sitting out 
boxer821: posts big blind $0.10
*** HOLE CARDS ***
manashov: folds 
Kow6oy: folds 
chimera252: folds 
popypaleta: raises $0.20 to $0.30
boxer821: raises $0.60 to $0.90
popypaleta: folds 
Uncalled bet ($0.60) returned to boxer821
boxer821 collected $0.60 from pot
*** SUMMARY ***
Total pot $0.60 | Rake $0 
Seat 1: boxer821 (big blind) collected ($0.60)
Seat 2: manashov folded before Flop (didn't bet)
Seat 3: Kow6oy folded before Flop (didn't bet)
Seat 4: chimera252 (button) folded before Flop (didn't bet)
Seat 5: popypaleta (small blind) folded before Flop



PokerStars Hand #166667488342:  Hold'em No Limit ($0.05/$0.10 USD) - 2017/02/23 16:02:04 ET
Table 'Aegle' 6-max Seat #2 is the button
Seat 1: phatts76 ($4 in chips) 
Seat 2: yodzik ($5 in chips) 
Seat 3: DrejAtom ($10.66 in chips) 
Seat 4: ab260414 ($11.32 in chips) 
Seat 5: KokoulinV ($11.13 in chips) 
Seat 6: CHRO8 ($20.59 in chips) 
DrejAtom: posts small blind $0.05
ab260414: posts big blind $0.10
phatts76: posts big blind $0.10
*** HOLE CARDS ***
KokoulinV: folds 
CHRO8: folds 
phatts76: checks 
yodzik: raises $0.20 to $0.30
DrejAtom: calls $0.25
ab260414: folds 
phatts76: folds 
*** FLOP *** [7c Qh 4d]
DrejAtom: checks 
yodzik: bets $0.50
DrejAtom: raises $1.80 to $2.30
yodzik: folds 
Uncalled bet ($1.80) returned to DrejAtom
DrejAtom collected $1.72 from pot
*** SUMMARY ***
Total pot $1.80 | Rake $0.08 
Board [7c Qh 4d]
Seat 1: phatts76 folded before Flop
Seat 2: yodzik (button) folded on the Flop
Seat 3: DrejAtom (small blind) collected ($1.72)
Seat 4: ab260414 (big blind) folded before Flop
Seat 5: KokoulinV folded before Flop (didn't bet)
Seat 6: CHRO8 folded before Flop (didn't bet)



PokerStars Hand #166667488657:  Hold'em No Limit ($0.05/$0.10 USD) - 2017/02/23 16:02:05 ET
Table 'Jacchia' 6-max Seat #1 is the button
Seat 1: viklundm ($35.79 in chips) 
Seat 2: VAD21 ($18.34 in chips) 
Seat 4: paterthomas ($9.40 in chips) 
Seat 6: RoJ1 ($11.03 in chips) 
VAD21: posts small blind $0.05
Polapa D.: is sitting out 
paterthomas: posts big blind $0.10
Polapa D. leaves the table
*** HOLE CARDS ***
RoJ1: raises $0.12 to $0.22
viklundm: calls $0.22
VAD21: folds 
paterthomas: calls $0.12
*** FLOP *** [8c Kh Ad]
paterthomas: checks 
RoJ1: checks 
viklundm: checks 
*** TURN *** [8c Kh Ad] [6h]
paterthomas: checks 
RoJ1: bets $0.35
viklundm: calls $0.35
maxiv608 joins the table at seat #3 
paterthomas: folds 
*** RIVER *** [8c Kh Ad 6h] [2h]
RoJ1: bets $1.16
viklundm: folds 
Uncalled bet ($1.16) returned to RoJ1
RoJ1 collected $1.35 from pot
*** SUMMARY ***
Total pot $1.41 | Rake $0.06 
Board [8c Kh Ad 6h 2h]
Seat 1: viklundm (button) folded on the River
Seat 2: VAD21 (small blind) folded before Flop
Seat 4: paterthomas (big blind) folded on the Turn
Seat 6: RoJ1 collected ($1.35)



PokerStars Hand #166667488767:  Hold'em No Limit ($0.05/$0.10 USD) - 2017/02/23 16:02:05 ET
Table 'Virginia II' 6-max Seat #6 is the button
Seat 1: Iarlei ($11.46 in chips) 
Seat 2: Yspenyanin ($10 in chips) 
Seat 3: garigura ($14.71 in chips) 
Seat 4: onkelottoHH ($11.48 in chips) 
Seat 5: dr.goofy ($20.26 in chips) 
Seat 6: ab260414 ($10.45 in chips) 
Iarlei: posts small blind $0.05
Yspenyanin: posts big blind $0.10
*** HOLE CARDS ***
garigura: folds 
onkelottoHH: folds 
dr.goofy: folds 
ab260414: folds 
Iarlei: raises $0.20 to $0.30
Yspenyanin: folds 
Uncalled bet ($0.20) returned to Iarlei
Iarlei collected $0.20 from pot
*** SUMMARY ***
Total pot $0.20 | Rake $0 
Seat 1: Iarlei (small blind) collected ($0.20)
Seat 2: Yspenyanin (big blind) folded before Flop
Seat 3: garigura folded before Flop (didn't bet)
Seat 4: onkelottoHH folded before Flop (didn't bet)
Seat 5: dr.goofy folded before Flop (didn't bet)
Seat 6: ab260414 (button) folded before Flop (didn't bet)



PokerStars Hand #166667489019:  Hold'em No Limit ($0.05/$0.10 USD) - 2017/02/23 16:02:05 ET
Table 'Postrema' 6-max Seat #2 is the button
Seat 1: CHRO8 ($9.94 in chips) 
Seat 2: pancernik21 ($12.61 in chips) 
Seat 3: edcc19 ($2.96 in chips) 
Seat 4: ChuikaPridi ($13.48 in chips) 
Seat 5: Comeback3392 ($12.20 in chips) 
Seat 6: Scanner17 ($10 in chips) 
edcc19: posts small blind $0.05
ChuikaPridi: posts big blind $0.10
*** HOLE CARDS ***
Comeback3392: folds 
Scanner17: raises $0.20 to $0.30
CHRO8: calls $0.30
pancernik21: folds 
edcc19: folds 
ChuikaPridi: folds 
*** FLOP *** [3c 5d 9c]
Scanner17: bets $0.55
CHRO8: raises $0.85 to $1.40
Scanner17: calls $0.85
*** TURN *** [3c 5d 9c] [3h]
Scanner17: checks 
CHRO8: bets $1.80
Scanner17: calls $1.80
*** RIVER *** [3c 5d 9c 3h] [4h]
Scanner17: checks 
CHRO8: bets $6.44 and is all-in
Scanner17: folds 
Uncalled bet ($6.44) returned to CHRO8
CHRO8 collected $6.83 from pot
*** SUMMARY ***
Total pot $7.15 | Rake $0.32 
Board [3c 5d 9c 3h 4h]
Seat 1: CHRO8 collected ($6.83)
Seat 2: pancernik21 (button) folded before Flop (didn't bet)
Seat 3: edcc19 (small blind) folded before Flop
Seat 4: ChuikaPridi (big blind) folded before Flop
Seat 5: Comeback3392 folded before Flop (didn't bet)
Seat 6: Scanner17 folded on the River



PokerStars Hand #166667489218:  Hold'em No Limit ($0.05/$0.10 USD) - 2017/02/23 16:02:05 ET
Table 'Sirius II' 6-max Seat #6 is the button
Seat 1: Ampped87 ($13.91 in chips) 
Seat 3: Spud014 ($10 in chips) 
Seat 6: MihaGr ($10 in chips) 
Ampped87: posts small blind $0.05
jamalungma: is sitting out 
Spud014: posts big blind $0.10
pokekrk: sits out 
jamalungma leaves the table
*** HOLE CARDS ***
MihaGr: folds 
Ampped87: raises $0.20 to $0.30
Spud014: raises $0.75 to $1.05
Ampped87: folds 
Uncalled bet ($0.75) returned to Spud014
Spud014 collected $0.60 from pot
*** SUMMARY ***
Total pot $0.60 | Rake $0 
Seat 1: Ampped87 (small blind) folded before Flop
Seat 3: Spud014 (big blind) collected ($0.60)
Seat 6: MihaGr (button) folded before Flop (didn't bet)



PokerStars Hand #166667489267:  Hold'em No Limit ($0.05/$0.10 USD) - 2017/02/23 16:02:05 ET
Table 'Kobresia II' 6-max Seat #1 is the button
Seat 1: RoJ1 ($13.96 in chips) 
Seat 2: Dcaro31 ($13.49 in chips) 
Seat 3: FRAID358 ($10.84 in chips) 
Seat 4: armstv ($10.87 in chips) 
Seat 5: Goroshkos88 ($11.89 in chips) 
Seat 6: WinninBikini ($10 in chips) 
Dcaro31: posts small blind $0.05
FRAID358: posts big blind $0.10
*** HOLE CARDS ***
armstv: raises $0.30 to $0.40
Goroshkos88: folds 
WinninBikini: folds 
RoJ1: folds 
Dcaro31: folds 
FRAID358: folds 
Uncalled bet ($0.30) returned to armstv
armstv collected $0.25 from pot
*** SUMMARY ***
Total pot $0.25 | Rake $0 
Seat 1: RoJ1 (button) folded before Flop (didn't bet)
Seat 2: Dcaro31 (small blind) folded before Flop
Seat 3: FRAID358 (big blind) folded before Flop
Seat 4: armstv collected ($0.25)
Seat 5: Goroshkos88 folded before Flop (didn't bet)
Seat 6: WinninBikini folded before Flop (didn't bet)



PokerStars Hand #166667489577:  Hold'em No Limit ($0.05/$0.10 USD) - 2017/02/23 16:02:06 ET
Table 'Aludra II' 6-max Seat #1 is the button
Seat 1: voledy ($10 in chips) 
Seat 2: JahSoldier69 ($10.18 in chips) 
Seat 3: 2G28 ($13 in chips) 
Seat 4: MihaGr ($10 in chips) 
Seat 5: kingartur222 ($15.85 in chips) 
Seat 6: call me haaa ($14.05 in chips) 
JahSoldier69: posts small blind $0.05
2G28: posts big blind $0.10
*** HOLE CARDS ***
MihaGr: folds 
kingartur222: folds 
call me haaa: folds 
voledy: raises $0.15 to $0.25
JahSoldier69: folds 
2G28: folds 
Uncalled bet ($0.15) returned to voledy
voledy collected $0.25 from pot
*** SUMMARY ***
Total pot $0.25 | Rake $0 
Seat 1: voledy (button) collected ($0.25)
Seat 2: JahSoldier69 (small blind) folded before Flop
Seat 3: 2G28 (big blind) folded before Flop
Seat 4: MihaGr folded before Flop (didn't bet)
Seat 5: kingartur222 folded before Flop (didn't bet)
Seat 6: call me haaa folded before Flop (didn't bet)



PokerStars Hand #166667489583:  Hold'em No Limit ($0.05/$0.10 USD) - 2017/02/23 16:02:06 ET
Table 'Anhui II' 6-max Seat #3 is the button
Seat 1: kingartur222 ($11.99 in chips) 
Seat 2: kikus334 ($11.20 in chips) 
Seat 3: lochniak556 ($28.60 in chips) 
Seat 4: dragonste89 ($10 in chips) 
Seat 5: Bandyaev ($10 in chips) 
Seat 6: .BaRReL.1122 ($5.01 in chips) 
dragonste89: posts small blind $0.05
Bandyaev: posts big blind $0.10
*** HOLE CARDS ***
.BaRReL.1122: calls $0.10
kingartur222: folds 
kikus334: calls $0.10
lochniak556: raises $0.30 to $0.40
dragonste89: folds 
Bandyaev: folds 
.BaRReL.1122: calls $0.30
kikus334: calls $0.30
*** FLOP *** [Jh As 7d]
.BaRReL.1122: checks 
kikus334: checks 
lochniak556: bets $0.60
.BaRReL.1122: calls $0.60
kikus334: folds 
*** TURN *** [Jh As 7d] [6s]
.BaRReL.1122: bets $4.01 and is all-in
lochniak556: folds [Jd 3s]
Uncalled bet ($4.01) returned to .BaRReL.1122
.BaRReL.1122 collected $2.44 from pot
*** SUMMARY ***
Total pot $2.55 | Rake $0.11 
Board [Jh As 7d 6s]
Seat 1: kingartur222 folded before Flop (didn't bet)
Seat 2: kikus334 folded on the Flop
Seat 3: lochniak556 (button) folded on the Turn
Seat 4: dragonste89 (small blind) folded before Flop
Seat 5: Bandyaev (big blind) folded before Flop
Seat 6: .BaRReL.1122 collected ($2.44)



PokerStars Hand #166667490115:  Hold'em No Limit ($0.05/$0.10 USD) - 2017/02/23 16:02:06 ET
Table 'Mesarthim' 6-max Seat #1 is the button
Seat 1: Mancuso2010 ($17.10 in chips) 
Seat 2: MühliJr ($10.83 in chips) 
Seat 3: Damage514 ($8.34 in chips) 
Seat 4: Strelok1974 ($10.51 in chips) 
Seat 5: Iarlei ($11.05 in chips) 
Seat 6: bdixon_5 ($8.96 in chips) 
MühliJr: posts small blind $0.05
Damage514: posts big blind $0.10
*** HOLE CARDS ***
Strelok1974: folds 
Iarlei: folds 
bdixon_5: folds 
Mancuso2010: raises $0.20 to $0.30
MühliJr: folds 
Damage514: calls $0.20
*** FLOP *** [9c 3s 5s]
Damage514: bets $0.50
Mancuso2010: calls $0.50
*** TURN *** [9c 3s 5s] [7h]
Damage514: bets $1.50
Mancuso2010: folds 
Uncalled bet ($1.50) returned to Damage514
Damage514 collected $1.58 from pot
*** SUMMARY ***
Total pot $1.65 | Rake $0.07 
Board [9c 3s 5s 7h]
Seat 1: Mancuso2010 (button) folded on the Turn
Seat 2: MühliJr (small blind) folded before Flop
Seat 3: Damage514 (big blind) collected ($1.58)
Seat 4: Strelok1974 folded before Flop (didn't bet)
Seat 5: Iarlei folded before Flop (didn't bet)
Seat 6: bdixon_5 folded before Flop (didn't bet)



PokerStars Hand #166667490116:  Hold'em No Limit ($0.05/$0.10 USD) - 2017/02/23 16:02:06 ET
Table 'Atropos' 6-max Seat #1 is the button
Seat 1: ScorpionF39 ($0.88 in chips) 
Seat 3: NvR.m1nD ($10.89 in chips) 
Seat 4: iDecMate ($13.05 in chips) 
Seat 5: KokoulinV ($12.09 in chips) 
Seat 6: Iarlei ($10.80 in chips) 
yodzik will be allowed to play after the button
NvR.m1nD: posts small blind $0.05
iDecMate: posts big blind $0.10
*** HOLE CARDS ***
KokoulinV: folds 
Iarlei: raises $0.20 to $0.30
ScorpionF39: folds 
NvR.m1nD: calls $0.25
iDecMate: calls $0.20
*** FLOP *** [4d Qc Th]
NvR.m1nD: checks 
iDecMate: checks 
Iarlei: bets $0.45
NvR.m1nD: calls $0.45
iDecMate: calls $0.45
*** TURN *** [4d Qc Th] [Ah]
NvR.m1nD: checks 
iDecMate: checks 
Iarlei: bets $1.35
NvR.m1nD: folds 
iDecMate: folds 
Uncalled bet ($1.35) returned to Iarlei
Iarlei collected $2.15 from pot
*** SUMMARY ***
Total pot $2.25 | Rake $0.10 
Board [4d Qc Th Ah]
Seat 1: ScorpionF39 (button) folded before Flop (didn't bet)
Seat 3: NvR.m1nD (small blind) folded on the Turn
Seat 4: iDecMate (big blind) folded on the Turn
Seat 5: KokoulinV folded before Flop (didn't bet)
Seat 6: Iarlei collected ($2.15)



PokerStars Hand #166667490693:  Hold'em No Limit ($0.05/$0.10 USD) - 2017/02/23 16:02:07 ET
Table 'Thoas' 6-max Seat #3 is the button
Seat 1: Pekaml ($11.28 in chips) 
Seat 2: themacer24 ($8.52 in chips) 
Seat 3: by.y.y.y86 ($10 in chips) 
Seat 4: Morris_Chair ($17.86 in chips) 
Seat 5: Kow6oy ($10.17 in chips) 
Seat 6: takis nik ($10 in chips) 
Morris_Chair: posts small blind $0.05
Kow6oy: posts big blind $0.10
*** HOLE CARDS ***
takis nik: folds 
Pekaml: raises $0.20 to $0.30
themacer24: folds 
by.y.y.y86: folds 
Morris_Chair: folds 
Kow6oy: folds 
Uncalled bet ($0.20) returned to Pekaml
Pekaml collected $0.25 from pot
*** SUMMARY ***
Total pot $0.25 | Rake $0 
Seat 1: Pekaml collected ($0.25)
Seat 2: themacer24 folded before Flop (didn't bet)
Seat 3: by.y.y.y86 (button) folded before Flop (didn't bet)
Seat 4: Morris_Chair (small blind) folded before Flop
Seat 5: Kow6oy (big blind) folded before Flop
Seat 6: takis nik folded before Flop (didn't bet)



PokerStars Hand #166667490730:  Hold'em No Limit ($0.05/$0.10 USD) - 2017/02/23 16:02:07 ET
Table 'Repsolda' 6-max Seat #3 is the button
Seat 1: fabadam ($10.65 in chips) 
Seat 2: MBen10 ($26.06 in chips) 
Seat 3: manashov ($12.32 in chips) 
Seat 5: danky24 ($7.40 in chips) 
Seat 6: RkaczoR ($10 in chips) 
danky24: posts small blind $0.05
RkaczoR: posts big blind $0.10
*** HOLE CARDS ***
fabadam: folds 
MihaGr joins the table at seat #4 
MBen10: raises $0.15 to $0.25
manashov: raises $0.45 to $0.70
danky24: folds 
RkaczoR: folds 
MBen10: calls $0.45
*** FLOP *** [6d 2d Kd]
MBen10: checks 
manashov: bets $0.80
MBen10: folds 
Uncalled bet ($0.80) returned to manashov
manashov collected $1.48 from pot
*** SUMMARY ***
Total pot $1.55 | Rake $0.07 
Board [6d 2d Kd]
Seat 1: fabadam folded before Flop (didn't bet)
Seat 2: MBen10 folded on the Flop
Seat 3: manashov (button) collected ($1.48)
Seat 5: danky24 (small blind) folded before Flop
Seat 6: RkaczoR (big blind) folded before Flop



PokerStars Hand #166667490761:  Hold'em No Limit ($0.05/$0.10 USD) - 2017/02/23 16:02:07 ET
Table 'Marghanna II' 6-max Seat #4 is the button
Seat 1: steepfell ($11.89 in chips) 
Seat 2: Namhkal ($11.61 in chips) 
Seat 3: Innerwuss ($11.32 in chips) 
Seat 4: D3NyA ($12.37 in chips) 
Seat 5: ofl21189 ($7.48 in chips) 
Seat 6: VAD21 ($13.31 in chips) 
ofl21189: posts small blind $0.05
VAD21: posts big blind $0.10
*** HOLE CARDS ***
steepfell: folds 
Namhkal: folds 
Innerwuss: folds 
D3NyA: folds 
ofl21189: calls $0.05
VAD21: checks 
*** FLOP *** [Ks 3c 9h]
ofl21189: bets $0.20
VAD21: folds 
Uncalled bet ($0.20) returned to ofl21189
ofl21189 collected $0.19 from pot
*** SUMMARY ***
Total pot $0.20 | Rake $0.01 
Board [Ks 3c 9h]
Seat 1: steepfell folded before Flop (didn't bet)
Seat 2: Namhkal folded before Flop (didn't bet)
Seat 3: Innerwuss folded before Flop (didn't bet)
Seat 4: D3NyA (button) folded before Flop (didn't bet)
Seat 5: ofl21189 (small blind) collected ($0.19)
Seat 6: VAD21 (big blind) folded on the Flop



PokerStars Hand #166667491371:  Hold'em No Limit ($0.05/$0.10 USD) - 2017/02/23 16:02:08 ET
Table 'Selinur' 6-max Seat #5 is the button
Seat 1: KA3AXCTAHEU, ($10 in chips) 
Seat 2: jamalungma ($10 in chips) 
Seat 3: bambolejro ($10.52 in chips) 
Seat 4: freezing666 ($11.63 in chips) 
Seat 5: IAntikI ($10.22 in chips) 
Seat 6: homelessdan ($17.82 in chips) 
homelessdan: posts small blind $0.05
KA3AXCTAHEU,: posts big blind $0.10
*** HOLE CARDS ***
jamalungma: folds 
bambolejro: folds 
freezing666: folds 
IAntikI: raises $0.15 to $0.25
homelessdan: folds 
KA3AXCTAHEU,: folds 
Uncalled bet ($0.15) returned to IAntikI
IAntikI collected $0.25 from pot
*** SUMMARY ***
Total pot $0.25 | Rake $0 
Seat 1: KA3AXCTAHEU, (big blind) folded before Flop
Seat 2: jamalungma folded before Flop (didn't bet)
Seat 3: bambolejro folded before Flop (didn't bet)
Seat 4: freezing666 folded before Flop (didn't bet)
Seat 5: IAntikI (button) collected ($0.25)
Seat 6: homelessdan (small blind) folded before Flop



PokerStars Hand #166667491502:  Hold'em No Limit ($0.05/$0.10 USD) - 2017/02/23 16:02:08 ET
Table 'Tyndareus III' 6-max Seat #6 is the button
Seat 1: MBen10 ($10 in chips) 
Seat 2: MihaGr ($10.15 in chips) 
Seat 3: XaXaTyH4uK ($10.60 in chips) 
Seat 4: Therodorus ($11.61 in chips) 
Seat 5: Chodemuncher ($10 in chips) 
Seat 6: Elinaattor ($9.65 in chips) 
MBen10: posts small blind $0.05
MihaGr: posts big blind $0.10
*** HOLE CARDS ***
XaXaTyH4uK: folds 
Therodorus: folds 
Chodemuncher: raises $0.20 to $0.30
Elinaattor: folds 
MBen10: folds 
MihaGr: folds 
Uncalled bet ($0.20) returned to Chodemuncher
Chodemuncher collected $0.25 from pot
*** SUMMARY ***
Total pot $0.25 | Rake $0 
Seat 1: MBen10 (small blind) folded before Flop
Seat 2: MihaGr (big blind) folded before Flop
Seat 3: XaXaTyH4uK folded before Flop (didn't bet)
Seat 4: Therodorus folded before Flop (didn't bet)
Seat 5: Chodemuncher collected ($0.25)
Seat 6: Elinaattor (button) folded before Flop (didn't bet)



PokerStars Hand #166667491558:  Hold'em No Limit ($0.05/$0.10 USD) - 2017/02/23 16:02:08 ET
Table 'Thia' 6-max Seat #3 is the button
Seat 1: Eddys Edge ($10.18 in chips) 
Seat 2: sugrob86 ($20.40 in chips) 
Seat 3: northug18 ($7.56 in chips) 
Seat 4: Bandyaev ($10 in chips) 
Seat 5: ab260414 ($10.72 in chips) 
Seat 6: ex3Lero86 ($15.60 in chips) 
Bandyaev: posts small blind $0.05
ab260414: posts big blind $0.10
*** HOLE CARDS ***
ex3Lero86: folds 
Eddys Edge: raises $0.20 to $0.30
sugrob86: calls $0.30
northug18: calls $0.30
Bandyaev: folds 
ab260414: folds 
*** FLOP *** [Kc 8d Kd]
Eddys Edge: bets $0.50
sugrob86: folds 
northug18: raises $0.50 to $1
Eddys Edge: calls $0.50
*** TURN *** [Kc 8d Kd] [3h]
Eddys Edge: checks 
northug18: bets $1.70
Eddys Edge: folds 
Uncalled bet ($1.70) returned to northug18
northug18 collected $2.91 from pot
*** SUMMARY ***
Total pot $3.05 | Rake $0.14 
Board [Kc 8d Kd 3h]
Seat 1: Eddys Edge folded on the Turn
Seat 2: sugrob86 folded on the Flop
Seat 3: northug18 (button) collected ($2.91)
Seat 4: Bandyaev (small blind) folded before Flop
Seat 5: ab260414 (big blind) folded before Flop
Seat 6: ex3Lero86 folded before Flop (didn't bet)



PokerStars Hand #166667492123:  Hold'em No Limit ($0.05/$0.10 USD) - 2017/02/23 16:02:09 ET
Table 'Girtab II' 6-max Seat #5 is the button
Seat 1: Kow6oy ($10 in chips) 
Seat 2: Pokeaster ($13.77 in chips) 
Seat 4: Hyd SK ($27.03 in chips) 
Seat 5: dzesio18 ($12.19 in chips) 
Seat 6: DamDatsAnAce ($10 in chips) 
DamDatsAnAce: posts small blind $0.05
Kow6oy: posts big blind $0.10
chimera252: sits out 
*** HOLE CARDS ***
Pokeaster: folds 
Hyd SK: folds 
dzesio18: folds 
DamDatsAnAce: folds 
Uncalled bet ($0.05) returned to Kow6oy
Kow6oy collected $0.10 from pot
*** SUMMARY ***
Total pot $0.10 | Rake $0 
Seat 1: Kow6oy (big blind) collected ($0.10)
Seat 2: Pokeaster folded before Flop (didn't bet)
Seat 4: Hyd SK folded before Flop (didn't bet)
Seat 5: dzesio18 (button) folded before Flop (didn't bet)
Seat 6: DamDatsAnAce (small blind) folded before Flop



PokerStars Hand #166667492325:  Hold'em No Limit ($0.05/$0.10 USD) - 2017/02/23 16:02:09 ET
Table 'Azelfafage' 6-max Seat #3 is the button
Seat 1: Sbozzz ($15.76 in chips) 
Seat 2: tr41n3r12 ($10.30 in chips) 
Seat 3: todor1711 ($19.93 in chips) 
Seat 4: fedorka rus ($10.37 in chips) 
Seat 5: 8th wonders ($12.73 in chips) 
Seat 6: KA3AXCTAHEU, ($10 in chips) 
fedorka rus: posts small blind $0.05
8th wonders: posts big blind $0.10
*** HOLE CARDS ***
KA3AXCTAHEU,: folds 
Sbozzz: folds 
tr41n3r12: folds 
todor1711: folds 
fedorka rus: folds 
Uncalled bet ($0.05) returned to 8th wonders
8th wonders collected $0.10 from pot
*** SUMMARY ***
Total pot $0.10 | Rake $0 
Seat 1: Sbozzz folded before Flop (didn't bet)
Seat 2: tr41n3r12 folded before Flop (didn't bet)
Seat 3: todor1711 (button) folded before Flop (didn't bet)
Seat 4: fedorka rus (small blind) folded before Flop
Seat 5: 8th wonders (big blind) collected ($0.10)
Seat 6: KA3AXCTAHEU, folded before Flop (didn't bet)



PokerStars Hand #166667492397:  Hold'em No Limit ($0.05/$0.10 USD) - 2017/02/23 16:02:09 ET
Table 'Nemo III' 6-max Seat #3 is the button
Seat 2: Bandyaev ($11.89 in chips) 
Seat 3: Therodorus ($10.51 in chips) 
Seat 4: vtalian ($9.60 in chips) 
Seat 5: Joker51_wtf! ($10 in chips) 
Seat 6: SALAMIS85 ($13.64 in chips) 
vtalian: posts small blind $0.05
Joker51_wtf!: posts big blind $0.10
*** HOLE CARDS ***
SALAMIS85: folds 
Bandyaev: folds 
Therodorus: raises $0.15 to $0.25
vtalian: folds 
Joker51_wtf!: calls $0.15
*** FLOP *** [3h As 9s]
Joker51_wtf!: checks 
Therodorus: checks 
*** TURN *** [3h As 9s] [Jd]
Joker51_wtf!: checks 
Therodorus: bets $0.39
Joker51_wtf!: calls $0.39
*** RIVER *** [3h As 9s Jd] [Ac]
Joker51_wtf!: checks 
Therodorus: bets $0.93
Joker51_wtf!: calls $0.93
*** SHOW DOWN ***
Therodorus: shows [8s Th] (a pair of Aces)
Joker51_wtf!: shows [Ks Jc] (two pair, Aces and Jacks)
Joker51_wtf! collected $3.05 from pot
*** SUMMARY ***
Total pot $3.19 | Rake $0.14 
Board [3h As 9s Jd Ac]
Seat 2: Bandyaev folded before Flop (didn't bet)
Seat 3: Therodorus (button) showed [8s Th] and lost with a pair of Aces
Seat 4: vtalian (small blind) folded before Flop
Seat 5: Joker51_wtf! (big blind) showed [Ks Jc] and won ($3.05) with two pair, Aces and Jacks
Seat 6: SALAMIS85 folded before Flop (didn't bet)



PokerStars Hand #166667492777:  Hold'em No Limit ($0.05/$0.10 USD) - 2017/02/23 16:02:09 ET
Table 'Nauheima II' 6-max Seat #4 is the button
Seat 1: HARDCORE66RU ($17.89 in chips) 
Seat 2: Peter0087 ($9.59 in chips) 
Seat 3: KokoulinV ($13.74 in chips) 
Seat 4: Innerwuss ($10.12 in chips) 
Seat 5: Kow6oy ($10.50 in chips) 
Seat 6: bonyo71 ($5.19 in chips) 
Kow6oy: posts small blind $0.05
bonyo71: posts big blind $0.10
*** HOLE CARDS ***
HARDCORE66RU: raises $0.20 to $0.30
Peter0087: folds 
KokoulinV: folds 
Innerwuss: folds 
Kow6oy: folds 
bonyo71: folds 
Uncalled bet ($0.20) returned to HARDCORE66RU
HARDCORE66RU collected $0.25 from pot
*** SUMMARY ***
Total pot $0.25 | Rake $0 
Seat 1: HARDCORE66RU collected ($0.25)
Seat 2: Peter0087 folded before Flop (didn't bet)
Seat 3: KokoulinV folded before Flop (didn't bet)
Seat 4: Innerwuss (button) folded before Flop (didn't bet)
Seat 5: Kow6oy (small blind) folded before Flop
Seat 6: bonyo71 (big blind) folded before Flop



PokerStars Hand #166667492944:  Hold'em No Limit ($0.05/$0.10 USD) - 2017/02/23 16:02:10 ET
Table 'Apollonia' 6-max Seat #6 is the button
Seat 1: ex3Lero86 ($10.16 in chips) 
Seat 2: ibara000 ($18.84 in chips) 
Seat 3: derbesteojr ($9.35 in chips) 
Seat 4: Goroshkos88 ($17.46 in chips) 
Seat 5: EphemeralBen ($13.49 in chips) 
Seat 6: Namhkal ($10.25 in chips) 
ex3Lero86: posts small blind $0.05
ibara000: posts big blind $0.10
*** HOLE CARDS ***
derbesteojr: folds 
Goroshkos88: folds 
EphemeralBen: folds 
Namhkal: folds 
ex3Lero86: folds 
Uncalled bet ($0.05) returned to ibara000
ibara000 collected $0.10 from pot
*** SUMMARY ***
Total pot $0.10 | Rake $0 
Seat 1: ex3Lero86 (small blind) folded before Flop
Seat 2: ibara000 (big blind) collected ($0.10)
Seat 3: derbesteojr folded before Flop (didn't bet)
Seat 4: Goroshkos88 folded before Flop (didn't bet)
Seat 5: EphemeralBen folded before Flop (didn't bet)
Seat 6: Namhkal (button) folded before Flop (didn't bet)



PokerStars Hand #166667492947:  Hold'em No Limit ($0.05/$0.10 USD) - 2017/02/23 16:02:10 ET
Table 'Ophelia' 6-max Seat #6 is the button
Seat 1: ralfi37 ($10.91 in chips) 
Seat 2: popypaleta ($16.12 in chips) 
Seat 3: mvp0013 ($11.60 in chips) 
Seat 4: Cluckh ($11.65 in chips) 
Seat 5: truck1234 ($14.01 in chips) 
Seat 6: Yabidooo ($10.86 in chips) 
ralfi37: posts small blind $0.05
popypaleta: posts big blind $0.10
*** HOLE CARDS ***
mvp0013: folds 
Cluckh: raises $0.20 to $0.30
truck1234: folds 
Yabidooo: folds 
ralfi37: calls $0.25
popypaleta: calls $0.20
*** FLOP *** [Jd 6d 7s]
ralfi37: checks 
popypaleta: checks 
Cluckh: checks 
*** TURN *** [Jd 6d 7s] [8c]
ralfi37: checks 
popypaleta: bets $0.60
Cluckh: folds 
ralfi37: folds 
Uncalled bet ($0.60) returned to popypaleta
popypaleta collected $0.86 from pot
*** SUMMARY ***
Total pot $0.90 | Rake $0.04 
Board [Jd 6d 7s 8c]
Seat 1: ralfi37 (small blind) folded on the Turn
Seat 2: popypaleta (big blind) collected ($0.86)
Seat 3: mvp0013 folded before Flop (didn't bet)
Seat 4: Cluckh folded on the Turn
Seat 5: truck1234 folded before Flop (didn't bet)
Seat 6: Yabidooo (button) folded before Flop (didn't bet)



PokerStars Hand #166667492974:  Hold'em No Limit ($0.05/$0.10 USD) - 2017/02/23 16:02:10 ET
Table 'Antielus II' 6-max Seat #6 is the button
Seat 1: Dcaro31 ($17.35 in chips) 
Seat 2: Orlangoor ($10.80 in chips) 
Seat 3: mcyi3at2 ($12.89 in chips) 
Seat 5: Hyd SK ($10 in chips) 
Seat 6: GiveTwoMe ($12.08 in chips) 
Dcaro31: posts small blind $0.05
Orlangoor: posts big blind $0.10
XwinX25: sits out 
*** HOLE CARDS ***
mcyi3at2: folds 
Hyd SK: folds 
GiveTwoMe: raises $0.20 to $0.30
Dcaro31: folds 
Orlangoor: calls $0.20
*** FLOP *** [4s 9s 6s]
Orlangoor: checks 
GiveTwoMe: bets $0.37
Orlangoor: folds 
Uncalled bet ($0.37) returned to GiveTwoMe
GiveTwoMe collected $0.62 from pot
*** SUMMARY ***
Total pot $0.65 | Rake $0.03 
Board [4s 9s 6s]
Seat 1: Dcaro31 (small blind) folded before Flop
Seat 2: Orlangoor (big blind) folded on the Flop
Seat 3: mcyi3at2 folded before Flop (didn't bet)
Seat 5: Hyd SK folded before Flop (didn't bet)
Seat 6: GiveTwoMe (button) collected ($0.62)



PokerStars Hand #166667493302:  Hold'em No Limit ($0.05/$0.10 USD) - 2017/02/23 16:02:10 ET
Table 'Arduina' 6-max Seat #3 is the button
Seat 1: kickereens ($18.44 in chips) 
Seat 2: Andy Wolf ($14.60 in chips) 
Seat 3: Dcaro31 ($13.11 in chips) 
Seat 4: ChuikaPridi ($30.78 in chips) 
Seat 5: ettedallas ($5.16 in chips) 
Seat 6: dierri ($9.99 in chips) 
ChuikaPridi: posts small blind $0.05
ettedallas: posts big blind $0.10
*** HOLE CARDS ***
dierri: raises $0.20 to $0.30
kickereens: folds 
Andy Wolf: folds 
Dcaro31: folds 
ChuikaPridi: folds 
ettedallas: folds 
Uncalled bet ($0.20) returned to dierri
dierri collected $0.25 from pot
*** SUMMARY ***
Total pot $0.25 | Rake $0 
Seat 1: kickereens folded before Flop (didn't bet)
Seat 2: Andy Wolf folded before Flop (didn't bet)
Seat 3: Dcaro31 (button) folded before Flop (didn't bet)
Seat 4: ChuikaPridi (small blind) folded before Flop
Seat 5: ettedallas (big blind) folded before Flop
Seat 6: dierri collected ($0.25)



PokerStars Hand #166667493305:  Hold'em No Limit ($0.05/$0.10 USD) - 2017/02/23 16:02:10 ET
Table 'Caupolican' 6-max Seat #4 is the button
Seat 1: kingartur222 ($10.68 in chips) 
Seat 2: garigura ($19.55 in chips) 
Seat 3: arturgalant ($4.32 in chips) 
Seat 4: mhonielsen ($11.46 in chips) 
Seat 5: Kazacha ($10.85 in chips) 
Seat 6: crazydevill ($11.02 in chips) 
Kazacha: posts small blind $0.05
crazydevill: posts big blind $0.10
*** HOLE CARDS ***
kingartur222: folds 
garigura: folds 
arturgalant: folds 
mhonielsen: raises $0.10 to $0.20
Kazacha: folds 
crazydevill: calls $0.10
*** FLOP *** [4s 6d 6h]
crazydevill: checks 
mhonielsen: bets $0.25
crazydevill: folds 
Uncalled bet ($0.25) returned to mhonielsen
mhonielsen collected $0.43 from pot
*** SUMMARY ***
Total pot $0.45 | Rake $0.02 
Board [4s 6d 6h]
Seat 1: kingartur222 folded before Flop (didn't bet)
Seat 2: garigura folded before Flop (didn't bet)
Seat 3: arturgalant folded before Flop (didn't bet)
Seat 4: mhonielsen (button) collected ($0.43)
Seat 5: Kazacha (small blind) folded before Flop
Seat 6: crazydevill (big blind) folded on the Flop



PokerStars Hand #166667493391:  Hold'em No Limit ($0.05/$0.10 USD) - 2017/02/23 16:02:10 ET
Table 'Nekkar' 6-max Seat #6 is the button
Seat 2: Bird et al ($10 in chips) 
Seat 3: Zemz_Ru ($16.99 in chips) 
Seat 4: kingartur222 ($12.25 in chips) 
Seat 5: Vrinni ($12.10 in chips) 
Seat 6: Eddys Edge ($10.50 in chips) 
Bird et al: posts small blind $0.05
Zemz_Ru: posts big blind $0.10
*** HOLE CARDS ***
kingartur222: folds 
Vrinni: folds 
Eddys Edge: raises $0.10 to $0.20
Bird et al: folds 
Zemz_Ru: calls $0.10
*** FLOP *** [Ac 6s 8c]
Zemz_Ru: checks 
Eddys Edge: bets $0.30
Zemz_Ru: folds 
Uncalled bet ($0.30) returned to Eddys Edge
Eddys Edge collected $0.43 from pot
*** SUMMARY ***
Total pot $0.45 | Rake $0.02 
Board [Ac 6s 8c]
Seat 2: Bird et al (small blind) folded before Flop
Seat 3: Zemz_Ru (big blind) folded on the Flop
Seat 4: kingartur222 folded before Flop (didn't bet)
Seat 5: Vrinni folded before Flop (didn't bet)
Seat 6: Eddys Edge (button) collected ($0.43)



PokerStars Hand #166667493554:  Hold'em No Limit ($0.05/$0.10 USD) - 2017/02/23 16:02:10 ET
Table 'Rotraut' 6-max Seat #1 is the button
Seat 1: Hypermetal ($13.34 in chips) 
Seat 2: Newqbrown ($10.58 in chips) 
Seat 3: FlackoD ($12.47 in chips) 
Seat 4: Darkfrai ($10 in chips) 
Seat 5: Bird et al ($11.75 in chips) 
Seat 6: KokoulinV ($12.99 in chips) 
Newqbrown: posts small blind $0.05
FlackoD: posts big blind $0.10
*** HOLE CARDS ***
Darkfrai: folds 
Bird et al: folds 
KokoulinV: folds 
Hypermetal: raises $0.10 to $0.20
Newqbrown: calls $0.15
FlackoD: raises $0.70 to $0.90
Hypermetal: folds 
Newqbrown: calls $0.70
*** FLOP *** [8c 3s 8s]
Newqbrown: checks 
FlackoD: checks 
*** TURN *** [8c 3s 8s] [Qc]
Newqbrown: bets $1
FlackoD: folds 
Uncalled bet ($1) returned to Newqbrown
Newqbrown collected $1.91 from pot
*** SUMMARY ***
Total pot $2 | Rake $0.09 
Board [8c 3s 8s Qc]
Seat 1: Hypermetal (button) folded before Flop
Seat 2: Newqbrown (small blind) collected ($1.91)
Seat 3: FlackoD (big blind) folded on the Turn
Seat 4: Darkfrai folded before Flop (didn't bet)
Seat 5: Bird et al folded before Flop (didn't bet)
Seat 6: KokoulinV folded before Flop (didn't bet)



PokerStars Hand #166667493721:  Hold'em No Limit ($0.05/$0.10 USD) - 2017/02/23 16:02:10 ET
Table 'Eurykleia' 6-max Seat #4 is the button
Seat 1: Giyorod ($11.20 in chips) 
Seat 2: x3ultimate ($10 in chips) 
Seat 3: boxer821 ($20.56 in chips) 
Seat 4: 6ePeMeHHa9 ($16.51 in chips) 
Seat 5: fishhook5 ($10 in chips) 
Seat 6: afca128 ($6.57 in chips) 
fishhook5: posts small blind $0.05
afca128: posts big blind $0.10
*** HOLE CARDS ***
Giyorod: folds 
x3ultimate: folds 
boxer821: folds 
6ePeMeHHa9: raises $0.14 to $0.24
fishhook5: folds 
afca128: folds 
Uncalled bet ($0.14) returned to 6ePeMeHHa9
6ePeMeHHa9 collected $0.25 from pot
*** SUMMARY ***
Total pot $0.25 | Rake $0 
Seat 1: Giyorod folded before Flop (didn't bet)
Seat 2: x3ultimate folded before Flop (didn't bet)
Seat 3: boxer821 folded before Flop (didn't bet)
Seat 4: 6ePeMeHHa9 (button) collected ($0.25)
Seat 5: fishhook5 (small blind) folded before Flop
Seat 6: afca128 (big blind) folded before Flop



PokerStars Hand #166667494051:  Hold'em No Limit ($0.05/$0.10 USD) - 2017/02/23 16:02:11 ET
Table 'Ebella II' 6-max Seat #5 is the button
Seat 1: gaHy_HaXeP ($10 in chips) 
Seat 2: Therodorus ($10 in chips) 
Seat 3: Torften2 ($16.22 in chips) 
Seat 4: ValdemorS ($10.15 in chips) 
Seat 5: Bird et al ($10 in chips) 
Seat 6: Joker51_wtf! ($10.05 in chips) 
Joker51_wtf!: posts small blind $0.05
gaHy_HaXeP: posts big blind $0.10
*** HOLE CARDS ***
Therodorus: folds 
Torften2: folds 
ValdemorS: folds 
Bird et al: raises $0.15 to $0.25
Joker51_wtf!: folds 
gaHy_HaXeP: folds 
Uncalled bet ($0.15) returned to Bird et al
Bird et al collected $0.25 from pot
*** SUMMARY ***
Total pot $0.25 | Rake $0 
Seat 1: gaHy_HaXeP (big blind) folded before Flop
Seat 2: Therodorus folded before Flop (didn't bet)
Seat 3: Torften2 folded before Flop (didn't bet)
Seat 4: ValdemorS folded before Flop (didn't bet)
Seat 5: Bird et al (button) collected ($0.25)
Seat 6: Joker51_wtf! (small blind) folded before Flop



PokerStars Hand #166667494170:  Hold'em No Limit ($0.05/$0.10 USD) - 2017/02/23 16:02:11 ET
Table 'Hestia' 6-max Seat #4 is the button
Seat 1: Pekaml ($10 in chips) 
Seat 2: RoJ1 ($11.97 in chips) 
Seat 3: MBen10 ($12.86 in chips) 
Seat 4: Lucky HoBBiT ($10 in chips) 
Seat 5: CiisCi ($16.10 in chips) 
CiisCi: posts small blind $0.05
MihaGr: is sitting out 
Pekaml: posts big blind $0.10
*** HOLE CARDS ***
MihaGr leaves the table
RoJ1: raises $0.12 to $0.22
MBen10: raises $0.63 to $0.85
Lucky HoBBiT: folds 
CiisCi: folds 
Pekaml: folds 
RoJ1: folds 
Uncalled bet ($0.63) returned to MBen10
MBen10 collected $0.59 from pot
*** SUMMARY ***
Total pot $0.59 | Rake $0 
Seat 1: Pekaml (big blind) folded before Flop
Seat 2: RoJ1 folded before Flop
Seat 3: MBen10 collected ($0.59)
Seat 4: Lucky HoBBiT (button) folded before Flop (didn't bet)
Seat 5: CiisCi (small blind) folded before Flop



PokerStars Hand #166667494377:  Hold'em No Limit ($0.05/$0.10 USD) - 2017/02/23 16:02:11 ET
Table 'Ruvuma' 6-max Seat #5 is the button
Seat 1: FRAID358 ($10.40 in chips) 
Seat 2: Fab_1512 ($13.08 in chips) 
Seat 3: Spud014 ($11.26 in chips) 
Seat 4: DamDatsAnAce ($10.15 in chips) 
Seat 5: sexy_seagull ($10 in chips) 
Seat 6: Elinaattor ($9.50 in chips) 
Elinaattor: posts small blind $0.05
FRAID358: posts big blind $0.10
*** HOLE CARDS ***
Fab_1512: raises $0.10 to $0.20
Spud014: folds 
DamDatsAnAce: calls $0.20
sexy_seagull: folds 
Elinaattor: folds 
FRAID358: folds 
*** FLOP *** [Th 4h Ks]
Fab_1512: checks 
DamDatsAnAce: bets $0.35
Fab_1512: calls $0.35
*** TURN *** [Th 4h Ks] [5s]
Fab_1512: checks 
DamDatsAnAce: bets $0.79
Fab_1512: calls $0.79
*** RIVER *** [Th 4h Ks 5s] [5h]
Fab_1512: bets $0.40
DamDatsAnAce: calls $0.40
*** SHOW DOWN ***
Fab_1512: shows [4d 4s] (a full house, Fours full of Fives)
DamDatsAnAce: mucks hand 
Fab_1512 collected $3.47 from pot
*** SUMMARY ***
Total pot $3.63 | Rake $0.16 
Board [Th 4h Ks 5s 5h]
Seat 1: FRAID358 (big blind) folded before Flop
Seat 2: Fab_1512 showed [4d 4s] and won ($3.47) with a full house, Fours full of Fives
Seat 3: Spud014 folded before Flop (didn't bet)
Seat 4: DamDatsAnAce mucked
Seat 5: sexy_seagull (button) folded before Flop (didn't bet)
Seat 6: Elinaattor (small blind) folded before Flop



PokerStars Hand #166667494389:  Hold'em No Limit ($0.05/$0.10 USD) - 2017/02/23 16:02:11 ET
Table 'Hercynia III' 6-max Seat #5 is the button
Seat 1: Bird et al ($14.73 in chips) 
Seat 2: Action_Gibi ($9.20 in chips) 
Seat 3: Dcaro31 ($20.54 in chips) 
Seat 4: Darkfrai ($16.36 in chips) 
Seat 5: THIMUCHIN ($14.79 in chips) 
Seat 6: bdixon_5 ($10.77 in chips) 
bdixon_5: posts small blind $0.05
Bird et al: posts big blind $0.10
*** HOLE CARDS ***
Action_Gibi: calls $0.10
Dcaro31: folds 
Darkfrai: raises $0.25 to $0.35
THIMUCHIN: folds 
bdixon_5: folds 
Bird et al: folds 
Action_Gibi: calls $0.25
*** FLOP *** [3h Qd 9h]
Action_Gibi: checks 
Darkfrai: checks 
*** TURN *** [3h Qd 9h] [7c]
Action_Gibi: checks 
Darkfrai: checks 
*** RIVER *** [3h Qd 9h 7c] [9c]
Action_Gibi: bets $0.60
Darkfrai: calls $0.60
*** SHOW DOWN ***
Action_Gibi: shows [Td Kc] (a pair of Nines)
Darkfrai: shows [6h 6c] (two pair, Nines and Sixes)
Darkfrai collected $1.96 from pot
*** SUMMARY ***
Total pot $2.05 | Rake $0.09 
Board [3h Qd 9h 7c 9c]
Seat 1: Bird et al (big blind) folded before Flop
Seat 2: Action_Gibi showed [Td Kc] and lost with a pair of Nines
Seat 3: Dcaro31 folded before Flop (didn't bet)
Seat 4: Darkfrai showed [6h 6c] and won ($1.96) with two pair, Nines and Sixes
Seat 5: THIMUCHIN (button) folded before Flop (didn't bet)
Seat 6: bdixon_5 (small blind) folded before Flop



PokerStars Hand #166667495124:  Hold'em No Limit ($0.05/$0.10 USD) - 2017/02/23 16:02:12 ET
Table 'Hajek III' 6-max Seat #2 is the button
Seat 1: MBen10 ($10.75 in chips) 
Seat 2: fortieth ($12.08 in chips) 
Seat 3: fedorka rus ($10.51 in chips) 
Seat 4: NvR.m1nD ($10.67 in chips) 
Seat 5: Croplayer1 ($15.56 in chips) 
Seat 6: fabadam ($22.46 in chips) 
fedorka rus: posts small blind $0.05
NvR.m1nD: posts big blind $0.10
*** HOLE CARDS ***
Croplayer1: folds 
fabadam: folds 
MBen10: folds 
fortieth: raises $0.17 to $0.27
fedorka rus: folds 
NvR.m1nD: folds 
Uncalled bet ($0.17) returned to fortieth
fortieth collected $0.25 from pot
*** SUMMARY ***
Total pot $0.25 | Rake $0 
Seat 1: MBen10 folded before Flop (didn't bet)
Seat 2: fortieth (button) collected ($0.25)
Seat 3: fedorka rus (small blind) folded before Flop
Seat 4: NvR.m1nD (big blind) folded before Flop
Seat 5: Croplayer1 folded before Flop (didn't bet)
Seat 6: fabadam folded before Flop (didn't bet)



PokerStars Hand #166667495390:  Hold'em No Limit ($0.05/$0.10 USD) - 2017/02/23 16:02:12 ET
Table 'Senta II' 6-max Seat #2 is the button
Seat 2: NvR.m1nD ($10.63 in chips) 
Seat 3: Aescul@pius ($21.30 in chips) 
Seat 4: fedorka rus ($21.82 in chips) 
Seat 5: Algarah ($6.04 in chips) 
Seat 6: T9MS ($11.92 in chips) 
Aescul@pius: posts small blind $0.05
fedorka rus: posts big blind $0.10
*** HOLE CARDS ***
Algarah: folds 
T9MS: folds 
NvR.m1nD: folds 
Aescul@pius: folds 
Uncalled bet ($0.05) returned to fedorka rus
fedorka rus collected $0.10 from pot
*** SUMMARY ***
Total pot $0.10 | Rake $0 
Seat 2: NvR.m1nD (button) folded before Flop (didn't bet)
Seat 3: Aescul@pius (small blind) folded before Flop
Seat 4: fedorka rus (big blind) collected ($0.10)
Seat 5: Algarah folded before Flop (didn't bet)
Seat 6: T9MS folded before Flop (didn't bet)



PokerStars Hand #166667495396:  Hold'em No Limit ($0.05/$0.10 USD) - 2017/02/23 16:02:12 ET
Table 'Arpola' 6-max Seat #1 is the button
Seat 1: dincimus ($10 in chips) 
Seat 2: patrick19111 ($10.18 in chips) 
Seat 3: simaryk ($2.99 in chips) 
Seat 4: Orlangoor ($19.20 in chips) 
Seat 5: truck1234 ($11.39 in chips) 
Seat 6: Andrei ProFF ($10 in chips) 
patrick19111: posts small blind $0.05
simaryk: posts big blind $0.10
*** HOLE CARDS ***
Orlangoor: folds 
truck1234: folds 
Andrei ProFF: raises $0.20 to $0.30
dincimus: folds 
patrick19111: folds 
simaryk: calls $0.20
*** FLOP *** [3h Kh 9h]
simaryk: checks 
Andrei ProFF: bets $0.30
simaryk: folds 
Uncalled bet ($0.30) returned to Andrei ProFF
Andrei ProFF collected $0.62 from pot
*** SUMMARY ***
Total pot $0.65 | Rake $0.03 
Board [3h Kh 9h]
Seat 1: dincimus (button) folded before Flop (didn't bet)
Seat 2: patrick19111 (small blind) folded before Flop
Seat 3: simaryk (big blind) folded on the Flop
Seat 4: Orlangoor folded before Flop (didn't bet)
Seat 5: truck1234 folded before Flop (didn't bet)
Seat 6: Andrei ProFF collected ($0.62)



PokerStars Hand #166667495640:  Hold'em No Limit ($0.05/$0.10 USD) - 2017/02/23 16:02:13 ET
Table 'Glarona' 6-max Seat #3 is the button
Seat 1: LarryTheStar ($10.80 in chips) 
Seat 2: BookWorm78 ($10.02 in chips) 
Seat 3: hoedje72 ($4.06 in chips) 
Seat 4: CrippledGod ($6.77 in chips) 
Seat 5: david_sara83 ($10 in chips) 
Seat 6: Namhkal ($11.08 in chips) 
CrippledGod: posts small blind $0.05
david_sara83: posts big blind $0.10
*** HOLE CARDS ***
Namhkal: folds 
LarryTheStar: folds 
BookWorm78: folds 
hoedje72: raises $0.10 to $0.20
CrippledGod: folds 
david_sara83: raises $1.09 to $1.29
hoedje72: folds 
Uncalled bet ($1.09) returned to david_sara83
david_sara83 collected $0.45 from pot
*** SUMMARY ***
Total pot $0.45 | Rake $0 
Seat 1: LarryTheStar folded before Flop (didn't bet)
Seat 2: BookWorm78 folded before Flop (didn't bet)
Seat 3: hoedje72 (button) folded before Flop
Seat 4: CrippledGod (small blind) folded before Flop
Seat 5: david_sara83 (big blind) collected ($0.45)
Seat 6: Namhkal folded before Flop (didn't bet)



PokerStars Hand #166667495653:  Hold'em No Limit ($0.05/$0.10 USD) - 2017/02/23 16:02:13 ET
Table 'Wesselink II' 6-max Seat #5 is the button
Seat 1: vladcol ($5.74 in chips) 
Seat 2: jamalungma ($11.26 in chips) 
Seat 3: Wargolandros ($9.07 in chips) 
Seat 4: BahiaMinhaP ($10.78 in chips) 
Seat 5: xdjango07x ($18.38 in chips) 
Seat 6: bambolejro ($10 in chips) 
bambolejro: posts small blind $0.05
vladcol: posts big blind $0.10
*** HOLE CARDS ***
jamalungma: folds 
Wargolandros: folds 
BahiaMinhaP: folds 
xdjango07x: folds 
bambolejro: folds 
Uncalled bet ($0.05) returned to vladcol
vladcol collected $0.10 from pot
*** SUMMARY ***
Total pot $0.10 | Rake $0 
Seat 1: vladcol (big blind) collected ($0.10)
Seat 2: jamalungma folded before Flop (didn't bet)
Seat 3: Wargolandros folded before Flop (didn't bet)
Seat 4: BahiaMinhaP folded before Flop (didn't bet)
Seat 5: xdjango07x (button) folded before Flop (didn't bet)
Seat 6: bambolejro (small blind) folded before Flop



PokerStars Hand #166667495693:  Hold'em No Limit ($0.05/$0.10 USD) - 2017/02/23 16:02:13 ET
Table 'Aisakos II' 6-max Seat #5 is the button
Seat 1: Crafty23@PS ($10 in chips) 
Seat 2: svaika24 ($16.93 in chips) 
Seat 3: iamkakaroto ($10.69 in chips) 
Seat 4: T9MS ($10 in chips) 
Seat 5: KokoulinV ($11.66 in chips) 
Seat 6: LarryTheStar ($10.05 in chips) 
LarryTheStar: posts small blind $0.05
Crafty23@PS: posts big blind $0.10
*** HOLE CARDS ***
svaika24: folds 
iamkakaroto: folds 
T9MS: folds 
KokoulinV: raises $0.10 to $0.20
LarryTheStar: calls $0.15
Crafty23@PS: calls $0.10
*** FLOP *** [3d 4d 2c]
LarryTheStar: checks 
Crafty23@PS: checks 
KokoulinV: bets $0.40
LarryTheStar: folds 
Crafty23@PS: calls $0.40
*** TURN *** [3d 4d 2c] [4s]
Crafty23@PS: checks 
KokoulinV: bets $0.90
Crafty23@PS: folds 
Uncalled bet ($0.90) returned to KokoulinV
KokoulinV collected $1.34 from pot
*** SUMMARY ***
Total pot $1.40 | Rake $0.06 
Board [3d 4d 2c 4s]
Seat 1: Crafty23@PS (big blind) folded on the Turn
Seat 2: svaika24 folded before Flop (didn't bet)
Seat 3: iamkakaroto folded before Flop (didn't bet)
Seat 4: T9MS folded before Flop (didn't bet)
Seat 5: KokoulinV (button) collected ($1.34)
Seat 6: LarryTheStar (small blind) folded on the Flop



PokerStars Hand #166667495698:  Hold'em No Limit ($0.05/$0.10 USD) - 2017/02/23 16:02:13 ET
Table 'Stroobantia' 6-max Seat #3 is the button
Seat 1: mam9zyc ($7.55 in chips) 
Seat 2: XwinX25 ($10.34 in chips) 
Seat 3: Namhkal ($10 in chips) 
Seat 4: Yspenyanin ($10.18 in chips) 
Seat 5: boxer821 ($10.64 in chips) 
Seat 6: KokoulinV ($15.52 in chips) 
Yspenyanin: posts small blind $0.05
boxer821: posts big blind $0.10
*** HOLE CARDS ***
KokoulinV: raises $0.20 to $0.30
mam9zyc: folds 
XwinX25: folds 
Namhkal: folds 
Yspenyanin: folds 
boxer821: folds 
Uncalled bet ($0.20) returned to KokoulinV
KokoulinV collected $0.25 from pot
*** SUMMARY ***
Total pot $0.25 | Rake $0 
Seat 1: mam9zyc folded before Flop (didn't bet)
Seat 2: XwinX25 folded before Flop (didn't bet)
Seat 3: Namhkal (button) folded before Flop (didn't bet)
Seat 4: Yspenyanin (small blind) folded before Flop
Seat 5: boxer821 (big blind) folded before Flop
Seat 6: KokoulinV collected ($0.25)



PokerStars Hand #166667495842:  Hold'em No Limit ($0.05/$0.10 USD) - 2017/02/23 16:02:13 ET
Table 'Deflotte' 6-max Seat #4 is the button
Seat 1: Zooplack ($15.54 in chips) 
Seat 3: Croplayer1 ($10.15 in chips) 
Seat 4: 8th wonders ($10.15 in chips) 
Seat 5: Pokeaster ($11.42 in chips) 
Seat 6: Iarlei ($11.39 in chips) 
Pokeaster: posts small blind $0.05
Iarlei: posts big blind $0.10
MonteCris92: sits out 
*** HOLE CARDS ***
Zooplack: folds 
Croplayer1: folds 
8th wonders: raises $0.20 to $0.30
Pokeaster: folds 
Iarlei: raises $0.70 to $1
8th wonders: calls $0.70
*** FLOP *** [Ac 8h 5d]
Iarlei: bets $1.05
8th wonders: folds 
Uncalled bet ($1.05) returned to Iarlei
Iarlei collected $1.96 from pot
*** SUMMARY ***
Total pot $2.05 | Rake $0.09 
Board [Ac 8h 5d]
Seat 1: Zooplack folded before Flop (didn't bet)
Seat 3: Croplayer1 folded before Flop (didn't bet)
Seat 4: 8th wonders (button) folded on the Flop
Seat 5: Pokeaster (small blind) folded before Flop
Seat 6: Iarlei (big blind) collected ($1.96)



PokerStars Hand #166667496276:  Hold'em No Limit ($0.05/$0.10 USD) - 2017/02/23 16:02:13 ET
Table 'Lederle' 6-max Seat #5 is the button
Seat 2: truck1234 ($16 in chips) 
Seat 3: Kazacha ($10.35 in chips) 
Seat 4: Pokeaster ($13.61 in chips) 
Seat 5: 8th wonders ($14.16 in chips) 
Seat 6: pokekrk ($10 in chips) 
pokekrk: posts small blind $0.05
D3NyA: is sitting out 
truck1234: posts big blind $0.10
*** HOLE CARDS ***
Kazacha: raises $0.14 to $0.24
Pokeaster: folds 
8th wonders: folds 
pokekrk: folds 
truck1234: folds 
Uncalled bet ($0.14) returned to Kazacha
Kazacha collected $0.25 from pot
*** SUMMARY ***
Total pot $0.25 | Rake $0 
Seat 2: truck1234 (big blind) folded before Flop
Seat 3: Kazacha collected ($0.25)
Seat 4: Pokeaster folded before Flop (didn't bet)
Seat 5: 8th wonders (button) folded before Flop (didn't bet)
Seat 6: pokekrk (small blind) folded before Flop



PokerStars Hand #166667496349:  Hold'em No Limit ($0.05/$0.10 USD) - 2017/02/23 16:02:13 ET
Table 'Rosalia' 6-max Seat #2 is the button
Seat 1: Hyd SK ($10 in chips) 
Seat 2: Bandyaev ($11.84 in chips) 
Seat 3: Andy Wolf ($12.23 in chips) 
Seat 4: THIMUCHIN ($10 in chips) 
Seat 5: miron762 ($7.75 in chips) 
Seat 6: facewald ($18.74 in chips) 
Andy Wolf: posts small blind $0.05
THIMUCHIN: posts big blind $0.10
*** HOLE CARDS ***
miron762: calls $0.10
facewald: raises $0.12 to $0.22
Hyd SK: raises $0.53 to $0.75
Bandyaev: folds 
Andy Wolf: folds 
THIMUCHIN: folds 
miron762: calls $0.65
facewald: folds 
*** FLOP *** [Th 8d Jc]
miron762: bets $7 and is all-in
Hyd SK: calls $7
*** TURN *** [Th 8d Jc] [5c]
*** RIVER *** [Th 8d Jc 5c] [Jd]
*** SHOW DOWN ***
miron762: shows [8s Tc] (two pair, Jacks and Tens)
Hyd SK: shows [Qs Kh] (a pair of Jacks)
miron762 collected $15.16 from pot
*** SUMMARY ***
Total pot $15.87 | Rake $0.71 
Board [Th 8d Jc 5c Jd]
Seat 1: Hyd SK showed [Qs Kh] and lost with a pair of Jacks
Seat 2: Bandyaev (button) folded before Flop (didn't bet)
Seat 3: Andy Wolf (small blind) folded before Flop
Seat 4: THIMUCHIN (big blind) folded before Flop
Seat 5: miron762 showed [8s Tc] and won ($15.16) with two pair, Jacks and Tens
Seat 6: facewald folded before Flop



PokerStars Hand #166667496462:  Hold'em No Limit ($0.05/$0.10 USD) - 2017/02/23 16:02:14 ET
Table 'Aconcagua' 6-max Seat #6 is the button
Seat 4: pivanki11 ($9.53 in chips) 
Seat 5: frazaunch ($6.80 in chips) 
Seat 6: coolisses111 ($9.21 in chips) 
pivanki11: posts small blind $0.05
frazaunch: posts big blind $0.10
pivanki11: posts the ante $0.02
frazaunch: posts the ante $0.02
coolisses111: posts the ante $0.02
*** HOLE CARDS ***
coolisses111: folds 
pivanki11: folds 
Uncalled bet ($0.05) returned to frazaunch
frazaunch collected $0.16 from pot
*** SUMMARY ***
Total pot $0.16 | Rake $0 
Seat 4: pivanki11 (small blind) folded before Flop
Seat 5: frazaunch (big blind) collected ($0.16)
Seat 6: coolisses111 (button) folded before Flop (didn't bet)



PokerStars Hand #166667496708:  Hold'em No Limit ($0.05/$0.10 USD) - 2017/02/23 16:02:14 ET
Table 'Nerthus II' 6-max Seat #5 is the button
Seat 1: mdelfin0 ($10.33 in chips) 
Seat 2: Hovhannes990 ($8.78 in chips) 
Seat 3: Mamm0nism ($18.82 in chips) 
Seat 4: myevc ($16.28 in chips) 
Seat 5: Hyd SK ($12.70 in chips) 
Seat 6: Lucky HoBBiT ($10 in chips) 
Lucky HoBBiT: posts small blind $0.05
mdelfin0: posts big blind $0.10
*** HOLE CARDS ***
Hovhannes990: folds 
Mamm0nism: folds 
myevc: folds 
Hyd SK: folds 
Lucky HoBBiT: folds 
Uncalled bet ($0.05) returned to mdelfin0
mdelfin0 collected $0.10 from pot
*** SUMMARY ***
Total pot $0.10 | Rake $0 
Seat 1: mdelfin0 (big blind) collected ($0.10)
Seat 2: Hovhannes990 folded before Flop (didn't bet)
Seat 3: Mamm0nism folded before Flop (didn't bet)
Seat 4: myevc folded before Flop (didn't bet)
Seat 5: Hyd SK (button) folded before Flop (didn't bet)
Seat 6: Lucky HoBBiT (small blind) folded before Flop



PokerStars Hand #166667496740:  Hold'em No Limit ($0.05/$0.10 USD) - 2017/02/23 16:02:14 ET
Table 'Nuki' 6-max Seat #6 is the button
Seat 1: bdixon_5 ($7.95 in chips) 
Seat 2: ArcticBearDK ($18.58 in chips) 
Seat 3: david_sara83 ($13.77 in chips) 
Seat 4: GESPERIA ($28.61 in chips) 
Seat 5: fabadam ($11.38 in chips) 
Seat 6: Zooplack ($25.27 in chips) 
bdixon_5: posts small blind $0.05
ArcticBearDK: posts big blind $0.10
*** HOLE CARDS ***
david_sara83: folds 
GESPERIA: folds 
fabadam: folds 
Zooplack: folds 
bdixon_5: folds 
Uncalled bet ($0.05) returned to ArcticBearDK
ArcticBearDK collected $0.10 from pot
*** SUMMARY ***
Total pot $0.10 | Rake $0 
Seat 1: bdixon_5 (small blind) folded before Flop
Seat 2: ArcticBearDK (big blind) collected ($0.10)
Seat 3: david_sara83 folded before Flop (didn't bet)
Seat 4: GESPERIA folded before Flop (didn't bet)
Seat 5: fabadam folded before Flop (didn't bet)
Seat 6: Zooplack (button) folded before Flop (didn't bet)



PokerStars Hand #166667497041:  Hold'em No Limit ($0.05/$0.10 USD) - 2017/02/23 16:02:14 ET
Table 'Rostia' 6-max Seat #2 is the button
Seat 1: paxit71 ($8 in chips) 
Seat 2: david_sara83 ($19.26 in chips) 
Seat 3: ImpAV ($10.20 in chips) 
Seat 4: Hyd SK ($11.68 in chips) 
Seat 5: Buddy8711 ($15.77 in chips) 
Seat 6: Giyorod ($10.85 in chips) 
ImpAV: posts small blind $0.05
Hyd SK: posts big blind $0.10
*** HOLE CARDS ***
Buddy8711: folds 
Buddy8711 leaves the table
Giyorod: folds 
paxit71: calls $0.10
david_sara83: folds 
ImpAV: raises $0.20 to $0.30
Hyd SK: folds 
paxit71: calls $0.20
*** FLOP *** [6c 8d Qc]
ImpAV: checks 
paxit71: checks 
*** TURN *** [6c 8d Qc] [3s]
ImpAV: checks 
silsilviu joins the table at seat #5 
paxit71: checks 
*** RIVER *** [6c 8d Qc 3s] [5c]
ImpAV: bets $1
paxit71: folds 
Uncalled bet ($1) returned to ImpAV
ImpAV collected $0.67 from pot
*** SUMMARY ***
Total pot $0.70 | Rake $0.03 
Board [6c 8d Qc 3s 5c]
Seat 1: paxit71 folded on the River
Seat 2: david_sara83 (button) folded before Flop (didn't bet)
Seat 3: ImpAV (small blind) collected ($0.67)
Seat 4: Hyd SK (big blind) folded before Flop
Seat 5: Buddy8711 folded before Flop (didn't bet)
Seat 6: Giyorod folded before Flop (didn't bet)



PokerStars Hand #166667497093:  Hold'em No Limit ($0.05/$0.10 USD) - 2017/02/23 16:02:14 ET
Table 'Caprera III' 6-max Seat #5 is the button
Seat 1: Vrinni ($10 in chips) 
Seat 2: hg123454321 ($8.70 in chips) 
Seat 3: Darkfrai ($10 in chips) 
Seat 4: oddshoff ($9 in chips) 
Seat 5: fedorka rus ($50.58 in chips) 
Seat 6: GESPERIA ($18.68 in chips) 
GESPERIA: posts small blind $0.05
Vrinni: posts big blind $0.10
*** HOLE CARDS ***
hg123454321: folds 
Darkfrai: folds 
oddshoff: folds 
fedorka rus: folds 
GESPERIA: raises $0.20 to $0.30
Vrinni: raises $0.66 to $0.96
GESPERIA: folds 
Uncalled bet ($0.66) returned to Vrinni
Vrinni collected $0.60 from pot
*** SUMMARY ***
Total pot $0.60 | Rake $0 
Seat 1: Vrinni (big blind) collected ($0.60)
Seat 2: hg123454321 folded before Flop (didn't bet)
Seat 3: Darkfrai folded before Flop (didn't bet)
Seat 4: oddshoff folded before Flop (didn't bet)
Seat 5: fedorka rus (button) folded before Flop (didn't bet)
Seat 6: GESPERIA (small blind) folded before Flop



PokerStars Hand #166667497291:  Hold'em No Limit ($0.05/$0.10 USD) - 2017/02/23 16:02:14 ET
Table 'Gaika II' 6-max Seat #3 is the button
Seat 1: Ice_Isayev ($10 in chips) 
Seat 2: steepfell ($10.32 in chips) 
Seat 3: iDecMate ($16.30 in chips) 
Seat 4: Hyd SK ($11.72 in chips) 
Seat 5: KokoulinV ($15.80 in chips) 
Seat 6: bartabs2 ($8.75 in chips) 
Hyd SK: posts small blind $0.05
KokoulinV: posts big blind $0.10
*** HOLE CARDS ***
bartabs2: folds 
Ice_Isayev: folds 
steepfell: folds 
iDecMate: raises $0.15 to $0.25
Hyd SK: folds 
KokoulinV: calls $0.15
*** FLOP *** [8d 8c 7h]
KokoulinV: checks 
iDecMate: bets $0.35
KokoulinV: calls $0.35
*** TURN *** [8d 8c 7h] [9d]
KokoulinV: checks 
iDecMate: bets $0.79
KokoulinV: calls $0.79
*** RIVER *** [8d 8c 7h 9d] [Ac]
KokoulinV: checks 
iDecMate: bets $1.80
KokoulinV: calls $1.80
*** SHOW DOWN ***
iDecMate: shows [9s 9h] (a full house, Nines full of Eights)
KokoulinV: mucks hand 
iDecMate collected $6.14 from pot
*** SUMMARY ***
Total pot $6.43 | Rake $0.29 
Board [8d 8c 7h 9d Ac]
Seat 1: Ice_Isayev folded before Flop (didn't bet)
Seat 2: steepfell folded before Flop (didn't bet)
Seat 3: iDecMate (button) showed [9s 9h] and won ($6.14) with a full house, Nines full of Eights
Seat 4: Hyd SK (small blind) folded before Flop
Seat 5: KokoulinV (big blind) mucked
Seat 6: bartabs2 folded before Flop (didn't bet)



PokerStars Hand #166667497369:  Hold'em No Limit ($0.05/$0.10 USD) - 2017/02/23 16:02:15 ET
Table 'Carina' 6-max Seat #6 is the button
Seat 2: kickereens ($24.14 in chips) 
Seat 3: LarryTheStar ($10 in chips) 
Seat 4: crazydevill ($10.15 in chips) 
Seat 6: alexweezer ($9.95 in chips) 
kickereens: posts small blind $0.05
LarryTheStar: posts big blind $0.10
Kupi007 joins the table at seat #1 
IAntikI: sits out 
*** HOLE CARDS ***
crazydevill: folds 
alexweezer: folds 
kickereens: raises $0.20 to $0.30
LarryTheStar: folds 
Uncalled bet ($0.20) returned to kickereens
kickereens collected $0.20 from pot
*** SUMMARY ***
Total pot $0.20 | Rake $0 
Seat 2: kickereens (small blind) collected ($0.20)
Seat 3: LarryTheStar (big blind) folded before Flop
Seat 4: crazydevill folded before Flop (didn't bet)
Seat 6: alexweezer (button) folded before Flop (didn't bet)



PokerStars Hand #166667497410:  Hold'em No Limit ($0.05/$0.10 USD) - 2017/02/23 16:02:15 ET
Table 'Lacroute' 6-max Seat #3 is the button
Seat 1: johnnyPieper ($9.12 in chips) 
Seat 2: Andy Wolf ($10 in chips) 
Seat 3: Croplayer1 ($11.79 in chips) 
Seat 4: st4tion ($15.96 in chips) 
Seat 5: steepfell ($11.12 in chips) 
Seat 6: IAntikI ($10 in chips) 
st4tion: posts small blind $0.05
steepfell: posts big blind $0.10
*** HOLE CARDS ***
IAntikI: folds 
johnnyPieper: calls $0.10
Andy Wolf: folds 
Croplayer1: raises $0.30 to $0.40
st4tion: folds 
steepfell: folds 
johnnyPieper: calls $0.30
*** FLOP *** [6s Qc 4d]
johnnyPieper: bets $0.40
Croplayer1: raises $0.86 to $1.26
johnnyPieper: calls $0.86
*** TURN *** [6s Qc 4d] [Kd]
johnnyPieper: bets $1.60
Croplayer1: raises $8.53 to $10.13 and is all-in
johnnyPieper: folds 
Uncalled bet ($8.53) returned to Croplayer1
Croplayer1 collected $6.37 from pot
*** SUMMARY ***
Total pot $6.67 | Rake $0.30 
Board [6s Qc 4d Kd]
Seat 1: johnnyPieper folded on the Turn
Seat 2: Andy Wolf folded before Flop (didn't bet)
Seat 3: Croplayer1 (button) collected ($6.37)
Seat 4: st4tion (small blind) folded before Flop
Seat 5: steepfell (big blind) folded before Flop
Seat 6: IAntikI folded before Flop (didn't bet)



PokerStars Hand #166667497558:  Hold'em No Limit ($0.05/$0.10 USD) - 2017/02/23 16:02:15 ET
Table 'California II' 6-max Seat #5 is the button
Seat 1: fedorka rus ($10.23 in chips) 
Seat 2: homelessdan ($10.15 in chips) 
Seat 3: Bird et al ($10.35 in chips) 
Seat 5: bambolejro ($15.02 in chips) 
Seat 6: chiko4040 ($8.71 in chips) 
chiko4040: posts small blind $0.05
fedorka rus: posts big blind $0.10
pokekrk: sits out 
*** HOLE CARDS ***
homelessdan: folds 
Bird et al: folds 
bambolejro: folds 
chiko4040: folds 
Uncalled bet ($0.05) returned to fedorka rus
fedorka rus collected $0.10 from pot
*** SUMMARY ***
Total pot $0.10 | Rake $0 
Seat 1: fedorka rus (big blind) collected ($0.10)
Seat 2: homelessdan folded before Flop (didn't bet)
Seat 3: Bird et al folded before Flop (didn't bet)
Seat 5: bambolejro (button) folded before Flop (didn't bet)
Seat 6: chiko4040 (small blind) folded before Flop



PokerStars Hand #166667497811:  Hold'em No Limit ($0.05/$0.10 USD) - 2017/02/23 16:02:15 ET
Table 'Brendelia II' 6-max Seat #3 is the button
Seat 2: Crimsonr ($5.72 in chips) 
Seat 3: ValdemorS ($17.79 in chips) 
Seat 6: luckyPositiv ($10.79 in chips) 
luckyPositiv: posts small blind $0.05
Crimsonr: posts big blind $0.10
Crimsonr: posts the ante $0.02
ValdemorS: posts the ante $0.02
luckyPositiv: posts the ante $0.02
*** HOLE CARDS ***
ValdemorS: folds 
luckyPositiv: raises $0.20 to $0.30
Crimsonr: calls $0.20
*** FLOP *** [Th 4d 7h]
luckyPositiv: checks 
Crimsonr: bets $0.70
luckyPositiv: folds 
Uncalled bet ($0.70) returned to Crimsonr
Crimsonr collected $0.63 from pot
*** SUMMARY ***
Total pot $0.66 | Rake $0.03 
Board [Th 4d 7h]
Seat 2: Crimsonr (big blind) collected ($0.63)
Seat 3: ValdemorS (button) folded before Flop (didn't bet)
Seat 6: luckyPositiv (small blind) folded on the Flop



PokerStars Hand #166667497834:  Hold'em No Limit ($0.05/$0.10 USD) - 2017/02/23 16:02:15 ET
Table 'Walpurga' 6-max Seat #1 is the button
Seat 1: chimera252 ($12.22 in chips) 
Seat 2: paxit71 ($6.94 in chips) 
Seat 3: Innerwuss ($19.24 in chips) 
Seat 4: oddshoff ($12.79 in chips) 
paxit71: posts small blind $0.05
Innerwuss: posts big blind $0.10
AIONCMA1988: sits out 
*** HOLE CARDS ***
oddshoff: folds 
chimera252: folds 
paxit71: calls $0.05
Innerwuss: checks 
*** FLOP *** [Ks 2d 4h]
paxit71: checks 
Innerwuss: checks 
*** TURN *** [Ks 2d 4h] [Qd]
paxit71: checks 
Innerwuss: checks 
*** RIVER *** [Ks 2d 4h Qd] [Js]
paxit71: checks 
Innerwuss: checks 
*** SHOW DOWN ***
paxit71: shows [5s Tc] (high card King)
Innerwuss: shows [Kh 7d] (a pair of Kings)
Innerwuss collected $0.19 from pot
*** SUMMARY ***
Total pot $0.20 | Rake $0.01 
Board [Ks 2d 4h Qd Js]
Seat 1: chimera252 (button) folded before Flop (didn't bet)
Seat 2: paxit71 (small blind) showed [5s Tc] and lost with high card King
Seat 3: Innerwuss (big blind) showed [Kh 7d] and won ($0.19) with a pair of Kings
Seat 4: oddshoff folded before Flop (didn't bet)



PokerStars Hand #166667497892:  Hold'em No Limit ($0.05/$0.10 USD) - 2017/02/23 16:02:15 ET
Table 'Nehalennia III' 6-max Seat #3 is the button
Seat 1: boxer821 ($13.22 in chips) 
Seat 2: fortieth ($9.79 in chips) 
Seat 3: ValdemorS ($17.95 in chips) 
Seat 4: eniksenik ($10 in chips) 
Seat 5: wulffboy ($35.23 in chips) 
Seat 6: valzeny ($20.59 in chips) 
eniksenik: posts small blind $0.05
wulffboy: posts big blind $0.10
boxer821: posts the ante $0.02
fortieth: posts the ante $0.02
ValdemorS: posts the ante $0.02
eniksenik: posts the ante $0.02
wulffboy: posts the ante $0.02
valzeny: posts the ante $0.02
*** HOLE CARDS ***
valzeny: folds 
boxer821: folds 
fortieth: folds 
ValdemorS: folds 
eniksenik: raises $0.20 to $0.30
wulffboy: calls $0.20
*** FLOP *** [6s 6d 6h]
eniksenik: checks 
wulffboy: bets $0.60
eniksenik: folds 
Uncalled bet ($0.60) returned to wulffboy
wulffboy collected $0.69 from pot
*** SUMMARY ***
Total pot $0.72 | Rake $0.03 
Board [6s 6d 6h]
Seat 1: boxer821 folded before Flop (didn't bet)
Seat 2: fortieth folded before Flop (didn't bet)
Seat 3: ValdemorS (button) folded before Flop (didn't bet)
Seat 4: eniksenik (small blind) folded on the Flop
Seat 5: wulffboy (big blind) collected ($0.69)
Seat 6: valzeny folded before Flop (didn't bet)



PokerStars Hand #166667498219:  Hold'em No Limit ($0.05/$0.10 USD) - 2017/02/23 16:02:16 ET
Table 'Pallas II' 6-max Seat #2 is the button
Seat 1: mdelfin0 ($15.88 in chips) 
Seat 2: FRAID358 ($9.80 in chips) 
Seat 4: Mr. Bluff 34 ($11.17 in chips) 
Seat 5: Yspenyanin ($19.71 in chips) 
Seat 6: xdjango07x ($12.38 in chips) 
KRZuff will be allowed to play after the button
Mr. Bluff 34: posts small blind $0.05
Yspenyanin: posts big blind $0.10
*** HOLE CARDS ***
xdjango07x: folds 
mdelfin0: folds 
FRAID358: raises $0.20 to $0.30
Mr. Bluff 34: folds 
Yspenyanin: folds 
Uncalled bet ($0.20) returned to FRAID358
FRAID358 collected $0.25 from pot
*** SUMMARY ***
Total pot $0.25 | Rake $0 
Seat 1: mdelfin0 folded before Flop (didn't bet)
Seat 2: FRAID358 (button) collected ($0.25)
Seat 4: Mr. Bluff 34 (small blind) folded before Flop
Seat 5: Yspenyanin (big blind) folded before Flop
Seat 6: xdjango07x folded before Flop (didn't bet)



PokerStars Hand #166667498282:  Hold'em No Limit ($0.05/$0.10 USD) - 2017/02/23 16:02:16 ET
Table 'Vaisala' 6-max Seat #3 is the button
Seat 1: Pekaml ($10.15 in chips) 
Seat 2: XaXaTyH4uK ($10.10 in chips) 
Seat 3: x3ultimate ($10 in chips) 
Seat 4: sexy_seagull ($11.16 in chips) 
Seat 5: AIONCMA1988 ($5 in chips) 
Seat 6: Aleksey K228 ($15.73 in chips) 
sexy_seagull: posts small blind $0.05
AIONCMA1988: posts big blind $0.10
*** HOLE CARDS ***
Aleksey K228: raises $0.20 to $0.30
Pekaml: folds 
XaXaTyH4uK: folds 
x3ultimate: folds 
sexy_seagull: calls $0.25
AIONCMA1988: folds 
*** FLOP *** [4s Tc 7h]
sexy_seagull: checks 
Aleksey K228: checks 
*** TURN *** [4s Tc 7h] [Td]
sexy_seagull: bets $0.46
Aleksey K228: folds 
Uncalled bet ($0.46) returned to sexy_seagull
sexy_seagull collected $0.67 from pot
*** SUMMARY ***
Total pot $0.70 | Rake $0.03 
Board [4s Tc 7h Td]
Seat 1: Pekaml folded before Flop (didn't bet)
Seat 2: XaXaTyH4uK folded before Flop (didn't bet)
Seat 3: x3ultimate (button) folded before Flop (didn't bet)
Seat 4: sexy_seagull (small blind) collected ($0.67)
Seat 5: AIONCMA1988 (big blind) folded before Flop
Seat 6: Aleksey K228 folded on the Turn



PokerStars Hand #166667498358:  Hold'em No Limit ($0.05/$0.10 USD) - 2017/02/23 16:02:16 ET
Table 'Themisto II' 6-max Seat #6 is the button
Seat 1: kickereens ($13.36 in chips) 
Seat 2: CA225 ($8.77 in chips) 
Seat 3: eniksenik ($11.21 in chips) 
Seat 4: Innerwuss ($11.19 in chips) 
Seat 5: ex3Lero86 ($10.94 in chips) 
Seat 6: noobigrok ($4 in chips) 
kickereens: posts small blind $0.05
CA225: posts big blind $0.10
*** HOLE CARDS ***
eniksenik: folds 
Innerwuss: folds 
ex3Lero86: folds 
noobigrok: folds 
kickereens: raises $0.20 to $0.30
CA225: calls $0.20
*** FLOP *** [6c Qc 5s]
kickereens: bets $0.30
CA225: calls $0.30
*** TURN *** [6c Qc 5s] [3s]
kickereens: checks 
CA225: checks 
*** RIVER *** [6c Qc 5s 3s] [9h]
kickereens: checks 
CA225: bets $0.60
kickereens: calls $0.60
*** SHOW DOWN ***
CA225: shows [9d 6h] (two pair, Nines and Sixes)
kickereens: mucks hand 
CA225 collected $2.29 from pot
*** SUMMARY ***
Total pot $2.40 | Rake $0.11 
Board [6c Qc 5s 3s 9h]
Seat 1: kickereens (small blind) mucked
Seat 2: CA225 (big blind) showed [9d 6h] and won ($2.29) with two pair, Nines and Sixes
Seat 3: eniksenik folded before Flop (didn't bet)
Seat 4: Innerwuss folded before Flop (didn't bet)
Seat 5: ex3Lero86 folded before Flop (didn't bet)
Seat 6: noobigrok (button) folded before Flop (didn't bet)



PokerStars Hand #166667498667:  Hold'em No Limit ($0.05/$0.10 USD) - 2017/02/23 16:02:16 ET
Table 'Lobelia II' 6-max Seat #1 is the button
Seat 1: facewald ($28.95 in chips) 
Seat 2: Dcaro31 ($18.19 in chips) 
Seat 3: oddshoff ($11.69 in chips) 
Seat 5: Feverhead ($20.43 in chips) 
Seat 6: NvR.m1nD ($10 in chips) 
Dcaro31: posts small blind $0.05
oddshoff: posts big blind $0.10
*** HOLE CARDS ***
Feverhead: folds 
NvR.m1nD: folds 
facewald: raises $0.19 to $0.29
Dcaro31: folds 
oddshoff: raises $0.51 to $0.80
facewald: calls $0.51
*** FLOP *** [7s 9s Jd]
oddshoff: bets $1.05
facewald: calls $1.05
*** TURN *** [7s 9s Jd] [8d]
oddshoff: bets $2.39
facewald: calls $2.39
*** RIVER *** [7s 9s Jd 8d] [5s]
oddshoff: bets $4.07
facewald: calls $4.07
*** SHOW DOWN ***
oddshoff: shows [Ts Ad] (a straight, Seven to Jack)
facewald: mucks hand 
oddshoff collected $15.92 from pot
*** SUMMARY ***
Total pot $16.67 | Rake $0.75 
Board [7s 9s Jd 8d 5s]
Seat 1: facewald (button) mucked
Seat 2: Dcaro31 (small blind) folded before Flop
Seat 3: oddshoff (big blind) showed [Ts Ad] and won ($15.92) with a straight, Seven to Jack
Seat 5: Feverhead folded before Flop (didn't bet)
Seat 6: NvR.m1nD folded before Flop (didn't bet)



PokerStars Hand #166667498705:  Hold'em No Limit ($0.05/$0.10 USD) - 2017/02/23 16:02:16 ET
Table 'Lampetia III' 6-max Seat #5 is the button
Seat 1: gaHy_HaXeP ($10.30 in chips) 
Seat 2: DamDatsAnAce ($10.10 in chips) 
Seat 3: Therodorus ($10.30 in chips) 
Seat 4: IAntikI ($10.91 in chips) 
Seat 5: robson1235 ($19.55 in chips) 
Seat 6: bdixon_5 ($9.40 in chips) 
bdixon_5: posts small blind $0.05
gaHy_HaXeP: posts big blind $0.10
*** HOLE CARDS ***
DamDatsAnAce: folds 
Therodorus: raises $0.20 to $0.30
IAntikI: raises $0.60 to $0.90
robson1235: folds 
bdixon_5: folds 
gaHy_HaXeP: folds 
Therodorus: folds 
Uncalled bet ($0.60) returned to IAntikI
IAntikI collected $0.75 from pot
*** SUMMARY ***
Total pot $0.75 | Rake $0 
Seat 1: gaHy_HaXeP (big blind) folded before Flop
Seat 2: DamDatsAnAce folded before Flop (didn't bet)
Seat 3: Therodorus folded before Flop
Seat 4: IAntikI collected ($0.75)
Seat 5: robson1235 (button) folded before Flop (didn't bet)
Seat 6: bdixon_5 (small blind) folded before Flop



PokerStars Hand #166667498859:  Hold'em No Limit ($0.05/$0.10 USD) - 2017/02/23 16:02:16 ET
Table 'Pandora III' 6-max Seat #3 is the button
Seat 1: Pokeaster ($10.99 in chips) 
Seat 2: garigura ($11.77 in chips) 
Seat 3: ChuikaPridi ($16.78 in chips) 
Seat 4: mhonielsen ($10 in chips) 
Seat 5: MühliJr ($10.15 in chips) 
mhonielsen: posts small blind $0.05
MühliJr: posts big blind $0.10
yodzik: sits out 
*** HOLE CARDS ***
Pokeaster: folds 
garigura: folds 
ChuikaPridi: folds 
mhonielsen: folds 
Uncalled bet ($0.05) returned to MühliJr
MühliJr collected $0.10 from pot
*** SUMMARY ***
Total pot $0.10 | Rake $0 
Seat 1: Pokeaster folded before Flop (didn't bet)
Seat 2: garigura folded before Flop (didn't bet)
Seat 3: ChuikaPridi (button) folded before Flop (didn't bet)
Seat 4: mhonielsen (small blind) folded before Flop
Seat 5: MühliJr (big blind) collected ($0.10)



PokerStars Hand #166667499216:  Hold'em No Limit ($0.05/$0.10 USD) - 2017/02/23 16:02:16 ET
Table 'Cyane' 6-max Seat #3 is the button
Seat 1: KA3AXCTAHEU, ($10.32 in chips) 
Seat 2: Temniy Elf ($10.15 in chips) 
Seat 3: Mamm0nism ($13.94 in chips) 
Seat 4: truck1234 ($21.01 in chips) 
Seat 5: ChuikaPridi ($10.32 in chips) 
Seat 6: 8th wonders ($10.15 in chips) 
truck1234: posts small blind $0.05
ChuikaPridi: posts big blind $0.10
*** HOLE CARDS ***
8th wonders: raises $0.10 to $0.20
KA3AXCTAHEU,: folds 
Temniy Elf: folds 
Mamm0nism: folds 
truck1234: folds 
ChuikaPridi: folds 
Uncalled bet ($0.10) returned to 8th wonders
8th wonders collected $0.25 from pot
*** SUMMARY ***
Total pot $0.25 | Rake $0 
Seat 1: KA3AXCTAHEU, folded before Flop (didn't bet)
Seat 2: Temniy Elf folded before Flop (didn't bet)
Seat 3: Mamm0nism (button) folded before Flop (didn't bet)
Seat 4: truck1234 (small blind) folded before Flop
Seat 5: ChuikaPridi (big blind) folded before Flop
Seat 6: 8th wonders collected ($0.25)



PokerStars Hand #166667499781:  Hold'em No Limit ($0.05/$0.10 USD) - 2017/02/23 16:02:17 ET
Table 'Clavel' 6-max Seat #4 is the button
Seat 1: KRZuff ($14.73 in chips) 
Seat 2: RoJ1 ($12.37 in chips) 
Seat 4: Dcaro31 ($11.81 in chips) 
Seat 5: Vrinni ($10.44 in chips) 
Seat 6: Gra_anD77 ($4.01 in chips) 
Vrinni: posts small blind $0.05
Gra_anD77: posts big blind $0.10
*** HOLE CARDS ***
KRZuff: raises $0.20 to $0.30
RoJ1: folds 
Dcaro31: folds 
Vrinni: folds 
Gra_anD77: calls $0.20
*** FLOP *** [Qs Kd Kc]
Gra_anD77: bets $0.31
KRZuff: calls $0.31
*** TURN *** [Qs Kd Kc] [Ad]
Gra_anD77: bets $0.61
KRZuff: folds 
Uncalled bet ($0.61) returned to Gra_anD77
Gra_anD77 collected $1.21 from pot
*** SUMMARY ***
Total pot $1.27 | Rake $0.06 
Board [Qs Kd Kc Ad]
Seat 1: KRZuff folded on the Turn
Seat 2: RoJ1 folded before Flop (didn't bet)
Seat 4: Dcaro31 (button) folded before Flop (didn't bet)
Seat 5: Vrinni (small blind) folded before Flop
Seat 6: Gra_anD77 (big blind) collected ($1.21)



PokerStars Hand #166667500248:  Hold'em No Limit ($0.05/$0.10 USD) - 2017/02/23 16:02:17 ET
Table 'Siebohme' 6-max Seat #6 is the button
Seat 1: kusa4ki ($11.43 in chips) 
Seat 2: el toro 1507 ($11.68 in chips) 
Seat 3: ex3Lero86 ($10.15 in chips) 
Seat 4: Innerwuss ($10.09 in chips) 
Seat 5: Kazacha ($10.10 in chips) 
Seat 6: townerz1991 ($10.53 in chips) 
kusa4ki: posts small blind $0.05
el toro 1507: posts big blind $0.10
*** HOLE CARDS ***
ex3Lero86: folds 
Innerwuss: folds 
Kazacha: folds 
townerz1991: folds 
kusa4ki: folds 
Uncalled bet ($0.05) returned to el toro 1507
el toro 1507 collected $0.10 from pot
*** SUMMARY ***
Total pot $0.10 | Rake $0 
Seat 1: kusa4ki (small blind) folded before Flop
Seat 2: el toro 1507 (big blind) collected ($0.10)
Seat 3: ex3Lero86 folded before Flop (didn't bet)
Seat 4: Innerwuss folded before Flop (didn't bet)
Seat 5: Kazacha folded before Flop (didn't bet)
Seat 6: townerz1991 (button) folded before Flop (didn't bet)



PokerStars Hand #166667500636:  Hold'em No Limit ($0.05/$0.10 USD) - 2017/02/23 16:02:18 ET
Table 'Ostara III' 6-max Seat #1 is the button
Seat 1: MühliJr ($10.47 in chips) 
Seat 2: Action_Gibi ($7.64 in chips) 
Seat 3: vtalian ($10.11 in chips) 
Seat 5: dzesio18 ($12.45 in chips) 
Seat 6: FlopsterGB ($11.90 in chips) 
Action_Gibi: posts small blind $0.05
vtalian: posts big blind $0.10
*** HOLE CARDS ***
dzesio18: folds 
FlopsterGB: folds 
MühliJr: raises $0.15 to $0.25
Action_Gibi: calls $0.20
vtalian: folds 
*** FLOP *** [2s Qd 9d]
Action_Gibi: checks 
MühliJr: bets $0.33
Action_Gibi: calls $0.33
*** TURN *** [2s Qd 9d] [8c]
Action_Gibi: bets $0.50
MühliJr: calls $0.50
*** RIVER *** [2s Qd 9d 8c] [Js]
Action_Gibi: checks 
MühliJr: bets $1.45
Action_Gibi: calls $1.45
*** SHOW DOWN ***
MühliJr: shows [6d 4d] (high card Queen)
Action_Gibi: shows [Ad Qc] (a pair of Queens)
Action_Gibi collected $4.93 from pot
*** SUMMARY ***
Total pot $5.16 | Rake $0.23 
Board [2s Qd 9d 8c Js]
Seat 1: MühliJr (button) showed [6d 4d] and lost with high card Queen
Seat 2: Action_Gibi (small blind) showed [Ad Qc] and won ($4.93) with a pair of Queens
Seat 3: vtalian (big blind) folded before Flop
Seat 5: dzesio18 folded before Flop (didn't bet)
Seat 6: FlopsterGB folded before Flop (didn't bet)



PokerStars Hand #166667501141:  Hold'em No Limit ($0.05/$0.10 USD) - 2017/02/23 16:02:18 ET
Table 'Caupolican II' 6-max Seat #1 is the button
Seat 1: Strelok1974 ($10 in chips) 
Seat 2: MBen10 ($19.70 in chips) 
Seat 3: fedorka rus ($12.53 in chips) 
Seat 4: GESPERIA ($22.77 in chips) 
Seat 5: ArcticBearDK ($14.44 in chips) 
Seat 6: pancernik21 ($14.07 in chips) 
MBen10: posts small blind $0.05
fedorka rus: posts big blind $0.10
*** HOLE CARDS ***
GESPERIA: folds 
ArcticBearDK: folds 
pancernik21: raises $0.20 to $0.30
Strelok1974: folds 
MBen10: folds 
fedorka rus: calls $0.20
*** FLOP *** [6d Tc 7s]
fedorka rus: checks 
pancernik21: bets $0.47
fedorka rus: calls $0.47
*** TURN *** [6d Tc 7s] [2c]
fedorka rus: checks 
pancernik21: checks 
*** RIVER *** [6d Tc 7s 2c] [4c]
fedorka rus: checks 
pancernik21: checks 
*** SHOW DOWN ***
fedorka rus: shows [Kc Th] (a pair of Tens)
pancernik21: mucks hand 
fedorka rus collected $1.52 from pot
*** SUMMARY ***
Total pot $1.59 | Rake $0.07 
Board [6d Tc 7s 2c 4c]
Seat 1: Strelok1974 (button) folded before Flop (didn't bet)
Seat 2: MBen10 (small blind) folded before Flop
Seat 3: fedorka rus (big blind) showed [Kc Th] and won ($1.52) with a pair of Tens
Seat 4: GESPERIA folded before Flop (didn't bet)
Seat 5: ArcticBearDK folded before Flop (didn't bet)
Seat 6: pancernik21 mucked



PokerStars Hand #166667501274:  Hold'em No Limit ($0.05/$0.10 USD) - 2017/02/23 16:02:18 ET
Table 'Serpens' 6-max Seat #4 is the button
Seat 1: Namhkal ($10.45 in chips) 
Seat 2: KA3AXCTAHEU, ($10.15 in chips) 
Seat 3: homelessdan ($28.35 in chips) 
Seat 4: Ragazzi3 ($17.49 in chips) 
Seat 5: XwinX25 ($11.71 in chips) 
Seat 6: Croplayer1 ($10 in chips) 
XwinX25: posts small blind $0.05
Croplayer1: posts big blind $0.10
*** HOLE CARDS ***
Namhkal: folds 
KA3AXCTAHEU,: folds 
homelessdan: folds 
Ragazzi3: folds 
XwinX25: raises $0.15 to $0.25
Croplayer1: folds 
Uncalled bet ($0.15) returned to XwinX25
XwinX25 collected $0.20 from pot
*** SUMMARY ***
Total pot $0.20 | Rake $0 
Seat 1: Namhkal folded before Flop (didn't bet)
Seat 2: KA3AXCTAHEU, folded before Flop (didn't bet)
Seat 3: homelessdan folded before Flop (didn't bet)
Seat 4: Ragazzi3 (button) folded before Flop (didn't bet)
Seat 5: XwinX25 (small blind) collected ($0.20)
Seat 6: Croplayer1 (big blind) folded before Flop



PokerStars Hand #166667501492:  Hold'em No Limit ($0.05/$0.10 USD) - 2017/02/23 16:02:19 ET
Table 'Nymphe II' 6-max Seat #4 is the button
Seat 1: jacktayra ($3.47 in chips) 
Seat 2: Newqbrown ($10.15 in chips) 
Seat 3: THIMUCHIN ($14.05 in chips) 
Seat 4: coolisses111 ($19.55 in chips) 
Seat 5: Yspenyanin ($10.99 in chips) 
Seat 6: Xander188 ($18.23 in chips) 
Yspenyanin: posts small blind $0.05
Xander188: posts big blind $0.10
*** HOLE CARDS ***
jacktayra: calls $0.10
Newqbrown: folds 
THIMUCHIN: folds 
coolisses111: raises $0.30 to $0.40
Yspenyanin: folds 
Xander188: folds 
jacktayra: calls $0.30
*** FLOP *** [3s Jh 2s]
jacktayra: checks 
coolisses111: bets $0.70
jacktayra: calls $0.70
*** TURN *** [3s Jh 2s] [7h]
jacktayra: checks 
coolisses111: checks 
*** RIVER *** [3s Jh 2s 7h] [6d]
jacktayra: checks 
coolisses111: checks 
*** SHOW DOWN ***
jacktayra: shows [2h 3h] (two pair, Threes and Deuces)
coolisses111: mucks hand 
jacktayra collected $2.24 from pot
*** SUMMARY ***
Total pot $2.35 | Rake $0.11 
Board [3s Jh 2s 7h 6d]
Seat 1: jacktayra showed [2h 3h] and won ($2.24) with two pair, Threes and Deuces
Seat 2: Newqbrown folded before Flop (didn't bet)
Seat 3: THIMUCHIN folded before Flop (didn't bet)
Seat 4: coolisses111 (button) mucked
Seat 5: Yspenyanin (small blind) folded before Flop
Seat 6: Xander188 (big blind) folded before Flop



PokerStars Hand #166667501845:  Hold'em No Limit ($0.05/$0.10 USD) - 2017/02/23 16:02:19 ET
Table 'Wilkens II' 6-max Seat #5 is the button
Seat 1: Islamiq-GuRL ($12.30 in chips) 
Seat 2: manashov ($10.30 in chips) 
Seat 3: Namhkal ($10.80 in chips) 
Seat 4: myevc ($10 in chips) 
Seat 5: patrick19111 ($10 in chips) 
Seat 6: XaXaTyH4uK ($14.66 in chips) 
XaXaTyH4uK: posts small blind $0.05
Islamiq-GuRL: posts big blind $0.10
*** HOLE CARDS ***
manashov: raises $0.20 to $0.30
Namhkal: folds 
myevc: folds 
patrick19111: folds 
XaXaTyH4uK: folds 
Islamiq-GuRL: folds 
Uncalled bet ($0.20) returned to manashov
manashov collected $0.25 from pot
*** SUMMARY ***
Total pot $0.25 | Rake $0 
Seat 1: Islamiq-GuRL (big blind) folded before Flop
Seat 2: manashov collected ($0.25)
Seat 3: Namhkal folded before Flop (didn't bet)
Seat 4: myevc folded before Flop (didn't bet)
Seat 5: patrick19111 (button) folded before Flop (didn't bet)
Seat 6: XaXaTyH4uK (small blind) folded before Flop



PokerStars Hand #166667502046:  Hold'em No Limit ($0.05/$0.10 USD) - 2017/02/23 16:02:19 ET
Table 'Gaika' 6-max Seat #5 is the button
Seat 1: oddshoff ($12.56 in chips) 
Seat 2: NvR.m1nD ($18.22 in chips) 
Seat 3: david_sara83 ($10.32 in chips) 
Seat 4: fortieth ($11.50 in chips) 
Seat 5: fedorka rus ($10.50 in chips) 
Seat 6: dr.goofy ($11.05 in chips) 
dr.goofy: posts small blind $0.05
oddshoff: posts big blind $0.10
*** HOLE CARDS ***
NvR.m1nD: folds 
david_sara83: folds 
fortieth: folds 
fedorka rus: raises $0.20 to $0.30
dr.goofy: folds 
oddshoff: folds 
Uncalled bet ($0.20) returned to fedorka rus
fedorka rus collected $0.25 from pot
*** SUMMARY ***
Total pot $0.25 | Rake $0 
Seat 1: oddshoff (big blind) folded before Flop
Seat 2: NvR.m1nD folded before Flop (didn't bet)
Seat 3: david_sara83 folded before Flop (didn't bet)
Seat 4: fortieth folded before Flop (didn't bet)
Seat 5: fedorka rus (button) collected ($0.25)
Seat 6: dr.goofy (small blind) folded before Flop



PokerStars Hand #166667502086:  Hold'em No Limit ($0.05/$0.10 USD) - 2017/02/23 16:02:19 ET
Table 'Marbachia II' 6-max Seat #1 is the button
Seat 1: AC Evergreen ($10 in chips) 
Seat 2: Yabidooo ($10.30 in chips) 
Seat 4: BahiaMinhaP ($10 in chips) 
Seat 5: Kow6oy ($10 in chips) 
Seat 6: DamDatsAnAce ($10 in chips) 
Yabidooo: posts small blind $0.05
BahiaMinhaP: posts big blind $0.10
*** HOLE CARDS ***
MisterX413 joins the table at seat #3 
Kow6oy: folds 
Kow6oy leaves the table
DamDatsAnAce: folds 
AC Evergreen: folds 
MihaGr joins the table at seat #5 
Yabidooo: calls $0.05
BahiaMinhaP: raises $0.25 to $0.35
Yabidooo: calls $0.25
*** FLOP *** [Td Ah Ac]
Yabidooo: checks 
BahiaMinhaP: checks 
*** TURN *** [Td Ah Ac] [3d]
Yabidooo: bets $0.34
BahiaMinhaP: calls $0.34
*** RIVER *** [Td Ah Ac 3d] [3c]
Yabidooo: bets $0.50
BahiaMinhaP: folds 
Uncalled bet ($0.50) returned to Yabidooo
Yabidooo collected $1.32 from pot
*** SUMMARY ***
Total pot $1.38 | Rake $0.06 
Board [Td Ah Ac 3d 3c]
Seat 1: AC Evergreen (button) folded before Flop (didn't bet)
Seat 2: Yabidooo (small blind) collected ($1.32)
Seat 4: BahiaMinhaP (big blind) folded on the River
Seat 5: Kow6oy folded before Flop (didn't bet)
Seat 6: DamDatsAnAce folded before Flop (didn't bet)



PokerStars Hand #166667502210:  Hold'em No Limit ($0.05/$0.10 USD) - 2017/02/23 16:02:19 ET
Table 'Lagrula' 6-max Seat #6 is the button
Seat 1: Ice_Isayev ($10 in chips) 
Seat 3: micke667 ($16.28 in chips) 
Seat 4: Calimero2408 ($4.67 in chips) 
Seat 5: Iarlei ($10 in chips) 
Seat 6: Spud014 ($10.95 in chips) 
Ice_Isayev: posts small blind $0.05
jamalungma: is sitting out 
jamalungma leaves the table
micke667: posts big blind $0.10
*** HOLE CARDS ***
KRZuff joins the table at seat #2 
Calimero2408: calls $0.10
Iarlei: calls $0.10
Spud014: folds 
Ice_Isayev: folds 
micke667: checks 
*** FLOP *** [Jd 4h 8d]
micke667: bets $0.10
Calimero2408: calls $0.10
Iarlei: raises $0.35 to $0.45
micke667: calls $0.35
Calimero2408: calls $0.35
*** TURN *** [Jd 4h 8d] [Js]
micke667: checks 
Calimero2408: checks 
Iarlei: checks 
*** RIVER *** [Jd 4h 8d Js] [Tc]
micke667: checks 
Calimero2408: checks 
Iarlei: checks 
*** SHOW DOWN ***
micke667: shows [9d 5d] (a pair of Jacks)
Calimero2408: shows [Jc Qd] (three of a kind, Jacks)
Iarlei: mucks hand 
Calimero2408 collected $1.62 from pot
*** SUMMARY ***
Total pot $1.70 | Rake $0.08 
Board [Jd 4h 8d Js Tc]
Seat 1: Ice_Isayev (small blind) folded before Flop
Seat 3: micke667 (big blind) showed [9d 5d] and lost with a pair of Jacks
Seat 4: Calimero2408 showed [Jc Qd] and won ($1.62) with three of a kind, Jacks
Seat 5: Iarlei mucked
Seat 6: Spud014 (button) folded before Flop (didn't bet)



PokerStars Hand #166667502477:  Hold'em No Limit ($0.05/$0.10 USD) - 2017/02/23 16:02:20 ET
Table 'Lehigh' 6-max Seat #5 is the button
Seat 1: kowe4ka565 ($10.30 in chips) 
Seat 2: EggMayo ($10 in chips) 
Seat 3: Therodorus ($10.45 in chips) 
Seat 4: Chodemuncher ($10.20 in chips) 
Seat 5: Xander188 ($10 in chips) 
Seat 6: CallByValue ($9.50 in chips) 
CallByValue: posts small blind $0.05
kowe4ka565: posts big blind $0.10
*** HOLE CARDS ***
EggMayo: folds 
Therodorus: raises $0.20 to $0.30
Chodemuncher: folds 
Xander188: folds 
CallByValue: folds 
kowe4ka565: calls $0.20
*** FLOP *** [Jc Jh 9h]
kowe4ka565: checks 
Therodorus: checks 
*** TURN *** [Jc Jh 9h] [6h]
kowe4ka565: checks 
Therodorus: checks 
*** RIVER *** [Jc Jh 9h 6h] [Ad]
kowe4ka565: bets $3.20
Therodorus: folds 
Uncalled bet ($3.20) returned to kowe4ka565
EggMayo leaves the table
kowe4ka565 collected $0.62 from pot
*** SUMMARY ***
Total pot $0.65 | Rake $0.03 
Board [Jc Jh 9h 6h Ad]
Seat 1: kowe4ka565 (big blind) collected ($0.62)
Seat 2: EggMayo folded before Flop (didn't bet)
Seat 3: Therodorus folded on the River
Seat 4: Chodemuncher folded before Flop (didn't bet)
Seat 5: Xander188 (button) folded before Flop (didn't bet)
Seat 6: CallByValue (small blind) folded before Flop



PokerStars Hand #166667502528:  Hold'em No Limit ($0.05/$0.10 USD) - 2017/02/23 16:02:20 ET
Table 'Pompeja III' 6-max Seat #3 is the button
Seat 1: Iarlei ($12.04 in chips) 
Seat 2: steepfell ($10.69 in chips) 
Seat 3: Yspenyanin ($12 in chips) 
Seat 4: Cluckh ($11.96 in chips) 
Seat 5: Spud014 ($12.14 in chips) 
Seat 6: mega spasser ($5.10 in chips) 
Cluckh: posts small blind $0.05
Spud014: posts big blind $0.10
*** HOLE CARDS ***
mega spasser: folds 
Iarlei: folds 
steepfell: folds 
Yspenyanin: folds 
Cluckh: folds 
Uncalled bet ($0.05) returned to Spud014
Spud014 collected $0.10 from pot
*** SUMMARY ***
Total pot $0.10 | Rake $0 
Seat 1: Iarlei folded before Flop (didn't bet)
Seat 2: steepfell folded before Flop (didn't bet)
Seat 3: Yspenyanin (button) folded before Flop (didn't bet)
Seat 4: Cluckh (small blind) folded before Flop
Seat 5: Spud014 (big blind) collected ($0.10)
Seat 6: mega spasser folded before Flop (didn't bet)



PokerStars Hand #166667502591:  Hold'em No Limit ($0.05/$0.10 USD) - 2017/02/23 16:02:20 ET
Table 'Iapetus III' 6-max Seat #6 is the button
Seat 3: takis nik ($10 in chips) 
Seat 4: XaXaTyH4uK ($10.30 in chips) 
Seat 5: homelessdan ($13.91 in chips) 
Seat 6: yodzik ($9.93 in chips) 
Crafty23@PS will be allowed to play after the button
takis nik: posts small blind $0.05
XaXaTyH4uK: posts big blind $0.10
*** HOLE CARDS ***
homelessdan: folds 
yodzik: folds 
takis nik: folds 
Uncalled bet ($0.05) returned to XaXaTyH4uK
XaXaTyH4uK collected $0.10 from pot
*** SUMMARY ***
Total pot $0.10 | Rake $0 
Seat 3: takis nik (small blind) folded before Flop
Seat 4: XaXaTyH4uK (big blind) collected ($0.10)
Seat 5: homelessdan folded before Flop (didn't bet)
Seat 6: yodzik (button) folded before Flop (didn't bet)



PokerStars Hand #166667502686:  Hold'em No Limit ($0.05/$0.10 USD) - 2017/02/23 16:02:20 ET
Table 'Syringa' 6-max Seat #6 is the button
Seat 1: bdixon_5 ($8 in chips) 
Seat 2: Goroshkos88 ($10 in chips) 
Seat 4: tangler19 ($14.58 in chips) 
Seat 5: Andrei ProFF ($13.31 in chips) 
Seat 6: ibara000 ($16.69 in chips) 
bdixon_5: posts small blind $0.05
Goroshkos88: posts big blind $0.10
Yspenyanin: sits out 
*** HOLE CARDS ***
tangler19: folds 
Andrei ProFF: folds 
ibara000: raises $0.16 to $0.26
bdixon_5: folds 
Goroshkos88: raises $0.64 to $0.90
ibara000: folds 
Uncalled bet ($0.64) returned to Goroshkos88
Goroshkos88 collected $0.57 from pot
*** SUMMARY ***
Total pot $0.57 | Rake $0 
Seat 1: bdixon_5 (small blind) folded before Flop
Seat 2: Goroshkos88 (big blind) collected ($0.57)
Seat 4: tangler19 folded before Flop (didn't bet)
Seat 5: Andrei ProFF folded before Flop (didn't bet)
Seat 6: ibara000 (button) folded before Flop



PokerStars Hand #166667502694:  Hold'em No Limit ($0.05/$0.10 USD) - 2017/02/23 16:02:20 ET
Table 'Markab II' 6-max Seat #4 is the button
Seat 1: david_sara83 ($10.17 in chips) 
Seat 2: truck1234 ($11.05 in chips) 
Seat 3: sexy_seagull ($10 in chips) 
Seat 4: Crafty23@PS ($11.54 in chips) 
Seat 5: Rodik002 ($19.22 in chips) 
Seat 6: Comeback3392 ($10.64 in chips) 
Rodik002: posts small blind $0.05
Comeback3392: posts big blind $0.10
*** HOLE CARDS ***
david_sara83: folds 
truck1234: folds 
sexy_seagull: folds 
Crafty23@PS: raises $0.15 to $0.25
Rodik002: folds 
Comeback3392: folds 
Uncalled bet ($0.15) returned to Crafty23@PS
Crafty23@PS collected $0.25 from pot
*** SUMMARY ***
Total pot $0.25 | Rake $0 
Seat 1: david_sara83 folded before Flop (didn't bet)
Seat 2: truck1234 folded before Flop (didn't bet)
Seat 3: sexy_seagull folded before Flop (didn't bet)
Seat 4: Crafty23@PS (button) collected ($0.25)
Seat 5: Rodik002 (small blind) folded before Flop
Seat 6: Comeback3392 (big blind) folded before Flop



PokerStars Hand #166667502724:  Hold'em No Limit ($0.05/$0.10 USD) - 2017/02/23 16:02:20 ET
Table 'Aludra II' 6-max Seat #2 is the button
Seat 1: voledy ($10.15 in chips) 
Seat 2: JahSoldier69 ($10.13 in chips) 
Seat 3: 2G28 ($12.90 in chips) 
Seat 4: MihaGr ($10 in chips) 
Seat 5: kingartur222 ($15.85 in chips) 
Seat 6: call me haaa ($14.05 in chips) 
2G28: posts small blind $0.05
MihaGr: posts big blind $0.10
*** HOLE CARDS ***
kingartur222: folds 
call me haaa: folds 
voledy: folds 
JahSoldier69: raises $0.15 to $0.25
2G28: calls $0.20
MihaGr: calls $0.15
*** FLOP *** [8c Th 3d]
2G28: checks 
MihaGr: bets $0.50
JahSoldier69: calls $0.50
2G28: folds 
*** TURN *** [8c Th 3d] [Ts]
MihaGr: bets $1
JahSoldier69: calls $1
*** RIVER *** [8c Th 3d Ts] [Jc]
MihaGr: bets $2.30
JahSoldier69: raises $6.08 to $8.38 and is all-in
MihaGr: folds 
Uncalled bet ($6.08) returned to JahSoldier69
JahSoldier69 collected $7.97 from pot
*** SUMMARY ***
Total pot $8.35 | Rake $0.38 
Board [8c Th 3d Ts Jc]
Seat 1: voledy folded before Flop (didn't bet)
Seat 2: JahSoldier69 (button) collected ($7.97)
Seat 3: 2G28 (small blind) folded on the Flop
Seat 4: MihaGr (big blind) folded on the River
Seat 5: kingartur222 folded before Flop (didn't bet)
Seat 6: call me haaa folded before Flop (didn't bet)



PokerStars Hand #166667502839:  Hold'em No Limit ($0.05/$0.10 USD) - 2017/02/23 16:02:20 ET
Table 'Tyndareus II' 6-max Seat #4 is the button
Seat 1: Makc1705 ($3.65 in chips) 
Seat 2: Therodorus ($11.62 in chips) 
Seat 3: McCleans ($11.21 in chips) 
Seat 4: gaHy_HaXeP ($11.21 in chips) 
Seat 5: vtalian ($8.25 in chips) 
Seat 6: sexy_seagull ($10 in chips) 
vtalian: posts small blind $0.05
sexy_seagull: posts big blind $0.10
*** HOLE CARDS ***
Makc1705 has timed out
Makc1705: folds 
Therodorus: raises $0.20 to $0.30
McCleans: folds 
gaHy_HaXeP: folds 
vtalian: folds 
sexy_seagull: folds 
Uncalled bet ($0.20) returned to Therodorus
Therodorus collected $0.25 from pot
*** SUMMARY ***
Total pot $0.25 | Rake $0 
Seat 1: Makc1705 folded before Flop (didn't bet)
Seat 2: Therodorus collected ($0.25)
Seat 3: McCleans folded before Flop (didn't bet)
Seat 4: gaHy_HaXeP (button) folded before Flop (didn't bet)
Seat 5: vtalian (small blind) folded before Flop
Seat 6: sexy_seagull (big blind) folded before Flop



PokerStars Hand #166667503368:  Hold'em No Limit ($0.05/$0.10 USD) - 2017/02/23 16:02:21 ET
Table 'Fechtig III' 6-max Seat #5 is the button
Seat 1: Scanner17 ($10 in chips) 
Seat 2: GV82 ($15.96 in chips) 
Seat 3: eniksenik ($10 in chips) 
Seat 4: kickereens ($11.23 in chips) 
Seat 5: ksandr_hom ($10.10 in chips) 
Seat 6: Glatzemandse ($20.10 in chips) 
Glatzemandse: posts small blind $0.05
Scanner17: posts big blind $0.10
*** HOLE CARDS ***
GV82: raises $0.10 to $0.20
eniksenik: folds 
kickereens: folds 
ksandr_hom: folds 
Glatzemandse: calls $0.15
Scanner17: folds 
*** FLOP *** [Th 2s 5c]
Glatzemandse: checks 
GV82: checks 
*** TURN *** [Th 2s 5c] [Js]
Glatzemandse: checks 
GV82: bets $0.24
Glatzemandse: calls $0.24
*** RIVER *** [Th 2s 5c Js] [6c]
Glatzemandse: checks 
GV82: bets $0.47
Glatzemandse: calls $0.47
*** SHOW DOWN ***
GV82: shows [Jd 8d] (a pair of Jacks)
Glatzemandse: mucks hand 
GV82 collected $1.83 from pot
*** SUMMARY ***
Total pot $1.92 | Rake $0.09 
Board [Th 2s 5c Js 6c]
Seat 1: Scanner17 (big blind) folded before Flop
Seat 2: GV82 showed [Jd 8d] and won ($1.83) with a pair of Jacks
Seat 3: eniksenik folded before Flop (didn't bet)
Seat 4: kickereens folded before Flop (didn't bet)
Seat 5: ksandr_hom (button) folded before Flop (didn't bet)
Seat 6: Glatzemandse (small blind) mucked



PokerStars Hand #166667503431:  Hold'em No Limit ($0.05/$0.10 USD) - 2017/02/23 16:02:21 ET
Table 'Phereclos II' 6-max Seat #1 is the button
Seat 1: Croplayer1 ($10 in chips) 
Seat 2: Kazacha ($10.18 in chips) 
Seat 3: kickereens ($21.31 in chips) 
Seat 4: DamDatsAnAce ($10.38 in chips) 
Seat 5: Smitty03300 ($10.15 in chips) 
Seat 6: mhonielsen ($16.07 in chips) 
Kazacha: posts small blind $0.05
kickereens: posts big blind $0.10
*** HOLE CARDS ***
DamDatsAnAce: raises $0.30 to $0.40
Smitty03300: folds 
mhonielsen: folds 
Croplayer1: folds 
Kazacha: folds 
kickereens: folds 
Uncalled bet ($0.30) returned to DamDatsAnAce
DamDatsAnAce collected $0.25 from pot
*** SUMMARY ***
Total pot $0.25 | Rake $0 
Seat 1: Croplayer1 (button) folded before Flop (didn't bet)
Seat 2: Kazacha (small blind) folded before Flop
Seat 3: kickereens (big blind) folded before Flop
Seat 4: DamDatsAnAce collected ($0.25)
Seat 5: Smitty03300 folded before Flop (didn't bet)
Seat 6: mhonielsen folded before Flop (didn't bet)



PokerStars Hand #166667503432:  Hold'em No Limit ($0.05/$0.10 USD) - 2017/02/23 16:02:21 ET
Table 'Wil' 6-max Seat #4 is the button
Seat 1: jwhelan94 ($24.47 in chips) 
Seat 2: Vrinni ($22.36 in chips) 
Seat 3: Namhkal ($10 in chips) 
Seat 4: x3ultimate ($10.42 in chips) 
Seat 5: Feverhead ($11.63 in chips) 
Seat 6: Comeback3392 ($14.33 in chips) 
Feverhead: posts small blind $0.05
Comeback3392: posts big blind $0.10
*** HOLE CARDS ***
jwhelan94: folds 
Vrinni: folds 
Namhkal: folds 
x3ultimate: raises $0.15 to $0.25
Feverhead: folds 
Comeback3392: calls $0.15
*** FLOP *** [Qd Ac 5c]
Comeback3392: checks 
x3ultimate: bets $0.35
Comeback3392: folds 
Uncalled bet ($0.35) returned to x3ultimate
x3ultimate collected $0.53 from pot
*** SUMMARY ***
Total pot $0.55 | Rake $0.02 
Board [Qd Ac 5c]
Seat 1: jwhelan94 folded before Flop (didn't bet)
Seat 2: Vrinni folded before Flop (didn't bet)
Seat 3: Namhkal folded before Flop (didn't bet)
Seat 4: x3ultimate (button) collected ($0.53)
Seat 5: Feverhead (small blind) folded before Flop
Seat 6: Comeback3392 (big blind) folded on the Flop



PokerStars Hand #166667503545:  Hold'em No Limit ($0.05/$0.10 USD) - 2017/02/23 16:02:21 ET
Table 'Joella' 6-max Seat #2 is the button
Seat 1: Dcaro31 ($13.25 in chips) 
Seat 2: Kaelyns_Bark ($9.81 in chips) 
Seat 3: Joker51_wtf! ($10 in chips) 
Seat 5: Anestakis777 ($3.83 in chips) 
Seat 6: dr.goofy ($11.76 in chips) 
Joker51_wtf!: posts small blind $0.05
Anestakis777: posts big blind $0.10
*** HOLE CARDS ***
dr.goofy: folds 
Dcaro31: folds 
Kaelyns_Bark: calls $0.10
Joker51_wtf!: folds 
Anestakis777: checks 
*** FLOP *** [9d Qd 8h]
Anestakis777: bets $0.20
Kaelyns_Bark: raises $0.20 to $0.40
Anestakis777: calls $0.20
*** TURN *** [9d Qd 8h] [7h]
Anestakis777: checks 
Kaelyns_Bark: bets $0.60
Anestakis777: calls $0.60
*** RIVER *** [9d Qd 8h 7h] [7s]
Anestakis777: bets $0.50
Kaelyns_Bark: folds 
Uncalled bet ($0.50) returned to Anestakis777
Anestakis777 collected $2.15 from pot
*** SUMMARY ***
Total pot $2.25 | Rake $0.10 
Board [9d Qd 8h 7h 7s]
Seat 1: Dcaro31 folded before Flop (didn't bet)
Seat 2: Kaelyns_Bark (button) folded on the River
Seat 3: Joker51_wtf! (small blind) folded before Flop
Seat 5: Anestakis777 (big blind) collected ($2.15)
Seat 6: dr.goofy folded before Flop (didn't bet)



PokerStars Hand #166667503733:  Hold'em No Limit ($0.05/$0.10 USD) - 2017/02/23 16:02:21 ET
Table 'Isberga' 6-max Seat #2 is the button
Seat 1: Feverhead ($17.27 in chips) 
Seat 2: GESPERIA ($10 in chips) 
Seat 4: THIMUCHIN ($11.09 in chips) 
Seat 5: YoungGriff86 ($18.75 in chips) 
Seat 6: Goroshkos88 ($21.35 in chips) 
THIMUCHIN: posts small blind $0.05
YoungGriff86: posts big blind $0.10
*** HOLE CARDS ***
Goroshkos88: folds 
Feverhead: folds 
GESPERIA: raises $0.20 to $0.30
THIMUCHIN: folds 
YoungGriff86: raises $0.20 to $0.50
GESPERIA: calls $0.20
*** FLOP *** [Kh 7h 9s]
YoungGriff86: bets $0.60
GESPERIA: calls $0.60
*** TURN *** [Kh 7h 9s] [Ac]
YoungGriff86: bets $2.15
GESPERIA: folds 
Uncalled bet ($2.15) returned to YoungGriff86
YoungGriff86 collected $2.15 from pot
*** SUMMARY ***
Total pot $2.25 | Rake $0.10 
Board [Kh 7h 9s Ac]
Seat 1: Feverhead folded before Flop (didn't bet)
Seat 2: GESPERIA (button) folded on the Turn
Seat 4: THIMUCHIN (small blind) folded before Flop
Seat 5: YoungGriff86 (big blind) collected ($2.15)
Seat 6: Goroshkos88 folded before Flop (didn't bet)



PokerStars Hand #166667503862:  Hold'em No Limit ($0.05/$0.10 USD) - 2017/02/23 16:02:21 ET
Table 'Lorbach' 6-max Seat #3 is the button
Seat 1: LarryTheStar ($11.12 in chips) 
Seat 2: fabadam ($12.33 in chips) 
Seat 3: ArcticBearDK ($11.05 in chips) 
Seat 4: McCleans ($10.59 in chips) 
Seat 5: Cluckh ($14.77 in chips) 
Seat 6: Worlz ($12.82 in chips) 
McCleans: posts small blind $0.05
Cluckh: posts big blind $0.10
*** HOLE CARDS ***
Worlz: folds 
LarryTheStar: folds 
fabadam: raises $0.20 to $0.30
ArcticBearDK: folds 
McCleans: folds 
Cluckh: folds 
Uncalled bet ($0.20) returned to fabadam
fabadam collected $0.25 from pot
*** SUMMARY ***
Total pot $0.25 | Rake $0 
Seat 1: LarryTheStar folded before Flop (didn't bet)
Seat 2: fabadam collected ($0.25)
Seat 3: ArcticBearDK (button) folded before Flop (didn't bet)
Seat 4: McCleans (small blind) folded before Flop
Seat 5: Cluckh (big blind) folded before Flop
Seat 6: Worlz folded before Flop (didn't bet)



PokerStars Hand #166667504498:  Hold'em No Limit ($0.05/$0.10 USD) - 2017/02/23 16:02:22 ET
Table 'Peiroos III' 6-max Seat #4 is the button
Seat 1: tequila_joop ($10.07 in chips) 
Seat 3: nabatov.m ($6.03 in chips) 
Seat 4: pivanki11 ($10.89 in chips) 
Seat 5: ChuikaPridi ($9.81 in chips) 
Seat 6: CHRO8 ($9.78 in chips) 
ChuikaPridi: posts small blind $0.05
CHRO8: posts big blind $0.10
tequila_joop: posts the ante $0.02
nabatov.m: posts the ante $0.02
pivanki11: posts the ante $0.02
ChuikaPridi: posts the ante $0.02
CHRO8: posts the ante $0.02
*** HOLE CARDS ***
tequila_joop: folds 
nabatov.m: folds 
pivanki11: raises $0.20 to $0.30
ChuikaPridi: folds 
CHRO8: folds 
Uncalled bet ($0.20) returned to pivanki11
pivanki11 collected $0.35 from pot
*** SUMMARY ***
Total pot $0.35 | Rake $0 
Seat 1: tequila_joop folded before Flop (didn't bet)
Seat 3: nabatov.m folded before Flop (didn't bet)
Seat 4: pivanki11 (button) collected ($0.35)
Seat 5: ChuikaPridi (small blind) folded before Flop
Seat 6: CHRO8 (big blind) folded before Flop



PokerStars Hand #166667504649:  Hold'em No Limit ($0.05/$0.10 USD) - 2017/02/23 16:02:22 ET
Table 'Kochera' 6-max Seat #2 is the button
Seat 1: chimera252 ($11.50 in chips) 
Seat 2: bartabs2 ($10.61 in chips) 
Seat 3: KA3AXCTAHEU, ($10 in chips) 
Seat 4: johkom ($5.61 in chips) 
Seat 5: univibe68 ($12 in chips) 
Seat 6: oddshoff ($9.48 in chips) 
KA3AXCTAHEU,: posts small blind $0.05
johkom: posts big blind $0.10
*** HOLE CARDS ***
univibe68: folds 
oddshoff: folds 
chimera252: folds 
bartabs2: folds 
KA3AXCTAHEU,: raises $0.15 to $0.25
johkom: folds 
Uncalled bet ($0.15) returned to KA3AXCTAHEU,
KA3AXCTAHEU, collected $0.20 from pot
*** SUMMARY ***
Total pot $0.20 | Rake $0 
Seat 1: chimera252 folded before Flop (didn't bet)
Seat 2: bartabs2 (button) folded before Flop (didn't bet)
Seat 3: KA3AXCTAHEU, (small blind) collected ($0.20)
Seat 4: johkom (big blind) folded before Flop
Seat 5: univibe68 folded before Flop (didn't bet)
Seat 6: oddshoff folded before Flop (didn't bet)



PokerStars Hand #166667504677:  Hold'em No Limit ($0.05/$0.10 USD) - 2017/02/23 16:02:22 ET
Table 'Vesta II' 6-max Seat #3 is the button
Seat 1: Yabidooo ($13.16 in chips) 
Seat 2: joewatson90 ($9.95 in chips) 
Seat 3: Pokeaster ($11.91 in chips) 
Seat 4: Dcaro31 ($10.12 in chips) 
Seat 5: Andy Wolf ($12.75 in chips) 
Dcaro31: posts small blind $0.05
Andy Wolf: posts big blind $0.10
*** HOLE CARDS ***
Yabidooo: folds 
CDestructivo leaves the table
joewatson90: folds 
Pokeaster: raises $0.15 to $0.25
Dcaro31: calls $0.20
Andy Wolf: folds 
*** FLOP *** [5h 6h 2s]
Dcaro31: checks 
Pokeaster: checks 
*** TURN *** [5h 6h 2s] [9s]
Dcaro31: checks 
Pokeaster: checks 
*** RIVER *** [5h 6h 2s 9s] [Qd]
Dcaro31: checks 
Pokeaster: checks 
*** SHOW DOWN ***
Dcaro31: shows [8d Td] (high card Queen)
Pokeaster: shows [3c Ad] (high card Ace)
Pokeaster collected $0.57 from pot
*** SUMMARY ***
Total pot $0.60 | Rake $0.03 
Board [5h 6h 2s 9s Qd]
Seat 1: Yabidooo folded before Flop (didn't bet)
Seat 2: joewatson90 folded before Flop (didn't bet)
Seat 3: Pokeaster (button) showed [3c Ad] and won ($0.57) with high card Ace
Seat 4: Dcaro31 (small blind) showed [8d Td] and lost with high card Queen
Seat 5: Andy Wolf (big blind) folded before Flop



PokerStars Hand #166667504724:  Hold'em No Limit ($0.05/$0.10 USD) - 2017/02/23 16:02:22 ET
Table 'Euryalos II' 6-max Seat #3 is the button
Seat 1: acekid403 ($10 in chips) 
Seat 3: Hyd SK ($10.25 in chips) 
Seat 4: popypaleta ($15.77 in chips) 
Seat 6: MihaGr ($10 in chips) 
popypaleta: posts small blind $0.05
voledy: is sitting out 
MihaGr: posts big blind $0.10
voledy leaves the table
Yspenyanin leaves the table
acekid403: posts big blind $0.10
*** HOLE CARDS ***
acekid403: checks 
Hyd SK: raises $1 to $1.10
popypaleta: folds 
MihaGr: folds 
acekid403: folds 
Uncalled bet ($1) returned to Hyd SK
horang2 joins the table at seat #5 
Hyd SK collected $0.35 from pot
*** SUMMARY ***
Total pot $0.35 | Rake $0 
Seat 1: acekid403 folded before Flop
Seat 3: Hyd SK (button) collected ($0.35)
Seat 4: popypaleta (small blind) folded before Flop
Seat 6: MihaGr (big blind) folded before Flop



PokerStars Hand #166667504777:  Hold'em No Limit ($0.05/$0.10 USD) - 2017/02/23 16:02:22 ET
Table 'Ebella II' 6-max Seat #6 is the button
Seat 1: gaHy_HaXeP ($10 in chips) 
Seat 2: Therodorus ($10 in chips) 
Seat 3: Torften2 ($16.22 in chips) 
Seat 4: ValdemorS ($10.15 in chips) 
Seat 5: Bird et al ($10.15 in chips) 
Seat 6: Joker51_wtf! ($10 in chips) 
gaHy_HaXeP: posts small blind $0.05
Therodorus: posts big blind $0.10
*** HOLE CARDS ***
Torften2: calls $0.10
ValdemorS: folds 
Bird et al: raises $0.30 to $0.40
Joker51_wtf!: folds 
gaHy_HaXeP: folds 
Therodorus: folds 
Torften2: calls $0.30
*** FLOP *** [Td Ah Js]
Torften2: checks 
Bird et al: checks 
*** TURN *** [Td Ah Js] [9h]
Torften2: bets $1.40
Bird et al: folds 
Uncalled bet ($1.40) returned to Torften2
Torften2 collected $0.91 from pot
*** SUMMARY ***
Total pot $0.95 | Rake $0.04 
Board [Td Ah Js 9h]
Seat 1: gaHy_HaXeP (small blind) folded before Flop
Seat 2: Therodorus (big blind) folded before Flop
Seat 3: Torften2 collected ($0.91)
Seat 4: ValdemorS folded before Flop (didn't bet)
Seat 5: Bird et al folded on the Turn
Seat 6: Joker51_wtf! (button) folded before Flop (didn't bet)



PokerStars Hand #166667504905:  Hold'em No Limit ($0.05/$0.10 USD) - 2017/02/23 16:02:22 ET
Table 'Risha II' 6-max Seat #3 is the button
Seat 1: R. Lemonte ($10.73 in chips) 
Seat 2: KA3AXCTAHEU, ($12.65 in chips) 
Seat 3: steepfell ($10 in chips) 
Seat 4: Comeback3392 ($23.23 in chips) 
Seat 5: m.c-alkatraz ($10.35 in chips) 
Seat 6: univibe68 ($10.76 in chips) 
Comeback3392: posts small blind $0.05
m.c-alkatraz: posts big blind $0.10
*** HOLE CARDS ***
univibe68: folds 
R. Lemonte: calls $0.10
KA3AXCTAHEU,: folds 
steepfell: folds 
Comeback3392: calls $0.05
m.c-alkatraz: checks 
*** FLOP *** [6s 4s 2d]
Comeback3392: checks 
m.c-alkatraz: checks 
R. Lemonte: checks 
*** TURN *** [6s 4s 2d] [Ks]
Comeback3392: bets $0.22
m.c-alkatraz: folds 
R. Lemonte: folds 
Uncalled bet ($0.22) returned to Comeback3392
Comeback3392 collected $0.29 from pot
*** SUMMARY ***
Total pot $0.30 | Rake $0.01 
Board [6s 4s 2d Ks]
Seat 1: R. Lemonte folded on the Turn
Seat 2: KA3AXCTAHEU, folded before Flop (didn't bet)
Seat 3: steepfell (button) folded before Flop (didn't bet)
Seat 4: Comeback3392 (small blind) collected ($0.29)
Seat 5: m.c-alkatraz (big blind) folded on the Turn
Seat 6: univibe68 folded before Flop (didn't bet)



PokerStars Hand #166667505279:  Hold'em No Limit ($0.05/$0.10 USD) - 2017/02/23 16:02:23 ET
Table 'Virginia II' 6-max Seat #1 is the button
Seat 1: Iarlei ($11.56 in chips) 
Seat 2: Yspenyanin ($10 in chips) 
Seat 3: garigura ($14.71 in chips) 
Seat 4: onkelottoHH ($11.48 in chips) 
Seat 5: dr.goofy ($20.26 in chips) 
Seat 6: ab260414 ($10.45 in chips) 
Yspenyanin: posts small blind $0.05
garigura: posts big blind $0.10
*** HOLE CARDS ***
onkelottoHH: raises $0.20 to $0.30
dr.goofy: calls $0.30
ab260414: folds 
Iarlei: folds 
Yspenyanin: folds 
garigura: folds 
*** FLOP *** [3d 2d 7d]
onkelottoHH: checks 
dr.goofy: bets $0.40
onkelottoHH: folds 
Uncalled bet ($0.40) returned to dr.goofy
dr.goofy collected $0.72 from pot
*** SUMMARY ***
Total pot $0.75 | Rake $0.03 
Board [3d 2d 7d]
Seat 1: Iarlei (button) folded before Flop (didn't bet)
Seat 2: Yspenyanin (small blind) folded before Flop
Seat 3: garigura (big blind) folded before Flop
Seat 4: onkelottoHH folded on the Flop
Seat 5: dr.goofy collected ($0.72)
Seat 6: ab260414 folded before Flop (didn't bet)



PokerStars Hand #166667505359:  Hold'em No Limit ($0.05/$0.10 USD) - 2017/02/23 16:02:23 ET
Table 'Amalia' 6-max Seat #6 is the button
Seat 1: voledy ($12.89 in chips) 
Seat 2: DamDatsAnAce ($10.70 in chips) 
Seat 3: kickereens ($10.30 in chips) 
Seat 4: Rodik002 ($16.38 in chips) 
Seat 5: coolisses111 ($9.85 in chips) 
Seat 6: oktomber778 ($24.29 in chips) 
voledy: posts small blind $0.05
DamDatsAnAce: posts big blind $0.10
*** HOLE CARDS ***
kickereens: raises $0.20 to $0.30
Rodik002: folds 
coolisses111: raises $0.60 to $0.90
oktomber778: calls $0.90
voledy: folds 
DamDatsAnAce: folds 
kickereens: folds 
*** FLOP *** [Kc 7c 4h]
coolisses111: bets $1.50
oktomber778: folds 
Uncalled bet ($1.50) returned to coolisses111
coolisses111 collected $2.15 from pot
*** SUMMARY ***
Total pot $2.25 | Rake $0.10 
Board [Kc 7c 4h]
Seat 1: voledy (small blind) folded before Flop
Seat 2: DamDatsAnAce (big blind) folded before Flop
Seat 3: kickereens folded before Flop
Seat 4: Rodik002 folded before Flop (didn't bet)
Seat 5: coolisses111 collected ($2.15)
Seat 6: oktomber778 (button) folded on the Flop



PokerStars Hand #166667505375:  Hold'em No Limit ($0.05/$0.10 USD) - 2017/02/23 16:02:23 ET
Table 'Kunigunde II' 6-max Seat #4 is the button
Seat 1: facewald ($10.11 in chips) 
Seat 2: dragonste89 ($14.88 in chips) 
Seat 3: pancernik21 ($14.76 in chips) 
Seat 4: david_sara83 ($12.83 in chips) 
Seat 5: mdelfin0 ($11.64 in chips) 
Seat 6: Zooplack ($10 in chips) 
mdelfin0: posts small blind $0.05
Zooplack: posts big blind $0.10
*** HOLE CARDS ***
facewald: folds 
dragonste89: raises $0.25 to $0.35
pancernik21: folds 
david_sara83: folds 
mdelfin0: folds 
Zooplack: folds 
Uncalled bet ($0.25) returned to dragonste89
dragonste89 collected $0.25 from pot
*** SUMMARY ***
Total pot $0.25 | Rake $0 
Seat 1: facewald folded before Flop (didn't bet)
Seat 2: dragonste89 collected ($0.25)
Seat 3: pancernik21 folded before Flop (didn't bet)
Seat 4: david_sara83 (button) folded before Flop (didn't bet)
Seat 5: mdelfin0 (small blind) folded before Flop
Seat 6: Zooplack (big blind) folded before Flop



PokerStars Hand #166667505532:  Hold'em No Limit ($0.05/$0.10 USD) - 2017/02/23 16:02:23 ET
Table 'Aconcagua' 6-max Seat #4 is the button
Seat 4: pivanki11 ($9.46 in chips) 
Seat 5: frazaunch ($6.89 in chips) 
Seat 6: coolisses111 ($9.19 in chips) 
frazaunch: posts small blind $0.05
coolisses111: posts big blind $0.10
pivanki11: posts the ante $0.02
frazaunch: posts the ante $0.02
coolisses111: posts the ante $0.02
*** HOLE CARDS ***
pivanki11: folds 
frazaunch: calls $0.05
burtila1989 joins the table at seat #3 
coolisses111: checks 
*** FLOP *** [7d 5c Ks]
frazaunch: checks 
coolisses111: bets $0.20
frazaunch: calls $0.20
*** TURN *** [7d 5c Ks] [Jd]
frazaunch: checks 
coolisses111: checks 
*** RIVER *** [7d 5c Ks Jd] [Ac]
frazaunch: checks 
coolisses111: checks 
*** SHOW DOWN ***
frazaunch: shows [Kc Td] (a pair of Kings)
coolisses111: mucks hand 
frazaunch collected $0.63 from pot
*** SUMMARY ***
Total pot $0.66 | Rake $0.03 
Board [7d 5c Ks Jd Ac]
Seat 4: pivanki11 (button) folded before Flop (didn't bet)
Seat 5: frazaunch (small blind) showed [Kc Td] and won ($0.63) with a pair of Kings
Seat 6: coolisses111 (big blind) mucked



PokerStars Hand #166667505811:  Hold'em No Limit ($0.05/$0.10 USD) - 2017/02/23 16:02:23 ET
Table 'Krethon' 6-max Seat #5 is the button
Seat 1: boxer821 ($10.30 in chips) 
Seat 2: manashov ($10.80 in chips) 
Seat 3: Kow6oy ($14.86 in chips) 
Seat 4: chimera252 ($15.68 in chips) 
Seat 5: popypaleta ($10 in chips) 
boxer821: posts small blind $0.05
manashov: posts big blind $0.10
*** HOLE CARDS ***
Kow6oy: folds 
chimera252: folds 
popypaleta: folds 
boxer821: folds 
Uncalled bet ($0.05) returned to manashov
manashov collected $0.10 from pot
*** SUMMARY ***
Total pot $0.10 | Rake $0 
Seat 1: boxer821 (small blind) folded before Flop
Seat 2: manashov (big blind) collected ($0.10)
Seat 3: Kow6oy folded before Flop (didn't bet)
Seat 4: chimera252 folded before Flop (didn't bet)
Seat 5: popypaleta (button) folded before Flop (didn't bet)



PokerStars Hand #166667505848:  Hold'em No Limit ($0.05/$0.10 USD) - 2017/02/23 16:02:23 ET
Table 'Esperanto II' 6-max Seat #1 is the button
Seat 1: kurasd ($10.37 in chips) 
Seat 2: MihaGr ($10.09 in chips) 
Seat 3: Namhkal ($12.37 in chips) 
Seat 4: Andrei ProFF ($10.41 in chips) 
Seat 5: FRAID358 ($10 in chips) 
Seat 6: ArcticBearDK ($13.15 in chips) 
MihaGr: posts small blind $0.05
Namhkal: posts big blind $0.10
*** HOLE CARDS ***
Andrei ProFF: folds 
FRAID358: folds 
ArcticBearDK: raises $0.12 to $0.22
kurasd: calls $0.22
MihaGr: folds 
Namhkal: calls $0.12
*** FLOP *** [3h 8h 7s]
Namhkal: checks 
ArcticBearDK: checks 
kurasd: bets $0.20
Namhkal: folds 
ArcticBearDK: calls $0.20
*** TURN *** [3h 8h 7s] [5c]
ArcticBearDK: checks 
kurasd: bets $0.30
ArcticBearDK: folds 
Uncalled bet ($0.30) returned to kurasd
kurasd collected $1.06 from pot
*** SUMMARY ***
Total pot $1.11 | Rake $0.05 
Board [3h 8h 7s 5c]
Seat 1: kurasd (button) collected ($1.06)
Seat 2: MihaGr (small blind) folded before Flop
Seat 3: Namhkal (big blind) folded on the Flop
Seat 4: Andrei ProFF folded before Flop (didn't bet)
Seat 5: FRAID358 folded before Flop (didn't bet)
Seat 6: ArcticBearDK folded on the Turn



PokerStars Hand #166667506290:  Hold'em No Limit ($0.05/$0.10 USD) - 2017/02/23 16:02:24 ET
Table 'Nephthys II' 6-max Seat #2 is the button
Seat 1: DamDatsAnAce ($10.05 in chips) 
Seat 2: AC Evergreen ($10 in chips) 
Seat 3: Newqbrown ($20.34 in chips) 
Seat 5: kingartur222 ($9.16 in chips) 
Seat 6: CHRO8 ($14.49 in chips) 
Newqbrown: posts small blind $0.05
RkaczoR: is sitting out 
kingartur222: posts big blind $0.10
*** HOLE CARDS ***
RkaczoR leaves the table
MihaGr joins the table at seat #4 
CHRO8: folds 
DamDatsAnAce: folds 
AC Evergreen: raises $0.16 to $0.26
Newqbrown: calls $0.21
kingartur222: folds 
*** FLOP *** [Qc 6c Qd]
Newqbrown: checks 
AC Evergreen: bets $0.40
Newqbrown: folds 
Uncalled bet ($0.40) returned to AC Evergreen
AC Evergreen collected $0.59 from pot
*** SUMMARY ***
Total pot $0.62 | Rake $0.03 
Board [Qc 6c Qd]
Seat 1: DamDatsAnAce folded before Flop (didn't bet)
Seat 2: AC Evergreen (button) collected ($0.59)
Seat 3: Newqbrown (small blind) folded on the Flop
Seat 5: kingartur222 (big blind) folded before Flop
Seat 6: CHRO8 folded before Flop (didn't bet)



PokerStars Hand #166667506408:  Hold'em No Limit ($0.05/$0.10 USD) - 2017/02/23 16:02:24 ET
Table 'Geisha' 6-max Seat #5 is the button
Seat 1: facewald ($34.63 in chips) 
Seat 2: voledy ($10.15 in chips) 
Seat 4: jvstsayyes ($11.47 in chips) 
Seat 5: KRZuff ($14.10 in chips) 
Seat 6: Namhkal ($21.53 in chips) 
Namhkal: posts small blind $0.05
facewald: posts big blind $0.10
Eddys Edge: sits out 
*** HOLE CARDS ***
voledy: raises $0.20 to $0.30
jvstsayyes: folds 
KRZuff: folds 
Namhkal: folds 
facewald: folds 
Uncalled bet ($0.20) returned to voledy
voledy collected $0.25 from pot
*** SUMMARY ***
Total pot $0.25 | Rake $0 
Seat 1: facewald (big blind) folded before Flop
Seat 2: voledy collected ($0.25)
Seat 4: jvstsayyes folded before Flop (didn't bet)
Seat 5: KRZuff (button) folded before Flop (didn't bet)
Seat 6: Namhkal (small blind) folded before Flop



PokerStars Hand #166667506495:  Hold'em No Limit ($0.05/$0.10 USD) - 2017/02/23 16:02:24 ET
Table 'Eurydome II' 6-max Seat #4 is the button
Seat 2: Elinaattor ($10.34 in chips) 
Seat 3: gaHy_HaXeP ($10 in chips) 
Seat 4: Smitty03300 ($10.23 in chips) 
Seat 5: kush-killa87 ($13.62 in chips) 
Seat 6: Jucatorul823 ($6.45 in chips) 
kush-killa87: posts small blind $0.05
Jucatorul823: posts big blind $0.10
*** HOLE CARDS ***
Elinaattor: folds 
gaHy_HaXeP: folds 
Smitty03300: raises $0.10 to $0.20
kush-killa87: calls $0.15
Jucatorul823: calls $0.10
*** FLOP *** [6s 4d 9h]
kush-killa87: bets $0.30
Jucatorul823: folds 
Smitty03300: folds 
Uncalled bet ($0.30) returned to kush-killa87
kush-killa87 collected $0.57 from pot
*** SUMMARY ***
Total pot $0.60 | Rake $0.03 
Board [6s 4d 9h]
Seat 2: Elinaattor folded before Flop (didn't bet)
Seat 3: gaHy_HaXeP folded before Flop (didn't bet)
Seat 4: Smitty03300 (button) folded on the Flop
Seat 5: kush-killa87 (small blind) collected ($0.57)
Seat 6: Jucatorul823 (big blind) folded on the Flop



PokerStars Hand #166667506786:  Hold'em No Limit ($0.05/$0.10 USD) - 2017/02/23 16:02:24 ET
Table 'California II' 6-max Seat #6 is the button
Seat 1: fedorka rus ($10.28 in chips) 
Seat 2: homelessdan ($10.15 in chips) 
Seat 3: Bird et al ($10.35 in chips) 
Seat 5: bambolejro ($15.02 in chips) 
Seat 6: chiko4040 ($8.66 in chips) 
fedorka rus: posts small blind $0.05
homelessdan: posts big blind $0.10
pokekrk: sits out 
*** HOLE CARDS ***
Bird et al: folds 
bambolejro: raises $0.20 to $0.30
chiko4040: calls $0.30
fedorka rus: folds 
homelessdan: folds 
*** FLOP *** [4h 6h 7c]
bambolejro: bets $0.49
chiko4040: calls $0.49
*** TURN *** [4h 6h 7c] [5c]
bambolejro: checks 
chiko4040: bets $0.60
bambolejro: calls $0.60
*** RIVER *** [4h 6h 7c 5c] [Td]
bambolejro: checks 
chiko4040: checks 
*** SHOW DOWN ***
bambolejro: shows [Th Jh] (a pair of Tens)
chiko4040: mucks hand 
bambolejro collected $2.80 from pot
*** SUMMARY ***
Total pot $2.93 | Rake $0.13 
Board [4h 6h 7c 5c Td]
Seat 1: fedorka rus (small blind) folded before Flop
Seat 2: homelessdan (big blind) folded before Flop
Seat 3: Bird et al folded before Flop (didn't bet)
Seat 5: bambolejro showed [Th Jh] and won ($2.80) with a pair of Tens
Seat 6: chiko4040 (button) mucked



PokerStars Hand #166667506894:  Hold'em No Limit ($0.05/$0.10 USD) - 2017/02/23 16:02:25 ET
Table 'Wingolfia II' 6-max Seat #6 is the button
Seat 1: BahiaMinhaP ($10 in chips) 
Seat 2: NvR.m1nD ($10 in chips) 
Seat 3: truck1234 ($10 in chips) 
Seat 4: zlobslob ($19.17 in chips) 
Seat 5: tr41n3r12 ($11.43 in chips) 
Seat 6: EphemeralBen ($11.52 in chips) 
BahiaMinhaP: posts small blind $0.05
NvR.m1nD: posts big blind $0.10
*** HOLE CARDS ***
truck1234: folds 
zlobslob: raises $0.15 to $0.25
tr41n3r12: folds 
EphemeralBen: folds 
BahiaMinhaP: folds 
NvR.m1nD: folds 
Uncalled bet ($0.15) returned to zlobslob
zlobslob collected $0.25 from pot
*** SUMMARY ***
Total pot $0.25 | Rake $0 
Seat 1: BahiaMinhaP (small blind) folded before Flop
Seat 2: NvR.m1nD (big blind) folded before Flop
Seat 3: truck1234 folded before Flop (didn't bet)
Seat 4: zlobslob collected ($0.25)
Seat 5: tr41n3r12 folded before Flop (didn't bet)
Seat 6: EphemeralBen (button) folded before Flop (didn't bet)



PokerStars Hand #166667507150:  Hold'em No Limit ($0.05/$0.10 USD) - 2017/02/23 16:02:25 ET
Table 'Kanda' 6-max Seat #5 is the button
Seat 1: Andy Wolf ($10.56 in chips) 
Seat 2: Pelotín ($5.45 in chips) 
Seat 3: joewatson90 ($12.44 in chips) 
Seat 4: Orlangoor ($10.71 in chips) 
Seat 5: Temniy Elf ($10 in chips) 
Seat 6: oddshoff ($8.86 in chips) 
oddshoff: posts small blind $0.05
Andy Wolf: posts big blind $0.10
*** HOLE CARDS ***
Pelotín: folds 
joewatson90: folds 
Orlangoor: folds 
Temniy Elf: raises $0.15 to $0.25
oddshoff: folds 
Andy Wolf: folds 
Uncalled bet ($0.15) returned to Temniy Elf
Temniy Elf collected $0.25 from pot
*** SUMMARY ***
Total pot $0.25 | Rake $0 
Seat 1: Andy Wolf (big blind) folded before Flop
Seat 2: Pelotín folded before Flop (didn't bet)
Seat 3: joewatson90 folded before Flop (didn't bet)
Seat 4: Orlangoor folded before Flop (didn't bet)
Seat 5: Temniy Elf (button) collected ($0.25)
Seat 6: oddshoff (small blind) folded before Flop



PokerStars Hand #166667507731:  Hold'em No Limit ($0.05/$0.10 USD) - 2017/02/23 16:02:26 ET
Table 'Heka II' 6-max Seat #2 is the button
Seat 1: Mamm0nism ($13.97 in chips) 
Seat 2: oddshoff ($11.57 in chips) 
Seat 3: MühliJr ($10.35 in chips) 
Seat 4: theNot0r1ous ($10.07 in chips) 
Seat 5: ArcticBearDK ($12.78 in chips) 
Seat 6: MonteCris92 ($10 in chips) 
MühliJr: posts small blind $0.05
theNot0r1ous: posts big blind $0.10
*** HOLE CARDS ***
ArcticBearDK: raises $0.15 to $0.25
MonteCris92: folds 
Mamm0nism: raises $0.75 to $1
oddshoff: folds 
MühliJr: folds 
theNot0r1ous: folds 
ArcticBearDK: folds 
Uncalled bet ($0.75) returned to Mamm0nism
Mamm0nism collected $0.65 from pot
*** SUMMARY ***
Total pot $0.65 | Rake $0 
Seat 1: Mamm0nism collected ($0.65)
Seat 2: oddshoff (button) folded before Flop (didn't bet)
Seat 3: MühliJr (small blind) folded before Flop
Seat 4: theNot0r1ous (big blind) folded before Flop
Seat 5: ArcticBearDK folded before Flop
Seat 6: MonteCris92 folded before Flop (didn't bet)



PokerStars Hand #166667507776:  Hold'em No Limit ($0.05/$0.10 USD) - 2017/02/23 16:02:26 ET
Table 'Alnasl' 6-max Seat #3 is the button
Seat 1: KA3AXCTAHEU, ($11.22 in chips) 
Seat 2: XaXaTyH4uK ($10.60 in chips) 
Seat 3: david_sara83 ($22.69 in chips) 
Seat 4: oddshoff ($10.08 in chips) 
Seat 5: steepfell ($10.23 in chips) 
Seat 6: Zooplack ($13.43 in chips) 
oddshoff: posts small blind $0.05
steepfell: posts big blind $0.10
*** HOLE CARDS ***
Zooplack: folds 
KA3AXCTAHEU,: folds 
XaXaTyH4uK: raises $0.20 to $0.30
david_sara83: folds 
oddshoff: folds 
steepfell: folds 
Uncalled bet ($0.20) returned to XaXaTyH4uK
XaXaTyH4uK collected $0.25 from pot
*** SUMMARY ***
Total pot $0.25 | Rake $0 
Seat 1: KA3AXCTAHEU, folded before Flop (didn't bet)
Seat 2: XaXaTyH4uK collected ($0.25)
Seat 3: david_sara83 (button) folded before Flop (didn't bet)
Seat 4: oddshoff (small blind) folded before Flop
Seat 5: steepfell (big blind) folded before Flop
Seat 6: Zooplack folded before Flop (didn't bet)



PokerStars Hand #166667508438:  Hold'em No Limit ($0.05/$0.10 USD) - 2017/02/23 16:02:26 ET
Table 'Juliet II' 6-max Seat #6 is the button
Seat 1: alexpolevaja ($11.28 in chips) 
Seat 2: KA3AXCTAHEU, ($15.15 in chips) 
Seat 3: patrick19111 ($11.72 in chips) 
Seat 4: x3ultimate ($10 in chips) 
Seat 5: Dcaro31 ($19.02 in chips) 
Seat 6: BookWorm78 ($33.10 in chips) 
alexpolevaja: posts small blind $0.05
KA3AXCTAHEU,: posts big blind $0.10
*** HOLE CARDS ***
patrick19111: folds 
x3ultimate: folds 
Dcaro31: folds 
BookWorm78: folds 
alexpolevaja: calls $0.05
KA3AXCTAHEU,: checks 
*** FLOP *** [Jh 5h Ad]
alexpolevaja: bets $0.10
KA3AXCTAHEU,: raises $0.15 to $0.25
alexpolevaja: folds 
Uncalled bet ($0.15) returned to KA3AXCTAHEU,
KA3AXCTAHEU, collected $0.38 from pot
*** SUMMARY ***
Total pot $0.40 | Rake $0.02 
Board [Jh 5h Ad]
Seat 1: alexpolevaja (small blind) folded on the Flop
Seat 2: KA3AXCTAHEU, (big blind) collected ($0.38)
Seat 3: patrick19111 folded before Flop (didn't bet)
Seat 4: x3ultimate folded before Flop (didn't bet)
Seat 5: Dcaro31 folded before Flop (didn't bet)
Seat 6: BookWorm78 (button) folded before Flop (didn't bet)



PokerStars Hand #166667508639:  Hold'em No Limit ($0.05/$0.10 USD) - 2017/02/23 16:02:27 ET
Table 'Jokaste II' 6-max Seat #2 is the button
Seat 1: Hyd SK ($13.48 in chips) 
Seat 2: T9MS ($12.48 in chips) 
Seat 3: crazydevill ($9.90 in chips) 
Seat 4: FRAID358 ($14.86 in chips) 
Seat 5: Vrinni ($10.15 in chips) 
Seat 6: Adailton07 ($15.05 in chips) 
crazydevill: posts small blind $0.05
FRAID358: posts big blind $0.10
*** HOLE CARDS ***
Vrinni: folds 
Adailton07: raises $0.20 to $0.30
Hyd SK: folds 
T9MS: folds 
crazydevill: folds 
FRAID358: folds 
Uncalled bet ($0.20) returned to Adailton07
Adailton07 collected $0.25 from pot
*** SUMMARY ***
Total pot $0.25 | Rake $0 
Seat 1: Hyd SK folded before Flop (didn't bet)
Seat 2: T9MS (button) folded before Flop (didn't bet)
Seat 3: crazydevill (small blind) folded before Flop
Seat 4: FRAID358 (big blind) folded before Flop
Seat 5: Vrinni folded before Flop (didn't bet)
Seat 6: Adailton07 collected ($0.25)



PokerStars Hand #166667508673:  Hold'em No Limit ($0.05/$0.10 USD) - 2017/02/23 16:02:27 ET
Table 'Pandora III' 6-max Seat #4 is the button
Seat 1: Pokeaster ($10.99 in chips) 
Seat 2: garigura ($11.77 in chips) 
Seat 3: ChuikaPridi ($16.78 in chips) 
Seat 4: mhonielsen ($10 in chips) 
Seat 5: MühliJr ($10.20 in chips) 
Seat 6: yodzik ($5 in chips) 
MühliJr: posts small blind $0.05
yodzik: posts big blind $0.10
*** HOLE CARDS ***
Pokeaster: folds 
garigura: folds 
ChuikaPridi: raises $0.20 to $0.30
mhonielsen: folds 
MühliJr: folds 
yodzik: folds 
Uncalled bet ($0.20) returned to ChuikaPridi
ChuikaPridi collected $0.25 from pot
*** SUMMARY ***
Total pot $0.25 | Rake $0 
Seat 1: Pokeaster folded before Flop (didn't bet)
Seat 2: garigura folded before Flop (didn't bet)
Seat 3: ChuikaPridi collected ($0.25)
Seat 4: mhonielsen (button) folded before Flop (didn't bet)
Seat 5: MühliJr (small blind) folded before Flop
Seat 6: yodzik (big blind) folded before Flop



PokerStars Hand #166667508723:  Hold'em No Limit ($0.05/$0.10 USD) - 2017/02/23 16:02:27 ET
Table 'Apollonia' 6-max Seat #1 is the button
Seat 1: ex3Lero86 ($10.11 in chips) 
Seat 2: ibara000 ($18.89 in chips) 
Seat 3: derbesteojr ($9.35 in chips) 
Seat 4: Goroshkos88 ($17.46 in chips) 
Seat 5: EphemeralBen ($13.49 in chips) 
Seat 6: Namhkal ($10.25 in chips) 
ibara000: posts small blind $0.05
derbesteojr: posts big blind $0.10
*** HOLE CARDS ***
Goroshkos88: folds 
EphemeralBen: folds 
Namhkal: raises $0.15 to $0.25
ex3Lero86: folds 
ibara000: folds 
derbesteojr: folds 
Uncalled bet ($0.15) returned to Namhkal
Namhkal collected $0.25 from pot
*** SUMMARY ***
Total pot $0.25 | Rake $0 
Seat 1: ex3Lero86 (button) folded before Flop (didn't bet)
Seat 2: ibara000 (small blind) folded before Flop
Seat 3: derbesteojr (big blind) folded before Flop
Seat 4: Goroshkos88 folded before Flop (didn't bet)
Seat 5: EphemeralBen folded before Flop (didn't bet)
Seat 6: Namhkal collected ($0.25)



PokerStars Hand #166667508852:  Hold'em No Limit ($0.05/$0.10 USD) - 2017/02/23 16:02:27 ET
Table 'Hestia' 6-max Seat #5 is the button
Seat 1: Pekaml ($10 in chips) 
Seat 3: MBen10 ($13.23 in chips) 
Seat 4: Lucky HoBBiT ($10 in chips) 
Seat 5: CiisCi ($16.05 in chips) 
Pekaml: posts small blind $0.05
RoJ1: is sitting out 
MBen10: posts big blind $0.10
*** HOLE CARDS ***
RoJ1 leaves the table
Lucky HoBBiT: raises $0.20 to $0.30
Kow6oy joins the table at seat #6 
CiisCi: folds 
Pekaml: folds 
Kow6oy leaves the table
Smitty03300 joins the table at seat #6 
MBen10: calls $0.20
*** FLOP *** [4h Js Qd]
MBen10: bets $0.30
Lucky HoBBiT: calls $0.30
*** TURN *** [4h Js Qd] [3c]
MBen10: bets $0.79
Lucky HoBBiT: folds 
Uncalled bet ($0.79) returned to MBen10
MBen10 collected $1.19 from pot
*** SUMMARY ***
Total pot $1.25 | Rake $0.06 
Board [4h Js Qd 3c]
Seat 1: Pekaml (small blind) folded before Flop
Seat 3: MBen10 (big blind) collected ($1.19)
Seat 4: Lucky HoBBiT folded on the Turn
Seat 5: CiisCi (button) folded before Flop (didn't bet)



PokerStars Hand #166667509369:  Hold'em No Limit ($0.05/$0.10 USD) - 2017/02/23 16:02:27 ET
Table 'Ushakaron II' 6-max Seat #5 is the button
Seat 1: Kow6oy ($10.30 in chips) 
Seat 2: Iarlei ($10.23 in chips) 
Seat 3: Rodik002 ($10 in chips) 
Seat 4: avintage176 ($27.86 in chips) 
Seat 5: 1limewax1 ($18.40 in chips) 
Seat 6: eniksenik ($10 in chips) 
eniksenik: posts small blind $0.05
Kow6oy: posts big blind $0.10
*** HOLE CARDS ***
Iarlei: folds 
Rodik002: folds 
avintage176: folds 
1limewax1: raises $0.20 to $0.30
eniksenik: calls $0.25
Kow6oy: folds 
*** FLOP *** [Jd Ts Qc]
eniksenik: checks 
1limewax1: bets $0.40
eniksenik: calls $0.40
*** TURN *** [Jd Ts Qc] [3c]
eniksenik: checks 
1limewax1: checks 
*** RIVER *** [Jd Ts Qc 3c] [Ad]
eniksenik: bets $0.47
1limewax1: calls $0.47
*** SHOW DOWN ***
eniksenik: shows [9c Kh] (a straight, Ten to Ace)
1limewax1: mucks hand 
eniksenik collected $2.33 from pot
*** SUMMARY ***
Total pot $2.44 | Rake $0.11 
Board [Jd Ts Qc 3c Ad]
Seat 1: Kow6oy (big blind) folded before Flop
Seat 2: Iarlei folded before Flop (didn't bet)
Seat 3: Rodik002 folded before Flop (didn't bet)
Seat 4: avintage176 folded before Flop (didn't bet)
Seat 5: 1limewax1 (button) mucked
Seat 6: eniksenik (small blind) showed [9c Kh] and won ($2.33) with a straight, Ten to Ace



PokerStars Hand #166667509512:  Hold'em No Limit ($0.05/$0.10 USD) - 2017/02/23 16:02:27 ET
Table 'Cassini' 6-max Seat #4 is the button
Seat 1: Pokeaster ($10.15 in chips) 
Seat 2: mhonielsen ($13.09 in chips) 
Seat 4: fortieth ($13.72 in chips) 
Seat 5: johkom ($7.80 in chips) 
Seat 6: JahSoldier69 ($10 in chips) 
johkom: posts small blind $0.05
JahSoldier69: posts big blind $0.10
*** HOLE CARDS ***
Pokeaster: folds 
mhonielsen: folds 
fortieth: folds 
johkom: folds 
Uncalled bet ($0.05) returned to JahSoldier69
JahSoldier69 collected $0.10 from pot
*** SUMMARY ***
Total pot $0.10 | Rake $0 
Seat 1: Pokeaster folded before Flop (didn't bet)
Seat 2: mhonielsen folded before Flop (didn't bet)
Seat 4: fortieth (button) folded before Flop (didn't bet)
Seat 5: johkom (small blind) folded before Flop
Seat 6: JahSoldier69 (big blind) collected ($0.10)



PokerStars Hand #166667509532:  Hold'em No Limit ($0.05/$0.10 USD) - 2017/02/23 16:02:27 ET
Table 'Crommelin II' 6-max Seat #2 is the button
Seat 1: THIMUCHIN ($11.07 in chips) 
Seat 2: Bird et al ($10 in chips) 
Seat 3: Strelok1974 ($21.05 in chips) 
Seat 4: Pequeño Clau ($10.15 in chips) 
Seat 5: Action_Gibi ($20.19 in chips) 
Seat 6: Darkfrai ($10.95 in chips) 
Strelok1974: posts small blind $0.05
Pequeño Clau: posts big blind $0.10
*** HOLE CARDS ***
Action_Gibi: folds 
Darkfrai: folds 
THIMUCHIN: folds 
Bird et al: folds 
Strelok1974: raises $0.20 to $0.30
Pequeño Clau: raises $0.60 to $0.90
Strelok1974: raises $1.30 to $2.20
Pequeño Clau: folds 
Uncalled bet ($1.30) returned to Strelok1974
Strelok1974 collected $1.80 from pot
*** SUMMARY ***
Total pot $1.80 | Rake $0 
Seat 1: THIMUCHIN folded before Flop (didn't bet)
Seat 2: Bird et al (button) folded before Flop (didn't bet)
Seat 3: Strelok1974 (small blind) collected ($1.80)
Seat 4: Pequeño Clau (big blind) folded before Flop
Seat 5: Action_Gibi folded before Flop (didn't bet)
Seat 6: Darkfrai folded before Flop (didn't bet)



PokerStars Hand #166667509625:  Hold'em No Limit ($0.05/$0.10 USD) - 2017/02/23 16:02:28 ET
Table 'Grietje' 6-max Seat #5 is the button
Seat 1: WinninBikini ($14.98 in chips) 
Seat 2: Feverhead ($13.17 in chips) 
Seat 4: 6ePeMeHHa9 ($10 in chips) 
Seat 5: sbalass ($9.79 in chips) 
Seat 6: Prometheu$8 ($12 in chips) 
Prometheu$8: posts small blind $0.05
WinninBikini: posts big blind $0.10
iamkakaroto: sits out 
*** HOLE CARDS ***
Feverhead: folds 
6ePeMeHHa9: folds 
sbalass: raises $0.20 to $0.30
Prometheu$8: calls $0.25
iamkakaroto leaves the table
voledy joins the table at seat #3 
WinninBikini: calls $0.20
*** FLOP *** [Js 7s Tc]
Prometheu$8: checks 
WinninBikini: checks 
sbalass: bets $0.30
Prometheu$8: calls $0.30
WinninBikini: folds 
*** TURN *** [Js 7s Tc] [9h]
Prometheu$8: bets $1.43
sbalass: raises $7.76 to $9.19 and is all-in
Prometheu$8: calls $7.76
*** RIVER *** [Js 7s Tc 9h] [Ah]
*** SHOW DOWN ***
Prometheu$8: shows [Kc Qs] (a straight, Ten to Ace)
sbalass: shows [9d 8c] (a straight, Seven to Jack)
Prometheu$8 collected $18.99 from pot
*** SUMMARY ***
Total pot $19.88 | Rake $0.89 
Board [Js 7s Tc 9h Ah]
Seat 1: WinninBikini (big blind) folded on the Flop
Seat 2: Feverhead folded before Flop (didn't bet)
Seat 4: 6ePeMeHHa9 folded before Flop (didn't bet)
Seat 5: sbalass (button) showed [9d 8c] and lost with a straight, Seven to Jack
Seat 6: Prometheu$8 (small blind) showed [Kc Qs] and won ($18.99) with a straight, Ten to Ace



PokerStars Hand #166667510485:  Hold'em No Limit ($0.05/$0.10 USD) - 2017/02/23 16:02:28 ET
Table 'Tomita II' 6-max Seat #6 is the button
Seat 2: mhonielsen ($10 in chips) 
Seat 3: Lucky HoBBiT ($12.16 in chips) 
Seat 4: Hyd SK ($10 in chips) 
Seat 6: Punzzzer ($12.36 in chips) 
mhonielsen: posts small blind $0.05
Lucky HoBBiT: posts big blind $0.10
*** HOLE CARDS ***
Hyd SK: raises $0.25 to $0.35
Punzzzer: folds 
mhonielsen: folds 
Lucky HoBBiT: folds 
Uncalled bet ($0.25) returned to Hyd SK
Hyd SK collected $0.25 from pot
*** SUMMARY ***
Total pot $0.25 | Rake $0 
Seat 2: mhonielsen (small blind) folded before Flop
Seat 3: Lucky HoBBiT (big blind) folded before Flop
Seat 4: Hyd SK collected ($0.25)
Seat 6: Punzzzer (button) folded before Flop (didn't bet)



PokerStars Hand #166667510563:  Hold'em No Limit ($0.05/$0.10 USD) - 2017/02/23 16:02:29 ET
Table 'Hyakutake' 6-max Seat #6 is the button
Seat 1: Asilvagoat ($11.63 in chips) 
Seat 2: boxer821 ($10.66 in chips) 
Seat 3: lenboysprite ($7 in chips) 
Seat 4: eniksenik ($13.55 in chips) 
Seat 5: RoJ1 ($11.59 in chips) 
Seat 6: maxiv608 ($13.27 in chips) 
Asilvagoat: posts small blind $0.05
boxer821: posts big blind $0.10
*** HOLE CARDS ***
lenboysprite: calls $0.10
eniksenik: raises $0.30 to $0.40
RoJ1: folds 
maxiv608: folds 
Asilvagoat: folds 
boxer821: folds 
lenboysprite: folds 
Uncalled bet ($0.30) returned to eniksenik
eniksenik collected $0.35 from pot
*** SUMMARY ***
Total pot $0.35 | Rake $0 
Seat 1: Asilvagoat (small blind) folded before Flop
Seat 2: boxer821 (big blind) folded before Flop
Seat 3: lenboysprite folded before Flop
Seat 4: eniksenik collected ($0.35)
Seat 5: RoJ1 folded before Flop (didn't bet)
Seat 6: maxiv608 (button) folded before Flop (didn't bet)



PokerStars Hand #166667510628:  Hold'em No Limit ($0.05/$0.10 USD) - 2017/02/23 16:02:29 ET
Table 'Tomyris II' 6-max Seat #6 is the button
Seat 1: ArcticBearDK ($22.03 in chips) 
Seat 2: Yspenyanin ($12.54 in chips) 
Seat 3: robertsabb ($11.66 in chips) 
Seat 4: Dcaro31 ($10 in chips) 
Seat 5: joewatson90 ($12.05 in chips) 
Seat 6: StackSmakka ($12.22 in chips) 
ArcticBearDK: posts small blind $0.05
Yspenyanin: posts big blind $0.10
*** HOLE CARDS ***
robertsabb: folds 
Dcaro31: folds 
joewatson90: raises $0.20 to $0.30
StackSmakka: folds 
ArcticBearDK: folds 
Yspenyanin: folds 
Uncalled bet ($0.20) returned to joewatson90
joewatson90 collected $0.25 from pot
*** SUMMARY ***
Total pot $0.25 | Rake $0 
Seat 1: ArcticBearDK (small blind) folded before Flop
Seat 2: Yspenyanin (big blind) folded before Flop
Seat 3: robertsabb folded before Flop (didn't bet)
Seat 4: Dcaro31 folded before Flop (didn't bet)
Seat 5: joewatson90 collected ($0.25)
Seat 6: StackSmakka (button) folded before Flop (didn't bet)



PokerStars Hand #166667510629:  Hold'em No Limit ($0.05/$0.10 USD) - 2017/02/23 16:02:29 ET
Table 'Scabiosa III' 6-max Seat #3 is the button
Seat 1: Feverhead ($13.26 in chips) 
Seat 2: kinaó ($12.11 in chips) 
Seat 3: Goroshkos88 ($11.40 in chips) 
Seat 4: voledy ($10 in chips) 
Seat 5: patrick19111 ($24.75 in chips) 
Seat 6: Smitty03300 ($10.91 in chips) 
voledy: posts small blind $0.05
patrick19111: posts big blind $0.10
*** HOLE CARDS ***
Smitty03300: folds 
Feverhead: folds 
kinaó: folds 
Goroshkos88: folds 
voledy: raises $0.15 to $0.25
patrick19111: folds 
Uncalled bet ($0.15) returned to voledy
voledy collected $0.20 from pot
*** SUMMARY ***
Total pot $0.20 | Rake $0 
Seat 1: Feverhead folded before Flop (didn't bet)
Seat 2: kinaó folded before Flop (didn't bet)
Seat 3: Goroshkos88 (button) folded before Flop (didn't bet)
Seat 4: voledy (small blind) collected ($0.20)
Seat 5: patrick19111 (big blind) folded before Flop
Seat 6: Smitty03300 folded before Flop (didn't bet)



PokerStars Hand #166667510664:  Hold'em No Limit ($0.05/$0.10 USD) - 2017/02/23 16:02:29 ET
Table 'Sirius II' 6-max Seat #1 is the button
Seat 1: Ampped87 ($13.61 in chips) 
Seat 3: Spud014 ($10.30 in chips) 
Seat 5: pokekrk ($11.63 in chips) 
Seat 6: MihaGr ($10 in chips) 
Spud014: posts small blind $0.05
pokekrk: posts big blind $0.10
*** HOLE CARDS ***
MihaGr: folds 
Buddy8711 joins the table at seat #2 
Ampped87: raises $0.10 to $0.20
Spud014: folds 
pokekrk: folds 
Uncalled bet ($0.10) returned to Ampped87
Ampped87 collected $0.25 from pot
*** SUMMARY ***
Total pot $0.25 | Rake $0 
Seat 1: Ampped87 (button) collected ($0.25)
Seat 3: Spud014 (small blind) folded before Flop
Seat 5: pokekrk (big blind) folded before Flop
Seat 6: MihaGr folded before Flop (didn't bet)



PokerStars Hand #166667510857:  Hold'em No Limit ($0.05/$0.10 USD) - 2017/02/23 16:02:29 ET
Table 'Iduberga II' 6-max Seat #2 is the button
Seat 1: mhonielsen ($10.25 in chips) 
Seat 2: popypaleta ($12.12 in chips) 
Seat 3: scorpionfish ($11.63 in chips) 
Seat 4: Peter0087 ($10.03 in chips) 
Seat 5: Pokeaster ($10.62 in chips) 
Seat 6: tblocos ($13.37 in chips) 
scorpionfish: posts small blind $0.05
Peter0087: posts big blind $0.10
*** HOLE CARDS ***
Pokeaster: folds 
tblocos: calls $0.10
mhonielsen: raises $0.30 to $0.40
popypaleta: folds 
scorpionfish: folds 
Peter0087: folds 
tblocos: calls $0.30
*** FLOP *** [Kd 3s 2d]
tblocos: checks 
mhonielsen: bets $0.53
tblocos: folds 
Uncalled bet ($0.53) returned to mhonielsen
mhonielsen collected $0.91 from pot
*** SUMMARY ***
Total pot $0.95 | Rake $0.04 
Board [Kd 3s 2d]
Seat 1: mhonielsen collected ($0.91)
Seat 2: popypaleta (button) folded before Flop (didn't bet)
Seat 3: scorpionfish (small blind) folded before Flop
Seat 4: Peter0087 (big blind) folded before Flop
Seat 5: Pokeaster folded before Flop (didn't bet)
Seat 6: tblocos folded on the Flop



PokerStars Hand #166667510949:  Hold'em No Limit ($0.05/$0.10 USD) - 2017/02/23 16:02:29 ET
Table 'Kraz II' 6-max Seat #1 is the button
Seat 1: bdixon_5 ($9.70 in chips) 
Seat 2: Smok3008 ($8.13 in chips) 
Seat 3: Eddys Edge ($10.32 in chips) 
Seat 4: WinninBikini ($10.22 in chips) 
Seat 6: tr41n3r12 ($10.15 in chips) 
Smok3008: posts small blind $0.05
Eddys Edge: posts big blind $0.10
Joker51_wtf!: sits out 
*** HOLE CARDS ***
WinninBikini: raises $0.20 to $0.30
tr41n3r12: folds 
bdixon_5: folds 
Smok3008: folds 
Eddys Edge: calls $0.20
*** FLOP *** [6s Kc 6d]
Smok3008 leaves the table
Eddys Edge: checks 
WinninBikini: bets $0.38
Eddys Edge: calls $0.38
*** TURN *** [6s Kc 6d] [9d]
Eddys Edge: checks 
shellyld joins the table at seat #2 
WinninBikini: bets $0.90
Eddys Edge: calls $0.90
*** RIVER *** [6s Kc 6d 9d] [4d]
Eddys Edge: checks 
WinninBikini: checks 
*** SHOW DOWN ***
Eddys Edge: shows [Tc Th] (two pair, Tens and Sixes)
WinninBikini: shows [Ks As] (two pair, Kings and Sixes)
WinninBikini collected $3.07 from pot
*** SUMMARY ***
Total pot $3.21 | Rake $0.14 
Board [6s Kc 6d 9d 4d]
Seat 1: bdixon_5 (button) folded before Flop (didn't bet)
Seat 2: Smok3008 (small blind) folded before Flop
Seat 3: Eddys Edge (big blind) showed [Tc Th] and lost with two pair, Tens and Sixes
Seat 4: WinninBikini showed [Ks As] and won ($3.07) with two pair, Kings and Sixes
Seat 6: tr41n3r12 folded before Flop (didn't bet)



PokerStars Hand #166667510981:  Hold'em No Limit ($0.05/$0.10 USD) - 2017/02/23 16:02:29 ET
Table 'Iapetus III' 6-max Seat #3 is the button
Seat 3: takis nik ($10 in chips) 
Seat 4: XaXaTyH4uK ($10.35 in chips) 
Seat 5: homelessdan ($13.91 in chips) 
Seat 6: yodzik ($9.93 in chips) 
XaXaTyH4uK: posts small blind $0.05
homelessdan: posts big blind $0.10
Crafty23@PS: sits out 
*** HOLE CARDS ***
yodzik: folds 
takis nik: folds 
XaXaTyH4uK: raises $0.20 to $0.30
homelessdan: folds 
Uncalled bet ($0.20) returned to XaXaTyH4uK
XaXaTyH4uK collected $0.20 from pot
*** SUMMARY ***
Total pot $0.20 | Rake $0 
Seat 3: takis nik (button) folded before Flop (didn't bet)
Seat 4: XaXaTyH4uK (small blind) collected ($0.20)
Seat 5: homelessdan (big blind) folded before Flop
Seat 6: yodzik folded before Flop (didn't bet)



PokerStars Hand #166667511550:  Hold'em No Limit ($0.05/$0.10 USD) - 2017/02/23 16:02:30 ET
Table 'Tirela' 6-max Seat #3 is the button
Seat 1: Smitty03300 ($10 in chips) 
Seat 2: Andrei ProFF ($17.79 in chips) 
Seat 3: aim444 ($15.05 in chips) 
Seat 4: ArcticBearDK ($10.06 in chips) 
Seat 5: KRZuff ($10.47 in chips) 
Seat 6: coolisses111 ($9.05 in chips) 
ArcticBearDK: posts small blind $0.05
KRZuff: posts big blind $0.10
*** HOLE CARDS ***
coolisses111: folds 
Smitty03300: folds 
Andrei ProFF: folds 
aim444: calls $0.10
ArcticBearDK: folds 
KRZuff: raises $0.40 to $0.50
aim444: calls $0.40
*** FLOP *** [Th Qs Qd]
KRZuff: bets $0.60
aim444: calls $0.60
*** TURN *** [Th Qs Qd] [2d]
KRZuff: bets $0.90
aim444: calls $0.90
*** RIVER *** [Th Qs Qd 2d] [4c]
KRZuff: checks 
aim444: bets $1.94
KRZuff: folds 
Uncalled bet ($1.94) returned to aim444
aim444 collected $3.87 from pot
*** SUMMARY ***
Total pot $4.05 | Rake $0.18 
Board [Th Qs Qd 2d 4c]
Seat 1: Smitty03300 folded before Flop (didn't bet)
Seat 2: Andrei ProFF folded before Flop (didn't bet)
Seat 3: aim444 (button) collected ($3.87)
Seat 4: ArcticBearDK (small blind) folded before Flop
Seat 5: KRZuff (big blind) folded on the River
Seat 6: coolisses111 folded before Flop (didn't bet)



PokerStars Hand #166667511572:  Hold'em No Limit ($0.05/$0.10 USD) - 2017/02/23 16:02:30 ET
Table 'Klotho II' 6-max Seat #6 is the button
Seat 1: Alexey74516 ($7.37 in chips) 
Seat 2: kickereens ($10.20 in chips) 
Seat 3: Zooplack ($10.73 in chips) 
Seat 4: Lucky HoBBiT ($10.83 in chips) 
Seat 5: david_sara83 ($15.64 in chips) 
Seat 6: D3NyA ($11.57 in chips) 
Alexey74516: posts small blind $0.05
kickereens: posts big blind $0.10
*** HOLE CARDS ***
Zooplack: folds 
Lucky HoBBiT: raises $0.20 to $0.30
david_sara83: folds 
D3NyA: folds 
Alexey74516: calls $0.25
kickereens: folds 
*** FLOP *** [6s 7d Kd]
Alexey74516: checks 
Lucky HoBBiT: bets $0.42
Alexey74516: calls $0.42
*** TURN *** [6s 7d Kd] [Jh]
Alexey74516: checks 
Lucky HoBBiT: checks 
*** RIVER *** [6s 7d Kd Jh] [Qh]
Alexey74516: checks 
Lucky HoBBiT: checks 
*** SHOW DOWN ***
Alexey74516: shows [7c Th] (a pair of Sevens)
Lucky HoBBiT: mucks hand 
Alexey74516 collected $1.47 from pot
*** SUMMARY ***
Total pot $1.54 | Rake $0.07 
Board [6s 7d Kd Jh Qh]
Seat 1: Alexey74516 (small blind) showed [7c Th] and won ($1.47) with a pair of Sevens
Seat 2: kickereens (big blind) folded before Flop
Seat 3: Zooplack folded before Flop (didn't bet)
Seat 4: Lucky HoBBiT mucked
Seat 5: david_sara83 folded before Flop (didn't bet)
Seat 6: D3NyA (button) folded before Flop (didn't bet)



PokerStars Hand #166667511689:  Hold'em No Limit ($0.05/$0.10 USD) - 2017/02/23 16:02:30 ET
Table 'Sheragul III' 6-max Seat #4 is the button
Seat 1: danky24 ($17.66 in chips) 
Seat 2: Bird et al ($11.96 in chips) 
Seat 4: maxiv608 ($11.09 in chips) 
Seat 5: Bandyaev ($14.62 in chips) 
Seat 6: Andrei ProFF ($10 in chips) 
Bandyaev: posts small blind $0.05
Andrei ProFF: posts big blind $0.10
*** HOLE CARDS ***
danky24: folds 
Bird et al: folds 
maxiv608: raises $0.10 to $0.20
Bandyaev: folds 
Andrei ProFF: folds 
Uncalled bet ($0.10) returned to maxiv608
maxiv608 collected $0.25 from pot
*** SUMMARY ***
Total pot $0.25 | Rake $0 
Seat 1: danky24 folded before Flop (didn't bet)
Seat 2: Bird et al folded before Flop (didn't bet)
Seat 4: maxiv608 (button) collected ($0.25)
Seat 5: Bandyaev (small blind) folded before Flop
Seat 6: Andrei ProFF (big blind) folded before Flop



PokerStars Hand #166667511912:  Hold'em No Limit ($0.05/$0.10 USD) - 2017/02/23 16:02:30 ET
Table 'Nuki' 6-max Seat #1 is the button
Seat 1: bdixon_5 ($7.90 in chips) 
Seat 2: ArcticBearDK ($18.63 in chips) 
Seat 3: david_sara83 ($13.77 in chips) 
Seat 4: GESPERIA ($28.61 in chips) 
Seat 5: fabadam ($11.38 in chips) 
Seat 6: Zooplack ($25.27 in chips) 
ArcticBearDK: posts small blind $0.05
david_sara83: posts big blind $0.10
*** HOLE CARDS ***
GESPERIA: folds 
fabadam: raises $0.15 to $0.25
Zooplack: folds 
bdixon_5: calls $0.25
ArcticBearDK: raises $1.05 to $1.30
david_sara83: folds 
fabadam: folds 
bdixon_5: folds 
Uncalled bet ($1.05) returned to ArcticBearDK
ArcticBearDK collected $0.85 from pot
*** SUMMARY ***
Total pot $0.85 | Rake $0 
Seat 1: bdixon_5 (button) folded before Flop
Seat 2: ArcticBearDK (small blind) collected ($0.85)
Seat 3: david_sara83 (big blind) folded before Flop
Seat 4: GESPERIA folded before Flop (didn't bet)
Seat 5: fabadam folded before Flop
Seat 6: Zooplack folded before Flop (didn't bet)



PokerStars Hand #166667512074:  Hold'em No Limit ($0.05/$0.10 USD) - 2017/02/23 16:02:30 ET
Table 'Oongaq' 6-max Seat #3 is the button
Seat 1: Dmitrij218 ($13.60 in chips) 
Seat 2: homelessdan ($19.05 in chips) 
Seat 3: iDecMate ($10 in chips) 
Seat 4: Bird et al ($10 in chips) 
Seat 5: Dizzler1991 ($4.41 in chips) 
Seat 6: boxer821 ($10 in chips) 
Bird et al: posts small blind $0.05
Dizzler1991: posts big blind $0.10
*** HOLE CARDS ***
boxer821: folds 
Dmitrij218: folds 
homelessdan: folds 
iDecMate: folds 
Bird et al: folds 
Uncalled bet ($0.05) returned to Dizzler1991
Dizzler1991 collected $0.10 from pot
*** SUMMARY ***
Total pot $0.10 | Rake $0 
Seat 1: Dmitrij218 folded before Flop (didn't bet)
Seat 2: homelessdan folded before Flop (didn't bet)
Seat 3: iDecMate (button) folded before Flop (didn't bet)
Seat 4: Bird et al (small blind) folded before Flop
Seat 5: Dizzler1991 (big blind) collected ($0.10)
Seat 6: boxer821 folded before Flop (didn't bet)



PokerStars Hand #166667512617:  Hold'em No Limit ($0.05/$0.10 USD) - 2017/02/23 16:02:31 ET
Table 'Senta II' 6-max Seat #3 is the button
Seat 2: NvR.m1nD ($10.63 in chips) 
Seat 3: Aescul@pius ($21.25 in chips) 
Seat 4: fedorka rus ($21.87 in chips) 
Seat 5: Algarah ($6.04 in chips) 
Seat 6: T9MS ($11.92 in chips) 
fedorka rus: posts small blind $0.05
Algarah: posts big blind $0.10
*** HOLE CARDS ***
T9MS: folds 
NvR.m1nD: raises $0.15 to $0.25
Aescul@pius: folds 
fedorka rus: calls $0.20
Algarah: folds 
*** FLOP *** [Qc 7d 3d]
fedorka rus: checks 
NvR.m1nD: bets $0.38
fedorka rus: calls $0.38
*** TURN *** [Qc 7d 3d] [Ks]
fedorka rus: checks 
NvR.m1nD: bets $0.90
fedorka rus: folds 
Uncalled bet ($0.90) returned to NvR.m1nD
NvR.m1nD collected $1.30 from pot
*** SUMMARY ***
Total pot $1.36 | Rake $0.06 
Board [Qc 7d 3d Ks]
Seat 2: NvR.m1nD collected ($1.30)
Seat 3: Aescul@pius (button) folded before Flop (didn't bet)
Seat 4: fedorka rus (small blind) folded on the Turn
Seat 5: Algarah (big blind) folded before Flop
Seat 6: T9MS folded before Flop (didn't bet)



PokerStars Hand #166667512619:  Hold'em No Limit ($0.05/$0.10 USD) - 2017/02/23 16:02:31 ET
Table 'Emma II' 6-max Seat #1 is the button
Seat 1: LarryTheStar ($10 in chips) 
Seat 2: T9MS ($10 in chips) 
Seat 3: oddshoff ($9.67 in chips) 
Seat 4: Jucatorul823 ($5.97 in chips) 
Seat 5: Scanner17 ($11.21 in chips) 
Seat 6: CHRO8 ($14.82 in chips) 
T9MS: posts small blind $0.05
oddshoff: posts big blind $0.10
*** HOLE CARDS ***
Jucatorul823: folds 
Scanner17: folds 
CHRO8 has timed out
CHRO8: folds 
LarryTheStar: raises $0.10 to $0.20
T9MS: raises $0.60 to $0.80
oddshoff: folds 
LarryTheStar: calls $0.60
*** FLOP *** [Ac 6c 7d]
T9MS: bets $0.90
LarryTheStar: calls $0.90
*** TURN *** [Ac 6c 7d] [7h]
T9MS: bets $1.85
LarryTheStar: folds 
Uncalled bet ($1.85) returned to T9MS
T9MS collected $3.34 from pot
*** SUMMARY ***
Total pot $3.50 | Rake $0.16 
Board [Ac 6c 7d 7h]
Seat 1: LarryTheStar (button) folded on the Turn
Seat 2: T9MS (small blind) collected ($3.34)
Seat 3: oddshoff (big blind) folded before Flop
Seat 4: Jucatorul823 folded before Flop (didn't bet)
Seat 5: Scanner17 folded before Flop (didn't bet)
Seat 6: CHRO8 folded before Flop (didn't bet)



PokerStars Hand #166667512644:  Hold'em No Limit ($0.05/$0.10 USD) - 2017/02/23 16:02:31 ET
Table 'Halawe II' 6-max Seat #4 is the button
Seat 1: DIGOR100 ($6.87 in chips) 
Seat 2: Darkfrai ($10 in chips) 
Seat 3: cherep61987 ($10.72 in chips) 
Seat 4: voledy ($12.55 in chips) 
Seat 5: takis nik ($12.48 in chips) 
Seat 6: Rodik002 ($20.52 in chips) 
takis nik: posts small blind $0.05
Rodik002: posts big blind $0.10
*** HOLE CARDS ***
DIGOR100: raises $0.20 to $0.30
Darkfrai: folds 
cherep61987: folds 
voledy: folds 
takis nik: folds 
Rodik002: folds 
Uncalled bet ($0.20) returned to DIGOR100
DIGOR100 collected $0.25 from pot
*** SUMMARY ***
Total pot $0.25 | Rake $0 
Seat 1: DIGOR100 collected ($0.25)
Seat 2: Darkfrai folded before Flop (didn't bet)
Seat 3: cherep61987 folded before Flop (didn't bet)
Seat 4: voledy (button) folded before Flop (didn't bet)
Seat 5: takis nik (small blind) folded before Flop
Seat 6: Rodik002 (big blind) folded before Flop



PokerStars Hand #166667512688:  Hold'em No Limit ($0.05/$0.10 USD) - 2017/02/23 16:02:31 ET
Table 'Kobresia II' 6-max Seat #2 is the button
Seat 1: RoJ1 ($13.96 in chips) 
Seat 2: Dcaro31 ($13.44 in chips) 
Seat 3: FRAID358 ($10.74 in chips) 
Seat 4: armstv ($11.02 in chips) 
Seat 5: Goroshkos88 ($11.89 in chips) 
Seat 6: WinninBikini ($10 in chips) 
FRAID358: posts small blind $0.05
armstv: posts big blind $0.10
*** HOLE CARDS ***
Goroshkos88: folds 
WinninBikini: folds 
RoJ1: folds 
Dcaro31: folds 
FRAID358: raises $0.15 to $0.25
armstv: folds 
Uncalled bet ($0.15) returned to FRAID358
FRAID358 collected $0.20 from pot
*** SUMMARY ***
Total pot $0.20 | Rake $0 
Seat 1: RoJ1 folded before Flop (didn't bet)
Seat 2: Dcaro31 (button) folded before Flop (didn't bet)
Seat 3: FRAID358 (small blind) collected ($0.20)
Seat 4: armstv (big blind) folded before Flop
Seat 5: Goroshkos88 folded before Flop (didn't bet)
Seat 6: WinninBikini folded before Flop (didn't bet)



PokerStars Hand #166667512754:  Hold'em No Limit ($0.05/$0.10 USD) - 2017/02/23 16:02:31 ET
Table 'Sham' 6-max Seat #6 is the button
Seat 1: pancernik21 ($10 in chips) 
Seat 2: ex3Lero86 ($10.30 in chips) 
Seat 3: weez3r ($22.83 in chips) 
Seat 4: VAD21 ($12.80 in chips) 
Seat 5: T9MS ($10.28 in chips) 
Seat 6: bdixon_5 ($9.55 in chips) 
pancernik21: posts small blind $0.05
ex3Lero86: posts big blind $0.10
*** HOLE CARDS ***
weez3r: folds 
VAD21: raises $0.20 to $0.30
T9MS: folds 
bdixon_5: folds 
pancernik21: folds 
ex3Lero86: folds 
Uncalled bet ($0.20) returned to VAD21
VAD21 collected $0.25 from pot
*** SUMMARY ***
Total pot $0.25 | Rake $0 
Seat 1: pancernik21 (small blind) folded before Flop
Seat 2: ex3Lero86 (big blind) folded before Flop
Seat 3: weez3r folded before Flop (didn't bet)
Seat 4: VAD21 collected ($0.25)
Seat 5: T9MS folded before Flop (didn't bet)
Seat 6: bdixon_5 (button) folded before Flop (didn't bet)



PokerStars Hand #166667512903:  Hold'em No Limit ($0.05/$0.10 USD) - 2017/02/23 16:02:31 ET
Table 'Pompeja III' 6-max Seat #4 is the button
Seat 1: Iarlei ($12.04 in chips) 
Seat 2: steepfell ($10.69 in chips) 
Seat 3: Yspenyanin ($12 in chips) 
Seat 4: Cluckh ($11.91 in chips) 
Seat 5: Spud014 ($12.19 in chips) 
Seat 6: mega spasser ($5.10 in chips) 
Spud014: posts small blind $0.05
mega spasser: posts big blind $0.10
*** HOLE CARDS ***
Iarlei: folds 
steepfell: folds 
Yspenyanin: folds 
Cluckh: raises $0.15 to $0.25
Spud014: folds 
mega spasser: folds 
Uncalled bet ($0.15) returned to Cluckh
Cluckh collected $0.25 from pot
*** SUMMARY ***
Total pot $0.25 | Rake $0 
Seat 1: Iarlei folded before Flop (didn't bet)
Seat 2: steepfell folded before Flop (didn't bet)
Seat 3: Yspenyanin folded before Flop (didn't bet)
Seat 4: Cluckh (button) collected ($0.25)
Seat 5: Spud014 (small blind) folded before Flop
Seat 6: mega spasser (big blind) folded before Flop



PokerStars Hand #166667513106:  Hold'em No Limit ($0.05/$0.10 USD) - 2017/02/23 16:02:31 ET
Table 'Brambilla II' 6-max Seat #1 is the button
Seat 1: Rodik002 ($10.78 in chips) 
Seat 2: dwonder75 ($15.98 in chips) 
Seat 3: BORIS_ENEV ($14.39 in chips) 
Seat 4: david_sara83 ($12.07 in chips) 
Seat 5: FRAID358 ($10 in chips) 
Seat 6: boxer821 ($10.48 in chips) 
dwonder75: posts small blind $0.05
BORIS_ENEV: posts big blind $0.10
*** HOLE CARDS ***
david_sara83: folds 
FRAID358: folds 
boxer821: folds 
Rodik002: raises $0.10 to $0.20
dwonder75: calls $0.15
BORIS_ENEV: folds 
*** FLOP *** [Ts 5d Ks]
dwonder75: checks 
Rodik002: checks 
*** TURN *** [Ts 5d Ks] [2s]
dwonder75: bets $0.30
Rodik002: raises $0.59 to $0.89
dwonder75: calls $0.59
*** RIVER *** [Ts 5d Ks 2s] [9s]
dwonder75: bets $1.10
Rodik002: raises $2.58 to $3.68
dwonder75: folds 
Uncalled bet ($2.58) returned to Rodik002
Rodik002 collected $4.28 from pot
*** SUMMARY ***
Total pot $4.48 | Rake $0.20 
Board [Ts 5d Ks 2s 9s]
Seat 1: Rodik002 (button) collected ($4.28)
Seat 2: dwonder75 (small blind) folded on the River
Seat 3: BORIS_ENEV (big blind) folded before Flop
Seat 4: david_sara83 folded before Flop (didn't bet)
Seat 5: FRAID358 folded before Flop (didn't bet)
Seat 6: boxer821 folded before Flop (didn't bet)



PokerStars Hand #166667513249:  Hold'em No Limit ($0.05/$0.10 USD) - 2017/02/23 16:02:31 ET
Table 'Azelfafage' 6-max Seat #4 is the button
Seat 1: Sbozzz ($15.76 in chips) 
Seat 2: tr41n3r12 ($10.30 in chips) 
Seat 3: todor1711 ($19.93 in chips) 
Seat 4: fedorka rus ($10.32 in chips) 
Seat 5: 8th wonders ($12.78 in chips) 
Seat 6: KA3AXCTAHEU, ($10 in chips) 
8th wonders: posts small blind $0.05
KA3AXCTAHEU,: posts big blind $0.10
*** HOLE CARDS ***
Sbozzz: folds 
tr41n3r12: folds 
todor1711: raises $0.10 to $0.20
fedorka rus: calls $0.20
8th wonders: calls $0.15
KA3AXCTAHEU,: calls $0.10
*** FLOP *** [Kh Qd Qh]
8th wonders: checks 
KA3AXCTAHEU,: checks 
todor1711: bets $1
fedorka rus: folds 
8th wonders: folds 
KA3AXCTAHEU,: folds 
Uncalled bet ($1) returned to todor1711
todor1711 collected $0.76 from pot
*** SUMMARY ***
Total pot $0.80 | Rake $0.04 
Board [Kh Qd Qh]
Seat 1: Sbozzz folded before Flop (didn't bet)
Seat 2: tr41n3r12 folded before Flop (didn't bet)
Seat 3: todor1711 collected ($0.76)
Seat 4: fedorka rus (button) folded on the Flop
Seat 5: 8th wonders (small blind) folded on the Flop
Seat 6: KA3AXCTAHEU, (big blind) folded on the Flop



PokerStars Hand #166667513290:  Hold'em No Limit ($0.05/$0.10 USD) - 2017/02/23 16:02:31 ET
Table 'Stroobantia' 6-max Seat #4 is the button
Seat 1: mam9zyc ($7.55 in chips) 
Seat 2: XwinX25 ($10.34 in chips) 
Seat 3: Namhkal ($10 in chips) 
Seat 4: Yspenyanin ($10.13 in chips) 
Seat 5: boxer821 ($10.54 in chips) 
Seat 6: KokoulinV ($15.67 in chips) 
boxer821: posts small blind $0.05
KokoulinV: posts big blind $0.10
*** HOLE CARDS ***
mam9zyc: calls $0.10
XwinX25: folds 
Namhkal: raises $0.35 to $0.45
Yspenyanin: folds 
boxer821: folds 
KokoulinV: folds 
mam9zyc: calls $0.35
*** FLOP *** [Td 2c 6d]
mam9zyc: bets $0.70
Namhkal: calls $0.70
*** TURN *** [Td 2c 6d] [9h]
mam9zyc: bets $1.80
Namhkal: folds 
Uncalled bet ($1.80) returned to mam9zyc
mam9zyc collected $2.34 from pot
*** SUMMARY ***
Total pot $2.45 | Rake $0.11 
Board [Td 2c 6d 9h]
Seat 1: mam9zyc collected ($2.34)
Seat 2: XwinX25 folded before Flop (didn't bet)
Seat 3: Namhkal folded on the Turn
Seat 4: Yspenyanin (button) folded before Flop (didn't bet)
Seat 5: boxer821 (small blind) folded before Flop
Seat 6: KokoulinV (big blind) folded before Flop



PokerStars Hand #166667513466:  Hold'em No Limit ($0.05/$0.10 USD) - 2017/02/23 16:02:32 ET
Table 'Girtab II' 6-max Seat #6 is the button
Seat 1: Kow6oy ($10.05 in chips) 
Seat 2: Pokeaster ($13.77 in chips) 
Seat 4: Hyd SK ($27.03 in chips) 
Seat 5: dzesio18 ($12.19 in chips) 
Seat 6: DamDatsAnAce ($10 in chips) 
Kow6oy: posts small blind $0.05
Pokeaster: posts big blind $0.10
chimera252: sits out 
*** HOLE CARDS ***
Hyd SK: folds 
dzesio18: raises $0.25 to $0.35
DamDatsAnAce: folds 
Kow6oy: folds 
Pokeaster: folds 
Uncalled bet ($0.25) returned to dzesio18
dzesio18 collected $0.25 from pot
*** SUMMARY ***
Total pot $0.25 | Rake $0 
Seat 1: Kow6oy (small blind) folded before Flop
Seat 2: Pokeaster (big blind) folded before Flop
Seat 4: Hyd SK folded before Flop (didn't bet)
Seat 5: dzesio18 collected ($0.25)
Seat 6: DamDatsAnAce (button) folded before Flop (didn't bet)



PokerStars Hand #166667514102:  Hold'em No Limit ($0.05/$0.10 USD) - 2017/02/23 16:02:32 ET
Table 'Pirola III' 6-max Seat #1 is the button
Seat 1: bdixon_5 ($9.77 in chips) 
Seat 2: gaHy_HaXeP ($10 in chips) 
Seat 3: kingartur222 ($10.37 in chips) 
Seat 4: McCleans ($10.45 in chips) 
Seat 6: T9MS ($10 in chips) 
gaHy_HaXeP: posts small blind $0.05
kingartur222: posts big blind $0.10
tequila_joop: sits out 
*** HOLE CARDS ***
McCleans: folds 
T9MS: folds 
bdixon_5: raises $0.20 to $0.30
gaHy_HaXeP: calls $0.25
kingartur222: raises $1 to $1.30
bdixon_5: folds 
gaHy_HaXeP: folds 
Uncalled bet ($1) returned to kingartur222
kingartur222 collected $0.90 from pot
*** SUMMARY ***
Total pot $0.90 | Rake $0 
Seat 1: bdixon_5 (button) folded before Flop
Seat 2: gaHy_HaXeP (small blind) folded before Flop
Seat 3: kingartur222 (big blind) collected ($0.90)
Seat 4: McCleans folded before Flop (didn't bet)
Seat 6: T9MS folded before Flop (didn't bet)



PokerStars Hand #166667514220:  Hold'em No Limit ($0.05/$0.10 USD) - 2017/02/23 16:02:32 ET
Table 'Lesath III' 6-max Seat #4 is the button
Seat 1: Gogeta26 ($6.57 in chips) 
Seat 2: WinninBikini ($10.03 in chips) 
Seat 3: Giyorod ($10 in chips) 
Seat 4: Eddys Edge ($10 in chips) 
Seat 5: eniksenik ($16.05 in chips) 
Seat 6: patrick19111 ($10.71 in chips) 
eniksenik: posts small blind $0.05
patrick19111: posts big blind $0.10
*** HOLE CARDS ***
Gogeta26: folds 
WinninBikini: raises $0.20 to $0.30
Giyorod: folds 
Eddys Edge: folds 
eniksenik: folds 
patrick19111: folds 
Uncalled bet ($0.20) returned to WinninBikini
WinninBikini collected $0.25 from pot
*** SUMMARY ***
Total pot $0.25 | Rake $0 
Seat 1: Gogeta26 folded before Flop (didn't bet)
Seat 2: WinninBikini collected ($0.25)
Seat 3: Giyorod folded before Flop (didn't bet)
Seat 4: Eddys Edge (button) folded before Flop (didn't bet)
Seat 5: eniksenik (small blind) folded before Flop
Seat 6: patrick19111 (big blind) folded before Flop



PokerStars Hand #166667514266:  Hold'em No Limit ($0.05/$0.10 USD) - 2017/02/23 16:02:32 ET
Table 'Armenia' 6-max Seat #5 is the button
Seat 1: tr41n3r12 ($12.17 in chips) 
Seat 2: Yabidooo ($11.87 in chips) 
Seat 4: x3ultimate ($10 in chips) 
Seat 5: boxer821 ($12.10 in chips) 
Seat 6: mega spasser ($5.12 in chips) 
mega spasser: posts small blind $0.05
tr41n3r12: posts big blind $0.10
XwinX25: sits out 
*** HOLE CARDS ***
Yabidooo: folds 
x3ultimate: raises $0.20 to $0.30
boxer821: folds 
mega spasser: folds 
tr41n3r12: folds 
Uncalled bet ($0.20) returned to x3ultimate
x3ultimate collected $0.25 from pot
*** SUMMARY ***
Total pot $0.25 | Rake $0 
Seat 1: tr41n3r12 (big blind) folded before Flop
Seat 2: Yabidooo folded before Flop (didn't bet)
Seat 4: x3ultimate collected ($0.25)
Seat 5: boxer821 (button) folded before Flop (didn't bet)
Seat 6: mega spasser (small blind) folded before Flop



PokerStars Hand #166667514377:  Hold'em No Limit ($0.05/$0.10 USD) - 2017/02/23 16:02:33 ET
Table 'Izar' 6-max Seat #3 is the button
Seat 1: bambolejro ($10.54 in chips) 
Seat 2: mvp0013 ($10.89 in chips) 
Seat 3: Yspenyanin ($10.90 in chips) 
Seat 4: Matee92 ($6.56 in chips) 
Seat 5: fishhook5 ($10.35 in chips) 
Matee92: posts small blind $0.05
fishhook5: posts big blind $0.10
yodzik: sits out 
*** HOLE CARDS ***
bambolejro: folds 
mvp0013: folds 
Yspenyanin: folds 
Matee92: folds 
Uncalled bet ($0.05) returned to fishhook5
fishhook5 collected $0.10 from pot
*** SUMMARY ***
Total pot $0.10 | Rake $0 
Seat 1: bambolejro folded before Flop (didn't bet)
Seat 2: mvp0013 folded before Flop (didn't bet)
Seat 3: Yspenyanin (button) folded before Flop (didn't bet)
Seat 4: Matee92 (small blind) folded before Flop
Seat 5: fishhook5 (big blind) collected ($0.10)



PokerStars Hand #166667514547:  Hold'em No Limit ($0.05/$0.10 USD) - 2017/02/23 16:02:33 ET
Table 'Tyche III' 6-max Seat #5 is the button
Seat 1: milt65 ($10.31 in chips) 
Seat 2: arti192837 ($12.53 in chips) 
Seat 3: ChuikaPridi ($9.79 in chips) 
Seat 4: Kazacha ($10 in chips) 
Seat 5: chimera252 ($11.75 in chips) 
Seat 6: Ice_Isayev ($10 in chips) 
Ice_Isayev: posts small blind $0.05
milt65: posts big blind $0.10
*** HOLE CARDS ***
arti192837: folds 
ChuikaPridi: raises $0.20 to $0.30
Kazacha: folds 
chimera252: folds 
Ice_Isayev: folds 
milt65: folds 
Uncalled bet ($0.20) returned to ChuikaPridi
ChuikaPridi collected $0.25 from pot
*** SUMMARY ***
Total pot $0.25 | Rake $0 
Seat 1: milt65 (big blind) folded before Flop
Seat 2: arti192837 folded before Flop (didn't bet)
Seat 3: ChuikaPridi collected ($0.25)
Seat 4: Kazacha folded before Flop (didn't bet)
Seat 5: chimera252 (button) folded before Flop (didn't bet)
Seat 6: Ice_Isayev (small blind) folded before Flop



PokerStars Hand #166667514739:  Hold'em No Limit ($0.05/$0.10 USD) - 2017/02/23 16:02:33 ET
Table 'Carina' 6-max Seat #2 is the button
Seat 2: kickereens ($24.24 in chips) 
Seat 3: LarryTheStar ($10 in chips) 
Seat 4: crazydevill ($10.15 in chips) 
Seat 6: alexweezer ($9.95 in chips) 
LarryTheStar: posts small blind $0.05
crazydevill: posts big blind $0.10
IAntikI: sits out 
Kupi007: sits out 
*** HOLE CARDS ***
alexweezer: folds 
kickereens: folds 
LarryTheStar: raises $0.20 to $0.30
crazydevill: folds 
Uncalled bet ($0.20) returned to LarryTheStar
LarryTheStar collected $0.20 from pot
*** SUMMARY ***
Total pot $0.20 | Rake $0 
Seat 2: kickereens (button) folded before Flop (didn't bet)
Seat 3: LarryTheStar (small blind) collected ($0.20)
Seat 4: crazydevill (big blind) folded before Flop
Seat 6: alexweezer folded before Flop (didn't bet)



PokerStars Hand #166667514784:  Hold'em No Limit ($0.05/$0.10 USD) - 2017/02/23 16:02:33 ET
Table 'Bootes' 6-max Seat #3 is the button
Seat 1: Namhkal ($13.20 in chips) 
Seat 2: Bird et al ($19.45 in chips) 
Seat 3: KA3AXCTAHEU, ($19.63 in chips) 
Seat 4: totonove ($4.46 in chips) 
Seat 5: Pekaml ($15.19 in chips) 
Seat 6: cherep61987 ($10.37 in chips) 
totonove: posts small blind $0.05
Pekaml: posts big blind $0.10
*** HOLE CARDS ***
cherep61987: folds 
Namhkal: folds 
Bird et al: folds 
KA3AXCTAHEU,: folds 
totonove: raises $0.10 to $0.20
Pekaml: folds 
Uncalled bet ($0.10) returned to totonove
totonove collected $0.20 from pot
*** SUMMARY ***
Total pot $0.20 | Rake $0 
Seat 1: Namhkal folded before Flop (didn't bet)
Seat 2: Bird et al folded before Flop (didn't bet)
Seat 3: KA3AXCTAHEU, (button) folded before Flop (didn't bet)
Seat 4: totonove (small blind) collected ($0.20)
Seat 5: Pekaml (big blind) folded before Flop
Seat 6: cherep61987 folded before Flop (didn't bet)



PokerStars Hand #166667514942:  Hold'em No Limit ($0.05/$0.10 USD) - 2017/02/23 16:02:33 ET
Table 'Orthos III' 6-max Seat #2 is the button
Seat 1: sexy_seagull ($10 in chips) 
Seat 2: Xander188 ($16.03 in chips) 
Seat 3: koka4cs ($6.76 in chips) 
Seat 4: FlopsterGB ($14.79 in chips) 
Seat 5: Bird et al ($20.62 in chips) 
Seat 6: RoJ1 ($10.79 in chips) 
koka4cs: posts small blind $0.05
FlopsterGB: posts big blind $0.10
*** HOLE CARDS ***
Bird et al: folds 
RoJ1: folds 
sexy_seagull: raises $0.20 to $0.30
Xander188: folds 
koka4cs: calls $0.25
FlopsterGB: calls $0.20
*** FLOP *** [4c 3c Qh]
koka4cs: checks 
FlopsterGB: bets $0.41
sexy_seagull: folds 
koka4cs: calls $0.41
*** TURN *** [4c 3c Qh] [Kd]
koka4cs: checks 
FlopsterGB: checks 
*** RIVER *** [4c 3c Qh Kd] [2s]
koka4cs: checks 
FlopsterGB: checks 
*** SHOW DOWN ***
koka4cs: shows [Ac 2c] (a pair of Deuces)
FlopsterGB: shows [8h 8s] (a pair of Eights)
FlopsterGB collected $1.64 from pot
*** SUMMARY ***
Total pot $1.72 | Rake $0.08 
Board [4c 3c Qh Kd 2s]
Seat 1: sexy_seagull folded on the Flop
Seat 2: Xander188 (button) folded before Flop (didn't bet)
Seat 3: koka4cs (small blind) showed [Ac 2c] and lost with a pair of Deuces
Seat 4: FlopsterGB (big blind) showed [8h 8s] and won ($1.64) with a pair of Eights
Seat 5: Bird et al folded before Flop (didn't bet)
Seat 6: RoJ1 folded before Flop (didn't bet)



PokerStars Hand #166667515083:  Hold'em No Limit ($0.05/$0.10 USD) - 2017/02/23 16:02:33 ET
Table 'Lederle' 6-max Seat #6 is the button
Seat 2: truck1234 ($15.90 in chips) 
Seat 3: Kazacha ($10.50 in chips) 
Seat 4: Pokeaster ($13.61 in chips) 
Seat 5: 8th wonders ($14.16 in chips) 
Seat 6: pokekrk ($10 in chips) 
truck1234: posts small blind $0.05
Kazacha: posts big blind $0.10
*** HOLE CARDS ***
Pokeaster: folds 
8th wonders: folds 
pokekrk: folds 
truck1234: folds 
Uncalled bet ($0.05) returned to Kazacha
Kazacha collected $0.10 from pot
*** SUMMARY ***
Total pot $0.10 | Rake $0 
Seat 2: truck1234 (small blind) folded before Flop
Seat 3: Kazacha (big blind) collected ($0.10)
Seat 4: Pokeaster folded before Flop (didn't bet)
Seat 5: 8th wonders folded before Flop (didn't bet)
Seat 6: pokekrk (button) folded before Flop (didn't bet)



PokerStars Hand #166667515161:  Hold'em No Limit ($0.05/$0.10 USD) - 2017/02/23 16:02:33 ET
Table 'Selinur' 6-max Seat #6 is the button
Seat 1: KA3AXCTAHEU, ($10 in chips) 
Seat 3: bambolejro ($10.52 in chips) 
Seat 4: freezing666 ($11.63 in chips) 
Seat 5: IAntikI ($10.37 in chips) 
Seat 6: homelessdan ($17.77 in chips) 
KA3AXCTAHEU,: posts small blind $0.05
jamalungma: is sitting out 
jamalungma leaves the table
bambolejro: posts big blind $0.10
*** HOLE CARDS ***
freezing666: folds 
fredrik10528 joins the table at seat #2 
IAntikI: folds 
fredrik10528 leaves the table
homelessdan: raises $0.15 to $0.25
KA3AXCTAHEU,: folds 
hoedje72 joins the table at seat #2 
bambolejro: folds 
Uncalled bet ($0.15) returned to homelessdan
homelessdan collected $0.25 from pot
*** SUMMARY ***
Total pot $0.25 | Rake $0 
Seat 1: KA3AXCTAHEU, (small blind) folded before Flop
Seat 3: bambolejro (big blind) folded before Flop
Seat 4: freezing666 folded before Flop (didn't bet)
Seat 5: IAntikI folded before Flop (didn't bet)
Seat 6: homelessdan (button) collected ($0.25)



PokerStars Hand #166667515294:  Hold'em No Limit ($0.05/$0.10 USD) - 2017/02/23 16:02:34 ET
Table 'Hunnia' 6-max Seat #6 is the button
Seat 1: univibe68 ($22.70 in chips) 
Seat 2: mhonielsen ($10 in chips) 
Seat 4: Jalida3 ($9.41 in chips) 
Seat 5: Smarkon ($14.78 in chips) 
Seat 6: ChuikaPridi ($9.07 in chips) 
univibe68: posts small blind $0.05
mhonielsen: posts big blind $0.10
6ePeMeHHa9: sits out 
*** HOLE CARDS ***
Jalida3: folds 
Smarkon: folds 
ChuikaPridi: folds 
univibe68: folds 
Uncalled bet ($0.05) returned to mhonielsen
mhonielsen collected $0.10 from pot
*** SUMMARY ***
Total pot $0.10 | Rake $0 
Seat 1: univibe68 (small blind) folded before Flop
Seat 2: mhonielsen (big blind) collected ($0.10)
Seat 4: Jalida3 folded before Flop (didn't bet)
Seat 5: Smarkon folded before Flop (didn't bet)
Seat 6: ChuikaPridi (button) folded before Flop (didn't bet)



PokerStars Hand #166667515529:  Hold'em No Limit ($0.05/$0.10 USD) - 2017/02/23 16:02:34 ET
Table 'Siebohme' 6-max Seat #1 is the button
Seat 1: kusa4ki ($11.38 in chips) 
Seat 2: el toro 1507 ($11.73 in chips) 
Seat 3: ex3Lero86 ($10.15 in chips) 
Seat 4: Innerwuss ($10.09 in chips) 
Seat 5: Kazacha ($10.10 in chips) 
Seat 6: townerz1991 ($10.53 in chips) 
el toro 1507: posts small blind $0.05
ex3Lero86: posts big blind $0.10
*** HOLE CARDS ***
Innerwuss: folds 
Kazacha: folds 
townerz1991: folds 
kusa4ki: folds 
el toro 1507: raises $0.10 to $0.20
ex3Lero86: raises $0.60 to $0.80
el toro 1507: folds 
Uncalled bet ($0.60) returned to ex3Lero86
ex3Lero86 collected $0.40 from pot
*** SUMMARY ***
Total pot $0.40 | Rake $0 
Seat 1: kusa4ki (button) folded before Flop (didn't bet)
Seat 2: el toro 1507 (small blind) folded before Flop
Seat 3: ex3Lero86 (big blind) collected ($0.40)
Seat 4: Innerwuss folded before Flop (didn't bet)
Seat 5: Kazacha folded before Flop (didn't bet)
Seat 6: townerz1991 folded before Flop (didn't bet)



PokerStars Hand #166667515549:  Hold'em No Limit ($0.05/$0.10 USD) - 2017/02/23 16:02:34 ET
Table 'Hajek III' 6-max Seat #3 is the button
Seat 1: MBen10 ($10.75 in chips) 
Seat 2: fortieth ($12.23 in chips) 
Seat 3: fedorka rus ($10.46 in chips) 
Seat 4: NvR.m1nD ($10.57 in chips) 
Seat 5: Croplayer1 ($15.56 in chips) 
Seat 6: fabadam ($22.46 in chips) 
NvR.m1nD: posts small blind $0.05
Croplayer1: posts big blind $0.10
*** HOLE CARDS ***
fabadam: raises $0.15 to $0.25
MBen10: folds 
fortieth: calls $0.25
fedorka rus: folds 
NvR.m1nD: calls $0.20
Croplayer1: calls $0.15
*** FLOP *** [6c Ts 9d]
NvR.m1nD: checks 
Croplayer1: checks 
fabadam: checks 
fortieth: bets $0.51
NvR.m1nD: calls $0.51
Croplayer1: calls $0.51
fabadam: folds 
*** TURN *** [6c Ts 9d] [Jd]
NvR.m1nD: checks 
Croplayer1: checks 
fortieth: bets $1.28
NvR.m1nD: calls $1.28
Croplayer1: folds 
*** RIVER *** [6c Ts 9d Jd] [Qd]
NvR.m1nD: checks 
fortieth: checks 
*** SHOW DOWN ***
NvR.m1nD: shows [Qc Tc] (two pair, Queens and Tens)
fortieth: mucks hand 
NvR.m1nD collected $4.86 from pot
*** SUMMARY ***
Total pot $5.09 | Rake $0.23 
Board [6c Ts 9d Jd Qd]
Seat 1: MBen10 folded before Flop (didn't bet)
Seat 2: fortieth mucked
Seat 3: fedorka rus (button) folded before Flop (didn't bet)
Seat 4: NvR.m1nD (small blind) showed [Qc Tc] and won ($4.86) with two pair, Queens and Tens
Seat 5: Croplayer1 (big blind) folded on the Turn
Seat 6: fabadam folded on the Flop



PokerStars Hand #166667516006:  Hold'em No Limit ($0.05/$0.10 USD) - 2017/02/23 16:02:34 ET
Table 'Bengt' 6-max Seat #2 is the button
Seat 1: Lucky HoBBiT ($12.50 in chips) 
Seat 2: ChefRocco ($20.70 in chips) 
Seat 3: nantes15 ($12.41 in chips) 
Seat 4: 8th wonders ($10 in chips) 
Seat 5: RoJ1 ($10.46 in chips) 
Seat 6: Goroshkos88 ($10 in chips) 
nantes15: posts small blind $0.05
8th wonders: posts big blind $0.10
*** HOLE CARDS ***
RoJ1: folds 
Goroshkos88: folds 
Lucky HoBBiT: folds 
ChefRocco: calls $0.10
nantes15: calls $0.05
8th wonders: checks 
*** FLOP *** [9c 3c 5d]
nantes15: bets $0.15
8th wonders: calls $0.15
ChefRocco: calls $0.15
*** TURN *** [9c 3c 5d] [5c]
nantes15: checks 
8th wonders: checks 
ChefRocco: checks 
*** RIVER *** [9c 3c 5d 5c] [Ts]
nantes15: bets $1
8th wonders: folds 
ChefRocco: folds 
Uncalled bet ($1) returned to nantes15
nantes15 collected $0.72 from pot
*** SUMMARY ***
Total pot $0.75 | Rake $0.03 
Board [9c 3c 5d 5c Ts]
Seat 1: Lucky HoBBiT folded before Flop (didn't bet)
Seat 2: ChefRocco (button) folded on the River
Seat 3: nantes15 (small blind) collected ($0.72)
Seat 4: 8th wonders (big blind) folded on the River
Seat 5: RoJ1 folded before Flop (didn't bet)
Seat 6: Goroshkos88 folded before Flop (didn't bet)



PokerStars Hand #166667516266:  Hold'em No Limit ($0.05/$0.10 USD) - 2017/02/23 16:02:35 ET
Table 'Atalante' 6-max Seat #2 is the button
Seat 1: OceanBlue100 ($5.09 in chips) 
Seat 2: CiisCi ($19.77 in chips) 
Seat 3: Kow6oy ($10 in chips) 
Seat 4: Dcaro31 ($25.22 in chips) 
Seat 5: eniksenik ($10.29 in chips) 
Seat 6: FlopsterGB ($30.23 in chips) 
Kow6oy: posts small blind $0.05
Dcaro31: posts big blind $0.10
*** HOLE CARDS ***
eniksenik: folds 
FlopsterGB: folds 
OceanBlue100: raises $0.10 to $0.20
CiisCi: folds 
Kow6oy: folds 
Dcaro31: folds 
Uncalled bet ($0.10) returned to OceanBlue100
OceanBlue100 collected $0.25 from pot
*** SUMMARY ***
Total pot $0.25 | Rake $0 
Seat 1: OceanBlue100 collected ($0.25)
Seat 2: CiisCi (button) folded before Flop (didn't bet)
Seat 3: Kow6oy (small blind) folded before Flop
Seat 4: Dcaro31 (big blind) folded before Flop
Seat 5: eniksenik folded before Flop (didn't bet)
Seat 6: FlopsterGB folded before Flop (didn't bet)



PokerStars Hand #166667516748:  Hold'em No Limit ($0.05/$0.10 USD) - 2017/02/23 16:02:35 ET
Table 'Arduina' 6-max Seat #4 is the button
Seat 1: kickereens ($18.44 in chips) 
Seat 2: Andy Wolf ($14.60 in chips) 
Seat 3: Dcaro31 ($13.11 in chips) 
Seat 4: ChuikaPridi ($30.73 in chips) 
Seat 5: ettedallas ($5.06 in chips) 
Seat 6: dierri ($10.14 in chips) 
ettedallas: posts small blind $0.05
dierri: posts big blind $0.10
*** HOLE CARDS ***
kickereens: raises $0.20 to $0.30
Andy Wolf: folds 
Dcaro31: folds 
ChuikaPridi: folds 
ettedallas: folds 
dierri: folds 
Uncalled bet ($0.20) returned to kickereens
kickereens collected $0.25 from pot
*** SUMMARY ***
Total pot $0.25 | Rake $0 
Seat 1: kickereens collected ($0.25)
Seat 2: Andy Wolf folded before Flop (didn't bet)
Seat 3: Dcaro31 folded before Flop (didn't bet)
Seat 4: ChuikaPridi (button) folded before Flop (didn't bet)
Seat 5: ettedallas (small blind) folded before Flop
Seat 6: dierri (big blind) folded before Flop



PokerStars Hand #166667516900:  Hold'em No Limit ($0.05/$0.10 USD) - 2017/02/23 16:02:35 ET
Table 'Nekkar' 6-max Seat #2 is the button
Seat 2: Bird et al ($10 in chips) 
Seat 3: Zemz_Ru ($16.79 in chips) 
Seat 4: kingartur222 ($12.25 in chips) 
Seat 5: Vrinni ($12.10 in chips) 
Seat 6: Eddys Edge ($10.73 in chips) 
Zemz_Ru: posts small blind $0.05
kingartur222: posts big blind $0.10
*** HOLE CARDS ***
Vrinni: raises $0.20 to $0.30
Eddys Edge: folds 
Bird et al: calls $0.30
Zemz_Ru: calls $0.25
kingartur222: folds 
*** FLOP *** [Qs 5s Qc]
Zemz_Ru: checks 
Vrinni: checks 
Bird et al: checks 
*** TURN *** [Qs 5s Qc] [3c]
Zemz_Ru: checks 
Vrinni: checks 
Bird et al: bets $0.57
Zemz_Ru: calls $0.57
Vrinni: folds 
*** RIVER *** [Qs 5s Qc 3c] [8h]
Zemz_Ru: checks 
Bird et al: bets $1.22
Zemz_Ru: folds 
Uncalled bet ($1.22) returned to Bird et al
Bird et al collected $2.04 from pot
*** SUMMARY ***
Total pot $2.14 | Rake $0.10 
Board [Qs 5s Qc 3c 8h]
Seat 2: Bird et al (button) collected ($2.04)
Seat 3: Zemz_Ru (small blind) folded on the River
Seat 4: kingartur222 (big blind) folded before Flop
Seat 5: Vrinni folded on the Turn
Seat 6: Eddys Edge folded before Flop (didn't bet)



PokerStars Hand #166667516956:  Hold'em No Limit ($0.05/$0.10 USD) - 2017/02/23 16:02:35 ET
Table 'Eudora' 6-max Seat #2 is the button
Seat 1: archer2511 ($10.33 in chips) 
Seat 2: popypaleta ($10 in chips) 
Seat 3: Ice_Isayev ($10.35 in chips) 
Seat 5: chimera252 ($11.52 in chips) 
Seat 6: HARDCORE66RU ($10 in chips) 
Ice_Isayev: posts small blind $0.05
chimera252: posts big blind $0.10
*** HOLE CARDS ***
HARDCORE66RU: folds 
iamkakaroto joins the table at seat #4 
archer2511: raises $0.20 to $0.30
popypaleta: folds 
iamkakaroto leaves the table
Ice_Isayev: calls $0.25
chimera252: folds 
*** FLOP *** [9s 9c Ts]
Ice_Isayev: checks 
archer2511: checks 
*** TURN *** [9s 9c Ts] [6c]
yodzik joins the table at seat #4 
Ice_Isayev: checks 
archer2511: bets $0.30
Ice_Isayev: calls $0.30
*** RIVER *** [9s 9c Ts 6c] [Td]
Ice_Isayev: bets $0.70
archer2511: calls $0.70
*** SHOW DOWN ***
Ice_Isayev: shows [5c 5h] (two pair, Tens and Nines)
archer2511: shows [Kh Ah] (two pair, Tens and Nines - Ace kicker)
archer2511 collected $2.58 from pot
*** SUMMARY ***
Total pot $2.70 | Rake $0.12 
Board [9s 9c Ts 6c Td]
Seat 1: archer2511 showed [Kh Ah] and won ($2.58) with two pair, Tens and Nines
Seat 2: popypaleta (button) folded before Flop (didn't bet)
Seat 3: Ice_Isayev (small blind) showed [5c 5h] and lost with two pair, Tens and Nines
Seat 5: chimera252 (big blind) folded before Flop
Seat 6: HARDCORE66RU folded before Flop (didn't bet)



PokerStars Hand #166667517010:  Hold'em No Limit ($0.05/$0.10 USD) - 2017/02/23 16:02:36 ET
Table 'Nerthus II' 6-max Seat #6 is the button
Seat 1: mdelfin0 ($10.38 in chips) 
Seat 2: Hovhannes990 ($8.78 in chips) 
Seat 3: Mamm0nism ($18.82 in chips) 
Seat 4: myevc ($16.28 in chips) 
Seat 5: Hyd SK ($12.70 in chips) 
Seat 6: Lucky HoBBiT ($10 in chips) 
mdelfin0: posts small blind $0.05
Hovhannes990: posts big blind $0.10
*** HOLE CARDS ***
Mamm0nism: folds 
myevc: folds 
Hyd SK: raises $0.25 to $0.35
Lucky HoBBiT: folds 
mdelfin0: folds 
Hovhannes990: calls $0.25
*** FLOP *** [Ks 6d Td]
Hovhannes990: bets $0.10
Hyd SK: calls $0.10
*** TURN *** [Ks 6d Td] [7d]
Hovhannes990: bets $0.10
Hyd SK: calls $0.10
*** RIVER *** [Ks 6d Td 7d] [4d]
Hovhannes990: bets $1.20
Hyd SK: folds 
Uncalled bet ($1.20) returned to Hovhannes990
Hovhannes990 collected $1.10 from pot
*** SUMMARY ***
Total pot $1.15 | Rake $0.05 
Board [Ks 6d Td 7d 4d]
Seat 1: mdelfin0 (small blind) folded before Flop
Seat 2: Hovhannes990 (big blind) collected ($1.10)
Seat 3: Mamm0nism folded before Flop (didn't bet)
Seat 4: myevc folded before Flop (didn't bet)
Seat 5: Hyd SK folded on the River
Seat 6: Lucky HoBBiT (button) folded before Flop (didn't bet)



PokerStars Hand #166667517143:  Hold'em No Limit ($0.05/$0.10 USD) - 2017/02/23 16:02:36 ET
Table 'Nata II' 6-max Seat #5 is the button
Seat 1: luisantrs ($9.34 in chips) 
Seat 2: CHRO8 ($15.85 in chips) 
Seat 3: 8th wonders ($10 in chips) 
Seat 4: Comeback3392 ($10 in chips) 
Seat 5: RoJ1 ($10 in chips) 
Seat 6: IAntikI ($11.41 in chips) 
IAntikI: posts small blind $0.05
luisantrs: posts big blind $0.10
*** HOLE CARDS ***
CHRO8: folds 
8th wonders: folds 
Comeback3392: folds 
RoJ1: raises $0.12 to $0.22
IAntikI: folds 
luisantrs: calls $0.12
*** FLOP *** [2c Ah 8c]
luisantrs: checks 
RoJ1: bets $0.15
luisantrs: calls $0.15
*** TURN *** [2c Ah 8c] [3h]
luisantrs: bets $0.38
RoJ1: calls $0.38
*** RIVER *** [2c Ah 8c 3h] [Jd]
luisantrs: bets $1.48
RoJ1: calls $1.48
*** SHOW DOWN ***
luisantrs: shows [Qd 9d] (high card Ace)
RoJ1: shows [Ad 9s] (a pair of Aces)
RoJ1 collected $4.31 from pot
*** SUMMARY ***
Total pot $4.51 | Rake $0.20 
Board [2c Ah 8c 3h Jd]
Seat 1: luisantrs (big blind) showed [Qd 9d] and lost with high card Ace
Seat 2: CHRO8 folded before Flop (didn't bet)
Seat 3: 8th wonders folded before Flop (didn't bet)
Seat 4: Comeback3392 folded before Flop (didn't bet)
Seat 5: RoJ1 (button) showed [Ad 9s] and won ($4.31) with a pair of Aces
Seat 6: IAntikI (small blind) folded before Flop



PokerStars Hand #166667517628:  Hold'em No Limit ($0.05/$0.10 USD) - 2017/02/23 16:02:36 ET
Table 'Antinous' 6-max Seat #4 is the button
Seat 1: Andrei ProFF ($15.94 in chips) 
Seat 2: Nr847 ($10.61 in chips) 
Seat 3: dittoro ($10 in chips) 
Seat 4: Pekaml ($15.62 in chips) 
Seat 5: Covetsoles ($6.65 in chips) 
Seat 6: coolisses111 ($10 in chips) 
Covetsoles: posts small blind $0.05
coolisses111: posts big blind $0.10
*** HOLE CARDS ***
Andrei ProFF: folds 
Nr847: folds 
dittoro: folds 
Pekaml: raises $0.10 to $0.20
Covetsoles: folds 
coolisses111: raises $0.70 to $0.90
Pekaml: folds 
Uncalled bet ($0.70) returned to coolisses111
coolisses111 collected $0.45 from pot
*** SUMMARY ***
Total pot $0.45 | Rake $0 
Seat 1: Andrei ProFF folded before Flop (didn't bet)
Seat 2: Nr847 folded before Flop (didn't bet)
Seat 3: dittoro folded before Flop (didn't bet)
Seat 4: Pekaml (button) folded before Flop
Seat 5: Covetsoles (small blind) folded before Flop
Seat 6: coolisses111 (big blind) collected ($0.45)



PokerStars Hand #166667518223:  Hold'em No Limit ($0.05/$0.10 USD) - 2017/02/23 16:02:37 ET
Table 'Caprera III' 6-max Seat #6 is the button
Seat 1: Vrinni ($10.30 in chips) 
Seat 2: hg123454321 ($8.70 in chips) 
Seat 3: Darkfrai ($10 in chips) 
Seat 4: oddshoff ($9 in chips) 
Seat 5: fedorka rus ($50.58 in chips) 
Seat 6: GESPERIA ($18.38 in chips) 
Vrinni: posts small blind $0.05
hg123454321: posts big blind $0.10
*** HOLE CARDS ***
Darkfrai: raises $0.20 to $0.30
oddshoff: folds 
fedorka rus: calls $0.30
GESPERIA: folds 
Vrinni: folds 
hg123454321: raises $0.80 to $1.10
Darkfrai: folds 
fedorka rus: calls $0.80
*** FLOP *** [Ad 7s Kd]
hg123454321: bets $1.60
fedorka rus: folds 
Uncalled bet ($1.60) returned to hg123454321
hg123454321 collected $2.44 from pot
*** SUMMARY ***
Total pot $2.55 | Rake $0.11 
Board [Ad 7s Kd]
Seat 1: Vrinni (small blind) folded before Flop
Seat 2: hg123454321 (big blind) collected ($2.44)
Seat 3: Darkfrai folded before Flop
Seat 4: oddshoff folded before Flop (didn't bet)
Seat 5: fedorka rus folded on the Flop
Seat 6: GESPERIA (button) folded before Flop (didn't bet)



PokerStars Hand #166667518571:  Hold'em No Limit ($0.05/$0.10 USD) - 2017/02/23 16:02:37 ET
Table 'Torrence II' 6-max Seat #5 is the button
Seat 1: Starbooks ($4.27 in chips) 
Seat 2: scorpionfish ($16.25 in chips) 
Seat 3: coolisses111 ($9.55 in chips) 
Seat 4: Zooplack ($10.23 in chips) 
Seat 5: Kow6oy ($12.33 in chips) 
mhonielsen will be allowed to play after the button
Starbooks: posts small blind $0.05
scorpionfish: posts big blind $0.10
*** HOLE CARDS ***
coolisses111: raises $0.30 to $0.40
Zooplack: folds 
Kow6oy: folds 
Starbooks: folds 
scorpionfish: folds 
Uncalled bet ($0.30) returned to coolisses111
coolisses111 collected $0.25 from pot
*** SUMMARY ***
Total pot $0.25 | Rake $0 
Seat 1: Starbooks (small blind) folded before Flop
Seat 2: scorpionfish (big blind) folded before Flop
Seat 3: coolisses111 collected ($0.25)
Seat 4: Zooplack folded before Flop (didn't bet)
Seat 5: Kow6oy (button) folded before Flop (didn't bet)



PokerStars Hand #166667518858:  Hold'em No Limit ($0.05/$0.10 USD) - 2017/02/23 16:02:38 ET
Table 'Manto II' 6-max Seat #5 is the button
Seat 1: MihaGr ($10 in chips) 
Seat 2: voledy ($10 in chips) 
Seat 3: Komap511 ($10 in chips) 
Seat 4: dr.goofy ($10.27 in chips) 
Seat 5: ArcticBearDK ($22.35 in chips) 
Seat 6: pancernik21 ($17.40 in chips) 
pancernik21: posts small blind $0.05
MihaGr: posts big blind $0.10
*** HOLE CARDS ***
voledy: folds 
Komap511: raises $0.20 to $0.30
dr.goofy: folds 
ArcticBearDK: raises $0.90 to $1.20
pancernik21: calls $1.15
MihaGr: folds 
Komap511: raises $2.80 to $4
ArcticBearDK: raises $18.35 to $22.35 and is all-in
pancernik21: folds 
Komap511: calls $6 and is all-in
Uncalled bet ($12.35) returned to ArcticBearDK
*** FLOP *** [9h Jh 7c]
*** TURN *** [9h Jh 7c] [Jd]
*** RIVER *** [9h Jh 7c Jd] [5h]
*** SHOW DOWN ***
Komap511: shows [Kd Ac] (a pair of Jacks)
ArcticBearDK: shows [Qd Qs] (two pair, Queens and Jacks)
ArcticBearDK collected $20.34 from pot
*** SUMMARY ***
Total pot $21.30 | Rake $0.96 
Board [9h Jh 7c Jd 5h]
Seat 1: MihaGr (big blind) folded before Flop
Seat 2: voledy folded before Flop (didn't bet)
Seat 3: Komap511 showed [Kd Ac] and lost with a pair of Jacks
Seat 4: dr.goofy folded before Flop (didn't bet)
Seat 5: ArcticBearDK (button) showed [Qd Qs] and won ($20.34) with two pair, Queens and Jacks
Seat 6: pancernik21 (small blind) folded before Flop



PokerStars Hand #166667519225:  Hold'em No Limit ($0.05/$0.10 USD) - 2017/02/23 16:02:38 ET
Table 'Wesselink II' 6-max Seat #6 is the button
Seat 1: vladcol ($5.79 in chips) 
Seat 3: Wargolandros ($9.07 in chips) 
Seat 4: BahiaMinhaP ($10.78 in chips) 
Seat 5: xdjango07x ($18.38 in chips) 
Seat 6: bambolejro ($10 in chips) 
vladcol: posts small blind $0.05
jamalungma: is sitting out 
Wargolandros: posts big blind $0.10
jamalungma leaves the table
*** HOLE CARDS ***
KRZuff joins the table at seat #2 
BahiaMinhaP: folds 
xdjango07x: raises $0.20 to $0.30
bambolejro: folds 
vladcol: calls $0.25
Wargolandros: folds 
*** FLOP *** [4d 4c 3h]
vladcol: checks 
xdjango07x: bets $0.50
vladcol: folds 
Uncalled bet ($0.50) returned to xdjango07x
xdjango07x collected $0.67 from pot
*** SUMMARY ***
Total pot $0.70 | Rake $0.03 
Board [4d 4c 3h]
Seat 1: vladcol (small blind) folded on the Flop
Seat 3: Wargolandros (big blind) folded before Flop
Seat 4: BahiaMinhaP folded before Flop (didn't bet)
Seat 5: xdjango07x collected ($0.67)
Seat 6: bambolejro (button) folded before Flop (didn't bet)



PokerStars Hand #166667520208:  Hold'em No Limit ($0.05/$0.10 USD) - 2017/02/23 16:02:39 ET
Table 'Phereclos II' 6-max Seat #2 is the button
Seat 1: Croplayer1 ($10 in chips) 
Seat 2: Kazacha ($10.13 in chips) 
Seat 3: kickereens ($21.21 in chips) 
Seat 4: DamDatsAnAce ($10.53 in chips) 
Seat 5: Smitty03300 ($10.15 in chips) 
Seat 6: mhonielsen ($16.07 in chips) 
kickereens: posts small blind $0.05
DamDatsAnAce: posts big blind $0.10
*** HOLE CARDS ***
Smitty03300: raises $0.20 to $0.30
mhonielsen: folds 
Croplayer1: folds 
Kazacha: folds 
kickereens: folds 
DamDatsAnAce: folds 
Uncalled bet ($0.20) returned to Smitty03300
Smitty03300 collected $0.25 from pot
*** SUMMARY ***
Total pot $0.25 | Rake $0 
Seat 1: Croplayer1 folded before Flop (didn't bet)
Seat 2: Kazacha (button) folded before Flop (didn't bet)
Seat 3: kickereens (small blind) folded before Flop
Seat 4: DamDatsAnAce (big blind) folded before Flop
Seat 5: Smitty03300 collected ($0.25)
Seat 6: mhonielsen folded before Flop (didn't bet)



PokerStars Hand #166667520234:  Hold'em No Limit ($0.05/$0.10 USD) - 2017/02/23 16:02:39 ET
Table 'Serpens' 6-max Seat #5 is the button
Seat 1: Namhkal ($10.45 in chips) 
Seat 2: KA3AXCTAHEU, ($10.15 in chips) 
Seat 3: homelessdan ($28.35 in chips) 
Seat 4: Ragazzi3 ($17.49 in chips) 
Seat 5: XwinX25 ($11.81 in chips) 
Seat 6: Croplayer1 ($10 in chips) 
Croplayer1: posts small blind $0.05
Namhkal: posts big blind $0.10
*** HOLE CARDS ***
KA3AXCTAHEU,: folds 
homelessdan: raises $0.20 to $0.30
Ragazzi3: raises $0.20 to $0.50
XwinX25: folds 
Croplayer1: folds 
Namhkal: folds 
homelessdan: calls $0.20
*** FLOP *** [5s Kd Qh]
homelessdan: checks 
Ragazzi3: checks 
*** TURN *** [5s Kd Qh] [9s]
homelessdan: checks 
Ragazzi3: checks 
*** RIVER *** [5s Kd Qh 9s] [7s]
homelessdan: bets $0.70
Ragazzi3: calls $0.70
*** SHOW DOWN ***
homelessdan: shows [Qd Ah] (a pair of Queens)
Ragazzi3: shows [Jh Js] (a pair of Jacks)
homelessdan collected $2.44 from pot
*** SUMMARY ***
Total pot $2.55 | Rake $0.11 
Board [5s Kd Qh 9s 7s]
Seat 1: Namhkal (big blind) folded before Flop
Seat 2: KA3AXCTAHEU, folded before Flop (didn't bet)
Seat 3: homelessdan showed [Qd Ah] and won ($2.44) with a pair of Queens
Seat 4: Ragazzi3 showed [Jh Js] and lost with a pair of Jacks
Seat 5: XwinX25 (button) folded before Flop (didn't bet)
Seat 6: Croplayer1 (small blind) folded before Flop



PokerStars Hand #166667520358:  Hold'em No Limit ($0.05/$0.10 USD) - 2017/02/23 16:02:39 ET
Table 'Wilkens II' 6-max Seat #6 is the button
Seat 1: Islamiq-GuRL ($12.20 in chips) 
Seat 2: manashov ($10.45 in chips) 
Seat 3: Namhkal ($10.80 in chips) 
Seat 4: myevc ($10 in chips) 
Seat 5: patrick19111 ($10 in chips) 
Seat 6: XaXaTyH4uK ($14.61 in chips) 
Islamiq-GuRL: posts small blind $0.05
manashov: posts big blind $0.10
*** HOLE CARDS ***
Namhkal: folds 
myevc: folds 
patrick19111: folds 
XaXaTyH4uK: raises $0.20 to $0.30
Islamiq-GuRL: folds 
manashov: folds 
Uncalled bet ($0.20) returned to XaXaTyH4uK
XaXaTyH4uK collected $0.25 from pot
*** SUMMARY ***
Total pot $0.25 | Rake $0 
Seat 1: Islamiq-GuRL (small blind) folded before Flop
Seat 2: manashov (big blind) folded before Flop
Seat 3: Namhkal folded before Flop (didn't bet)
Seat 4: myevc folded before Flop (didn't bet)
Seat 5: patrick19111 folded before Flop (didn't bet)
Seat 6: XaXaTyH4uK (button) collected ($0.25)



PokerStars Hand #166667520519:  Hold'em No Limit ($0.05/$0.10 USD) - 2017/02/23 16:02:40 ET
Table 'Geisha' 6-max Seat #6 is the button
Seat 1: facewald ($34.53 in chips) 
Seat 2: voledy ($10.30 in chips) 
Seat 4: jvstsayyes ($11.47 in chips) 
Seat 5: KRZuff ($14.10 in chips) 
Seat 6: Namhkal ($21.48 in chips) 
facewald: posts small blind $0.05
voledy: posts big blind $0.10
Eddys Edge: sits out 
*** HOLE CARDS ***
jvstsayyes: folds 
KRZuff: folds 
Namhkal: folds 
facewald: raises $0.19 to $0.29
voledy: folds 
Uncalled bet ($0.19) returned to facewald
facewald collected $0.20 from pot
*** SUMMARY ***
Total pot $0.20 | Rake $0 
Seat 1: facewald (small blind) collected ($0.20)
Seat 2: voledy (big blind) folded before Flop
Seat 4: jvstsayyes folded before Flop (didn't bet)
Seat 5: KRZuff folded before Flop (didn't bet)
Seat 6: Namhkal (button) folded before Flop (didn't bet)



PokerStars Hand #166667520542:  Hold'em No Limit ($0.05/$0.10 USD) - 2017/02/23 16:02:40 ET
Table 'Sinon II' 6-max Seat #6 is the button
Seat 1: Aescul@pius ($10 in chips) 
Seat 2: ÄissesHai ($15.49 in chips) 
Seat 3: crazydevill ($10 in chips) 
Seat 4: Bandyaev ($15.48 in chips) 
Seat 5: ab260414 ($11.06 in chips) 
Seat 6: hartmut2012 ($6.68 in chips) 
Aescul@pius: posts small blind $0.05
ÄissesHai: posts big blind $0.10
*** HOLE CARDS ***
crazydevill: raises $0.20 to $0.30
Bandyaev: folds 
ab260414: folds 
hartmut2012: calls $0.30
Aescul@pius: folds 
ÄissesHai: folds 
*** FLOP *** [3d Jh Tc]
crazydevill: bets $0.40
hartmut2012: calls $0.40
*** TURN *** [3d Jh Tc] [9s]
crazydevill: bets $0.70
hartmut2012: folds 
Uncalled bet ($0.70) returned to crazydevill
crazydevill collected $1.48 from pot
*** SUMMARY ***
Total pot $1.55 | Rake $0.07 
Board [3d Jh Tc 9s]
Seat 1: Aescul@pius (small blind) folded before Flop
Seat 2: ÄissesHai (big blind) folded before Flop
Seat 3: crazydevill collected ($1.48)
Seat 4: Bandyaev folded before Flop (didn't bet)
Seat 5: ab260414 folded before Flop (didn't bet)
Seat 6: hartmut2012 (button) folded on the Turn



PokerStars Hand #166667520659:  Hold'em No Limit ($0.05/$0.10 USD) - 2017/02/23 16:02:40 ET
Table 'Unitas II' 6-max Seat #3 is the button
Seat 1: Peter0087 ($9.20 in chips) 
Seat 2: dragonste89 ($10.91 in chips) 
Seat 3: CallByValue ($9.85 in chips) 
Seat 4: truck1234 ($11.04 in chips) 
Seat 5: chimera252 ($25.76 in chips) 
truck1234: posts small blind $0.05
chimera252: posts big blind $0.10
paxit71: sits out 
*** HOLE CARDS ***
Peter0087: folds 
dragonste89: raises $0.20 to $0.30
CallByValue: folds 
truck1234: folds 
chimera252: folds 
Uncalled bet ($0.20) returned to dragonste89
dragonste89 collected $0.25 from pot
*** SUMMARY ***
Total pot $0.25 | Rake $0 
Seat 1: Peter0087 folded before Flop (didn't bet)
Seat 2: dragonste89 collected ($0.25)
Seat 3: CallByValue (button) folded before Flop (didn't bet)
Seat 4: truck1234 (small blind) folded before Flop
Seat 5: chimera252 (big blind) folded before Flop



PokerStars Hand #166667520963:  Hold'em No Limit ($0.05/$0.10 USD) - 2017/02/23 16:02:40 ET
Table 'Martha' 6-max Seat #3 is the button
Seat 1: Peter0087 ($10.26 in chips) 
Seat 2: pauli95 ($8.10 in chips) 
Seat 3: Hyd SK ($12.16 in chips) 
Seat 4: dittoro ($10.54 in chips) 
Seat 5: MihaGr ($10 in chips) 
Seat 6: 8th wonders ($10 in chips) 
dittoro: posts small blind $0.05
MihaGr: posts big blind $0.10
*** HOLE CARDS ***
8th wonders: folds 
Peter0087: folds 
pauli95: raises $0.20 to $0.30
Hyd SK: folds 
dittoro: folds 
MihaGr: folds 
Uncalled bet ($0.20) returned to pauli95
pauli95 collected $0.25 from pot
*** SUMMARY ***
Total pot $0.25 | Rake $0 
Seat 1: Peter0087 folded before Flop (didn't bet)
Seat 2: pauli95 collected ($0.25)
Seat 3: Hyd SK (button) folded before Flop (didn't bet)
Seat 4: dittoro (small blind) folded before Flop
Seat 5: MihaGr (big blind) folded before Flop
Seat 6: 8th wonders folded before Flop (didn't bet)



PokerStars Hand #166667521275:  Hold'em No Limit ($0.05/$0.10 USD) - 2017/02/23 16:02:40 ET
Table 'Gaika' 6-max Seat #6 is the button
Seat 1: oddshoff ($12.46 in chips) 
Seat 2: NvR.m1nD ($18.22 in chips) 
Seat 3: david_sara83 ($10.32 in chips) 
Seat 4: fortieth ($11.50 in chips) 
Seat 5: fedorka rus ($10.65 in chips) 
Seat 6: dr.goofy ($11 in chips) 
oddshoff: posts small blind $0.05
NvR.m1nD: posts big blind $0.10
*** HOLE CARDS ***
david_sara83: folds 
fortieth: folds 
fedorka rus: folds 
dr.goofy: folds 
oddshoff: folds 
Uncalled bet ($0.05) returned to NvR.m1nD
NvR.m1nD collected $0.10 from pot
*** SUMMARY ***
Total pot $0.10 | Rake $0 
Seat 1: oddshoff (small blind) folded before Flop
Seat 2: NvR.m1nD (big blind) collected ($0.10)
Seat 3: david_sara83 folded before Flop (didn't bet)
Seat 4: fortieth folded before Flop (didn't bet)
Seat 5: fedorka rus folded before Flop (didn't bet)
Seat 6: dr.goofy (button) folded before Flop (didn't bet)



PokerStars Hand #166667521447:  Hold'em No Limit ($0.05/$0.10 USD) - 2017/02/23 16:02:40 ET
Table 'Marghanna II' 6-max Seat #5 is the button
Seat 2: Namhkal ($11.61 in chips) 
Seat 3: Innerwuss ($11.32 in chips) 
Seat 4: D3NyA ($12.37 in chips) 
Seat 5: ofl21189 ($7.57 in chips) 
Seat 6: VAD21 ($13.21 in chips) 
VAD21: posts small blind $0.05
steepfell: is sitting out 
Namhkal: posts big blind $0.10
*** HOLE CARDS ***
steepfell leaves the table
KRZuff joins the table at seat #1 
Innerwuss: folds 
D3NyA: folds 
KRZuff leaves the table
ofl21189: calls $0.10
Goroshkos88 joins the table at seat #1 
VAD21: calls $0.05
Namhkal: raises $0.40 to $0.50
ofl21189: folds 
VAD21: folds 
Uncalled bet ($0.40) returned to Namhkal
Namhkal collected $0.30 from pot
*** SUMMARY ***
Total pot $0.30 | Rake $0 
Seat 2: Namhkal (big blind) collected ($0.30)
Seat 3: Innerwuss folded before Flop (didn't bet)
Seat 4: D3NyA folded before Flop (didn't bet)
Seat 5: ofl21189 (button) folded before Flop
Seat 6: VAD21 (small blind) folded before Flop



PokerStars Hand #166667521980:  Hold'em No Limit ($0.05/$0.10 USD) - 2017/02/23 16:02:41 ET
Table 'Izar' 6-max Seat #4 is the button
Seat 1: bambolejro ($10.54 in chips) 
Seat 2: mvp0013 ($10.89 in chips) 
Seat 3: Yspenyanin ($10.90 in chips) 
Seat 4: Matee92 ($6.51 in chips) 
Seat 5: fishhook5 ($10.40 in chips) 
Seat 6: yodzik ($5 in chips) 
fishhook5: posts small blind $0.05
yodzik: posts big blind $0.10
*** HOLE CARDS ***
bambolejro: folds 
mvp0013: folds 
Yspenyanin: folds 
Matee92: folds 
fishhook5: raises $0.14 to $0.24
yodzik: raises $0.66 to $0.90
fishhook5: raises $4.20 to $5.10
yodzik: folds 
Uncalled bet ($4.20) returned to fishhook5
fishhook5 collected $1.80 from pot
*** SUMMARY ***
Total pot $1.80 | Rake $0 
Seat 1: bambolejro folded before Flop (didn't bet)
Seat 2: mvp0013 folded before Flop (didn't bet)
Seat 3: Yspenyanin folded before Flop (didn't bet)
Seat 4: Matee92 (button) folded before Flop (didn't bet)
Seat 5: fishhook5 (small blind) collected ($1.80)
Seat 6: yodzik (big blind) folded before Flop



PokerStars Hand #166667522188:  Hold'em No Limit ($0.05/$0.10 USD) - 2017/02/23 16:02:41 ET
Table 'Jokaste II' 6-max Seat #3 is the button
Seat 1: Hyd SK ($13.48 in chips) 
Seat 2: T9MS ($12.48 in chips) 
Seat 3: crazydevill ($10 in chips) 
Seat 4: FRAID358 ($14.76 in chips) 
Seat 5: Vrinni ($10.15 in chips) 
Seat 6: Adailton07 ($15.20 in chips) 
FRAID358: posts small blind $0.05
Vrinni: posts big blind $0.10
*** HOLE CARDS ***
Adailton07: folds 
Hyd SK: folds 
T9MS: folds 
crazydevill: raises $0.20 to $0.30
FRAID358: raises $0.60 to $0.90
Vrinni: folds 
crazydevill: folds 
Uncalled bet ($0.60) returned to FRAID358
FRAID358 collected $0.70 from pot
*** SUMMARY ***
Total pot $0.70 | Rake $0 
Seat 1: Hyd SK folded before Flop (didn't bet)
Seat 2: T9MS folded before Flop (didn't bet)
Seat 3: crazydevill (button) folded before Flop
Seat 4: FRAID358 (small blind) collected ($0.70)
Seat 5: Vrinni (big blind) folded before Flop
Seat 6: Adailton07 folded before Flop (didn't bet)



PokerStars Hand #166667522437:  Hold'em No Limit ($0.05/$0.10 USD) - 2017/02/23 16:02:42 ET
Table 'Lorbach' 6-max Seat #4 is the button
Seat 1: LarryTheStar ($11.12 in chips) 
Seat 2: fabadam ($12.48 in chips) 
Seat 3: ArcticBearDK ($11.05 in chips) 
Seat 4: McCleans ($10.54 in chips) 
Seat 5: Cluckh ($14.67 in chips) 
Seat 6: Worlz ($12.82 in chips) 
Cluckh: posts small blind $0.05
Worlz: posts big blind $0.10
*** HOLE CARDS ***
LarryTheStar: folds 
fabadam: raises $0.15 to $0.25
ArcticBearDK: folds 
McCleans: folds 
Cluckh: folds 
Worlz: folds 
Uncalled bet ($0.15) returned to fabadam
fabadam collected $0.25 from pot
*** SUMMARY ***
Total pot $0.25 | Rake $0 
Seat 1: LarryTheStar folded before Flop (didn't bet)
Seat 2: fabadam collected ($0.25)
Seat 3: ArcticBearDK folded before Flop (didn't bet)
Seat 4: McCleans (button) folded before Flop (didn't bet)
Seat 5: Cluckh (small blind) folded before Flop
Seat 6: Worlz (big blind) folded before Flop



PokerStars Hand #166667522462:  Hold'em No Limit ($0.05/$0.10 USD) - 2017/02/23 16:02:42 ET
Table 'Lampetia' 6-max Seat #5 is the button
Seat 1: WinninBikini ($10.64 in chips) 
Seat 2: ex3Lero86 ($10 in chips) 
Seat 3: Ice_Isayev ($10.73 in chips) 
Seat 4: Rodik002 ($15.33 in chips) 
Seat 5: luisantrs ($9.01 in chips) 
Seat 6: Scanner17 ($11.81 in chips) 
Scanner17: posts small blind $0.05
WinninBikini: posts big blind $0.10
*** HOLE CARDS ***
ex3Lero86: folds 
Ice_Isayev: folds 
Rodik002: folds 
luisantrs: raises $0.20 to $0.30
Scanner17: folds 
WinninBikini: calls $0.20
*** FLOP *** [4d 7c Tc]
WinninBikini: checks 
luisantrs: bets $0.62
WinninBikini: folds 
Uncalled bet ($0.62) returned to luisantrs
luisantrs collected $0.62 from pot
*** SUMMARY ***
Total pot $0.65 | Rake $0.03 
Board [4d 7c Tc]
Seat 1: WinninBikini (big blind) folded on the Flop
Seat 2: ex3Lero86 folded before Flop (didn't bet)
Seat 3: Ice_Isayev folded before Flop (didn't bet)
Seat 4: Rodik002 folded before Flop (didn't bet)
Seat 5: luisantrs (button) collected ($0.62)
Seat 6: Scanner17 (small blind) folded before Flop



PokerStars Hand #166667522531:  Hold'em No Limit ($0.05/$0.10 USD) - 2017/02/23 16:02:42 ET
Table 'Euryalos II' 6-max Seat #4 is the button
Seat 1: acekid403 ($9.90 in chips) 
Seat 3: Hyd SK ($10.50 in chips) 
Seat 4: popypaleta ($15.72 in chips) 
Seat 6: MihaGr ($10 in chips) 
horang2 will be allowed to play after the button
MihaGr: posts small blind $0.05
silsilviu joins the table at seat #2 
acekid403: posts big blind $0.10
*** HOLE CARDS ***
Hyd SK: folds 
popypaleta: folds 
MihaGr: folds 
Uncalled bet ($0.05) returned to acekid403
acekid403 collected $0.10 from pot
*** SUMMARY ***
Total pot $0.10 | Rake $0 
Seat 1: acekid403 (big blind) collected ($0.10)
Seat 3: Hyd SK folded before Flop (didn't bet)
Seat 4: popypaleta (button) folded before Flop (didn't bet)
Seat 6: MihaGr (small blind) folded before Flop



PokerStars Hand #166667522672:  Hold'em No Limit ($0.05/$0.10 USD) - 2017/02/23 16:02:42 ET
Table 'Laetitia II' 6-max Seat #6 is the button
Seat 1: Cluckh ($11.47 in chips) 
Seat 2: manashov ($10.37 in chips) 
Seat 3: 6ePeMeHHa9 ($10.29 in chips) 
Seat 4: Feverhead ($16.81 in chips) 
Seat 5: D3NyA ($16.93 in chips) 
Seat 6: Dima91360 ($3.87 in chips) 
Cluckh: posts small blind $0.05
manashov: posts big blind $0.10
*** HOLE CARDS ***
6ePeMeHHa9: folds 
Feverhead: folds 
D3NyA: folds 
Dima91360: calls $0.10
Cluckh: folds 
manashov: checks 
*** FLOP *** [9c 3c 5h]
manashov: checks 
Dima91360: checks 
*** TURN *** [9c 3c 5h] [6h]
manashov: checks 
Dima91360: checks 
*** RIVER *** [9c 3c 5h 6h] [4c]
manashov: checks 
Dima91360: checks 
*** SHOW DOWN ***
manashov: shows [Ts 3h] (a pair of Threes)
Dima91360: shows [5s Th] (a pair of Fives)
Dima91360 collected $0.24 from pot
*** SUMMARY ***
Total pot $0.25 | Rake $0.01 
Board [9c 3c 5h 6h 4c]
Seat 1: Cluckh (small blind) folded before Flop
Seat 2: manashov (big blind) showed [Ts 3h] and lost with a pair of Threes
Seat 3: 6ePeMeHHa9 folded before Flop (didn't bet)
Seat 4: Feverhead folded before Flop (didn't bet)
Seat 5: D3NyA folded before Flop (didn't bet)
Seat 6: Dima91360 (button) showed [5s Th] and won ($0.24) with a pair of Fives



PokerStars Hand #166667522741:  Hold'em No Limit ($0.05/$0.10 USD) - 2017/02/23 16:02:42 ET
Table 'Kanda' 6-max Seat #6 is the button
Seat 1: Andy Wolf ($10.46 in chips) 
Seat 2: Pelotín ($5.45 in chips) 
Seat 3: joewatson90 ($12.44 in chips) 
Seat 4: Orlangoor ($10.71 in chips) 
Seat 5: Temniy Elf ($10.15 in chips) 
Seat 6: oddshoff ($8.81 in chips) 
Andy Wolf: posts small blind $0.05
Pelotín: posts big blind $0.10
*** HOLE CARDS ***
joewatson90: raises $0.20 to $0.30
Orlangoor: folds 
Temniy Elf: folds 
oddshoff: folds 
Andy Wolf: folds 
Pelotín: folds 
Uncalled bet ($0.20) returned to joewatson90
joewatson90 collected $0.25 from pot
*** SUMMARY ***
Total pot $0.25 | Rake $0 
Seat 1: Andy Wolf (small blind) folded before Flop
Seat 2: Pelotín (big blind) folded before Flop
Seat 3: joewatson90 collected ($0.25)
Seat 4: Orlangoor folded before Flop (didn't bet)
Seat 5: Temniy Elf folded before Flop (didn't bet)
Seat 6: oddshoff (button) folded before Flop (didn't bet)



PokerStars Hand #166667522748:  Hold'em No Limit ($0.05/$0.10 USD) - 2017/02/23 16:02:42 ET
Table 'Crocus' 6-max Seat #3 is the button
Seat 1: truck1234 ($24.76 in chips) 
Seat 2: garigura ($11.19 in chips) 
Seat 3: Limpa Meza ($0.86 in chips) 
Seat 4: patrick19111 ($12.31 in chips) 
Seat 5: Golsuorsi ($10 in chips) 
Seat 6: Rodik002 ($10 in chips) 
patrick19111: posts small blind $0.05
Golsuorsi: posts big blind $0.10
*** HOLE CARDS ***
Rodik002: folds 
truck1234: raises $0.20 to $0.30
garigura: folds 
Limpa Meza: folds 
patrick19111: folds 
Golsuorsi: folds 
Uncalled bet ($0.20) returned to truck1234
truck1234 collected $0.25 from pot
*** SUMMARY ***
Total pot $0.25 | Rake $0 
Seat 1: truck1234 collected ($0.25)
Seat 2: garigura folded before Flop (didn't bet)
Seat 3: Limpa Meza (button) folded before Flop (didn't bet)
Seat 4: patrick19111 (small blind) folded before Flop
Seat 5: Golsuorsi (big blind) folded before Flop
Seat 6: Rodik002 folded before Flop (didn't bet)



PokerStars Hand #166667522767:  Hold'em No Limit ($0.05/$0.10 USD) - 2017/02/23 16:02:42 ET
Table 'Siebohme II' 6-max Seat #5 is the button
Seat 1: homelessdan ($18.22 in chips) 
Seat 2: townerz1991 ($14.17 in chips) 
Seat 3: D3NyA ($10.33 in chips) 
Seat 4: POT_TRADER ($11.99 in chips) 
Seat 5: NvR.m1nD ($10 in chips) 
Seat 6: Fozzy690 ($10.36 in chips) 
Fozzy690: posts small blind $0.05
homelessdan: posts big blind $0.10
*** HOLE CARDS ***
townerz1991: folds 
D3NyA: folds 
POT_TRADER: raises $0.12 to $0.22
NvR.m1nD: folds 
Fozzy690: calls $0.17
homelessdan: folds 
*** FLOP *** [8c 8d Ks]
Fozzy690: checks 
POT_TRADER: checks 
*** TURN *** [8c 8d Ks] [3c]
Fozzy690: checks 
POT_TRADER: bets $0.35
Fozzy690: folds 
Uncalled bet ($0.35) returned to POT_TRADER
POT_TRADER collected $0.52 from pot
*** SUMMARY ***
Total pot $0.54 | Rake $0.02 
Board [8c 8d Ks 3c]
Seat 1: homelessdan (big blind) folded before Flop
Seat 2: townerz1991 folded before Flop (didn't bet)
Seat 3: D3NyA folded before Flop (didn't bet)
Seat 4: POT_TRADER collected ($0.52)
Seat 5: NvR.m1nD (button) folded before Flop (didn't bet)
Seat 6: Fozzy690 (small blind) folded on the Turn



PokerStars Hand #166667522785:  Hold'em No Limit ($0.05/$0.10 USD) - 2017/02/23 16:02:42 ET
Table 'Gyldenia II' 6-max Seat #6 is the button
Seat 1: KokoulinV ($10 in chips) 
Seat 2: Bandyaev ($11.24 in chips) 
Seat 3: ex3Lero86 ($23.37 in chips) 
Seat 5: CHRO8 ($17.41 in chips) 
Seat 6: 8th wonders ($10 in chips) 
KokoulinV: posts small blind $0.05
Bandyaev: posts big blind $0.10
*** HOLE CARDS ***
ex3Lero86: folds 
CHRO8: folds 
8th wonders: raises $0.20 to $0.30
KokoulinV: raises $0.70 to $1
Bandyaev: folds 
8th wonders: folds 
Uncalled bet ($0.70) returned to KokoulinV
KokoulinV collected $0.70 from pot
*** SUMMARY ***
Total pot $0.70 | Rake $0 
Seat 1: KokoulinV (small blind) collected ($0.70)
Seat 2: Bandyaev (big blind) folded before Flop
Seat 3: ex3Lero86 folded before Flop (didn't bet)
Seat 5: CHRO8 folded before Flop (didn't bet)
Seat 6: 8th wonders (button) folded before Flop



PokerStars Hand #166667522858:  Hold'em No Limit ($0.05/$0.10 USD) - 2017/02/23 16:02:42 ET
Table 'Hunnia' 6-max Seat #1 is the button
Seat 1: univibe68 ($22.65 in chips) 
Seat 2: mhonielsen ($10.05 in chips) 
Seat 3: 6ePeMeHHa9 ($10 in chips) 
Seat 4: Jalida3 ($9.41 in chips) 
Seat 5: Smarkon ($14.78 in chips) 
Seat 6: ChuikaPridi ($9.07 in chips) 
mhonielsen: posts small blind $0.05
6ePeMeHHa9: posts big blind $0.10
*** HOLE CARDS ***
Jalida3: folds 
Smarkon: raises $0.20 to $0.30
ChuikaPridi: folds 
univibe68: folds 
mhonielsen: folds 
6ePeMeHHa9: folds 
Uncalled bet ($0.20) returned to Smarkon
Smarkon collected $0.25 from pot
*** SUMMARY ***
Total pot $0.25 | Rake $0 
Seat 1: univibe68 (button) folded before Flop (didn't bet)
Seat 2: mhonielsen (small blind) folded before Flop
Seat 3: 6ePeMeHHa9 (big blind) folded before Flop
Seat 4: Jalida3 folded before Flop (didn't bet)
Seat 5: Smarkon collected ($0.25)
Seat 6: ChuikaPridi folded before Flop (didn't bet)



PokerStars Hand #166667522996:  Hold'em No Limit ($0.05/$0.10 USD) - 2017/02/23 16:02:42 ET
Table 'Arkab' 6-max Seat #3 is the button
Seat 1: iamkakaroto ($10 in chips) 
Seat 2: aktion4ik ($12.39 in chips) 
Seat 3: sexy_seagull ($10 in chips) 
Seat 4: donkucallme ($16.45 in chips) 
Seat 5: OrionYusupov ($10.34 in chips) 
donkucallme: posts small blind $0.05
OrionYusupov: posts big blind $0.10
MihaGr: sits out 
*** HOLE CARDS ***
iamkakaroto: raises $0.20 to $0.30
aktion4ik: folds 
sexy_seagull: folds 
donkucallme: calls $0.25
OrionYusupov: folds 
*** FLOP *** [Js As 2d]
donkucallme: checks 
iamkakaroto: bets $0.36
donkucallme: raises $0.36 to $0.72
iamkakaroto: folds 
Uncalled bet ($0.36) returned to donkucallme
donkucallme collected $1.36 from pot
*** SUMMARY ***
Total pot $1.42 | Rake $0.06 
Board [Js As 2d]
Seat 1: iamkakaroto folded on the Flop
Seat 2: aktion4ik folded before Flop (didn't bet)
Seat 3: sexy_seagull (button) folded before Flop (didn't bet)
Seat 4: donkucallme (small blind) collected ($1.36)
Seat 5: OrionYusupov (big blind) folded before Flop



PokerStars Hand #166667523036:  Hold'em No Limit ($0.05/$0.10 USD) - 2017/02/23 16:02:42 ET
Table 'Pallas II' 6-max Seat #4 is the button
Seat 1: mdelfin0 ($15.88 in chips) 
Seat 2: FRAID358 ($9.95 in chips) 
Seat 4: Mr. Bluff 34 ($11.12 in chips) 
Seat 5: Yspenyanin ($19.61 in chips) 
Yspenyanin: posts small blind $0.05
xdjango07x: is sitting out 
mdelfin0: posts big blind $0.10
KRZuff: sits out 
*** HOLE CARDS ***
FRAID358: folds 
Mr. Bluff 34: folds 
Yspenyanin: raises $0.15 to $0.25
mdelfin0: folds 
Uncalled bet ($0.15) returned to Yspenyanin
Yspenyanin collected $0.20 from pot
*** SUMMARY ***
Total pot $0.20 | Rake $0 
Seat 1: mdelfin0 (big blind) folded before Flop
Seat 2: FRAID358 folded before Flop (didn't bet)
Seat 4: Mr. Bluff 34 (button) folded before Flop (didn't bet)
Seat 5: Yspenyanin (small blind) collected ($0.20)



PokerStars Hand #166667523290:  Hold'em No Limit ($0.05/$0.10 USD) - 2017/02/23 16:02:43 ET
Table 'Nikko II' 6-max Seat #4 is the button
Seat 1: bdixon_5 ($10.82 in chips) 
Seat 2: popypaleta ($10.15 in chips) 
Seat 3: Hyd SK ($11.36 in chips) 
Seat 4: Peter0087 ($9.84 in chips) 
Seat 5: Aescul@pius ($10 in chips) 
Seat 6: JahSoldier69 ($10 in chips) 
Aescul@pius: posts small blind $0.05
JahSoldier69: posts big blind $0.10
*** HOLE CARDS ***
bdixon_5: raises $0.20 to $0.30
popypaleta: folds 
Hyd SK: folds 
Peter0087: calls $0.30
Aescul@pius: calls $0.25
JahSoldier69: folds 
*** FLOP *** [7h As 9c]
Aescul@pius: checks 
bdixon_5: checks 
Peter0087: checks 
*** TURN *** [7h As 9c] [Ad]
Aescul@pius: bets $0.60
bdixon_5: folds 
Peter0087: folds 
Uncalled bet ($0.60) returned to Aescul@pius
Aescul@pius collected $0.96 from pot
*** SUMMARY ***
Total pot $1 | Rake $0.04 
Board [7h As 9c Ad]
Seat 1: bdixon_5 folded on the Turn
Seat 2: popypaleta folded before Flop (didn't bet)
Seat 3: Hyd SK folded before Flop (didn't bet)
Seat 4: Peter0087 (button) folded on the Turn
Seat 5: Aescul@pius (small blind) collected ($0.96)
Seat 6: JahSoldier69 (big blind) folded before Flop



PokerStars Hand #166667523621:  Hold'em No Limit ($0.05/$0.10 USD) - 2017/02/23 16:02:43 ET
Table 'Sheragul III' 6-max Seat #5 is the button
Seat 1: danky24 ($17.66 in chips) 
Seat 2: Bird et al ($11.96 in chips) 
Seat 4: maxiv608 ($11.24 in chips) 
Seat 5: Bandyaev ($14.57 in chips) 
Seat 6: Andrei ProFF ($10 in chips) 
Andrei ProFF: posts small blind $0.05
danky24: posts big blind $0.10
*** HOLE CARDS ***
Bird et al: folds 
maxiv608: folds 
Bandyaev: folds 
Andrei ProFF: raises $0.20 to $0.30
danky24: calls $0.20
*** FLOP *** [4d 3h 9c]
Andrei ProFF: bets $0.30
danky24: calls $0.30
*** TURN *** [4d 3h 9c] [6c]
Andrei ProFF: bets $0.70
danky24: calls $0.70
*** RIVER *** [4d 3h 9c 6c] [6s]
Andrei ProFF: checks 
danky24: bets $1.24
Andrei ProFF: folds 
Uncalled bet ($1.24) returned to danky24
danky24 collected $2.48 from pot
*** SUMMARY ***
Total pot $2.60 | Rake $0.12 
Board [4d 3h 9c 6c 6s]
Seat 1: danky24 (big blind) collected ($2.48)
Seat 2: Bird et al folded before Flop (didn't bet)
Seat 4: maxiv608 folded before Flop (didn't bet)
Seat 5: Bandyaev (button) folded before Flop (didn't bet)
Seat 6: Andrei ProFF (small blind) folded on the River



PokerStars Hand #166667524019:  Hold'em No Limit ($0.05/$0.10 USD) - 2017/02/23 16:02:43 ET
Table 'Wingolfia II' 6-max Seat #1 is the button
Seat 1: BahiaMinhaP ($10 in chips) 
Seat 2: NvR.m1nD ($10 in chips) 
Seat 3: truck1234 ($10 in chips) 
Seat 4: zlobslob ($19.32 in chips) 
Seat 5: tr41n3r12 ($11.43 in chips) 
Seat 6: EphemeralBen ($11.52 in chips) 
NvR.m1nD: posts small blind $0.05
truck1234: posts big blind $0.10
*** HOLE CARDS ***
zlobslob: raises $0.15 to $0.25
tr41n3r12: folds 
EphemeralBen: folds 
BahiaMinhaP: folds 
NvR.m1nD: calls $0.20
truck1234: folds 
*** FLOP *** [Kc 3d Ah]
NvR.m1nD: checks 
zlobslob: bets $0.30
NvR.m1nD: calls $0.30
*** TURN *** [Kc 3d Ah] [Qs]
NvR.m1nD: checks 
zlobslob: checks 
*** RIVER *** [Kc 3d Ah Qs] [Th]
NvR.m1nD: checks 
zlobslob: checks 
*** SHOW DOWN ***
NvR.m1nD: shows [As 9s] (a pair of Aces)
zlobslob: mucks hand 
NvR.m1nD collected $1.15 from pot
*** SUMMARY ***
Total pot $1.20 | Rake $0.05 
Board [Kc 3d Ah Qs Th]
Seat 1: BahiaMinhaP (button) folded before Flop (didn't bet)
Seat 2: NvR.m1nD (small blind) showed [As 9s] and won ($1.15) with a pair of Aces
Seat 3: truck1234 (big blind) folded before Flop
Seat 4: zlobslob mucked
Seat 5: tr41n3r12 folded before Flop (didn't bet)
Seat 6: EphemeralBen folded before Flop (didn't bet)



PokerStars Hand #166667524101:  Hold'em No Limit ($0.05/$0.10 USD) - 2017/02/23 16:02:43 ET
Table 'Camilla II' 6-max Seat #5 is the button
Seat 1: paxit71 ($8 in chips) 
Seat 2: Giyorod ($15.81 in chips) 
Seat 4: chimera252 ($12.41 in chips) 
Seat 5: LarryTheStar ($11.49 in chips) 
Seat 6: david_sara83 ($10.05 in chips) 
david_sara83: posts small blind $0.05
paxit71: posts big blind $0.10
Andy Wolf: sits out 
*** HOLE CARDS ***
Giyorod: folds 
chimera252: folds 
LarryTheStar: folds 
david_sara83: folds 
Uncalled bet ($0.05) returned to paxit71
paxit71 collected $0.10 from pot
*** SUMMARY ***
Total pot $0.10 | Rake $0 
Seat 1: paxit71 (big blind) collected ($0.10)
Seat 2: Giyorod folded before Flop (didn't bet)
Seat 4: chimera252 folded before Flop (didn't bet)
Seat 5: LarryTheStar (button) folded before Flop (didn't bet)
Seat 6: david_sara83 (small blind) folded before Flop



PokerStars Hand #166667524292:  Hold'em No Limit ($0.05/$0.10 USD) - 2017/02/23 16:02:44 ET
Table 'Scabiosa III' 6-max Seat #4 is the button
Seat 1: Feverhead ($13.26 in chips) 
Seat 2: kinaó ($12.11 in chips) 
Seat 3: Goroshkos88 ($11.40 in chips) 
Seat 4: voledy ($10.10 in chips) 
Seat 5: patrick19111 ($24.65 in chips) 
Seat 6: Smitty03300 ($10.91 in chips) 
patrick19111: posts small blind $0.05
Smitty03300: posts big blind $0.10
*** HOLE CARDS ***
Feverhead: raises $0.20 to $0.30
kinaó: folds 
Goroshkos88: folds 
voledy: folds 
patrick19111: folds 
kinaó leaves the table
Smitty03300: folds 
Uncalled bet ($0.20) returned to Feverhead
Feverhead collected $0.25 from pot
*** SUMMARY ***
Total pot $0.25 | Rake $0 
Seat 1: Feverhead collected ($0.25)
Seat 2: kinaó folded before Flop (didn't bet)
Seat 3: Goroshkos88 folded before Flop (didn't bet)
Seat 4: voledy (button) folded before Flop (didn't bet)
Seat 5: patrick19111 (small blind) folded before Flop
Seat 6: Smitty03300 (big blind) folded before Flop



PokerStars Hand #166667524343:  Hold'em No Limit ($0.05/$0.10 USD) - 2017/02/23 16:02:44 ET
Table 'Cassini' 6-max Seat #5 is the button
Seat 1: Pokeaster ($10.15 in chips) 
Seat 2: mhonielsen ($13.09 in chips) 
Seat 4: fortieth ($13.72 in chips) 
Seat 5: johkom ($7.75 in chips) 
Seat 6: JahSoldier69 ($10.05 in chips) 
JahSoldier69: posts small blind $0.05
Pokeaster: posts big blind $0.10
*** HOLE CARDS ***
mhonielsen: folds 
fortieth: folds 
johkom: folds 
JahSoldier69: folds 
Uncalled bet ($0.05) returned to Pokeaster
Pokeaster collected $0.10 from pot
*** SUMMARY ***
Total pot $0.10 | Rake $0 
Seat 1: Pokeaster (big blind) collected ($0.10)
Seat 2: mhonielsen folded before Flop (didn't bet)
Seat 4: fortieth folded before Flop (didn't bet)
Seat 5: johkom (button) folded before Flop (didn't bet)
Seat 6: JahSoldier69 (small blind) folded before Flop



PokerStars Hand #166667524384:  Hold'em No Limit ($0.05/$0.10 USD) - 2017/02/23 16:02:44 ET
Table 'Alnasl II' 6-max Seat #4 is the button
Seat 1: dragonste89 ($13.15 in chips) 
Seat 2: Therodorus ($11.91 in chips) 
Seat 3: ICBM-RS26 ($8.09 in chips) 
Seat 4: Eddys Edge ($10 in chips) 
Seat 5: mdelfin0 ($12.36 in chips) 
Seat 6: Bommer78 ($4.77 in chips) 
mdelfin0: posts small blind $0.05
Bommer78: posts big blind $0.10
*** HOLE CARDS ***
dragonste89: folds 
Therodorus: folds 
ICBM-RS26: raises $0.10 to $0.20
Eddys Edge: calls $0.20
mdelfin0: folds 
Bommer78: calls $0.10
*** FLOP *** [Ks Qh Th]
Bommer78: bets $0.30
ICBM-RS26: raises $0.30 to $0.60
Eddys Edge: folds 
Bommer78: calls $0.30
*** TURN *** [Ks Qh Th] [2h]
Bommer78: checks 
ICBM-RS26: bets $0.90
Bommer78: calls $0.90
*** RIVER *** [Ks Qh Th 2h] [9s]
Bommer78: checks 
ICBM-RS26: checks 
*** SHOW DOWN ***
Bommer78: shows [9d Kc] (two pair, Kings and Nines)
ICBM-RS26: shows [Qd Qs] (three of a kind, Queens)
ICBM-RS26 collected $3.49 from pot
*** SUMMARY ***
Total pot $3.65 | Rake $0.16 
Board [Ks Qh Th 2h 9s]
Seat 1: dragonste89 folded before Flop (didn't bet)
Seat 2: Therodorus folded before Flop (didn't bet)
Seat 3: ICBM-RS26 showed [Qd Qs] and won ($3.49) with three of a kind, Queens
Seat 4: Eddys Edge (button) folded on the Flop
Seat 5: mdelfin0 (small blind) folded before Flop
Seat 6: Bommer78 (big blind) showed [9d Kc] and lost with two pair, Kings and Nines



PokerStars Hand #166667524557:  Hold'em No Limit ($0.05/$0.10 USD) - 2017/02/23 16:02:44 ET
Table 'Arpola' 6-max Seat #2 is the button
Seat 1: dincimus ($10 in chips) 
Seat 2: patrick19111 ($10.13 in chips) 
Seat 3: simaryk ($2.69 in chips) 
Seat 4: Orlangoor ($19.20 in chips) 
Seat 5: truck1234 ($11.39 in chips) 
Seat 6: Andrei ProFF ($10.32 in chips) 
simaryk: posts small blind $0.05
Orlangoor: posts big blind $0.10
*** HOLE CARDS ***
truck1234: folds 
Andrei ProFF: raises $0.20 to $0.30
dincimus: folds 
patrick19111: folds 
simaryk: folds 
Orlangoor: folds 
Uncalled bet ($0.20) returned to Andrei ProFF
Andrei ProFF collected $0.25 from pot
*** SUMMARY ***
Total pot $0.25 | Rake $0 
Seat 1: dincimus folded before Flop (didn't bet)
Seat 2: patrick19111 (button) folded before Flop (didn't bet)
Seat 3: simaryk (small blind) folded before Flop
Seat 4: Orlangoor (big blind) folded before Flop
Seat 5: truck1234 folded before Flop (didn't bet)
Seat 6: Andrei ProFF collected ($0.25)



PokerStars Hand #166667524637:  Hold'em No Limit ($0.05/$0.10 USD) - 2017/02/23 16:02:44 ET
Table 'Markab II' 6-max Seat #5 is the button
Seat 1: david_sara83 ($10.17 in chips) 
Seat 2: truck1234 ($11.05 in chips) 
Seat 3: sexy_seagull ($10 in chips) 
Seat 4: Crafty23@PS ($11.69 in chips) 
Seat 5: Rodik002 ($19.17 in chips) 
Seat 6: Comeback3392 ($10.54 in chips) 
Comeback3392: posts small blind $0.05
david_sara83: posts big blind $0.10
*** HOLE CARDS ***
truck1234: folds 
sexy_seagull: raises $0.20 to $0.30
Crafty23@PS: folds 
Rodik002: folds 
Comeback3392: folds 
david_sara83: folds 
Uncalled bet ($0.20) returned to sexy_seagull
sexy_seagull collected $0.25 from pot
*** SUMMARY ***
Total pot $0.25 | Rake $0 
Seat 1: david_sara83 (big blind) folded before Flop
Seat 2: truck1234 folded before Flop (didn't bet)
Seat 3: sexy_seagull collected ($0.25)
Seat 4: Crafty23@PS folded before Flop (didn't bet)
Seat 5: Rodik002 (button) folded before Flop (didn't bet)
Seat 6: Comeback3392 (small blind) folded before Flop



PokerStars Hand #166667524694:  Hold'em No Limit ($0.05/$0.10 USD) - 2017/02/23 16:02:44 ET
Table 'Iapetus III' 6-max Seat #4 is the button
Seat 2: Crafty23@PS ($10 in chips) 
Seat 3: takis nik ($10 in chips) 
Seat 4: XaXaTyH4uK ($10.45 in chips) 
Seat 5: homelessdan ($13.81 in chips) 
homelessdan: posts small blind $0.05
yodzik: is sitting out 
Crafty23@PS: posts big blind $0.10
*** HOLE CARDS ***
takis nik: folds 
XaXaTyH4uK: folds 
homelessdan: folds 
Uncalled bet ($0.05) returned to Crafty23@PS
Crafty23@PS collected $0.10 from pot
*** SUMMARY ***
Total pot $0.10 | Rake $0 
Seat 2: Crafty23@PS (big blind) collected ($0.10)
Seat 3: takis nik folded before Flop (didn't bet)
Seat 4: XaXaTyH4uK (button) folded before Flop (didn't bet)
Seat 5: homelessdan (small blind) folded before Flop



PokerStars Hand #166667524728:  Hold'em No Limit ($0.05/$0.10 USD) - 2017/02/23 16:02:44 ET
Table 'Tyndareus III' 6-max Seat #1 is the button
Seat 1: MBen10 ($10 in chips) 
Seat 2: MihaGr ($10.05 in chips) 
Seat 4: Therodorus ($11.61 in chips) 
Seat 5: Chodemuncher ($10.15 in chips) 
Seat 6: Elinaattor ($9.65 in chips) 
MihaGr: posts small blind $0.05
XaXaTyH4uK: is sitting out 
XaXaTyH4uK leaves the table
Therodorus: posts big blind $0.10
*** HOLE CARDS ***
Chodemuncher: folds 
steepfell joins the table at seat #3 
Elinaattor: raises $0.25 to $0.35
MBen10: folds 
MihaGr: folds 
Therodorus: folds 
Uncalled bet ($0.25) returned to Elinaattor
Elinaattor collected $0.25 from pot
*** SUMMARY ***
Total pot $0.25 | Rake $0 
Seat 1: MBen10 (button) folded before Flop (didn't bet)
Seat 2: MihaGr (small blind) folded before Flop
Seat 4: Therodorus (big blind) folded before Flop
Seat 5: Chodemuncher folded before Flop (didn't bet)
Seat 6: Elinaattor collected ($0.25)



PokerStars Hand #166667525333:  Hold'em No Limit ($0.05/$0.10 USD) - 2017/02/23 16:02:45 ET
Table 'Pulcova II' 6-max Seat #5 is the button
Seat 1: sexy_seagull ($10.15 in chips) 
Seat 2: Kazacha ($10 in chips) 
Seat 3: Lao Tsy ($13.96 in chips) 
Seat 4: VioXion ($10.25 in chips) 
Seat 5: mdelfin0 ($12.74 in chips) 
Seat 6: Ice_Isayev ($10.70 in chips) 
Ice_Isayev: posts small blind $0.05
sexy_seagull: posts big blind $0.10
*** HOLE CARDS ***
Kazacha: folds 
Lao Tsy: raises $0.20 to $0.30
VioXion: folds 
mdelfin0: folds 
Ice_Isayev: folds 
sexy_seagull: calls $0.20
*** FLOP *** [Kh 8d Jc]
sexy_seagull: checks 
Lao Tsy: bets $0.49
sexy_seagull: folds 
Uncalled bet ($0.49) returned to Lao Tsy
Lao Tsy collected $0.62 from pot
*** SUMMARY ***
Total pot $0.65 | Rake $0.03 
Board [Kh 8d Jc]
Seat 1: sexy_seagull (big blind) folded on the Flop
Seat 2: Kazacha folded before Flop (didn't bet)
Seat 3: Lao Tsy collected ($0.62)
Seat 4: VioXion folded before Flop (didn't bet)
Seat 5: mdelfin0 (button) folded before Flop (didn't bet)
Seat 6: Ice_Isayev (small blind) folded before Flop



PokerStars Hand #166667525432:  Hold'em No Limit ($0.05/$0.10 USD) - 2017/02/23 16:02:45 ET
Table 'Cyane' 6-max Seat #4 is the button
Seat 1: KA3AXCTAHEU, ($10.32 in chips) 
Seat 2: Temniy Elf ($10.15 in chips) 
Seat 3: Mamm0nism ($13.94 in chips) 
Seat 4: truck1234 ($20.96 in chips) 
Seat 5: ChuikaPridi ($10.22 in chips) 
Seat 6: 8th wonders ($10.30 in chips) 
ChuikaPridi: posts small blind $0.05
8th wonders: posts big blind $0.10
*** HOLE CARDS ***
KA3AXCTAHEU,: folds 
Temniy Elf: folds 
Mamm0nism: folds 
truck1234: folds 
ChuikaPridi: raises $0.20 to $0.30
8th wonders: raises $0.70 to $1
ChuikaPridi: folds 
Uncalled bet ($0.70) returned to 8th wonders
8th wonders collected $0.60 from pot
*** SUMMARY ***
Total pot $0.60 | Rake $0 
Seat 1: KA3AXCTAHEU, folded before Flop (didn't bet)
Seat 2: Temniy Elf folded before Flop (didn't bet)
Seat 3: Mamm0nism folded before Flop (didn't bet)
Seat 4: truck1234 (button) folded before Flop (didn't bet)
Seat 5: ChuikaPridi (small blind) folded before Flop
Seat 6: 8th wonders (big blind) collected ($0.60)



PokerStars Hand #166667525567:  Hold'em No Limit ($0.05/$0.10 USD) - 2017/02/23 16:02:45 ET
Table 'Caupolican' 6-max Seat #5 is the button
Seat 1: kingartur222 ($10.68 in chips) 
Seat 2: garigura ($19.55 in chips) 
Seat 3: arturgalant ($4.32 in chips) 
Seat 4: mhonielsen ($11.69 in chips) 
Seat 5: Kazacha ($10.80 in chips) 
Seat 6: crazydevill ($10.82 in chips) 
crazydevill: posts small blind $0.05
kingartur222: posts big blind $0.10
*** HOLE CARDS ***
garigura: folds 
arturgalant: calls $0.10
mhonielsen: folds 
Kazacha: folds 
crazydevill: folds 
kingartur222: raises $0.40 to $0.50
arturgalant: calls $0.40
*** FLOP *** [2h 7d 3d]
kingartur222: checks 
arturgalant: checks 
*** TURN *** [2h 7d 3d] [6h]
kingartur222: checks 
arturgalant: checks 
*** RIVER *** [2h 7d 3d 6h] [7h]
kingartur222: checks 
arturgalant: checks 
*** SHOW DOWN ***
kingartur222: shows [As Js] (a pair of Sevens)
arturgalant: mucks hand 
kingartur222 collected $1 from pot
*** SUMMARY ***
Total pot $1.05 | Rake $0.05 
Board [2h 7d 3d 6h 7h]
Seat 1: kingartur222 (big blind) showed [As Js] and won ($1) with a pair of Sevens
Seat 2: garigura folded before Flop (didn't bet)
Seat 3: arturgalant mucked
Seat 4: mhonielsen folded before Flop (didn't bet)
Seat 5: Kazacha (button) folded before Flop (didn't bet)
Seat 6: crazydevill (small blind) folded before Flop



PokerStars Hand #166667525953:  Hold'em No Limit ($0.05/$0.10 USD) - 2017/02/23 16:02:46 ET
Table 'Krethon' 6-max Seat #1 is the button
Seat 1: boxer821 ($10.25 in chips) 
Seat 2: manashov ($10.85 in chips) 
Seat 4: chimera252 ($15.68 in chips) 
Seat 5: popypaleta ($10 in chips) 
manashov: posts small blind $0.05
Kow6oy: is sitting out 
chimera252: posts big blind $0.10
*** HOLE CARDS ***
popypaleta: raises $0.20 to $0.30
boxer821: folds 
Kow6oy leaves the table
manashov: folds 
chimera252: folds 
Uncalled bet ($0.20) returned to popypaleta
popypaleta collected $0.25 from pot
*** SUMMARY ***
Total pot $0.25 | Rake $0 
Seat 1: boxer821 (button) folded before Flop (didn't bet)
Seat 2: manashov (small blind) folded before Flop
Seat 4: chimera252 (big blind) folded before Flop
Seat 5: popypaleta collected ($0.25)



PokerStars Hand #166667526163:  Hold'em No Limit ($0.05/$0.10 USD) - 2017/02/23 16:02:46 ET
Table 'Syringa' 6-max Seat #1 is the button
Seat 1: bdixon_5 ($7.95 in chips) 
Seat 2: Goroshkos88 ($10.31 in chips) 
Seat 3: Yspenyanin ($13.52 in chips) 
Seat 4: tangler19 ($14.58 in chips) 
Seat 5: Andrei ProFF ($13.31 in chips) 
Seat 6: ibara000 ($16.43 in chips) 
Goroshkos88: posts small blind $0.05
Yspenyanin: posts big blind $0.10
*** HOLE CARDS ***
tangler19: folds 
Andrei ProFF: folds 
ibara000: folds 
bdixon_5: folds 
Goroshkos88: raises $0.15 to $0.25
Yspenyanin: folds 
Uncalled bet ($0.15) returned to Goroshkos88
Goroshkos88 collected $0.20 from pot
*** SUMMARY ***
Total pot $0.20 | Rake $0 
Seat 1: bdixon_5 (button) folded before Flop (didn't bet)
Seat 2: Goroshkos88 (small blind) collected ($0.20)
Seat 3: Yspenyanin (big blind) folded before Flop
Seat 4: tangler19 folded before Flop (didn't bet)
Seat 5: Andrei ProFF folded before Flop (didn't bet)
Seat 6: ibara000 folded before Flop (didn't bet)



PokerStars Hand #166667526638:  Hold'em No Limit ($0.05/$0.10 USD) - 2017/02/23 16:02:46 ET
Table 'Brendelia II' 6-max Seat #6 is the button
Seat 2: Crimsonr ($6.03 in chips) 
Seat 3: ValdemorS ($17.77 in chips) 
Seat 6: luckyPositiv ($10.47 in chips) 
Crimsonr: posts small blind $0.05
ValdemorS: posts big blind $0.10
Crimsonr: posts the ante $0.02
ValdemorS: posts the ante $0.02
luckyPositiv: posts the ante $0.02
*** HOLE CARDS ***
luckyPositiv: folds 
Crimsonr: folds 
Uncalled bet ($0.05) returned to ValdemorS
ValdemorS collected $0.16 from pot
*** SUMMARY ***
Total pot $0.16 | Rake $0 
Seat 2: Crimsonr (small blind) folded before Flop
Seat 3: ValdemorS (big blind) collected ($0.16)
Seat 6: luckyPositiv (button) folded before Flop (didn't bet)



PokerStars Hand #166667526774:  Hold'em No Limit ($0.05/$0.10 USD) - 2017/02/23 16:02:47 ET
Table 'Tyche III' 6-max Seat #6 is the button
Seat 1: milt65 ($10.21 in chips) 
Seat 3: ChuikaPridi ($9.94 in chips) 
Seat 4: Kazacha ($10 in chips) 
Seat 5: chimera252 ($11.75 in chips) 
Seat 6: Ice_Isayev ($10 in chips) 
milt65: posts small blind $0.05
arti192837: is sitting out 
ChuikaPridi: posts big blind $0.10
*** HOLE CARDS ***
Kazacha: folds 
chimera252: folds 
Ice_Isayev: raises $0.15 to $0.25
milt65: folds 
ChuikaPridi: folds 
Uncalled bet ($0.15) returned to Ice_Isayev
Ice_Isayev collected $0.25 from pot
*** SUMMARY ***
Total pot $0.25 | Rake $0 
Seat 1: milt65 (small blind) folded before Flop
Seat 3: ChuikaPridi (big blind) folded before Flop
Seat 4: Kazacha folded before Flop (didn't bet)
Seat 5: chimera252 folded before Flop (didn't bet)
Seat 6: Ice_Isayev (button) collected ($0.25)



PokerStars Hand #166667526871:  Hold'em No Limit ($0.05/$0.10 USD) - 2017/02/23 16:02:47 ET
Table 'Nauheima II' 6-max Seat #5 is the button
Seat 2: Peter0087 ($9.59 in chips) 
Seat 3: KokoulinV ($13.74 in chips) 
Seat 4: Innerwuss ($10.12 in chips) 
Seat 5: Kow6oy ($10.45 in chips) 
Seat 6: bonyo71 ($5.09 in chips) 
bonyo71: posts small blind $0.05
HARDCORE66RU: is sitting out 
Peter0087: posts big blind $0.10
*** HOLE CARDS ***
KokoulinV: folds 
Innerwuss: folds 
Kow6oy: folds 
bonyo71: folds 
Uncalled bet ($0.05) returned to Peter0087
Peter0087 collected $0.10 from pot
*** SUMMARY ***
Total pot $0.10 | Rake $0 
Seat 2: Peter0087 (big blind) collected ($0.10)
Seat 3: KokoulinV folded before Flop (didn't bet)
Seat 4: Innerwuss folded before Flop (didn't bet)
Seat 5: Kow6oy (button) folded before Flop (didn't bet)
Seat 6: bonyo71 (small blind) folded before Flop



PokerStars Hand #166667527290:  Hold'em No Limit ($0.05/$0.10 USD) - 2017/02/23 16:02:47 ET
Table 'Reginhild' 6-max Seat #5 is the button
Seat 1: iamkakaroto ($11.40 in chips) 
Seat 2: Kow6oy ($10.15 in chips) 
Seat 3: ARCHITECT83 ($6.18 in chips) 
Seat 4: Raymondo21 ($23.36 in chips) 
Seat 5: XCarlos610 ($28.74 in chips) 
Seat 6: eniksenik ($10.09 in chips) 
eniksenik: posts small blind $0.05
iamkakaroto: posts big blind $0.10
*** HOLE CARDS ***
Kow6oy: folds 
ARCHITECT83: folds 
Raymondo21: folds 
XCarlos610: folds 
eniksenik: folds 
Uncalled bet ($0.05) returned to iamkakaroto
iamkakaroto collected $0.10 from pot
*** SUMMARY ***
Total pot $0.10 | Rake $0 
Seat 1: iamkakaroto (big blind) collected ($0.10)
Seat 2: Kow6oy folded before Flop (didn't bet)
Seat 3: ARCHITECT83 folded before Flop (didn't bet)
Seat 4: Raymondo21 folded before Flop (didn't bet)
Seat 5: XCarlos610 (button) folded before Flop (didn't bet)
Seat 6: eniksenik (small blind) folded before Flop



PokerStars Hand #166667527522:  Hold'em No Limit ($0.05/$0.10 USD) - 2017/02/23 16:02:47 ET
Table 'Huberta II' 6-max Seat #2 is the button
Seat 1: tr41n3r12 ($10 in chips) 
Seat 2: Ice_Isayev ($12.88 in chips) 
Seat 3: patrick19111 ($10.80 in chips) 
Seat 4: VAD21 ($11.38 in chips) 
Seat 5: Feverhead ($27.13 in chips) 
patrick19111: posts small blind $0.05
VAD21: posts big blind $0.10
*** HOLE CARDS ***
Feverhead: folds 
tr41n3r12: folds 
Ice_Isayev: raises $0.15 to $0.25
patrick19111: folds 
VAD21: raises $0.55 to $0.80
Ice_Isayev: calls $0.55
*** FLOP *** [Jh 5d Qh]
VAD21: bets $0.80
Ice_Isayev: folds 
Uncalled bet ($0.80) returned to VAD21
VAD21 collected $1.58 from pot
*** SUMMARY ***
Total pot $1.65 | Rake $0.07 
Board [Jh 5d Qh]
Seat 1: tr41n3r12 folded before Flop (didn't bet)
Seat 2: Ice_Isayev (button) folded on the Flop
Seat 3: patrick19111 (small blind) folded before Flop
Seat 4: VAD21 (big blind) collected ($1.58)
Seat 5: Feverhead folded before Flop (didn't bet)



PokerStars Hand #166667527854:  Hold'em No Limit ($0.05/$0.10 USD) - 2017/02/23 16:02:48 ET
Table 'Vaisala' 6-max Seat #4 is the button
Seat 1: Pekaml ($10.15 in chips) 
Seat 2: XaXaTyH4uK ($10.10 in chips) 
Seat 3: x3ultimate ($10 in chips) 
Seat 4: sexy_seagull ($11.53 in chips) 
Seat 5: AIONCMA1988 ($4.90 in chips) 
Seat 6: Aleksey K228 ($15.43 in chips) 
AIONCMA1988: posts small blind $0.05
Aleksey K228: posts big blind $0.10
*** HOLE CARDS ***
Pekaml: folds 
XaXaTyH4uK: raises $0.20 to $0.30
x3ultimate: calls $0.30
sexy_seagull: folds 
AIONCMA1988: raises $0.60 to $0.90
Aleksey K228: folds 
XaXaTyH4uK: calls $0.60
x3ultimate: folds 
*** FLOP *** [5s 7h Qc]
AIONCMA1988: bets $1.05
XaXaTyH4uK: folds 
Uncalled bet ($1.05) returned to AIONCMA1988
AIONCMA1988 collected $2.10 from pot
*** SUMMARY ***
Total pot $2.20 | Rake $0.10 
Board [5s 7h Qc]
Seat 1: Pekaml folded before Flop (didn't bet)
Seat 2: XaXaTyH4uK folded on the Flop
Seat 3: x3ultimate folded before Flop
Seat 4: sexy_seagull (button) folded before Flop (didn't bet)
Seat 5: AIONCMA1988 (small blind) collected ($2.10)
Seat 6: Aleksey K228 (big blind) folded before Flop



PokerStars Hand #166667527875:  Hold'em No Limit ($0.05/$0.10 USD) - 2017/02/23 16:02:48 ET
Table 'Syringa II' 6-max Seat #5 is the button
Seat 1: GiveTwoMe ($11.85 in chips) 
Seat 2: Cluckh ($10.05 in chips) 
Seat 3: gaHy_HaXeP ($10.73 in chips) 
Seat 4: MBen10 ($10 in chips) 
Seat 5: Mishapok196 ($8.20 in chips) 
Seat 6: WinninBikini ($10.42 in chips) 
WinninBikini: posts small blind $0.05
GiveTwoMe: posts big blind $0.10
*** HOLE CARDS ***
Cluckh: raises $0.20 to $0.30
gaHy_HaXeP: folds 
MBen10: folds 
Mishapok196: calls $0.30
WinninBikini: folds 
GiveTwoMe: calls $0.20
*** FLOP *** [Tc 7d Th]
GiveTwoMe: checks 
Cluckh: bets $0.40
Mishapok196: folds 
GiveTwoMe: calls $0.40
*** TURN *** [Tc 7d Th] [Kh]
GiveTwoMe: checks 
Cluckh: bets $0.80
GiveTwoMe: raises $1.30 to $2.10
Cluckh: folds 
Uncalled bet ($1.30) returned to GiveTwoMe
GiveTwoMe collected $3.20 from pot
*** SUMMARY ***
Total pot $3.35 | Rake $0.15 
Board [Tc 7d Th Kh]
Seat 1: GiveTwoMe (big blind) collected ($3.20)
Seat 2: Cluckh folded on the Turn
Seat 3: gaHy_HaXeP folded before Flop (didn't bet)
Seat 4: MBen10 folded before Flop (didn't bet)
Seat 5: Mishapok196 (button) folded on the Flop
Seat 6: WinninBikini (small blind) folded before Flop



PokerStars Hand #166667527940:  Hold'em No Limit ($0.05/$0.10 USD) - 2017/02/23 16:02:48 ET
Table 'Samitchell III' 6-max Seat #3 is the button
Seat 1: dr.goofy ($10.27 in chips) 
Seat 2: Orlangoor ($10 in chips) 
Seat 3: Kow6oy ($10 in chips) 
Seat 4: eniksenik ($10.52 in chips) 
Seat 6: fedorka rus ($13.11 in chips) 
eniksenik: posts small blind $0.05
boxer821: is sitting out 
boxer821 leaves the table
fedorka rus: posts big blind $0.10
*** HOLE CARDS ***
JahSoldier69 joins the table at seat #5 
dr.goofy: folds 
Orlangoor: folds 
Kow6oy: folds 
eniksenik: raises $0.20 to $0.30
fedorka rus: folds 
Uncalled bet ($0.20) returned to eniksenik
eniksenik collected $0.20 from pot
*** SUMMARY ***
Total pot $0.20 | Rake $0 
Seat 1: dr.goofy folded before Flop (didn't bet)
Seat 2: Orlangoor folded before Flop (didn't bet)
Seat 3: Kow6oy (button) folded before Flop (didn't bet)
Seat 4: eniksenik (small blind) collected ($0.20)
Seat 6: fedorka rus (big blind) folded before Flop



PokerStars Hand #166667528328:  Hold'em No Limit ($0.05/$0.10 USD) - 2017/02/23 16:02:48 ET
Table 'Kunigunde II' 6-max Seat #5 is the button
Seat 1: facewald ($10.11 in chips) 
Seat 2: dragonste89 ($15.03 in chips) 
Seat 3: pancernik21 ($14.76 in chips) 
Seat 4: david_sara83 ($12.83 in chips) 
Seat 5: mdelfin0 ($11.59 in chips) 
Seat 6: Zooplack ($10 in chips) 
Zooplack: posts small blind $0.05
facewald: posts big blind $0.10
*** HOLE CARDS ***
dragonste89: raises $0.30 to $0.40
pancernik21: folds 
david_sara83: folds 
mdelfin0: folds 
Zooplack: folds 
facewald: folds 
Uncalled bet ($0.30) returned to dragonste89
dragonste89 collected $0.25 from pot
*** SUMMARY ***
Total pot $0.25 | Rake $0 
Seat 1: facewald (big blind) folded before Flop
Seat 2: dragonste89 collected ($0.25)
Seat 3: pancernik21 folded before Flop (didn't bet)
Seat 4: david_sara83 folded before Flop (didn't bet)
Seat 5: mdelfin0 (button) folded before Flop (didn't bet)
Seat 6: Zooplack (small blind) folded before Flop



PokerStars Hand #166667528479:  Hold'em No Limit ($0.05/$0.10 USD) - 2017/02/23 16:02:49 ET
Table 'Stroobantia II' 6-max Seat #4 is the button
Seat 1: XBrosh ($7.88 in chips) 
Seat 2: IAntikI ($10 in chips) 
Seat 3: 8th wonders ($10.88 in chips) 
Seat 4: Xander188 ($10 in chips) 
Seat 5: Zooplack ($12.38 in chips) 
Seat 6: CHRO8 ($13.12 in chips) 
Zooplack: posts small blind $0.05
CHRO8: posts big blind $0.10
*** HOLE CARDS ***
XBrosh: folds 
IAntikI: folds 
8th wonders: raises $0.20 to $0.30
Xander188: folds 
Zooplack: folds 
CHRO8: folds 
Uncalled bet ($0.20) returned to 8th wonders
8th wonders collected $0.25 from pot
*** SUMMARY ***
Total pot $0.25 | Rake $0 
Seat 1: XBrosh folded before Flop (didn't bet)
Seat 2: IAntikI folded before Flop (didn't bet)
Seat 3: 8th wonders collected ($0.25)
Seat 4: Xander188 (button) folded before Flop (didn't bet)
Seat 5: Zooplack (small blind) folded before Flop
Seat 6: CHRO8 (big blind) folded before Flop



PokerStars Hand #166667528559:  Hold'em No Limit ($0.05/$0.10 USD) - 2017/02/23 16:02:49 ET
Table 'Kochera' 6-max Seat #3 is the button
Seat 1: chimera252 ($11.50 in chips) 
Seat 2: bartabs2 ($10.61 in chips) 
Seat 3: KA3AXCTAHEU, ($10.10 in chips) 
Seat 4: johkom ($5.51 in chips) 
Seat 5: univibe68 ($12 in chips) 
Seat 6: oddshoff ($9.48 in chips) 
johkom: posts small blind $0.05
univibe68: posts big blind $0.10
*** HOLE CARDS ***
oddshoff: folds 
chimera252: raises $0.20 to $0.30
bartabs2: folds 
KA3AXCTAHEU,: folds 
johkom: folds 
univibe68: folds 
Uncalled bet ($0.20) returned to chimera252
chimera252 collected $0.25 from pot
*** SUMMARY ***
Total pot $0.25 | Rake $0 
Seat 1: chimera252 collected ($0.25)
Seat 2: bartabs2 folded before Flop (didn't bet)
Seat 3: KA3AXCTAHEU, (button) folded before Flop (didn't bet)
Seat 4: johkom (small blind) folded before Flop
Seat 5: univibe68 (big blind) folded before Flop
Seat 6: oddshoff folded before Flop (didn't bet)



PokerStars Hand #166667528617:  Hold'em No Limit ($0.05/$0.10 USD) - 2017/02/23 16:02:49 ET
Table 'Atalante' 6-max Seat #3 is the button
Seat 1: OceanBlue100 ($5.24 in chips) 
Seat 2: CiisCi ($19.77 in chips) 
Seat 3: Kow6oy ($10 in chips) 
Seat 4: Dcaro31 ($25.12 in chips) 
Seat 5: eniksenik ($10.29 in chips) 
Seat 6: FlopsterGB ($30.23 in chips) 
Dcaro31: posts small blind $0.05
eniksenik: posts big blind $0.10
*** HOLE CARDS ***
FlopsterGB: folds 
OceanBlue100: folds 
CiisCi: folds 
Kow6oy: folds 
Dcaro31: folds 
Uncalled bet ($0.05) returned to eniksenik
eniksenik collected $0.10 from pot
*** SUMMARY ***
Total pot $0.10 | Rake $0 
Seat 1: OceanBlue100 folded before Flop (didn't bet)
Seat 2: CiisCi folded before Flop (didn't bet)
Seat 3: Kow6oy (button) folded before Flop (didn't bet)
Seat 4: Dcaro31 (small blind) folded before Flop
Seat 5: eniksenik (big blind) collected ($0.10)
Seat 6: FlopsterGB folded before Flop (didn't bet)



PokerStars Hand #166667528652:  Hold'em No Limit ($0.05/$0.10 USD) - 2017/02/23 16:02:49 ET
Table 'Lederle' 6-max Seat #2 is the button
Seat 2: truck1234 ($15.85 in chips) 
Seat 3: Kazacha ($10.55 in chips) 
Seat 4: Pokeaster ($13.61 in chips) 
Seat 5: 8th wonders ($14.16 in chips) 
Seat 6: pokekrk ($10 in chips) 
Kazacha: posts small blind $0.05
Pokeaster: posts big blind $0.10
*** HOLE CARDS ***
8th wonders: folds 
pokekrk: folds 
truck1234: folds 
Kazacha: folds 
Uncalled bet ($0.05) returned to Pokeaster
Pokeaster collected $0.10 from pot
*** SUMMARY ***
Total pot $0.10 | Rake $0 
Seat 2: truck1234 (button) folded before Flop (didn't bet)
Seat 3: Kazacha (small blind) folded before Flop
Seat 4: Pokeaster (big blind) collected ($0.10)
Seat 5: 8th wonders folded before Flop (didn't bet)
Seat 6: pokekrk folded before Flop (didn't bet)



PokerStars Hand #166667528662:  Hold'em No Limit ($0.05/$0.10 USD) - 2017/02/23 16:02:49 ET
Table 'Ebella II' 6-max Seat #1 is the button
Seat 1: gaHy_HaXeP ($10 in chips) 
Seat 2: Therodorus ($10 in chips) 
Seat 3: Torften2 ($16.73 in chips) 
Seat 4: ValdemorS ($10.15 in chips) 
Seat 5: Bird et al ($10 in chips) 
Seat 6: Joker51_wtf! ($10 in chips) 
Therodorus: posts small blind $0.05
Torften2: posts big blind $0.10
*** HOLE CARDS ***
ValdemorS: raises $0.20 to $0.30
Bird et al: folds 
Joker51_wtf!: folds 
gaHy_HaXeP: folds 
Therodorus: folds 
Torften2: calls $0.20
*** FLOP *** [Ks 8s Jc]
Torften2: checks 
ValdemorS: checks 
*** TURN *** [Ks 8s Jc] [Ac]
Torften2: bets $0.40
ValdemorS: calls $0.40
*** RIVER *** [Ks 8s Jc Ac] [Kh]
Torften2: bets $0.40
ValdemorS: calls $0.40
*** SHOW DOWN ***
Torften2: shows [8d Jh] (two pair, Kings and Jacks)
ValdemorS: shows [Ad Qh] (two pair, Aces and Kings)
ValdemorS collected $2.15 from pot
*** SUMMARY ***
Total pot $2.25 | Rake $0.10 
Board [Ks 8s Jc Ac Kh]
Seat 1: gaHy_HaXeP (button) folded before Flop (didn't bet)
Seat 2: Therodorus (small blind) folded before Flop
Seat 3: Torften2 (big blind) showed [8d Jh] and lost with two pair, Kings and Jacks
Seat 4: ValdemorS showed [Ad Qh] and won ($2.15) with two pair, Aces and Kings
Seat 5: Bird et al folded before Flop (didn't bet)
Seat 6: Joker51_wtf! folded before Flop (didn't bet)



PokerStars Hand #166667528695:  Hold'em No Limit ($0.05/$0.10 USD) - 2017/02/23 16:02:49 ET
Table 'Hyakutake' 6-max Seat #1 is the button
Seat 1: Asilvagoat ($11.58 in chips) 
Seat 2: boxer821 ($10.56 in chips) 
Seat 3: lenboysprite ($6.90 in chips) 
Seat 4: eniksenik ($13.80 in chips) 
Seat 5: RoJ1 ($11.59 in chips) 
Seat 6: maxiv608 ($13.27 in chips) 
boxer821: posts small blind $0.05
lenboysprite: posts big blind $0.10
*** HOLE CARDS ***
eniksenik: folds 
RoJ1: folds 
maxiv608: folds 
Asilvagoat: folds 
boxer821: raises $0.15 to $0.25
lenboysprite: calls $0.15
*** FLOP *** [Ah Qd Qc]
boxer821: bets $0.35
lenboysprite: folds 
Uncalled bet ($0.35) returned to boxer821
boxer821 collected $0.48 from pot
*** SUMMARY ***
Total pot $0.50 | Rake $0.02 
Board [Ah Qd Qc]
Seat 1: Asilvagoat (button) folded before Flop (didn't bet)
Seat 2: boxer821 (small blind) collected ($0.48)
Seat 3: lenboysprite (big blind) folded on the Flop
Seat 4: eniksenik folded before Flop (didn't bet)
Seat 5: RoJ1 folded before Flop (didn't bet)
Seat 6: maxiv608 folded before Flop (didn't bet)



PokerStars Hand #166667528807:  Hold'em No Limit ($0.05/$0.10 USD) - 2017/02/23 16:02:49 ET
Table 'Gelria' 6-max Seat #3 is the button
Seat 1: ab260414 ($10 in chips) 
Seat 2: fishhook5 ($10 in chips) 
Seat 3: Orlangoor ($10.97 in chips) 
Seat 5: apenvel ($8.40 in chips) 
Seat 6: Andrei ProFF ($10.57 in chips) 
apenvel: posts small blind $0.05
Andrei ProFF: posts big blind $0.10
*** HOLE CARDS ***
ab260414: folds 
fishhook5: folds 
Orlangoor: raises $0.12 to $0.22
apenvel: calls $0.17
Andrei ProFF: folds 
*** FLOP *** [4c 6s 5s]
apenvel: checks 
Orlangoor: checks 
*** TURN *** [4c 6s 5s] [Qh]
apenvel: checks 
Orlangoor: bets $0.30
apenvel: folds 
Uncalled bet ($0.30) returned to Orlangoor
Orlangoor collected $0.52 from pot
*** SUMMARY ***
Total pot $0.54 | Rake $0.02 
Board [4c 6s 5s Qh]
Seat 1: ab260414 folded before Flop (didn't bet)
Seat 2: fishhook5 folded before Flop (didn't bet)
Seat 3: Orlangoor (button) collected ($0.52)
Seat 5: apenvel (small blind) folded on the Turn
Seat 6: Andrei ProFF (big blind) folded before Flop



PokerStars Hand #166667529234:  Hold'em No Limit ($0.05/$0.10 USD) - 2017/02/23 16:02:49 ET
Table 'Sirius II' 6-max Seat #3 is the button
Seat 1: Ampped87 ($13.76 in chips) 
Seat 3: Spud014 ($10.25 in chips) 
Seat 5: pokekrk ($11.53 in chips) 
Seat 6: MihaGr ($10 in chips) 
pokekrk: posts small blind $0.05
MihaGr: posts big blind $0.10
Buddy8711: sits out 
*** HOLE CARDS ***
Ampped87: folds 
Spud014: raises $0.10 to $0.20
pokekrk: folds 
MihaGr: folds 
Uncalled bet ($0.10) returned to Spud014
Spud014 collected $0.25 from pot
*** SUMMARY ***
Total pot $0.25 | Rake $0 
Seat 1: Ampped87 folded before Flop (didn't bet)
Seat 3: Spud014 (button) collected ($0.25)
Seat 5: pokekrk (small blind) folded before Flop
Seat 6: MihaGr (big blind) folded before Flop



PokerStars Hand #166667529358:  Hold'em No Limit ($0.05/$0.10 USD) - 2017/02/23 16:02:50 ET
Table 'Deflotte' 6-max Seat #5 is the button
Seat 1: Zooplack ($15.54 in chips) 
Seat 3: Croplayer1 ($10.15 in chips) 
Seat 4: 8th wonders ($10 in chips) 
Seat 5: Pokeaster ($11.37 in chips) 
Seat 6: Iarlei ($12.35 in chips) 
Iarlei: posts small blind $0.05
Zooplack: posts big blind $0.10
MonteCris92: sits out 
*** HOLE CARDS ***
Croplayer1: folds 
8th wonders: folds 
Pokeaster: raises $0.15 to $0.25
Iarlei: folds 
Zooplack: raises $0.50 to $0.75
Pokeaster: folds 
Uncalled bet ($0.50) returned to Zooplack
Zooplack collected $0.55 from pot
*** SUMMARY ***
Total pot $0.55 | Rake $0 
Seat 1: Zooplack (big blind) collected ($0.55)
Seat 3: Croplayer1 folded before Flop (didn't bet)
Seat 4: 8th wonders folded before Flop (didn't bet)
Seat 5: Pokeaster (button) folded before Flop
Seat 6: Iarlei (small blind) folded before Flop



PokerStars Hand #166667530102:  Hold'em No Limit ($0.05/$0.10 USD) - 2017/02/23 16:02:50 ET
Table 'Carina' 6-max Seat #3 is the button
Seat 2: kickereens ($24.24 in chips) 
Seat 3: LarryTheStar ($10.10 in chips) 
Seat 4: crazydevill ($10.05 in chips) 
Seat 5: IAntikI ($10 in chips) 
Seat 6: alexweezer ($9.95 in chips) 
crazydevill: posts small blind $0.05
IAntikI: posts big blind $0.10
Kupi007: sits out 
*** HOLE CARDS ***
alexweezer: folds 
kickereens: folds 
LarryTheStar: folds 
crazydevill: folds 
Uncalled bet ($0.05) returned to IAntikI
IAntikI collected $0.10 from pot
*** SUMMARY ***
Total pot $0.10 | Rake $0 
Seat 2: kickereens folded before Flop (didn't bet)
Seat 3: LarryTheStar (button) folded before Flop (didn't bet)
Seat 4: crazydevill (small blind) folded before Flop
Seat 5: IAntikI (big blind) collected ($0.10)
Seat 6: alexweezer folded before Flop (didn't bet)



PokerStars Hand #166667530493:  Hold'em No Limit ($0.05/$0.10 USD) - 2017/02/23 16:02:51 ET
Table 'Arduina' 6-max Seat #5 is the button
Seat 2: Andy Wolf ($14.60 in chips) 
Seat 3: Dcaro31 ($13.11 in chips) 
Seat 4: ChuikaPridi ($30.73 in chips) 
Seat 5: ettedallas ($5.01 in chips) 
Seat 6: dierri ($10.04 in chips) 
dierri: posts small blind $0.05
kickereens: is sitting out 
Andy Wolf: posts big blind $0.10
*** HOLE CARDS ***
kickereens leaves the table
Dcaro31: folds 
tauronex joins the table at seat #1 
ChuikaPridi: folds 
ettedallas: raises $0.20 to $0.30
dierri: folds 
Andy Wolf: folds 
Uncalled bet ($0.20) returned to ettedallas
ettedallas collected $0.25 from pot
*** SUMMARY ***
Total pot $0.25 | Rake $0 
Seat 2: Andy Wolf (big blind) folded before Flop
Seat 3: Dcaro31 folded before Flop (didn't bet)
Seat 4: ChuikaPridi folded before Flop (didn't bet)
Seat 5: ettedallas (button) collected ($0.25)
Seat 6: dierri (small blind) folded before Flop



PokerStars Hand #166667530757:  Hold'em No Limit ($0.05/$0.10 USD) - 2017/02/23 16:02:51 ET
Table 'Tyndareus II' 6-max Seat #5 is the button
Seat 1: Makc1705 ($3.65 in chips) 
Seat 2: Therodorus ($11.77 in chips) 
Seat 3: McCleans ($11.21 in chips) 
Seat 4: gaHy_HaXeP ($11.21 in chips) 
Seat 5: vtalian ($10 in chips) 
Seat 6: sexy_seagull ($10 in chips) 
sexy_seagull: posts small blind $0.05
Makc1705: posts big blind $0.10
*** HOLE CARDS ***
Therodorus: folds 
McCleans: folds 
gaHy_HaXeP: folds 
vtalian: folds 
sexy_seagull: folds 
Uncalled bet ($0.05) returned to Makc1705
Makc1705 collected $0.10 from pot
*** SUMMARY ***
Total pot $0.10 | Rake $0 
Seat 1: Makc1705 (big blind) collected ($0.10)
Seat 2: Therodorus folded before Flop (didn't bet)
Seat 3: McCleans folded before Flop (didn't bet)
Seat 4: gaHy_HaXeP folded before Flop (didn't bet)
Seat 5: vtalian (button) folded before Flop (didn't bet)
Seat 6: sexy_seagull (small blind) folded before Flop



PokerStars Hand #166667531019:  Hold'em No Limit ($0.05/$0.10 USD) - 2017/02/23 16:02:51 ET
Table 'Kobresia II' 6-max Seat #3 is the button
Seat 1: RoJ1 ($13.96 in chips) 
Seat 2: Dcaro31 ($13.44 in chips) 
Seat 3: FRAID358 ($10.84 in chips) 
Seat 4: armstv ($10.92 in chips) 
Seat 5: Goroshkos88 ($11.89 in chips) 
Seat 6: WinninBikini ($10 in chips) 
armstv: posts small blind $0.05
Goroshkos88: posts big blind $0.10
*** HOLE CARDS ***
WinninBikini: folds 
RoJ1: folds 
Dcaro31: folds 
FRAID358: folds 
armstv: folds 
Uncalled bet ($0.05) returned to Goroshkos88
Goroshkos88 collected $0.10 from pot
*** SUMMARY ***
Total pot $0.10 | Rake $0 
Seat 1: RoJ1 folded before Flop (didn't bet)
Seat 2: Dcaro31 folded before Flop (didn't bet)
Seat 3: FRAID358 (button) folded before Flop (didn't bet)
Seat 4: armstv (small blind) folded before Flop
Seat 5: Goroshkos88 (big blind) collected ($0.10)
Seat 6: WinninBikini folded before Flop (didn't bet)



PokerStars Hand #166667531055:  Hold'em No Limit ($0.05/$0.10 USD) - 2017/02/23 16:02:51 ET
Table 'Eurykleia' 6-max Seat #5 is the button
Seat 1: Giyorod ($11.20 in chips) 
Seat 2: x3ultimate ($10 in chips) 
Seat 3: boxer821 ($20.56 in chips) 
Seat 4: 6ePeMeHHa9 ($16.66 in chips) 
Seat 5: fishhook5 ($10 in chips) 
Seat 6: afca128 ($6.47 in chips) 
afca128: posts small blind $0.05
Giyorod: posts big blind $0.10
*** HOLE CARDS ***
x3ultimate: raises $0.20 to $0.30
boxer821: folds 
6ePeMeHHa9: folds 
fishhook5: folds 
afca128: folds 
Giyorod: calls $0.20
*** FLOP *** [4c 3c 5d]
Giyorod: checks 
x3ultimate: bets $0.46
Giyorod: calls $0.46
*** TURN *** [4c 3c 5d] [Kh]
Giyorod: checks 
x3ultimate: bets $1.12
Giyorod: folds 
Uncalled bet ($1.12) returned to x3ultimate
x3ultimate collected $1.50 from pot
*** SUMMARY ***
Total pot $1.57 | Rake $0.07 
Board [4c 3c 5d Kh]
Seat 1: Giyorod (big blind) folded on the Turn
Seat 2: x3ultimate collected ($1.50)
Seat 3: boxer821 folded before Flop (didn't bet)
Seat 4: 6ePeMeHHa9 folded before Flop (didn't bet)
Seat 5: fishhook5 (button) folded before Flop (didn't bet)
Seat 6: afca128 (small blind) folded before Flop



PokerStars Hand #166667531641:  Hold'em No Limit ($0.05/$0.10 USD) - 2017/02/23 16:02:52 ET
Table 'Aegle' 6-max Seat #3 is the button
Seat 1: phatts76 ($3.90 in chips) 
Seat 2: yodzik ($5 in chips) 
Seat 3: DrejAtom ($11.58 in chips) 
Seat 4: ab260414 ($11.22 in chips) 
Seat 5: KokoulinV ($11.13 in chips) 
Seat 6: CHRO8 ($20.59 in chips) 
ab260414: posts small blind $0.05
KokoulinV: posts big blind $0.10
*** HOLE CARDS ***
CHRO8: folds 
phatts76: folds 
yodzik: folds 
DrejAtom: calls $0.10
ab260414: folds 
KokoulinV: checks 
*** FLOP *** [5d 4h Ac]
KokoulinV: checks 
DrejAtom: checks 
*** TURN *** [5d 4h Ac] [Js]
KokoulinV: checks 
DrejAtom: checks 
*** RIVER *** [5d 4h Ac Js] [2h]
KokoulinV: checks 
DrejAtom: bets $0.60
KokoulinV: folds 
Uncalled bet ($0.60) returned to DrejAtom
DrejAtom collected $0.24 from pot
*** SUMMARY ***
Total pot $0.25 | Rake $0.01 
Board [5d 4h Ac Js 2h]
Seat 1: phatts76 folded before Flop (didn't bet)
Seat 2: yodzik folded before Flop (didn't bet)
Seat 3: DrejAtom (button) collected ($0.24)
Seat 4: ab260414 (small blind) folded before Flop
Seat 5: KokoulinV (big blind) folded on the River
Seat 6: CHRO8 folded before Flop (didn't bet)



PokerStars Hand #166667531704:  Hold'em No Limit ($0.05/$0.10 USD) - 2017/02/23 16:02:52 ET
Table 'Alnasl' 6-max Seat #4 is the button
Seat 1: KA3AXCTAHEU, ($11.22 in chips) 
Seat 2: XaXaTyH4uK ($10.75 in chips) 
Seat 3: david_sara83 ($22.69 in chips) 
Seat 4: oddshoff ($10.03 in chips) 
Seat 5: steepfell ($10.13 in chips) 
Seat 6: Zooplack ($13.43 in chips) 
steepfell: posts small blind $0.05
Zooplack: posts big blind $0.10
*** HOLE CARDS ***
KA3AXCTAHEU,: folds 
XaXaTyH4uK: folds 
david_sara83: folds 
oddshoff: raises $0.10 to $0.20
steepfell: raises $0.50 to $0.70
Zooplack: folds 
oddshoff: folds 
Uncalled bet ($0.50) returned to steepfell
steepfell collected $0.50 from pot
*** SUMMARY ***
Total pot $0.50 | Rake $0 
Seat 1: KA3AXCTAHEU, folded before Flop (didn't bet)
Seat 2: XaXaTyH4uK folded before Flop (didn't bet)
Seat 3: david_sara83 folded before Flop (didn't bet)
Seat 4: oddshoff (button) folded before Flop
Seat 5: steepfell (small blind) collected ($0.50)
Seat 6: Zooplack (big blind) folded before Flop



PokerStars Hand #166667531726:  Hold'em No Limit ($0.05/$0.10 USD) - 2017/02/23 16:02:52 ET
Table 'Brendelia II' 6-max Seat #2 is the button
Seat 2: Crimsonr ($5.96 in chips) 
Seat 3: ValdemorS ($17.86 in chips) 
Seat 6: luckyPositiv ($10.45 in chips) 
ValdemorS: posts small blind $0.05
luckyPositiv: posts big blind $0.10
Crimsonr: posts the ante $0.02
ValdemorS: posts the ante $0.02
luckyPositiv: posts the ante $0.02
*** HOLE CARDS ***
Crimsonr: folds 
ValdemorS: folds 
Uncalled bet ($0.05) returned to luckyPositiv
luckyPositiv collected $0.16 from pot
*** SUMMARY ***
Total pot $0.16 | Rake $0 
Seat 2: Crimsonr (button) folded before Flop (didn't bet)
Seat 3: ValdemorS (small blind) folded before Flop
Seat 6: luckyPositiv (big blind) collected ($0.16)



PokerStars Hand #166667531735:  Hold'em No Limit ($0.05/$0.10 USD) - 2017/02/23 16:02:52 ET
Table 'Goto II' 6-max Seat #6 is the button
Seat 1: FRAID358 ($12.81 in chips) 
Seat 2: 6ePeMeHHa9 ($11.09 in chips) 
Seat 3: Goroshkos88 ($10.59 in chips) 
Seat 4: KRZuff ($13.04 in chips) 
Seat 5: RoJ1 ($13.72 in chips) 
Seat 6: ermananb93 ($13.29 in chips) 
FRAID358: posts small blind $0.05
6ePeMeHHa9: posts big blind $0.10
*** HOLE CARDS ***
Goroshkos88: folds 
KRZuff: folds 
RoJ1: folds 
ermananb93: calls $0.10
FRAID358: folds 
6ePeMeHHa9: raises $0.30 to $0.40
ermananb93: calls $0.30
*** FLOP *** [9c 3h Kd]
6ePeMeHHa9: checks 
ermananb93: bets $0.20
6ePeMeHHa9: calls $0.20
*** TURN *** [9c 3h Kd] [5d]
6ePeMeHHa9: checks 
ermananb93: bets $0.20
6ePeMeHHa9: raises $0.70 to $0.90
ermananb93: folds 
Uncalled bet ($0.70) returned to 6ePeMeHHa9
6ePeMeHHa9 collected $1.58 from pot
*** SUMMARY ***
Total pot $1.65 | Rake $0.07 
Board [9c 3h Kd 5d]
Seat 1: FRAID358 (small blind) folded before Flop
Seat 2: 6ePeMeHHa9 (big blind) collected ($1.58)
Seat 3: Goroshkos88 folded before Flop (didn't bet)
Seat 4: KRZuff folded before Flop (didn't bet)
Seat 5: RoJ1 folded before Flop (didn't bet)
Seat 6: ermananb93 (button) folded on the Turn



PokerStars Hand #166667532223:  Hold'em No Limit ($0.05/$0.10 USD) - 2017/02/23 16:02:52 ET
Table 'Nemo III' 6-max Seat #4 is the button
Seat 2: Bandyaev ($11.89 in chips) 
Seat 3: Therodorus ($10 in chips) 
Seat 4: vtalian ($9.55 in chips) 
Seat 5: Joker51_wtf! ($11.48 in chips) 
Seat 6: SALAMIS85 ($13.64 in chips) 
Joker51_wtf!: posts small blind $0.05
SALAMIS85: posts big blind $0.10
*** HOLE CARDS ***
Bandyaev: folds 
Therodorus: folds 
vtalian: raises $0.20 to $0.30
Joker51_wtf!: folds 
SALAMIS85: folds 
Uncalled bet ($0.20) returned to vtalian
vtalian collected $0.25 from pot
*** SUMMARY ***
Total pot $0.25 | Rake $0 
Seat 2: Bandyaev folded before Flop (didn't bet)
Seat 3: Therodorus folded before Flop (didn't bet)
Seat 4: vtalian (button) collected ($0.25)
Seat 5: Joker51_wtf! (small blind) folded before Flop
Seat 6: SALAMIS85 (big blind) folded before Flop



PokerStars Hand #166667532235:  Hold'em No Limit ($0.05/$0.10 USD) - 2017/02/23 16:02:52 ET
Table 'Antielus II' 6-max Seat #1 is the button
Seat 1: Dcaro31 ($17.30 in chips) 
Seat 2: Orlangoor ($10.50 in chips) 
Seat 3: mcyi3at2 ($12.89 in chips) 
Seat 5: Hyd SK ($10 in chips) 
Seat 6: GiveTwoMe ($12.40 in chips) 
Orlangoor: posts small blind $0.05
mcyi3at2: posts big blind $0.10
XwinX25: sits out 
*** HOLE CARDS ***
Hyd SK: raises $0.25 to $0.35
GiveTwoMe: folds 
Dcaro31: folds 
Orlangoor: calls $0.30
mcyi3at2: calls $0.25
*** FLOP *** [As 2h Th]
Orlangoor: checks 
mcyi3at2: checks 
Hyd SK: bets $0.50
Orlangoor: folds 
mcyi3at2: folds 
Uncalled bet ($0.50) returned to Hyd SK
Hyd SK collected $1 from pot
*** SUMMARY ***
Total pot $1.05 | Rake $0.05 
Board [As 2h Th]
Seat 1: Dcaro31 (button) folded before Flop (didn't bet)
Seat 2: Orlangoor (small blind) folded on the Flop
Seat 3: mcyi3at2 (big blind) folded on the Flop
Seat 5: Hyd SK collected ($1)
Seat 6: GiveTwoMe folded before Flop (didn't bet)



PokerStars Hand #166667532590:  Hold'em No Limit ($0.05/$0.10 USD) - 2017/02/23 16:02:53 ET
Table 'Hamal II' 6-max Seat #4 is the button
Seat 1: saxoalto2011 ($8.49 in chips) 
Seat 2: pancernik21 ($10 in chips) 
Seat 3: Cluckh ($11.24 in chips) 
Seat 4: ArcticBearDK ($10.81 in chips) 
Seat 5: eniksenik ($10.46 in chips) 
Seat 6: LarryTheStar ($11.24 in chips) 
eniksenik: posts small blind $0.05
LarryTheStar: posts big blind $0.10
*** HOLE CARDS ***
saxoalto2011: raises $0.30 to $0.40
pancernik21: folds 
Cluckh: folds 
ArcticBearDK: folds 
eniksenik: folds 
LarryTheStar: folds 
Uncalled bet ($0.30) returned to saxoalto2011
saxoalto2011 collected $0.25 from pot
*** SUMMARY ***
Total pot $0.25 | Rake $0 
Seat 1: saxoalto2011 collected ($0.25)
Seat 2: pancernik21 folded before Flop (didn't bet)
Seat 3: Cluckh folded before Flop (didn't bet)
Seat 4: ArcticBearDK (button) folded before Flop (didn't bet)
Seat 5: eniksenik (small blind) folded before Flop
Seat 6: LarryTheStar (big blind) folded before Flop



PokerStars Hand #166667532614:  Hold'em No Limit ($0.05/$0.10 USD) - 2017/02/23 16:02:53 ET
Table 'Epimetheus' 6-max Seat #3 is the button
Seat 1: 6ePeMeHHa9 ($10.64 in chips) 
Seat 2: patrick19111 ($15.05 in chips) 
Seat 3: dineldidi ($9.84 in chips) 
Seat 5: afca128 ($24.33 in chips) 
Seat 6: voledy ($10 in chips) 
afca128: posts small blind $0.05
voledy: posts big blind $0.10
*** HOLE CARDS ***
6ePeMeHHa9: folds 
patrick19111: folds 
dineldidi: folds 
afca128: raises $0.20 to $0.30
voledy: folds 
Uncalled bet ($0.20) returned to afca128
afca128 collected $0.20 from pot
*** SUMMARY ***
Total pot $0.20 | Rake $0 
Seat 1: 6ePeMeHHa9 folded before Flop (didn't bet)
Seat 2: patrick19111 folded before Flop (didn't bet)
Seat 3: dineldidi (button) folded before Flop (didn't bet)
Seat 5: afca128 (small blind) collected ($0.20)
Seat 6: voledy (big blind) folded before Flop



PokerStars Hand #166667533116:  Hold'em No Limit ($0.05/$0.10 USD) - 2017/02/23 16:02:53 ET
Table 'Lehigh' 6-max Seat #6 is the button
Seat 1: kowe4ka565 ($10.62 in chips) 
Seat 3: Therodorus ($10.15 in chips) 
Seat 4: Chodemuncher ($10.20 in chips) 
Seat 5: Xander188 ($10 in chips) 
Seat 6: CallByValue ($9.45 in chips) 
kowe4ka565: posts small blind $0.05
Therodorus: posts big blind $0.10
*** HOLE CARDS ***
Chodemuncher: folds 
Xander188: folds 
Sbozzz joins the table at seat #2 
CallByValue: folds 
kowe4ka565: calls $0.05
Therodorus: raises $0.35 to $0.45
kowe4ka565: calls $0.35
*** FLOP *** [Qd 2d Qs]
kowe4ka565: bets $0.43
Therodorus: folds 
Uncalled bet ($0.43) returned to kowe4ka565
kowe4ka565 collected $0.86 from pot
*** SUMMARY ***
Total pot $0.90 | Rake $0.04 
Board [Qd 2d Qs]
Seat 1: kowe4ka565 (small blind) collected ($0.86)
Seat 3: Therodorus (big blind) folded on the Flop
Seat 4: Chodemuncher folded before Flop (didn't bet)
Seat 5: Xander188 folded before Flop (didn't bet)
Seat 6: CallByValue (button) folded before Flop (didn't bet)



PokerStars Hand #166667533162:  Hold'em No Limit ($0.05/$0.10 USD) - 2017/02/23 16:02:53 ET
Table 'Glarona' 6-max Seat #4 is the button
Seat 1: LarryTheStar ($10.80 in chips) 
Seat 2: BookWorm78 ($10.02 in chips) 
Seat 3: hoedje72 ($3.86 in chips) 
Seat 4: CrippledGod ($6.72 in chips) 
Seat 5: david_sara83 ($10.25 in chips) 
Seat 6: Namhkal ($11.08 in chips) 
david_sara83: posts small blind $0.05
Namhkal: posts big blind $0.10
*** HOLE CARDS ***
LarryTheStar: folds 
BookWorm78: folds 
hoedje72: folds 
CrippledGod: folds 
david_sara83: raises $0.20 to $0.30
Namhkal: folds 
Uncalled bet ($0.20) returned to david_sara83
david_sara83 collected $0.20 from pot
*** SUMMARY ***
Total pot $0.20 | Rake $0 
Seat 1: LarryTheStar folded before Flop (didn't bet)
Seat 2: BookWorm78 folded before Flop (didn't bet)
Seat 3: hoedje72 folded before Flop (didn't bet)
Seat 4: CrippledGod (button) folded before Flop (didn't bet)
Seat 5: david_sara83 (small blind) collected ($0.20)
Seat 6: Namhkal (big blind) folded before Flop



PokerStars Hand #166667533192:  Hold'em No Limit ($0.05/$0.10 USD) - 2017/02/23 16:02:53 ET
Table 'Pandora III' 6-max Seat #5 is the button
Seat 1: Pokeaster ($10.99 in chips) 
Seat 2: garigura ($11.77 in chips) 
Seat 3: ChuikaPridi ($16.93 in chips) 
Seat 4: mhonielsen ($10 in chips) 
Seat 5: MühliJr ($10.15 in chips) 
Seat 6: yodzik ($5 in chips) 
yodzik: posts small blind $0.05
Pokeaster: posts big blind $0.10
*** HOLE CARDS ***
garigura: folds 
ChuikaPridi: folds 
mhonielsen: raises $0.15 to $0.25
MühliJr: raises $0.55 to $0.80
yodzik: folds 
Pokeaster: folds 
mhonielsen: folds 
Uncalled bet ($0.55) returned to MühliJr
MühliJr collected $0.65 from pot
*** SUMMARY ***
Total pot $0.65 | Rake $0 
Seat 1: Pokeaster (big blind) folded before Flop
Seat 2: garigura folded before Flop (didn't bet)
Seat 3: ChuikaPridi folded before Flop (didn't bet)
Seat 4: mhonielsen folded before Flop
Seat 5: MühliJr (button) collected ($0.65)
Seat 6: yodzik (small blind) folded before Flop



PokerStars Hand #166667533256:  Hold'em No Limit ($0.05/$0.10 USD) - 2017/02/23 16:02:54 ET
Table 'Peiroos' 6-max Seat #5 is the button
Seat 1: ksandr_hom ($10 in chips) 
Seat 2: Nr847 ($10 in chips) 
Seat 3: atlx0711 ($26.87 in chips) 
Seat 4: Peter0087 ($10 in chips) 
Seat 5: sergio-cb164 ($9.40 in chips) 
Seat 6: DevonMiles88 ($3.97 in chips) 
DevonMiles88: posts small blind $0.05
ksandr_hom: posts big blind $0.10
*** HOLE CARDS ***
Nr847: folds 
atlx0711: folds 
Peter0087: folds 
sergio-cb164: folds 
DevonMiles88: raises $0.30 to $0.40
ksandr_hom: folds 
Uncalled bet ($0.30) returned to DevonMiles88
DevonMiles88 collected $0.20 from pot
*** SUMMARY ***
Total pot $0.20 | Rake $0 
Seat 1: ksandr_hom (big blind) folded before Flop
Seat 2: Nr847 folded before Flop (didn't bet)
Seat 3: atlx0711 folded before Flop (didn't bet)
Seat 4: Peter0087 folded before Flop (didn't bet)
Seat 5: sergio-cb164 (button) folded before Flop (didn't bet)
Seat 6: DevonMiles88 (small blind) collected ($0.20)



PokerStars Hand #166667533411:  Hold'em No Limit ($0.05/$0.10 USD) - 2017/02/23 16:02:54 ET
Table 'Walpurga' 6-max Seat #2 is the button
Seat 1: chimera252 ($12.22 in chips) 
Seat 2: paxit71 ($6.84 in chips) 
Seat 3: Innerwuss ($19.33 in chips) 
Seat 4: oddshoff ($12.79 in chips) 
Innerwuss: posts small blind $0.05
oddshoff: posts big blind $0.10
AIONCMA1988: sits out 
*** HOLE CARDS ***
chimera252: folds 
paxit71: folds 
Innerwuss: folds 
Uncalled bet ($0.05) returned to oddshoff
oddshoff collected $0.10 from pot
*** SUMMARY ***
Total pot $0.10 | Rake $0 
Seat 1: chimera252 folded before Flop (didn't bet)
Seat 2: paxit71 (button) folded before Flop (didn't bet)
Seat 3: Innerwuss (small blind) folded before Flop
Seat 4: oddshoff (big blind) collected ($0.10)



PokerStars Hand #166667533542:  Hold'em No Limit ($0.05/$0.10 USD) - 2017/02/23 16:02:54 ET
Table 'Nehalennia III' 6-max Seat #4 is the button
Seat 1: boxer821 ($13.20 in chips) 
Seat 2: fortieth ($9.77 in chips) 
Seat 3: ValdemorS ($17.93 in chips) 
Seat 4: eniksenik ($10 in chips) 
Seat 5: wulffboy ($35.60 in chips) 
Seat 6: valzeny ($20.57 in chips) 
wulffboy: posts small blind $0.05
valzeny: posts big blind $0.10
boxer821: posts the ante $0.02
fortieth: posts the ante $0.02
ValdemorS: posts the ante $0.02
eniksenik: posts the ante $0.02
wulffboy: posts the ante $0.02
valzeny: posts the ante $0.02
*** HOLE CARDS ***
boxer821: folds 
fortieth: raises $0.25 to $0.35
ValdemorS: calls $0.35
eniksenik: folds 
wulffboy: folds 
valzeny: folds 
*** FLOP *** [Kd 4s Qs]
fortieth: bets $0.65
ValdemorS: folds 
Uncalled bet ($0.65) returned to fortieth
fortieth collected $0.93 from pot
*** SUMMARY ***
Total pot $0.97 | Rake $0.04 
Board [Kd 4s Qs]
Seat 1: boxer821 folded before Flop (didn't bet)
Seat 2: fortieth collected ($0.93)
Seat 3: ValdemorS folded on the Flop
Seat 4: eniksenik (button) folded before Flop (didn't bet)
Seat 5: wulffboy (small blind) folded before Flop
Seat 6: valzeny (big blind) folded before Flop



PokerStars Hand #166667533691:  Hold'em No Limit ($0.05/$0.10 USD) - 2017/02/23 16:02:54 ET
Table 'Thoas' 6-max Seat #4 is the button
Seat 1: Pekaml ($11.43 in chips) 
Seat 2: themacer24 ($8.52 in chips) 
Seat 3: by.y.y.y86 ($10 in chips) 
Seat 4: Morris_Chair ($17.81 in chips) 
Seat 5: Kow6oy ($10.07 in chips) 
Seat 6: takis nik ($10 in chips) 
Kow6oy: posts small blind $0.05
takis nik: posts big blind $0.10
*** HOLE CARDS ***
Pekaml: raises $0.30 to $0.40
themacer24: folds 
by.y.y.y86: folds 
Morris_Chair: folds 
Kow6oy: folds 
takis nik: folds 
Uncalled bet ($0.30) returned to Pekaml
Pekaml collected $0.25 from pot
*** SUMMARY ***
Total pot $0.25 | Rake $0 
Seat 1: Pekaml collected ($0.25)
Seat 2: themacer24 folded before Flop (didn't bet)
Seat 3: by.y.y.y86 folded before Flop (didn't bet)
Seat 4: Morris_Chair (button) folded before Flop (didn't bet)
Seat 5: Kow6oy (small blind) folded before Flop
Seat 6: takis nik (big blind) folded before Flop



PokerStars Hand #166667533922:  Hold'em No Limit ($0.05/$0.10 USD) - 2017/02/23 16:02:54 ET
Table 'Rosalia' 6-max Seat #3 is the button
Seat 1: Hyd SK ($10 in chips) 
Seat 2: Bandyaev ($11.84 in chips) 
Seat 3: Andy Wolf ($12.18 in chips) 
Seat 4: THIMUCHIN ($10 in chips) 
Seat 5: miron762 ($15.16 in chips) 
Seat 6: facewald ($18.52 in chips) 
THIMUCHIN: posts small blind $0.05
miron762: posts big blind $0.10
*** HOLE CARDS ***
facewald: raises $0.19 to $0.29
Hyd SK: folds 
Bandyaev: folds 
Andy Wolf: folds 
THIMUCHIN: folds 
miron762: calls $0.19
*** FLOP *** [5s Jd 7c]
miron762: bets $0.40
facewald: calls $0.40
*** TURN *** [5s Jd 7c] [7s]
miron762: bets $0.40
facewald: calls $0.40
*** RIVER *** [5s Jd 7c 7s] [9c]
miron762: bets $0.50
facewald: calls $0.50
*** SHOW DOWN ***
miron762: shows [8c 7d] (three of a kind, Sevens)
facewald: mucks hand 
miron762 collected $3.08 from pot
*** SUMMARY ***
Total pot $3.23 | Rake $0.15 
Board [5s Jd 7c 7s 9c]
Seat 1: Hyd SK folded before Flop (didn't bet)
Seat 2: Bandyaev folded before Flop (didn't bet)
Seat 3: Andy Wolf (button) folded before Flop (didn't bet)
Seat 4: THIMUCHIN (small blind) folded before Flop
Seat 5: miron762 (big blind) showed [8c 7d] and won ($3.08) with three of a kind, Sevens
Seat 6: facewald mucked



PokerStars Hand #166667534591:  Hold'em No Limit ($0.05/$0.10 USD) - 2017/02/23 16:02:55 ET
Table 'Eurydome II' 6-max Seat #5 is the button
Seat 2: Elinaattor ($10.34 in chips) 
Seat 3: gaHy_HaXeP ($10 in chips) 
Seat 4: Smitty03300 ($10.03 in chips) 
Seat 5: kush-killa87 ($13.99 in chips) 
Seat 6: Jucatorul823 ($6.25 in chips) 
Jucatorul823: posts small blind $0.05
Elinaattor: posts big blind $0.10
*** HOLE CARDS ***
gaHy_HaXeP: folds 
Smitty03300: folds 
kush-killa87: folds 
Jucatorul823: folds 
Uncalled bet ($0.05) returned to Elinaattor
Elinaattor collected $0.10 from pot
*** SUMMARY ***
Total pot $0.10 | Rake $0 
Seat 2: Elinaattor (big blind) collected ($0.10)
Seat 3: gaHy_HaXeP folded before Flop (didn't bet)
Seat 4: Smitty03300 folded before Flop (didn't bet)
Seat 5: kush-killa87 (button) folded before Flop (didn't bet)
Seat 6: Jucatorul823 (small blind) folded before Flop



PokerStars Hand #166667534592:  Hold'em No Limit ($0.05/$0.10 USD) - 2017/02/23 16:02:55 ET
Table 'Sham' 6-max Seat #1 is the button
Seat 1: pancernik21 ($10 in chips) 
Seat 2: ex3Lero86 ($10.20 in chips) 
Seat 3: weez3r ($22.83 in chips) 
Seat 4: VAD21 ($12.95 in chips) 
Seat 5: T9MS ($10.28 in chips) 
Seat 6: bdixon_5 ($9.55 in chips) 
ex3Lero86: posts small blind $0.05
weez3r: posts big blind $0.10
*** HOLE CARDS ***
VAD21: folds 
T9MS: raises $0.20 to $0.30
bdixon_5: folds 
pancernik21: folds 
ex3Lero86: folds 
weez3r: folds 
Uncalled bet ($0.20) returned to T9MS
T9MS collected $0.25 from pot
*** SUMMARY ***
Total pot $0.25 | Rake $0 
Seat 1: pancernik21 (button) folded before Flop (didn't bet)
Seat 2: ex3Lero86 (small blind) folded before Flop
Seat 3: weez3r (big blind) folded before Flop
Seat 4: VAD21 folded before Flop (didn't bet)
Seat 5: T9MS collected ($0.25)
Seat 6: bdixon_5 folded before Flop (didn't bet)



PokerStars Hand #166667535112:  Hold'em No Limit ($0.05/$0.10 USD) - 2017/02/23 16:02:56 ET
Table 'Pyrrhus III' 6-max Seat #6 is the button
Seat 1: skatejeff ($6.12 in chips) 
Seat 2: univibe68 ($20.55 in chips) 
Seat 3: coolisses111 ($9.75 in chips) 
Seat 4: ex3Lero86 ($22.34 in chips) 
Seat 5: mAEgar ($4.71 in chips) 
Seat 6: MLPlayer16 ($19.86 in chips) 
skatejeff: posts small blind $0.05
univibe68: posts big blind $0.10
skatejeff: posts the ante $0.02
univibe68: posts the ante $0.02
coolisses111: posts the ante $0.02
ex3Lero86: posts the ante $0.02
mAEgar: posts the ante $0.02
MLPlayer16: posts the ante $0.02
*** HOLE CARDS ***
coolisses111: folds 
ex3Lero86: folds 
mAEgar: calls $0.10
skatejeff said, "nh"
MLPlayer16: folds 
skatejeff: calls $0.05
univibe68: checks 
*** FLOP *** [Qc Qh 6d]
skatejeff: checks 
univibe68: checks 
mAEgar: checks 
*** TURN *** [Qc Qh 6d] [2c]
skatejeff: checks 
univibe68: checks 
mAEgar: checks 
*** RIVER *** [Qc Qh 6d 2c] [As]
skatejeff: checks 
univibe68: checks 
mAEgar: checks 
*** SHOW DOWN ***
skatejeff: shows [3s 4d] (a pair of Queens)
univibe68: shows [3d 8s] (a pair of Queens - Ace+Eight kicker)
mAEgar: shows [8h Ks] (a pair of Queens - Ace+King kicker)
mAEgar collected $0.40 from pot
*** SUMMARY ***
Total pot $0.42 | Rake $0.02 
Board [Qc Qh 6d 2c As]
Seat 1: skatejeff (small blind) showed [3s 4d] and lost with a pair of Queens
Seat 2: univibe68 (big blind) showed [3d 8s] and lost with a pair of Queens
Seat 3: coolisses111 folded before Flop (didn't bet)
Seat 4: ex3Lero86 folded before Flop (didn't bet)
Seat 5: mAEgar showed [8h Ks] and won ($0.40) with a pair of Queens
Seat 6: MLPlayer16 (button) folded before Flop (didn't bet)



PokerStars Hand #166667535149:  Hold'em No Limit ($0.05/$0.10 USD) - 2017/02/23 16:02:56 ET
Table 'Lederle' 6-max Seat #3 is the button
Seat 2: truck1234 ($15.85 in chips) 
Seat 3: Kazacha ($10.50 in chips) 
Seat 4: Pokeaster ($13.66 in chips) 
Seat 5: 8th wonders ($14.16 in chips) 
Seat 6: pokekrk ($10 in chips) 
Pokeaster: posts small blind $0.05
8th wonders: posts big blind $0.10
*** HOLE CARDS ***
pokekrk: raises $0.20 to $0.30
truck1234: folds 
Kazacha: folds 
Pokeaster: folds 
8th wonders: folds 
Uncalled bet ($0.20) returned to pokekrk
pokekrk collected $0.25 from pot
*** SUMMARY ***
Total pot $0.25 | Rake $0 
Seat 2: truck1234 folded before Flop (didn't bet)
Seat 3: Kazacha (button) folded before Flop (didn't bet)
Seat 4: Pokeaster (small blind) folded before Flop
Seat 5: 8th wonders (big blind) folded before Flop
Seat 6: pokekrk collected ($0.25)



