PokerStars Hand #166667859342:  Hold'em No Limit ($0.05/$0.10 USD) - 2017/02/23 16:08:50 ET
Table 'Antielus II' 6-max Seat #6 is the button
Seat 1: Dcaro31 ($18.54 in chips) 
Seat 2: Orlangoor ($10 in chips) 
Seat 3: mcyi3at2 ($11.73 in chips) 
Seat 4: XwinX25 ($10 in chips) 
Seat 5: Hyd SK ($12.75 in chips) 
Seat 6: GiveTwoMe ($11.30 in chips) 
Dcaro31: posts small blind $0.05
Orlangoor: posts big blind $0.10
*** HOLE CARDS ***
mcyi3at2: raises $0.20 to $0.30
XwinX25: folds 
Hyd SK: calls $0.30
GiveTwoMe: folds 
Dcaro31: folds 
Orlangoor: calls $0.20
*** FLOP *** [3c Qd 7h]
Orlangoor: checks 
mcyi3at2: bets $0.60
Hyd SK: raises $1.06 to $1.66
Orlangoor: folds 
mcyi3at2: calls $1.06
*** TURN *** [3c Qd 7h] [Ts]
mcyi3at2: checks 
Hyd SK: bets $2.04
mcyi3at2: folds 
Uncalled bet ($2.04) returned to Hyd SK
Hyd SK collected $4.08 from pot
*** SUMMARY ***
Total pot $4.27 | Rake $0.19 
Board [3c Qd 7h Ts]
Seat 1: Dcaro31 (small blind) folded before Flop
Seat 2: Orlangoor (big blind) folded on the Flop
Seat 3: mcyi3at2 folded on the Turn
Seat 4: XwinX25 folded before Flop (didn't bet)
Seat 5: Hyd SK collected ($4.08)
Seat 6: GiveTwoMe (button) folded before Flop (didn't bet)



PokerStars Hand #166667859465:  Hold'em No Limit ($0.05/$0.10 USD) - 2017/02/23 16:08:50 ET
Table 'Wilkens II' 6-max Seat #5 is the button
Seat 1: Islamiq-GuRL ($10.34 in chips) 
Seat 2: manashov ($10.75 in chips) 
Seat 3: Namhkal ($11.68 in chips) 
Seat 4: myevc ($10 in chips) 
Seat 5: patrick19111 ($11.33 in chips) 
Seat 6: XaXaTyH4uK ($14.06 in chips) 
XaXaTyH4uK: posts small blind $0.05
Islamiq-GuRL: posts big blind $0.10
*** HOLE CARDS ***
manashov: folds 
Namhkal: folds 
myevc: raises $0.15 to $0.25
patrick19111: raises $0.65 to $0.90
XaXaTyH4uK: folds 
Islamiq-GuRL: folds 
myevc: raises $1.40 to $2.30
patrick19111: calls $1.40
*** FLOP *** [9c 4s 7s]
myevc: checks 
patrick19111: bets $1.90
myevc: folds 
Uncalled bet ($1.90) returned to patrick19111
patrick19111 collected $4.54 from pot
*** SUMMARY ***
Total pot $4.75 | Rake $0.21 
Board [9c 4s 7s]
Seat 1: Islamiq-GuRL (big blind) folded before Flop
Seat 2: manashov folded before Flop (didn't bet)
Seat 3: Namhkal folded before Flop (didn't bet)
Seat 4: myevc folded on the Flop
Seat 5: patrick19111 (button) collected ($4.54)
Seat 6: XaXaTyH4uK (small blind) folded before Flop



PokerStars Hand #166667859479:  Hold'em No Limit ($0.05/$0.10 USD) - 2017/02/23 16:08:50 ET
Table 'Atropos' 6-max Seat #1 is the button
Seat 1: ScorpionF39 ($2.07 in chips) 
Seat 2: yodzik ($5 in chips) 
Seat 3: NvR.m1nD ($10.53 in chips) 
Seat 4: iDecMate ($10.97 in chips) 
Seat 5: KokoulinV ($11.79 in chips) 
Seat 6: Iarlei ($12.58 in chips) 
yodzik: posts small blind $0.05
NvR.m1nD: posts big blind $0.10
*** HOLE CARDS ***
iDecMate: folds 
KokoulinV: folds 
Iarlei: folds 
ScorpionF39: calls $0.10
yodzik: raises $0.20 to $0.30
NvR.m1nD: folds 
ScorpionF39: calls $0.20
*** FLOP *** [7s 8c 5d]
yodzik: checks 
ScorpionF39: checks 
*** TURN *** [7s 8c 5d] [Ac]
yodzik: checks 
ScorpionF39: bets $0.10
yodzik: folds 
Uncalled bet ($0.10) returned to ScorpionF39
ScorpionF39 collected $0.67 from pot
*** SUMMARY ***
Total pot $0.70 | Rake $0.03 
Board [7s 8c 5d Ac]
Seat 1: ScorpionF39 (button) collected ($0.67)
Seat 2: yodzik (small blind) folded on the Turn
Seat 3: NvR.m1nD (big blind) folded before Flop
Seat 4: iDecMate folded before Flop (didn't bet)
Seat 5: KokoulinV folded before Flop (didn't bet)
Seat 6: Iarlei folded before Flop (didn't bet)



PokerStars Hand #166667859499:  Hold'em No Limit ($0.05/$0.10 USD) - 2017/02/23 16:08:50 ET
Table 'Xanthippe II' 6-max Seat #2 is the button
Seat 2: Bird et al ($10.08 in chips) 
Seat 3: Dcaro31 ($14.66 in chips) 
Seat 6: Orlangoor ($13.18 in chips) 
Dcaro31: posts small blind $0.05
Orlangoor: posts big blind $0.10
*** HOLE CARDS ***
yodzik leaves the table
Bird et al: raises $0.15 to $0.25
Dcaro31: folds 
Orlangoor: folds 
Uncalled bet ($0.15) returned to Bird et al
Bird et al collected $0.25 from pot
*** SUMMARY ***
Total pot $0.25 | Rake $0 
Seat 2: Bird et al (button) collected ($0.25)
Seat 3: Dcaro31 (small blind) folded before Flop
Seat 6: Orlangoor (big blind) folded before Flop



PokerStars Hand #166667859521:  Hold'em No Limit ($0.05/$0.10 USD) - 2017/02/23 16:08:50 ET
Table 'Nerthus II' 6-max Seat #4 is the button
Seat 1: mdelfin0 ($12.30 in chips) 
Seat 2: Hovhannes990 ($9.58 in chips) 
Seat 3: Mamm0nism ($18.71 in chips) 
Seat 4: myevc ($16.28 in chips) 
Seat 5: Hyd SK ($10.52 in chips) 
Seat 6: Lucky HoBBiT ($10 in chips) 
Hyd SK: posts small blind $0.05
Lucky HoBBiT: posts big blind $0.10
*** HOLE CARDS ***
mdelfin0: folds 
Hovhannes990: calls $0.10
Mamm0nism: folds 
myevc: raises $0.40 to $0.50
Hyd SK: folds 
Lucky HoBBiT: folds 
Hovhannes990: folds 
Uncalled bet ($0.40) returned to myevc
myevc collected $0.35 from pot
*** SUMMARY ***
Total pot $0.35 | Rake $0 
Seat 1: mdelfin0 folded before Flop (didn't bet)
Seat 2: Hovhannes990 folded before Flop
Seat 3: Mamm0nism folded before Flop (didn't bet)
Seat 4: myevc (button) collected ($0.35)
Seat 5: Hyd SK (small blind) folded before Flop
Seat 6: Lucky HoBBiT (big blind) folded before Flop



PokerStars Hand #166667859592:  Hold'em No Limit ($0.05/$0.10 USD) - 2017/02/23 16:08:50 ET
Table 'Caupolican II' 6-max Seat #2 is the button
Seat 1: Strelok1974 ($10 in chips) 
Seat 2: MBen10 ($21.60 in chips) 
Seat 4: GESPERIA ($21.32 in chips) 
Seat 5: ArcticBearDK ($15.45 in chips) 
Seat 6: pancernik21 ($13.15 in chips) 
GESPERIA: posts small blind $0.05
ArcticBearDK: posts big blind $0.10
*** HOLE CARDS ***
pancernik21: raises $0.20 to $0.30
Strelok1974: calls $0.30
MBen10: raises $0.85 to $1.15
GESPERIA: folds 
ArcticBearDK: folds 
pancernik21: raises $1.15 to $2.30
Strelok1974: folds 
MBen10: calls $1.15
*** FLOP *** [2c As 8c]
pancernik21: bets $1.64
MBen10: calls $1.64
*** TURN *** [2c As 8c] [4c]
pancernik21: checks 
MBen10: checks 
*** RIVER *** [2c As 8c 4c] [8h]
pancernik21: checks 
MBen10: bets $2.38
pancernik21: folds 
Uncalled bet ($2.38) returned to MBen10
MBen10 collected $7.96 from pot
*** SUMMARY ***
Total pot $8.33 | Rake $0.37 
Board [2c As 8c 4c 8h]
Seat 1: Strelok1974 folded before Flop
Seat 2: MBen10 (button) collected ($7.96)
Seat 4: GESPERIA (small blind) folded before Flop
Seat 5: ArcticBearDK (big blind) folded before Flop
Seat 6: pancernik21 folded on the River



PokerStars Hand #166667859596:  Hold'em No Limit ($0.05/$0.10 USD) - 2017/02/23 16:08:50 ET
Table 'Nuki' 6-max Seat #4 is the button
Seat 1: bdixon_5 ($7.80 in chips) 
Seat 2: ArcticBearDK ($19.03 in chips) 
Seat 3: david_sara83 ($13.24 in chips) 
Seat 4: GESPERIA ($28.43 in chips) 
Seat 5: fabadam ($11.03 in chips) 
Seat 6: Zooplack ($25.77 in chips) 
fabadam: posts small blind $0.05
Zooplack: posts big blind $0.10
*** HOLE CARDS ***
bdixon_5: folds 
ArcticBearDK: folds 
david_sara83: folds 
GESPERIA: folds 
fabadam: raises $0.20 to $0.30
Zooplack: folds 
Uncalled bet ($0.20) returned to fabadam
fabadam collected $0.20 from pot
*** SUMMARY ***
Total pot $0.20 | Rake $0 
Seat 1: bdixon_5 folded before Flop (didn't bet)
Seat 2: ArcticBearDK folded before Flop (didn't bet)
Seat 3: david_sara83 folded before Flop (didn't bet)
Seat 4: GESPERIA (button) folded before Flop (didn't bet)
Seat 5: fabadam (small blind) collected ($0.20)
Seat 6: Zooplack (big blind) folded before Flop



PokerStars Hand #166667859938:  Hold'em No Limit ($0.05/$0.10 USD) - 2017/02/23 16:08:50 ET
Table 'Lampetia' 6-max Seat #6 is the button
Seat 1: WinninBikini ($10.23 in chips) 
Seat 2: ex3Lero86 ($10.30 in chips) 
Seat 3: Ice_Isayev ($19.89 in chips) 
Seat 4: Rodik002 ($10 in chips) 
Seat 5: luisantrs ($10.37 in chips) 
Seat 6: Scanner17 ($12.09 in chips) 
WinninBikini: posts small blind $0.05
ex3Lero86: posts big blind $0.10
*** HOLE CARDS ***
Ice_Isayev: folds 
Rodik002: folds 
luisantrs: folds 
Scanner17: folds 
WinninBikini: folds 
Uncalled bet ($0.05) returned to ex3Lero86
ex3Lero86 collected $0.10 from pot
*** SUMMARY ***
Total pot $0.10 | Rake $0 
Seat 1: WinninBikini (small blind) folded before Flop
Seat 2: ex3Lero86 (big blind) collected ($0.10)
Seat 3: Ice_Isayev folded before Flop (didn't bet)
Seat 4: Rodik002 folded before Flop (didn't bet)
Seat 5: luisantrs folded before Flop (didn't bet)
Seat 6: Scanner17 (button) folded before Flop (didn't bet)



PokerStars Hand #166667860031:  Hold'em No Limit ($0.05/$0.10 USD) - 2017/02/23 16:08:50 ET
Table 'Heka II' 6-max Seat #1 is the button
Seat 1: Mamm0nism ($15.36 in chips) 
Seat 2: oddshoff ($11.12 in chips) 
Seat 3: MühliJr ($10 in chips) 
Seat 4: theNot0r1ous ($10.93 in chips) 
Seat 5: ArcticBearDK ($12.53 in chips) 
Seat 6: MonteCris92 ($10.36 in chips) 
oddshoff: posts small blind $0.05
MühliJr: posts big blind $0.10
*** HOLE CARDS ***
theNot0r1ous: folds 
ArcticBearDK: raises $0.20 to $0.30
MonteCris92: folds 
Mamm0nism: folds 
oddshoff: folds 
MühliJr: folds 
Uncalled bet ($0.20) returned to ArcticBearDK
ArcticBearDK collected $0.25 from pot
*** SUMMARY ***
Total pot $0.25 | Rake $0 
Seat 1: Mamm0nism (button) folded before Flop (didn't bet)
Seat 2: oddshoff (small blind) folded before Flop
Seat 3: MühliJr (big blind) folded before Flop
Seat 4: theNot0r1ous folded before Flop (didn't bet)
Seat 5: ArcticBearDK collected ($0.25)
Seat 6: MonteCris92 folded before Flop (didn't bet)



PokerStars Hand #166667860100:  Hold'em No Limit ($0.05/$0.10 USD) - 2017/02/23 16:08:50 ET
Table 'Isberga' 6-max Seat #4 is the button
Seat 1: Feverhead ($18.12 in chips) 
Seat 2: GESPERIA ($10.37 in chips) 
Seat 4: THIMUCHIN ($10.64 in chips) 
Seat 5: YoungGriff86 ($18.77 in chips) 
Seat 6: Goroshkos88 ($21.66 in chips) 
YoungGriff86: posts small blind $0.05
Goroshkos88: posts big blind $0.10
*** HOLE CARDS ***
Feverhead: folds 
GESPERIA: folds 
THIMUCHIN: raises $0.10 to $0.20
YoungGriff86: folds 
Goroshkos88: folds 
Uncalled bet ($0.10) returned to THIMUCHIN
THIMUCHIN collected $0.25 from pot
*** SUMMARY ***
Total pot $0.25 | Rake $0 
Seat 1: Feverhead folded before Flop (didn't bet)
Seat 2: GESPERIA folded before Flop (didn't bet)
Seat 4: THIMUCHIN (button) collected ($0.25)
Seat 5: YoungGriff86 (small blind) folded before Flop
Seat 6: Goroshkos88 (big blind) folded before Flop



PokerStars Hand #166667860202:  Hold'em No Limit ($0.05/$0.10 USD) - 2017/02/23 16:08:50 ET
Table 'Mizar II' 6-max Seat #2 is the button
Seat 1: Cole Jaq ($6.65 in chips) 
Seat 2: rusu_rapid ($10 in chips) 
Seat 3: Therodorus ($11.61 in chips) 
Therodorus: posts small blind $0.05
Cole Jaq: posts big blind $0.10
*** HOLE CARDS ***
rusu_rapid: folds 
Therodorus: raises $0.10 to $0.20
Cole Jaq: calls $0.10
*** FLOP *** [2c Th 7d]
DEraser joins the table at seat #4 
Therodorus: bets $0.22
Cole Jaq: calls $0.22
*** TURN *** [2c Th 7d] [6c]
AC Evergreen joins the table at seat #5 
Therodorus: bets $0.50
Cole Jaq: calls $0.50
*** RIVER *** [2c Th 7d 6c] [7h]
JahSoldier69 joins the table at seat #6 
Therodorus: checks 
Cole Jaq: bets $5.73 and is all-in
Therodorus: folds 
Uncalled bet ($5.73) returned to Cole Jaq
JahSoldier69 leaves the table
Cole Jaq collected $1.76 from pot
*** SUMMARY ***
Total pot $1.84 | Rake $0.08 
Board [2c Th 7d 6c 7h]
Seat 1: Cole Jaq (big blind) collected ($1.76)
Seat 2: rusu_rapid (button) folded before Flop (didn't bet)
Seat 3: Therodorus (small blind) folded on the River



PokerStars Hand #166667860231:  Hold'em No Limit ($0.05/$0.10 USD) - 2017/02/23 16:08:50 ET
Table 'Aludra II' 6-max Seat #6 is the button
Seat 1: voledy ($10.13 in chips) 
Seat 2: JahSoldier69 ($13.75 in chips) 
Seat 3: mbkongstad ($9.85 in chips) 
Seat 4: MihaGr ($10 in chips) 
Seat 5: kingartur222 ($16.17 in chips) 
Seat 6: call me haaa ($14.84 in chips) 
voledy: posts small blind $0.05
JahSoldier69: posts big blind $0.10
*** HOLE CARDS ***
mbkongstad: folds 
MihaGr: folds 
kingartur222 has timed out
kingartur222: folds 
call me haaa: folds 
voledy: raises $0.15 to $0.25
JahSoldier69: calls $0.15
*** FLOP *** [2h Qd Ks]
voledy: checks 
JahSoldier69: bets $0.30
voledy: folds 
Uncalled bet ($0.30) returned to JahSoldier69
JahSoldier69 collected $0.48 from pot
*** SUMMARY ***
Total pot $0.50 | Rake $0.02 
Board [2h Qd Ks]
Seat 1: voledy (small blind) folded on the Flop
Seat 2: JahSoldier69 (big blind) collected ($0.48)
Seat 3: mbkongstad folded before Flop (didn't bet)
Seat 4: MihaGr folded before Flop (didn't bet)
Seat 5: kingartur222 folded before Flop (didn't bet)
Seat 6: call me haaa (button) folded before Flop (didn't bet)



PokerStars Hand #166667860335:  Hold'em No Limit ($0.05/$0.10 USD) - 2017/02/23 16:08:51 ET
Table 'Lederle' 6-max Seat #1 is the button
Seat 1: Sterjek ($9.85 in chips) 
Seat 2: truck1234 ($15.59 in chips) 
Seat 3: Kazacha ($11.35 in chips) 
Seat 4: Pokeaster ($13.66 in chips) 
Seat 5: 8th wonders ($13.68 in chips) 
Seat 6: pokekrk ($10 in chips) 
truck1234: posts small blind $0.05
Kazacha: posts big blind $0.10
*** HOLE CARDS ***
Pokeaster: folds 
8th wonders: folds 
pokekrk: folds 
Sterjek: folds 
truck1234: folds 
Uncalled bet ($0.05) returned to Kazacha
Kazacha collected $0.10 from pot
*** SUMMARY ***
Total pot $0.10 | Rake $0 
Seat 1: Sterjek (button) folded before Flop (didn't bet)
Seat 2: truck1234 (small blind) folded before Flop
Seat 3: Kazacha (big blind) collected ($0.10)
Seat 4: Pokeaster folded before Flop (didn't bet)
Seat 5: 8th wonders folded before Flop (didn't bet)
Seat 6: pokekrk folded before Flop (didn't bet)



PokerStars Hand #166667860383:  Hold'em No Limit ($0.05/$0.10 USD) - 2017/02/23 16:08:51 ET
Table 'Caprera III' 6-max Seat #1 is the button
Seat 1: Vrinni ($19.29 in chips) 
Seat 2: hg123454321 ($10.77 in chips) 
Seat 6: GESPERIA ($15.56 in chips) 
hg123454321: posts small blind $0.05
fedorka rus: is sitting out 
GESPERIA: posts big blind $0.10
*** HOLE CARDS ***
Vrinni: folds 
hg123454321: raises $0.10 to $0.20
GESPERIA: folds 
Uncalled bet ($0.10) returned to hg123454321
hg123454321 collected $0.20 from pot
*** SUMMARY ***
Total pot $0.20 | Rake $0 
Seat 1: Vrinni (button) folded before Flop (didn't bet)
Seat 2: hg123454321 (small blind) collected ($0.20)
Seat 6: GESPERIA (big blind) folded before Flop



PokerStars Hand #166667861035:  Hold'em No Limit ($0.05/$0.10 USD) - 2017/02/23 16:08:51 ET
Table 'Arpola' 6-max Seat #1 is the button
Seat 1: dincimus ($10.97 in chips) 
Seat 2: patrick19111 ($10.30 in chips) 
Seat 4: Orlangoor ($18.75 in chips) 
Seat 5: truck1234 ($11.51 in chips) 
Seat 6: DasoII ($5 in chips) 
patrick19111: posts small blind $0.05
Orlangoor: posts big blind $0.10
DasoII: posts big blind $0.10
*** HOLE CARDS ***
truck1234: raises $0.20 to $0.30
DasoII: folds 
dincimus: folds 
patrick19111: folds 
Orlangoor: folds 
Uncalled bet ($0.20) returned to truck1234
truck1234 collected $0.35 from pot
*** SUMMARY ***
Total pot $0.35 | Rake $0 
Seat 1: dincimus (button) folded before Flop (didn't bet)
Seat 2: patrick19111 (small blind) folded before Flop
Seat 4: Orlangoor (big blind) folded before Flop
Seat 5: truck1234 collected ($0.35)
Seat 6: DasoII folded before Flop



PokerStars Hand #166667861360:  Hold'em No Limit ($0.05/$0.10 USD) - 2017/02/23 16:08:52 ET
Table 'Caupolican' 6-max Seat #5 is the button
Seat 1: kingartur222 ($11.74 in chips) 
Seat 2: garigura ($18.75 in chips) 
Seat 3: ducksheep82 ($4.90 in chips) 
Seat 4: mhonielsen ($15.07 in chips) 
Seat 5: Kazacha ($12.40 in chips) 
Seat 6: crazydevill ($9.90 in chips) 
crazydevill: posts small blind $0.05
kingartur222: posts big blind $0.10
*** HOLE CARDS ***
garigura: folds 
ducksheep82: calls $0.10
mhonielsen: folds 
Kazacha: folds 
crazydevill: calls $0.05
kingartur222: checks 
*** FLOP *** [9h 7c Kc]
crazydevill: bets $0.20
kingartur222: raises $0.40 to $0.60
ducksheep82: folds 
crazydevill: calls $0.40
*** TURN *** [9h 7c Kc] [4d]
crazydevill: checks 
kingartur222: bets $1
crazydevill: folds 
Uncalled bet ($1) returned to kingartur222
kingartur222 collected $1.43 from pot
*** SUMMARY ***
Total pot $1.50 | Rake $0.07 
Board [9h 7c Kc 4d]
Seat 1: kingartur222 (big blind) collected ($1.43)
Seat 2: garigura folded before Flop (didn't bet)
Seat 3: ducksheep82 folded on the Flop
Seat 4: mhonielsen folded before Flop (didn't bet)
Seat 5: Kazacha (button) folded before Flop (didn't bet)
Seat 6: crazydevill (small blind) folded on the Turn



PokerStars Hand #166667861508:  Hold'em No Limit ($0.05/$0.10 USD) - 2017/02/23 16:08:52 ET
Table 'Cuyo' 6-max Seat #1 is the button
Seat 1: Bandyaev ($11.09 in chips) 
Seat 2: Therodorus ($10.15 in chips) 
Seat 3: Hergie88 ($9.10 in chips) 
Seat 6: iluzja12 ($9.63 in chips) 
Therodorus: posts small blind $0.05
Hergie88: posts big blind $0.10
DrVzad: sits out 
*** HOLE CARDS ***
iluzja12: raises $0.20 to $0.30
Bandyaev: raises $0.70 to $1
Therodorus: folds 
Hergie88: folds 
iluzja12: folds 
Uncalled bet ($0.70) returned to Bandyaev
Bandyaev collected $0.75 from pot
*** SUMMARY ***
Total pot $0.75 | Rake $0 
Seat 1: Bandyaev (button) collected ($0.75)
Seat 2: Therodorus (small blind) folded before Flop
Seat 3: Hergie88 (big blind) folded before Flop
Seat 6: iluzja12 folded before Flop



PokerStars Hand #166667861934:  Hold'em No Limit ($0.05/$0.10 USD) - 2017/02/23 16:08:52 ET
Table 'Hunnia' 6-max Seat #5 is the button
Seat 1: univibe68 ($21.18 in chips) 
Seat 2: mhonielsen ($10.94 in chips) 
Seat 3: 6ePeMeHHa9 ($10.56 in chips) 
Seat 4: Jalida3 ($11.88 in chips) 
Seat 5: Smarkon ($14.74 in chips) 
Seat 6: ChuikaPridi ($11.34 in chips) 
ChuikaPridi: posts small blind $0.05
univibe68: posts big blind $0.10
*** HOLE CARDS ***
mhonielsen: folds 
6ePeMeHHa9: folds 
Jalida3: folds 
Smarkon: folds 
ChuikaPridi: folds 
Uncalled bet ($0.05) returned to univibe68
univibe68 collected $0.10 from pot
*** SUMMARY ***
Total pot $0.10 | Rake $0 
Seat 1: univibe68 (big blind) collected ($0.10)
Seat 2: mhonielsen folded before Flop (didn't bet)
Seat 3: 6ePeMeHHa9 folded before Flop (didn't bet)
Seat 4: Jalida3 folded before Flop (didn't bet)
Seat 5: Smarkon (button) folded before Flop (didn't bet)
Seat 6: ChuikaPridi (small blind) folded before Flop



PokerStars Hand #166667862007:  Hold'em No Limit ($0.05/$0.10 USD) - 2017/02/23 16:08:52 ET
Table 'Lagrula' 6-max Seat #3 is the button
Seat 1: Ice_Isayev ($10 in chips) 
Seat 2: KRZuff ($10 in chips) 
Seat 3: micke667 ($16 in chips) 
Seat 4: Calimero2408 ($12.78 in chips) 
Seat 5: Iarlei ($10 in chips) 
Seat 6: Spud014 ($10 in chips) 
Calimero2408: posts small blind $0.05
Iarlei: posts big blind $0.10
*** HOLE CARDS ***
Spud014: folds 
Ice_Isayev: folds 
KRZuff: folds 
micke667: calls $0.10
Calimero2408: calls $0.05
Iarlei: checks 
*** FLOP *** [Jd Ac 2s]
Calimero2408: checks 
Iarlei: bets $0.15
micke667: folds 
Calimero2408: folds 
Uncalled bet ($0.15) returned to Iarlei
Iarlei collected $0.29 from pot
*** SUMMARY ***
Total pot $0.30 | Rake $0.01 
Board [Jd Ac 2s]
Seat 1: Ice_Isayev folded before Flop (didn't bet)
Seat 2: KRZuff folded before Flop (didn't bet)
Seat 3: micke667 (button) folded on the Flop
Seat 4: Calimero2408 (small blind) folded on the Flop
Seat 5: Iarlei (big blind) collected ($0.29)
Seat 6: Spud014 folded before Flop (didn't bet)



PokerStars Hand #166667862128:  Hold'em No Limit ($0.05/$0.10 USD) - 2017/02/23 16:08:53 ET
Table 'Hajek III' 6-max Seat #3 is the button
Seat 1: MBen10 ($12.18 in chips) 
Seat 2: fortieth ($10.04 in chips) 
Seat 3: fedorka rus ($10.46 in chips) 
Seat 4: NvR.m1nD ($13.57 in chips) 
Seat 6: fabadam ($22.21 in chips) 
NvR.m1nD: posts small blind $0.05
fabadam: posts big blind $0.10
*** HOLE CARDS ***
MBen10: raises $0.18 to $0.28
fortieth: calls $0.28
Croplayer1 leaves the table
fedorka rus: calls $0.28
x3ultimate joins the table at seat #5 
NvR.m1nD: folds 
x3ultimate leaves the table
JahSoldier69 joins the table at seat #5 
JahSoldier69 leaves the table
fabadam: calls $0.18
*** FLOP *** [6s Jc 5h]
fabadam: checks 
MBen10: bets $0.64
fortieth: folds 
Chrips joins the table at seat #5 
fedorka rus: folds 
fabadam: folds 
Uncalled bet ($0.64) returned to MBen10
MBen10 collected $1.12 from pot
*** SUMMARY ***
Total pot $1.17 | Rake $0.05 
Board [6s Jc 5h]
Seat 1: MBen10 collected ($1.12)
Seat 2: fortieth folded on the Flop
Seat 3: fedorka rus (button) folded on the Flop
Seat 4: NvR.m1nD (small blind) folded before Flop
Seat 6: fabadam (big blind) folded on the Flop



PokerStars Hand #166667862330:  Hold'em No Limit ($0.05/$0.10 USD) - 2017/02/23 16:08:53 ET
Table 'Union' 6-max Seat #3 is the button
Seat 1: IAntikI ($10 in chips) 
Seat 2: Zooplack ($10.15 in chips) 
Seat 3: Rodik002 ($11.86 in chips) 
Seat 5: Chodemuncher ($16.15 in chips) 
Seat 6: bonyo71 ($4 in chips) 
Chodemuncher: posts small blind $0.05
bonyo71: posts big blind $0.10
*** HOLE CARDS ***
Croplayer1 leaves the table
osmea joins the table at seat #4 
IAntikI: folds 
Zooplack: folds 
Rodik002: raises $0.10 to $0.20
Chodemuncher: folds 
bonyo71: folds 
Uncalled bet ($0.10) returned to Rodik002
Rodik002 collected $0.25 from pot
*** SUMMARY ***
Total pot $0.25 | Rake $0 
Seat 1: IAntikI folded before Flop (didn't bet)
Seat 2: Zooplack folded before Flop (didn't bet)
Seat 3: Rodik002 (button) collected ($0.25)
Seat 5: Chodemuncher (small blind) folded before Flop
Seat 6: bonyo71 (big blind) folded before Flop



PokerStars Hand #166667862526:  Hold'em No Limit ($0.05/$0.10 USD) - 2017/02/23 16:08:53 ET
Table 'Crocus' 6-max Seat #2 is the button
Seat 1: truck1234 ($25.76 in chips) 
Seat 2: garigura ($11.14 in chips) 
Seat 4: patrick19111 ($12.66 in chips) 
Seat 6: Rodik002 ($10 in chips) 
patrick19111: posts small blind $0.05
Rodik002: posts big blind $0.10
*** HOLE CARDS ***
Limpa Meza leaves the table
truck1234: calls $0.10
garigura: folds 
patrick19111: folds 
Rodik002: checks 
*** FLOP *** [Ac Qh 9h]
Rodik002: checks 
truck1234: checks 
*** TURN *** [Ac Qh 9h] [8d]
Yspenyanin joins the table at seat #3 
Rodik002: checks 
truck1234: checks 
*** RIVER *** [Ac Qh 9h 8d] [Qd]
Rodik002: checks 
truck1234: checks 
*** SHOW DOWN ***
Rodik002: shows [Jh 5d] (a pair of Queens)
truck1234: mucks hand 
Rodik002 collected $0.24 from pot
*** SUMMARY ***
Total pot $0.25 | Rake $0.01 
Board [Ac Qh 9h 8d Qd]
Seat 1: truck1234 mucked
Seat 2: garigura (button) folded before Flop (didn't bet)
Seat 4: patrick19111 (small blind) folded before Flop
Seat 6: Rodik002 (big blind) showed [Jh 5d] and won ($0.24) with a pair of Queens



PokerStars Hand #166667862578:  Hold'em No Limit ($0.05/$0.10 USD) - 2017/02/23 16:08:53 ET
Table 'Reginhild' 6-max Seat #5 is the button
Seat 1: iamkakaroto ($11.25 in chips) 
Seat 2: Kow6oy ($10 in chips) 
Seat 3: ARCHITECT83 ($8.03 in chips) 
Seat 4: Raymondo21 ($23.08 in chips) 
Seat 5: XCarlos610 ($29.43 in chips) 
Seat 6: eniksenik ($10 in chips) 
eniksenik: posts small blind $0.05
iamkakaroto: posts big blind $0.10
*** HOLE CARDS ***
Kow6oy: folds 
ARCHITECT83: folds 
Raymondo21: raises $0.20 to $0.30
XCarlos610: raises $0.40 to $0.70
eniksenik: calls $0.65
iamkakaroto: folds 
Raymondo21: calls $0.40
*** FLOP *** [4h 7s 2d]
eniksenik: checks 
Raymondo21: checks 
XCarlos610: checks 
*** TURN *** [4h 7s 2d] [Ad]
eniksenik: checks 
Raymondo21: checks 
XCarlos610: checks 
*** RIVER *** [4h 7s 2d Ad] [3h]
eniksenik: checks 
Raymondo21: checks 
XCarlos610: checks 
*** SHOW DOWN ***
eniksenik: shows [8s 8h] (a pair of Eights)
Raymondo21: shows [9d 9c] (a pair of Nines)
XCarlos610: mucks hand 
Raymondo21 collected $2.10 from pot
*** SUMMARY ***
Total pot $2.20 | Rake $0.10 
Board [4h 7s 2d Ad 3h]
Seat 1: iamkakaroto (big blind) folded before Flop
Seat 2: Kow6oy folded before Flop (didn't bet)
Seat 3: ARCHITECT83 folded before Flop (didn't bet)
Seat 4: Raymondo21 showed [9d 9c] and won ($2.10) with a pair of Nines
Seat 5: XCarlos610 (button) mucked
Seat 6: eniksenik (small blind) showed [8s 8h] and lost with a pair of Eights



PokerStars Hand #166667862630:  Hold'em No Limit ($0.05/$0.10 USD) - 2017/02/23 16:08:53 ET
Table 'Jokaste II' 6-max Seat #3 is the button
Seat 1: Hyd SK ($13.55 in chips) 
Seat 2: T9MS ($12.18 in chips) 
Seat 3: crazydevill ($11.65 in chips) 
Seat 4: FRAID358 ($15.26 in chips) 
Seat 5: Vrinni ($10.13 in chips) 
Seat 6: Adailton07 ($13.70 in chips) 
FRAID358: posts small blind $0.05
Vrinni: posts big blind $0.10
*** HOLE CARDS ***
Adailton07: folds 
Hyd SK: raises $0.25 to $0.35
T9MS: folds 
crazydevill: folds 
FRAID358: folds 
Vrinni: folds 
Uncalled bet ($0.25) returned to Hyd SK
Hyd SK collected $0.25 from pot
*** SUMMARY ***
Total pot $0.25 | Rake $0 
Seat 1: Hyd SK collected ($0.25)
Seat 2: T9MS folded before Flop (didn't bet)
Seat 3: crazydevill (button) folded before Flop (didn't bet)
Seat 4: FRAID358 (small blind) folded before Flop
Seat 5: Vrinni (big blind) folded before Flop
Seat 6: Adailton07 folded before Flop (didn't bet)



PokerStars Hand #166667862807:  Hold'em No Limit ($0.05/$0.10 USD) - 2017/02/23 16:08:53 ET
Table 'Giclas' 6-max Seat #1 is the button
Seat 1: david_sara83 ($10.19 in chips) 
Seat 2: Crafty23@PS ($10.31 in chips) 
Seat 3: fidas1972 ($6.63 in chips) 
Seat 4: Eddys Edge ($13.94 in chips) 
Seat 5: dedea1989 ($24.87 in chips) 
Seat 6: eniksenik ($14.48 in chips) 
Crafty23@PS: posts small blind $0.05
fidas1972: posts big blind $0.10
*** HOLE CARDS ***
Eddys Edge: folds 
dedea1989: calls $0.10
eniksenik: folds 
david_sara83: raises $0.30 to $0.40
Crafty23@PS: calls $0.35
fidas1972: folds 
dedea1989: calls $0.30
*** FLOP *** [2h Qs Qd]
Crafty23@PS: checks 
dedea1989: checks 
david_sara83: checks 
*** TURN *** [2h Qs Qd] [Jc]
Crafty23@PS: checks 
dedea1989: checks 
david_sara83: checks 
*** RIVER *** [2h Qs Qd Jc] [7h]
Crafty23@PS: bets $0.93
dedea1989: raises $0.93 to $1.86
david_sara83: folds 
Crafty23@PS: raises $3.72 to $5.58
dedea1989: raises $3.72 to $9.30
Crafty23@PS: raises $0.61 to $9.91 and is all-in
dedea1989: calls $0.61
*** SHOW DOWN ***
Crafty23@PS: shows [7c 7s] (a full house, Sevens full of Queens)
dedea1989: shows [Jd Qc] (a full house, Queens full of Jacks)
dedea1989 collected $20.17 from pot
*** SUMMARY ***
Total pot $21.12 | Rake $0.95 
Board [2h Qs Qd Jc 7h]
Seat 1: david_sara83 (button) folded on the River
Seat 2: Crafty23@PS (small blind) showed [7c 7s] and lost with a full house, Sevens full of Queens
Seat 3: fidas1972 (big blind) folded before Flop
Seat 4: Eddys Edge folded before Flop (didn't bet)
Seat 5: dedea1989 showed [Jd Qc] and won ($20.17) with a full house, Queens full of Jacks
Seat 6: eniksenik folded before Flop (didn't bet)



PokerStars Hand #166667862909:  Hold'em No Limit ($0.05/$0.10 USD) - 2017/02/23 16:08:53 ET
Table 'Rotraut' 6-max Seat #1 is the button
Seat 1: Hypermetal ($13.14 in chips) 
Seat 2: Newqbrown ($10.65 in chips) 
Seat 3: FlackoD ($13.46 in chips) 
Seat 5: Bird et al ($12.23 in chips) 
Seat 6: KokoulinV ($11.23 in chips) 
Newqbrown: posts small blind $0.05
FlackoD: posts big blind $0.10
*** HOLE CARDS ***
Bird et al: folds 
KokoulinV: folds 
Hypermetal: raises $0.10 to $0.20
Newqbrown: calls $0.15
FlackoD: calls $0.10
*** FLOP *** [Kh 6h Ks]
Newqbrown: checks 
FlackoD: checks 
Hypermetal: bets $0.43
Newqbrown: folds 
FlackoD: folds 
Uncalled bet ($0.43) returned to Hypermetal
Hypermetal collected $0.57 from pot
*** SUMMARY ***
Total pot $0.60 | Rake $0.03 
Board [Kh 6h Ks]
Seat 1: Hypermetal (button) collected ($0.57)
Seat 2: Newqbrown (small blind) folded on the Flop
Seat 3: FlackoD (big blind) folded on the Flop
Seat 5: Bird et al folded before Flop (didn't bet)
Seat 6: KokoulinV folded before Flop (didn't bet)



PokerStars Hand #166667863188:  Hold'em No Limit ($0.05/$0.10 USD) - 2017/02/23 16:08:54 ET
Table 'Luanda' 6-max Seat #1 is the button
Seat 1: AM-L-SL ($2.81 in chips) 
Seat 2: Xander188 ($10 in chips) 
Seat 4: aapokerkot ($10.38 in chips) 
Seat 5: st4tion ($12.03 in chips) 
Seat 6: KA3AXCTAHEU, ($11.43 in chips) 
Xander188: posts small blind $0.05
DamDatsAnAce: is sitting out 
DamDatsAnAce leaves the table
aapokerkot: posts big blind $0.10
*** HOLE CARDS ***
st4tion: raises $0.15 to $0.25
KA3AXCTAHEU,: folds 
pokekrk joins the table at seat #3 
AM-L-SL: folds 
Xander188: calls $0.20
aapokerkot: calls $0.15
*** FLOP *** [3h 8c Ah]
Xander188: checks 
aapokerkot: checks 
st4tion: checks 
*** TURN *** [3h 8c Ah] [3d]
Xander188: checks 
aapokerkot: checks 
st4tion: bets $0.48
Xander188: folds 
aapokerkot: folds 
Uncalled bet ($0.48) returned to st4tion
st4tion collected $0.72 from pot
*** SUMMARY ***
Total pot $0.75 | Rake $0.03 
Board [3h 8c Ah 3d]
Seat 1: AM-L-SL (button) folded before Flop (didn't bet)
Seat 2: Xander188 (small blind) folded on the Turn
Seat 4: aapokerkot (big blind) folded on the Turn
Seat 5: st4tion collected ($0.72)
Seat 6: KA3AXCTAHEU, folded before Flop (didn't bet)



PokerStars Hand #166667863785:  Hold'em No Limit ($0.05/$0.10 USD) - 2017/02/23 16:08:54 ET
Table 'Joella' 6-max Seat #1 is the button
Seat 1: Dcaro31 ($12.53 in chips) 
Seat 2: Kaelyns_Bark ($8.94 in chips) 
Seat 3: Joker51_wtf! ($11.66 in chips) 
Seat 5: Anestakis777 ($2.04 in chips) 
Seat 6: dr.goofy ($12.77 in chips) 
Kaelyns_Bark: posts small blind $0.05
Joker51_wtf!: posts big blind $0.10
KRZuff: sits out 
*** HOLE CARDS ***
Anestakis777: calls $0.10
dr.goofy: folds 
Dcaro31: raises $0.30 to $0.40
Kaelyns_Bark: folds 
Joker51_wtf!: folds 
Anestakis777: folds 
Uncalled bet ($0.30) returned to Dcaro31
Dcaro31 collected $0.35 from pot
*** SUMMARY ***
Total pot $0.35 | Rake $0 
Seat 1: Dcaro31 (button) collected ($0.35)
Seat 2: Kaelyns_Bark (small blind) folded before Flop
Seat 3: Joker51_wtf! (big blind) folded before Flop
Seat 5: Anestakis777 folded before Flop
Seat 6: dr.goofy folded before Flop (didn't bet)



PokerStars Hand #166667864052:  Hold'em No Limit ($0.05/$0.10 USD) - 2017/02/23 16:08:55 ET
Table 'Ushakaron II' 6-max Seat #2 is the button
Seat 1: Kow6oy ($10 in chips) 
Seat 2: Iarlei ($12.44 in chips) 
Seat 3: Rodik002 ($11.27 in chips) 
Seat 4: avintage176 ($29.73 in chips) 
Seat 5: 1limewax1 ($16.23 in chips) 
Seat 6: eniksenik ($10 in chips) 
Rodik002: posts small blind $0.05
avintage176: posts big blind $0.10
*** HOLE CARDS ***
1limewax1: folds 
eniksenik: folds 
Kow6oy: folds 
Iarlei: folds 
Rodik002: folds 
Uncalled bet ($0.05) returned to avintage176
avintage176 collected $0.10 from pot
*** SUMMARY ***
Total pot $0.10 | Rake $0 
Seat 1: Kow6oy folded before Flop (didn't bet)
Seat 2: Iarlei (button) folded before Flop (didn't bet)
Seat 3: Rodik002 (small blind) folded before Flop
Seat 4: avintage176 (big blind) collected ($0.10)
Seat 5: 1limewax1 folded before Flop (didn't bet)
Seat 6: eniksenik folded before Flop (didn't bet)



PokerStars Hand #166667864214:  Hold'em No Limit ($0.05/$0.10 USD) - 2017/02/23 16:08:55 ET
Table 'Hyakutake' 6-max Seat #4 is the button
Seat 1: Asilvagoat ($12.32 in chips) 
Seat 2: boxer821 ($13.42 in chips) 
Seat 3: lenboysprite ($3.51 in chips) 
Seat 4: eniksenik ($13.63 in chips) 
Seat 5: RoJ1 ($11.04 in chips) 
Seat 6: maxiv608 ($13.42 in chips) 
RoJ1: posts small blind $0.05
maxiv608: posts big blind $0.10
*** HOLE CARDS ***
Asilvagoat: folds 
boxer821: raises $0.20 to $0.30
lenboysprite: folds 
eniksenik: calls $0.30
RoJ1: folds 
maxiv608: folds 
*** FLOP *** [Js 9c 4d]
boxer821: checks 
eniksenik: bets $0.40
boxer821: folds 
Uncalled bet ($0.40) returned to eniksenik
eniksenik collected $0.72 from pot
*** SUMMARY ***
Total pot $0.75 | Rake $0.03 
Board [Js 9c 4d]
Seat 1: Asilvagoat folded before Flop (didn't bet)
Seat 2: boxer821 folded on the Flop
Seat 3: lenboysprite folded before Flop (didn't bet)
Seat 4: eniksenik (button) collected ($0.72)
Seat 5: RoJ1 (small blind) folded before Flop
Seat 6: maxiv608 (big blind) folded before Flop



PokerStars Hand #166667864367:  Hold'em No Limit ($0.05/$0.10 USD) - 2017/02/23 16:08:55 ET
Table 'Sirius II' 6-max Seat #2 is the button
Seat 1: Ampped87 ($13.85 in chips) 
Seat 2: Buddy8711 ($8.41 in chips) 
Seat 3: Spud014 ($10.15 in chips) 
Seat 6: MihaGr ($10 in chips) 
Spud014: posts small blind $0.05
LaFemme01 was removed from the table for failing to post
pokekrk: is sitting out 
MihaGr: posts big blind $0.10
*** HOLE CARDS ***
WinninBikini joins the table at seat #4 
Ampped87: raises $0.20 to $0.30
Buddy8711: folds 
pokekrk leaves the table
WinninBikini leaves the table
Spud014: folds 
Pekaml joins the table at seat #4 
MihaGr: folds 
Uncalled bet ($0.20) returned to Ampped87
Ampped87 collected $0.25 from pot
*** SUMMARY ***
Total pot $0.25 | Rake $0 
Seat 1: Ampped87 collected ($0.25)
Seat 2: Buddy8711 (button) folded before Flop (didn't bet)
Seat 3: Spud014 (small blind) folded before Flop
Seat 6: MihaGr (big blind) folded before Flop



PokerStars Hand #166667864682:  Hold'em No Limit ($0.05/$0.10 USD) - 2017/02/23 16:08:55 ET
Table 'Vesta II' 6-max Seat #6 is the button
Seat 1: Yabidooo ($17.32 in chips) 
Seat 2: Dimka4 ($10 in chips) 
Seat 3: Pokeaster ($12.71 in chips) 
Seat 4: Dcaro31 ($10 in chips) 
Seat 5: ChuikaPridi ($10 in chips) 
Seat 6: XaXaTyH4uK ($10.86 in chips) 
Yabidooo: posts small blind $0.05
Dimka4: posts big blind $0.10
*** HOLE CARDS ***
Pokeaster: folds 
Dcaro31: folds 
ChuikaPridi: folds 
XaXaTyH4uK: folds 
Yabidooo: folds 
Uncalled bet ($0.05) returned to Dimka4
Dimka4 collected $0.10 from pot
*** SUMMARY ***
Total pot $0.10 | Rake $0 
Seat 1: Yabidooo (small blind) folded before Flop
Seat 2: Dimka4 (big blind) collected ($0.10)
Seat 3: Pokeaster folded before Flop (didn't bet)
Seat 4: Dcaro31 folded before Flop (didn't bet)
Seat 5: ChuikaPridi folded before Flop (didn't bet)
Seat 6: XaXaTyH4uK (button) folded before Flop (didn't bet)



PokerStars Hand #166667865426:  Hold'em No Limit ($0.05/$0.10 USD) - 2017/02/23 16:08:56 ET
Table 'Gaika II' 6-max Seat #3 is the button
Seat 1: Ice_Isayev ($10 in chips) 
Seat 2: steepfell ($11.86 in chips) 
Seat 3: iDecMate ($18.73 in chips) 
Seat 4: Hyd SK ($10.48 in chips) 
Seat 5: KokoulinV ($12.56 in chips) 
Seat 6: bartabs2 ($8.87 in chips) 
Hyd SK: posts small blind $0.05
KokoulinV: posts big blind $0.10
*** HOLE CARDS ***
bartabs2: folds 
Ice_Isayev: folds 
steepfell: folds 
iDecMate: folds 
Hyd SK: folds 
Uncalled bet ($0.05) returned to KokoulinV
KokoulinV collected $0.10 from pot
*** SUMMARY ***
Total pot $0.10 | Rake $0 
Seat 1: Ice_Isayev folded before Flop (didn't bet)
Seat 2: steepfell folded before Flop (didn't bet)
Seat 3: iDecMate (button) folded before Flop (didn't bet)
Seat 4: Hyd SK (small blind) folded before Flop
Seat 5: KokoulinV (big blind) collected ($0.10)
Seat 6: bartabs2 folded before Flop (didn't bet)



PokerStars Hand #166667865800:  Hold'em No Limit ($0.05/$0.10 USD) - 2017/02/23 16:08:56 ET
Table 'Hercynia III' 6-max Seat #6 is the button
Seat 1: Bird et al ($14.68 in chips) 
Seat 2: Action_Gibi ($7.13 in chips) 
Seat 3: Dcaro31 ($20.02 in chips) 
Seat 5: THIMUCHIN ($15.30 in chips) 
Seat 6: bdixon_5 ($11.59 in chips) 
Bird et al: posts small blind $0.05
Action_Gibi: posts big blind $0.10
*** HOLE CARDS ***
Dcaro31: folds 
THIMUCHIN: folds 
bdixon_5: folds 
Bird et al: folds 
Uncalled bet ($0.05) returned to Action_Gibi
Action_Gibi collected $0.10 from pot
*** SUMMARY ***
Total pot $0.10 | Rake $0 
Seat 1: Bird et al (small blind) folded before Flop
Seat 2: Action_Gibi (big blind) collected ($0.10)
Seat 3: Dcaro31 folded before Flop (didn't bet)
Seat 5: THIMUCHIN folded before Flop (didn't bet)
Seat 6: bdixon_5 (button) folded before Flop (didn't bet)



PokerStars Hand #166667865801:  Hold'em No Limit ($0.05/$0.10 USD) - 2017/02/23 16:08:56 ET
Table 'Arkab' 6-max Seat #5 is the button
Seat 1: iamkakaroto ($10 in chips) 
Seat 2: aktion4ik ($12.24 in chips) 
Seat 3: sexy_seagull ($10 in chips) 
Seat 4: donkucallme ($24.60 in chips) 
Seat 5: OrionYusupov ($9.83 in chips) 
Seat 6: MihaGr ($11.25 in chips) 
MihaGr: posts small blind $0.05
iamkakaroto: posts big blind $0.10
*** HOLE CARDS ***
aktion4ik: folds 
sexy_seagull: folds 
donkucallme: folds 
OrionYusupov: folds 
MihaGr: folds 
Uncalled bet ($0.05) returned to iamkakaroto
iamkakaroto collected $0.10 from pot
*** SUMMARY ***
Total pot $0.10 | Rake $0 
Seat 1: iamkakaroto (big blind) collected ($0.10)
Seat 2: aktion4ik folded before Flop (didn't bet)
Seat 3: sexy_seagull folded before Flop (didn't bet)
Seat 4: donkucallme folded before Flop (didn't bet)
Seat 5: OrionYusupov (button) folded before Flop (didn't bet)
Seat 6: MihaGr (small blind) folded before Flop



PokerStars Hand #166667865840:  Hold'em No Limit ($0.05/$0.10 USD) - 2017/02/23 16:08:57 ET
Table 'Emma II' 6-max Seat #6 is the button
Seat 1: LarryTheStar ($10 in chips) 
Seat 2: T9MS ($11.64 in chips) 
Seat 3: oddshoff ($9.47 in chips) 
Seat 4: Jucatorul823 ($6.66 in chips) 
Seat 5: Scanner17 ($10.81 in chips) 
Seat 6: CHRO8 ($14.67 in chips) 
LarryTheStar: posts small blind $0.05
T9MS: posts big blind $0.10
*** HOLE CARDS ***
oddshoff: folds 
Jucatorul823: folds 
Scanner17: raises $0.20 to $0.30
CHRO8 has timed out
CHRO8: folds 
LarryTheStar: raises $0.70 to $1
T9MS: folds 
Scanner17: folds 
Uncalled bet ($0.70) returned to LarryTheStar
LarryTheStar collected $0.70 from pot
*** SUMMARY ***
Total pot $0.70 | Rake $0 
Seat 1: LarryTheStar (small blind) collected ($0.70)
Seat 2: T9MS (big blind) folded before Flop
Seat 3: oddshoff folded before Flop (didn't bet)
Seat 4: Jucatorul823 folded before Flop (didn't bet)
Seat 5: Scanner17 folded before Flop
Seat 6: CHRO8 (button) folded before Flop (didn't bet)



PokerStars Hand #166667866210:  Hold'em No Limit ($0.05/$0.10 USD) - 2017/02/23 16:08:57 ET
Table 'Martha' 6-max Seat #2 is the button
Seat 1: Peter0087 ($10.29 in chips) 
Seat 2: pauli95 ($10.21 in chips) 
Seat 3: Hyd SK ($12.42 in chips) 
Seat 4: dittoro ($10.15 in chips) 
Seat 5: MihaGr ($10 in chips) 
Seat 6: 8th wonders ($10 in chips) 
Hyd SK: posts small blind $0.05
dittoro: posts big blind $0.10
*** HOLE CARDS ***
MihaGr: folds 
8th wonders: folds 
Peter0087: folds 
pauli95: raises $0.20 to $0.30
Hyd SK: folds 
dittoro: calls $0.20
*** FLOP *** [Js Kc Ac]
dittoro: checks 
pauli95: checks 
*** TURN *** [Js Kc Ac] [6d]
dittoro: checks 
pauli95: bets $0.31
dittoro: calls $0.31
*** RIVER *** [Js Kc Ac 6d] [9s]
dittoro: checks 
pauli95: bets $0.61
dittoro: folds 
Uncalled bet ($0.61) returned to pauli95
pauli95 collected $1.21 from pot
*** SUMMARY ***
Total pot $1.27 | Rake $0.06 
Board [Js Kc Ac 6d 9s]
Seat 1: Peter0087 folded before Flop (didn't bet)
Seat 2: pauli95 (button) collected ($1.21)
Seat 3: Hyd SK (small blind) folded before Flop
Seat 4: dittoro (big blind) folded on the River
Seat 5: MihaGr folded before Flop (didn't bet)
Seat 6: 8th wonders folded before Flop (didn't bet)



PokerStars Hand #166667866552:  Hold'em No Limit ($0.05/$0.10 USD) - 2017/02/23 16:08:57 ET
Table 'Alnasl II' 6-max Seat #1 is the button
Seat 1: dragonste89 ($13.90 in chips) 
Seat 2: Therodorus ($10 in chips) 
Seat 3: ICBM-RS26 ($15.72 in chips) 
Seat 4: Eddys Edge ($10 in chips) 
Seat 5: mdelfin0 ($12.61 in chips) 
Seat 6: Bommer78 ($5.76 in chips) 
Therodorus: posts small blind $0.05
ICBM-RS26: posts big blind $0.10
*** HOLE CARDS ***
Eddys Edge: folds 
mdelfin0: folds 
Bommer78: calls $0.10
dragonste89: folds 
Therodorus: calls $0.05
ICBM-RS26: checks 
*** FLOP *** [Qh 4c 5h]
Therodorus: checks 
ICBM-RS26: checks 
Bommer78: checks 
*** TURN *** [Qh 4c 5h] [7s]
Therodorus: checks 
ICBM-RS26: checks 
Bommer78: bets $0.10
Therodorus: folds 
ICBM-RS26: folds 
Uncalled bet ($0.10) returned to Bommer78
Bommer78 collected $0.29 from pot
*** SUMMARY ***
Total pot $0.30 | Rake $0.01 
Board [Qh 4c 5h 7s]
Seat 1: dragonste89 (button) folded before Flop (didn't bet)
Seat 2: Therodorus (small blind) folded on the Turn
Seat 3: ICBM-RS26 (big blind) folded on the Turn
Seat 4: Eddys Edge folded before Flop (didn't bet)
Seat 5: mdelfin0 folded before Flop (didn't bet)
Seat 6: Bommer78 collected ($0.29)



PokerStars Hand #166667867295:  Hold'em No Limit ($0.05/$0.10 USD) - 2017/02/23 16:08:58 ET
Table 'Samitchell III' 6-max Seat #2 is the button
Seat 2: scorpionfish ($12.88 in chips) 
Seat 3: Vanne11 ($9.55 in chips) 
scorpionfish: posts small blind $0.05
Vanne11: posts big blind $0.10
*** HOLE CARDS ***
scorpionfish: folds 
Uncalled bet ($0.05) returned to Vanne11
Vanne11 collected $0.10 from pot
*** SUMMARY ***
Total pot $0.10 | Rake $0 
Seat 2: scorpionfish (button) (small blind) folded before Flop
Seat 3: Vanne11 (big blind) collected ($0.10)



PokerStars Hand #166667867729:  Hold'em No Limit ($0.05/$0.10 USD) - 2017/02/23 16:08:59 ET
Table 'Senta II' 6-max Seat #4 is the button
Seat 2: NvR.m1nD ($12.14 in chips) 
Seat 3: Aescul@pius ($21.88 in chips) 
Seat 4: fedorka rus ($20.79 in chips) 
Seat 5: Algarah ($5.28 in chips) 
Seat 6: T9MS ($11.32 in chips) 
Algarah: posts small blind $0.05
T9MS: posts big blind $0.10
Goovr: sits out 
*** HOLE CARDS ***
NvR.m1nD: raises $0.15 to $0.25
Aescul@pius: folds 
fedorka rus: calls $0.25
Algarah: folds 
T9MS: folds 
*** FLOP *** [6s 3c 6c]
NvR.m1nD: bets $0.41
fedorka rus: calls $0.41
*** TURN *** [6s 3c 6c] [9d]
NvR.m1nD: bets $0.95
fedorka rus: calls $0.95
*** RIVER *** [6s 3c 6c 9d] [7h]
NvR.m1nD: bets $2.61
fedorka rus: folds 
Uncalled bet ($2.61) returned to NvR.m1nD
NvR.m1nD collected $3.22 from pot
*** SUMMARY ***
Total pot $3.37 | Rake $0.15 
Board [6s 3c 6c 9d 7h]
Seat 2: NvR.m1nD collected ($3.22)
Seat 3: Aescul@pius folded before Flop (didn't bet)
Seat 4: fedorka rus (button) folded on the River
Seat 5: Algarah (small blind) folded before Flop
Seat 6: T9MS (big blind) folded before Flop



PokerStars Hand #166667867953:  Hold'em No Limit ($0.05/$0.10 USD) - 2017/02/23 16:08:59 ET
Table 'Risha II' 6-max Seat #3 is the button
Seat 1: R. Lemonte ($14.55 in chips) 
Seat 2: KA3AXCTAHEU, ($12.50 in chips) 
Seat 3: steepfell ($10 in chips) 
Seat 4: Comeback3392 ($19.58 in chips) 
Seat 5: m.c-alkatraz ($10.05 in chips) 
Seat 6: univibe68 ($10.76 in chips) 
Comeback3392: posts small blind $0.05
m.c-alkatraz: posts big blind $0.10
*** HOLE CARDS ***
univibe68: folds 
R. Lemonte: folds 
KA3AXCTAHEU,: raises $0.15 to $0.25
steepfell: raises $0.50 to $0.75
Comeback3392: folds 
m.c-alkatraz: folds 
KA3AXCTAHEU,: folds 
Uncalled bet ($0.50) returned to steepfell
steepfell collected $0.65 from pot
*** SUMMARY ***
Total pot $0.65 | Rake $0 
Seat 1: R. Lemonte folded before Flop (didn't bet)
Seat 2: KA3AXCTAHEU, folded before Flop
Seat 3: steepfell (button) collected ($0.65)
Seat 4: Comeback3392 (small blind) folded before Flop
Seat 5: m.c-alkatraz (big blind) folded before Flop
Seat 6: univibe68 folded before Flop (didn't bet)



PokerStars Hand #166667867964:  Hold'em No Limit ($0.05/$0.10 USD) - 2017/02/23 16:08:59 ET
Table 'Amalia' 6-max Seat #1 is the button
Seat 1: voledy ($12.63 in chips) 
Seat 2: DamDatsAnAce ($11 in chips) 
Seat 3: Kow6oy ($10 in chips) 
Seat 4: Rodik002 ($16.51 in chips) 
Seat 5: coolisses111 ($10.95 in chips) 
Seat 6: oktomber778 ($23.01 in chips) 
DamDatsAnAce: posts small blind $0.05
Kow6oy: posts big blind $0.10
*** HOLE CARDS ***
Rodik002: folds 
coolisses111: raises $0.30 to $0.40
oktomber778 has timed out
oktomber778: folds 
voledy: raises $0.80 to $1.20
DamDatsAnAce: folds 
Kow6oy: folds 
coolisses111: calls $0.80
*** FLOP *** [3s 7s Jh]
coolisses111: checks 
voledy: bets $1.39
coolisses111: raises $2.01 to $3.40
voledy: folds 
Uncalled bet ($2.01) returned to coolisses111
coolisses111 collected $5.09 from pot
*** SUMMARY ***
Total pot $5.33 | Rake $0.24 
Board [3s 7s Jh]
Seat 1: voledy (button) folded on the Flop
Seat 2: DamDatsAnAce (small blind) folded before Flop
Seat 3: Kow6oy (big blind) folded before Flop
Seat 4: Rodik002 folded before Flop (didn't bet)
Seat 5: coolisses111 collected ($5.09)
Seat 6: oktomber778 folded before Flop (didn't bet)



PokerStars Hand #166667868070:  Hold'em No Limit ($0.05/$0.10 USD) - 2017/02/23 16:08:59 ET
Table 'Selinur' 6-max Seat #2 is the button
Seat 1: KA3AXCTAHEU, ($10 in chips) 
Seat 2: hoedje72 ($7.22 in chips) 
Seat 5: DrVzad ($9.90 in chips) 
Seat 6: homelessdan ($18.50 in chips) 
bambolejro will be allowed to play after the button
DrVzad: posts small blind $0.05
homelessdan: posts big blind $0.10
*** HOLE CARDS ***
KA3AXCTAHEU,: raises $0.15 to $0.25
hoedje72: folds 
JahSoldier69 joins the table at seat #4 
JahSoldier69 leaves the table
DrVzad: folds 
homelessdan: folds 
Uncalled bet ($0.15) returned to KA3AXCTAHEU,
KA3AXCTAHEU, collected $0.25 from pot
*** SUMMARY ***
Total pot $0.25 | Rake $0 
Seat 1: KA3AXCTAHEU, collected ($0.25)
Seat 2: hoedje72 (button) folded before Flop (didn't bet)
Seat 5: DrVzad (small blind) folded before Flop
Seat 6: homelessdan (big blind) folded before Flop



PokerStars Hand #166667868729:  Hold'em No Limit ($0.05/$0.10 USD) - 2017/02/23 16:09:00 ET
Table 'Alzirr II' 6-max Seat #1 is the button
Seat 1: KA3AXCTAHEU, ($10.62 in chips) 
Seat 2: popypaleta ($10.05 in chips) 
Seat 3: devon_red ($7.50 in chips) 
Seat 5: yodzik ($5.93 in chips) 
Seat 6: AM-L-SL ($4.43 in chips) 
popypaleta: posts small blind $0.05
devon_red: posts big blind $0.10
*** HOLE CARDS ***
yodzik: raises $0.20 to $0.30
AM-L-SL: folds 
KA3AXCTAHEU,: folds 
popypaleta: folds 
devon_red: folds 
Uncalled bet ($0.20) returned to yodzik
yodzik collected $0.25 from pot
*** SUMMARY ***
Total pot $0.25 | Rake $0 
Seat 1: KA3AXCTAHEU, (button) folded before Flop (didn't bet)
Seat 2: popypaleta (small blind) folded before Flop
Seat 3: devon_red (big blind) folded before Flop
Seat 5: yodzik collected ($0.25)
Seat 6: AM-L-SL folded before Flop (didn't bet)



PokerStars Hand #166667868782:  Hold'em No Limit ($0.05/$0.10 USD) - 2017/02/23 16:09:00 ET
Table 'Siebohme' 6-max Seat #6 is the button
Seat 1: kusa4ki ($11.58 in chips) 
Seat 2: el toro 1507 ($11.53 in chips) 
Seat 3: ex3Lero86 ($10.41 in chips) 
Seat 5: Kazacha ($10 in chips) 
Seat 6: townerz1991 ($10 in chips) 
kusa4ki: posts small blind $0.05
el toro 1507: posts big blind $0.10
Kow6oy: sits out 
*** HOLE CARDS ***
ex3Lero86: folds 
Kazacha: folds 
townerz1991: raises $0.15 to $0.25
kusa4ki: folds 
el toro 1507: calls $0.15
*** FLOP *** [8h 7d Qc]
el toro 1507: checks 
townerz1991: bets $0.30
el toro 1507: folds 
Uncalled bet ($0.30) returned to townerz1991
townerz1991 collected $0.53 from pot
*** SUMMARY ***
Total pot $0.55 | Rake $0.02 
Board [8h 7d Qc]
Seat 1: kusa4ki (small blind) folded before Flop
Seat 2: el toro 1507 (big blind) folded on the Flop
Seat 3: ex3Lero86 folded before Flop (didn't bet)
Seat 5: Kazacha folded before Flop (didn't bet)
Seat 6: townerz1991 (button) collected ($0.53)



PokerStars Hand #166667868995:  Hold'em No Limit ($0.05/$0.10 USD) - 2017/02/23 16:09:00 ET
Table 'Cassini' 6-max Seat #6 is the button
Seat 1: Pokeaster ($11.23 in chips) 
Seat 2: mhonielsen ($12.41 in chips) 
Seat 4: fortieth ($13.97 in chips) 
Seat 5: DrVzad ($9.85 in chips) 
Seat 6: MihaGr ($10 in chips) 
Pokeaster: posts small blind $0.05
mhonielsen: posts big blind $0.10
J1234T: sits out 
*** HOLE CARDS ***
fortieth: folds 
DrVzad: raises $0.10 to $0.20
MihaGr: folds 
Pokeaster: folds 
mhonielsen: folds 
Uncalled bet ($0.10) returned to DrVzad
DrVzad collected $0.25 from pot
*** SUMMARY ***
Total pot $0.25 | Rake $0 
Seat 1: Pokeaster (small blind) folded before Flop
Seat 2: mhonielsen (big blind) folded before Flop
Seat 4: fortieth folded before Flop (didn't bet)
Seat 5: DrVzad collected ($0.25)
Seat 6: MihaGr (button) folded before Flop (didn't bet)



PokerStars Hand #166667869523:  Hold'em No Limit ($0.05/$0.10 USD) - 2017/02/23 16:09:01 ET
Table 'Pandora III' 6-max Seat #5 is the button
Seat 1: Pokeaster ($11.09 in chips) 
Seat 2: garigura ($11.54 in chips) 
Seat 3: Chodemuncher ($10 in chips) 
Seat 4: mhonielsen ($10.15 in chips) 
Seat 5: MühliJr ($10.57 in chips) 
Seat 6: yodzik ($5 in chips) 
yodzik: posts small blind $0.05
Pokeaster: posts big blind $0.10
*** HOLE CARDS ***
garigura: folds 
Chodemuncher: folds 
mhonielsen: folds 
MühliJr: folds 
yodzik: folds 
Uncalled bet ($0.05) returned to Pokeaster
Pokeaster collected $0.10 from pot
*** SUMMARY ***
Total pot $0.10 | Rake $0 
Seat 1: Pokeaster (big blind) collected ($0.10)
Seat 2: garigura folded before Flop (didn't bet)
Seat 3: Chodemuncher folded before Flop (didn't bet)
Seat 4: mhonielsen folded before Flop (didn't bet)
Seat 5: MühliJr (button) folded before Flop (didn't bet)
Seat 6: yodzik (small blind) folded before Flop



PokerStars Hand #166667869572:  Hold'em No Limit ($0.05/$0.10 USD) - 2017/02/23 16:09:01 ET
Table 'Tomyris II' 6-max Seat #4 is the button
Seat 1: ArcticBearDK ($21.83 in chips) 
Seat 2: Yspenyanin ($12.62 in chips) 
Seat 3: robertsabb ($12.13 in chips) 
Seat 4: Dcaro31 ($10 in chips) 
Seat 5: 6ePeMeHHa9 ($11.70 in chips) 
Seat 6: StackSmakka ($10.04 in chips) 
6ePeMeHHa9: posts small blind $0.05
StackSmakka: posts big blind $0.10
*** HOLE CARDS ***
ArcticBearDK: folds 
Yspenyanin: folds 
robertsabb: folds 
Dcaro31: folds 
6ePeMeHHa9: raises $0.20 to $0.30
StackSmakka: folds 
Uncalled bet ($0.20) returned to 6ePeMeHHa9
6ePeMeHHa9 collected $0.20 from pot
*** SUMMARY ***
Total pot $0.20 | Rake $0 
Seat 1: ArcticBearDK folded before Flop (didn't bet)
Seat 2: Yspenyanin folded before Flop (didn't bet)
Seat 3: robertsabb folded before Flop (didn't bet)
Seat 4: Dcaro31 (button) folded before Flop (didn't bet)
Seat 5: 6ePeMeHHa9 (small blind) collected ($0.20)
Seat 6: StackSmakka (big blind) folded before Flop



PokerStars Hand #166667869808:  Hold'em No Limit ($0.05/$0.10 USD) - 2017/02/23 16:09:01 ET
Table 'Nephthys II' 6-max Seat #1 is the button
Seat 1: DamDatsAnAce ($11.03 in chips) 
Seat 2: Ju$tD0it ($8.64 in chips) 
Seat 3: Newqbrown ($20.66 in chips) 
Seat 4: MihaGr ($10 in chips) 
Seat 5: kingartur222 ($8.61 in chips) 
Seat 6: CHRO8 ($14.29 in chips) 
Ju$tD0it: posts small blind $0.05
Newqbrown: posts big blind $0.10
*** HOLE CARDS ***
MihaGr: folds 
kingartur222: folds 
CHRO8: raises $0.20 to $0.30
DamDatsAnAce: calls $0.30
Ju$tD0it: calls $0.25
Newqbrown: calls $0.20
*** FLOP *** [7d Td 4d]
Ju$tD0it: checks 
Newqbrown: checks 
CHRO8: bets $0.80
DamDatsAnAce: calls $0.80
Ju$tD0it: folds 
Newqbrown: calls $0.80
*** TURN *** [7d Td 4d] [2d]
Newqbrown: checks 
CHRO8: checks 
DamDatsAnAce: checks 
*** RIVER *** [7d Td 4d 2d] [5h]
Newqbrown: checks 
CHRO8: bets $3.44
DamDatsAnAce: calls $3.44
Newqbrown: folds 
*** SHOW DOWN ***
CHRO8: shows [Ac Ad] (a flush, Ace high)
DamDatsAnAce: mucks hand 
CHRO8 collected $10.01 from pot
*** SUMMARY ***
Total pot $10.48 | Rake $0.47 
Board [7d Td 4d 2d 5h]
Seat 1: DamDatsAnAce (button) mucked
Seat 2: Ju$tD0it (small blind) folded on the Flop
Seat 3: Newqbrown (big blind) folded on the River
Seat 4: MihaGr folded before Flop (didn't bet)
Seat 5: kingartur222 folded before Flop (didn't bet)
Seat 6: CHRO8 showed [Ac Ad] and won ($10.01) with a flush, Ace high



PokerStars Hand #166667869810:  Hold'em No Limit ($0.05/$0.10 USD) - 2017/02/23 16:09:01 ET
Table 'Xanthippe II' 6-max Seat #3 is the button
Seat 2: Bird et al ($10.23 in chips) 
Seat 3: Dcaro31 ($14.61 in chips) 
Seat 6: Orlangoor ($13.08 in chips) 
Orlangoor: posts small blind $0.05
Bird et al: posts big blind $0.10
*** HOLE CARDS ***
Dcaro31: raises $0.20 to $0.30
Orlangoor: folds 
Bird et al: folds 
Uncalled bet ($0.20) returned to Dcaro31
Dcaro31 collected $0.25 from pot
*** SUMMARY ***
Total pot $0.25 | Rake $0 
Seat 2: Bird et al (big blind) folded before Flop
Seat 3: Dcaro31 (button) collected ($0.25)
Seat 6: Orlangoor (small blind) folded before Flop



PokerStars Hand #166667870014:  Hold'em No Limit ($0.05/$0.10 USD) - 2017/02/23 16:09:01 ET
Table 'Aisakos II' 6-max Seat #6 is the button
Seat 1: Crafty23@PS ($10.40 in chips) 
Seat 2: svaika24 ($17.02 in chips) 
Seat 3: iamkakaroto ($10.82 in chips) 
Seat 4: T9MS ($10.15 in chips) 
Seat 5: KokoulinV ($11.75 in chips) 
Seat 6: LarryTheStar ($10.03 in chips) 
Crafty23@PS: posts small blind $0.05
svaika24: posts big blind $0.10
*** HOLE CARDS ***
iamkakaroto: folds 
T9MS: raises $0.20 to $0.30
KokoulinV: folds 
LarryTheStar: folds 
Crafty23@PS: folds 
svaika24: folds 
Uncalled bet ($0.20) returned to T9MS
T9MS collected $0.25 from pot
*** SUMMARY ***
Total pot $0.25 | Rake $0 
Seat 1: Crafty23@PS (small blind) folded before Flop
Seat 2: svaika24 (big blind) folded before Flop
Seat 3: iamkakaroto folded before Flop (didn't bet)
Seat 4: T9MS collected ($0.25)
Seat 5: KokoulinV folded before Flop (didn't bet)
Seat 6: LarryTheStar (button) folded before Flop (didn't bet)



PokerStars Hand #166667870098:  Hold'em No Limit ($0.05/$0.10 USD) - 2017/02/23 16:09:01 ET
Table 'Kraz II' 6-max Seat #1 is the button
Seat 1: bdixon_5 ($9.10 in chips) 
Seat 2: shellyld ($9.90 in chips) 
Seat 3: Eddys Edge ($10.15 in chips) 
Seat 5: Joker51_wtf! ($10 in chips) 
Seat 6: tr41n3r12 ($11.26 in chips) 
shellyld: posts small blind $0.05
Eddys Edge: posts big blind $0.10
DrVzad: sits out 
*** HOLE CARDS ***
Joker51_wtf!: folds 
tr41n3r12: raises $0.20 to $0.30
bdixon_5: folds 
shellyld: folds 
Eddys Edge: calls $0.20
*** FLOP *** [8d 3h Jc]
Eddys Edge: checks 
tr41n3r12: bets $0.40
Eddys Edge: folds 
Uncalled bet ($0.40) returned to tr41n3r12
tr41n3r12 collected $0.62 from pot
*** SUMMARY ***
Total pot $0.65 | Rake $0.03 
Board [8d 3h Jc]
Seat 1: bdixon_5 (button) folded before Flop (didn't bet)
Seat 2: shellyld (small blind) folded before Flop
Seat 3: Eddys Edge (big blind) folded on the Flop
Seat 5: Joker51_wtf! folded before Flop (didn't bet)
Seat 6: tr41n3r12 collected ($0.62)



PokerStars Hand #166667870610:  Hold'em No Limit ($0.05/$0.10 USD) - 2017/02/23 16:09:02 ET
Table 'Nymphe II' 6-max Seat #4 is the button
Seat 1: jacktayra ($1.01 in chips) 
Seat 2: Newqbrown ($10.78 in chips) 
Seat 3: THIMUCHIN ($16.76 in chips) 
Seat 4: coolisses111 ($17.15 in chips) 
Seat 6: Xander188 ($10 in chips) 
Xander188: posts small blind $0.05
jacktayra: posts big blind $0.10
*** HOLE CARDS ***
Newqbrown: folds 
THIMUCHIN: raises $0.15 to $0.25
coolisses111: folds 
RoJ1 leaves the table
Xander188: raises $0.55 to $0.80
jacktayra: calls $0.70
THIMUCHIN: raises $1.55 to $2.35
Xander188: folds 
jacktayra: calls $0.21 and is all-in
Uncalled bet ($1.34) returned to THIMUCHIN
*** FLOP *** [Jh 4s 6d]
*** TURN *** [Jh 4s 6d] [Jc]
*** RIVER *** [Jh 4s 6d Jc] [5c]
*** SHOW DOWN ***
jacktayra: shows [7d 7s] (two pair, Jacks and Sevens)
THIMUCHIN: shows [Kh Ac] (a pair of Jacks)
jacktayra collected $2.69 from pot
*** SUMMARY ***
Total pot $2.82 | Rake $0.13 
Board [Jh 4s 6d Jc 5c]
Seat 1: jacktayra (big blind) showed [7d 7s] and won ($2.69) with two pair, Jacks and Sevens
Seat 2: Newqbrown folded before Flop (didn't bet)
Seat 3: THIMUCHIN showed [Kh Ac] and lost with a pair of Jacks
Seat 4: coolisses111 (button) folded before Flop (didn't bet)
Seat 6: Xander188 (small blind) folded before Flop



PokerStars Hand #166667870631:  Hold'em No Limit ($0.05/$0.10 USD) - 2017/02/23 16:09:02 ET
Table 'Lampetia' 6-max Seat #1 is the button
Seat 1: WinninBikini ($10.18 in chips) 
Seat 2: ex3Lero86 ($10.35 in chips) 
Seat 3: Ice_Isayev ($19.89 in chips) 
Seat 4: Rodik002 ($10 in chips) 
Seat 5: luisantrs ($10.37 in chips) 
Seat 6: Scanner17 ($12.09 in chips) 
ex3Lero86: posts small blind $0.05
Ice_Isayev: posts big blind $0.10
*** HOLE CARDS ***
Rodik002: folds 
luisantrs: raises $0.20 to $0.30
Scanner17: folds 
WinninBikini: folds 
ex3Lero86: folds 
Ice_Isayev: folds 
Uncalled bet ($0.20) returned to luisantrs
luisantrs collected $0.25 from pot
*** SUMMARY ***
Total pot $0.25 | Rake $0 
Seat 1: WinninBikini (button) folded before Flop (didn't bet)
Seat 2: ex3Lero86 (small blind) folded before Flop
Seat 3: Ice_Isayev (big blind) folded before Flop
Seat 4: Rodik002 folded before Flop (didn't bet)
Seat 5: luisantrs collected ($0.25)
Seat 6: Scanner17 folded before Flop (didn't bet)



PokerStars Hand #166667871162:  Hold'em No Limit ($0.05/$0.10 USD) - 2017/02/23 16:09:02 ET
Table 'Syringa II' 6-max Seat #5 is the button
Seat 1: GiveTwoMe ($15.17 in chips) 
Seat 2: Cluckh ($10.14 in chips) 
Seat 3: gaHy_HaXeP ($10.58 in chips) 
Seat 4: MBen10 ($13.93 in chips) 
Seat 5: Mishapok196 ($5.91 in chips) 
Seat 6: WinninBikini ($10 in chips) 
WinninBikini: posts small blind $0.05
GiveTwoMe: posts big blind $0.10
*** HOLE CARDS ***
Cluckh: raises $0.20 to $0.30
gaHy_HaXeP: calls $0.30
MBen10: folds 
Mishapok196: calls $0.30
WinninBikini: folds 
GiveTwoMe: folds 
*** FLOP *** [3c 6s 9s]
Cluckh: checks 
gaHy_HaXeP: checks 
Mishapok196: bets $0.20
Cluckh: folds 
gaHy_HaXeP: folds 
Uncalled bet ($0.20) returned to Mishapok196
Mishapok196 collected $1 from pot
*** SUMMARY ***
Total pot $1.05 | Rake $0.05 
Board [3c 6s 9s]
Seat 1: GiveTwoMe (big blind) folded before Flop
Seat 2: Cluckh folded on the Flop
Seat 3: gaHy_HaXeP folded on the Flop
Seat 4: MBen10 folded before Flop (didn't bet)
Seat 5: Mishapok196 (button) collected ($1)
Seat 6: WinninBikini (small blind) folded before Flop



PokerStars Hand #166667871220:  Hold'em No Limit ($0.05/$0.10 USD) - 2017/02/23 16:09:02 ET
Table 'Izar' 6-max Seat #4 is the button
Seat 1: bambolejro ($10.52 in chips) 
Seat 2: mvp0013 ($10 in chips) 
Seat 3: Yspenyanin ($11.17 in chips) 
Seat 4: Matee92 ($6.09 in chips) 
Seat 5: fishhook5 ($11.20 in chips) 
Seat 6: yodzik ($7.79 in chips) 
fishhook5: posts small blind $0.05
yodzik: posts big blind $0.10
*** HOLE CARDS ***
bambolejro: folds 
mvp0013: folds 
Yspenyanin: folds 
Matee92: calls $0.10
fishhook5: raises $0.20 to $0.30
yodzik: raises $0.60 to $0.90
Matee92: calls $0.80
fishhook5: calls $0.60
*** FLOP *** [9c Qs Ad]
fishhook5: checks 
yodzik: bets $1.10
Matee92: calls $1.10
fishhook5: folds 
*** TURN *** [9c Qs Ad] [3s]
yodzik: checks 
Matee92: checks 
*** RIVER *** [9c Qs Ad 3s] [2h]
yodzik: bets $5.79 and is all-in
Matee92: calls $4.09 and is all-in
Uncalled bet ($1.70) returned to yodzik
*** SHOW DOWN ***
yodzik: shows [Qd Ac] (two pair, Aces and Queens)
Matee92: shows [Kd Ks] (a pair of Kings)
yodzik collected $12.49 from pot
*** SUMMARY ***
Total pot $13.08 | Rake $0.59 
Board [9c Qs Ad 3s 2h]
Seat 1: bambolejro folded before Flop (didn't bet)
Seat 2: mvp0013 folded before Flop (didn't bet)
Seat 3: Yspenyanin folded before Flop (didn't bet)
Seat 4: Matee92 (button) showed [Kd Ks] and lost with a pair of Kings
Seat 5: fishhook5 (small blind) folded on the Flop
Seat 6: yodzik (big blind) showed [Qd Ac] and won ($12.49) with two pair, Aces and Queens



PokerStars Hand #166667871299:  Hold'em No Limit ($0.05/$0.10 USD) - 2017/02/23 16:09:03 ET
Table 'Serpens' 6-max Seat #1 is the button
Seat 1: Namhkal ($10 in chips) 
Seat 2: KA3AXCTAHEU, ($19.53 in chips) 
Seat 3: homelessdan ($30.23 in chips) 
Seat 4: Ragazzi3 ($9.45 in chips) 
Seat 5: XwinX25 ($11.97 in chips) 
Croplayer1 leaves the table
KA3AXCTAHEU,: posts small blind $0.05
homelessdan: posts big blind $0.10
*** HOLE CARDS ***
Ragazzi3: folds 
XwinX25: raises $0.20 to $0.30
Ragazzi3 leaves the table
Namhkal: folds 
KA3AXCTAHEU,: folds 
homelessdan: calls $0.20
*** FLOP *** [7c 9s 4c]
homelessdan: checks 
XwinX25: bets $0.45
homelessdan: folds 
Uncalled bet ($0.45) returned to XwinX25
XwinX25 collected $0.62 from pot
*** SUMMARY ***
Total pot $0.65 | Rake $0.03 
Board [7c 9s 4c]
Seat 1: Namhkal (button) folded before Flop (didn't bet)
Seat 2: KA3AXCTAHEU, (small blind) folded before Flop
Seat 3: homelessdan (big blind) folded on the Flop
Seat 4: Ragazzi3 folded before Flop (didn't bet)
Seat 5: XwinX25 collected ($0.62)



PokerStars Hand #166667871366:  Hold'em No Limit ($0.05/$0.10 USD) - 2017/02/23 16:09:03 ET
Table 'Caprera III' 6-max Seat #2 is the button
Seat 1: Vrinni ($19.29 in chips) 
Seat 2: hg123454321 ($10.87 in chips) 
Seat 6: GESPERIA ($15.46 in chips) 
GESPERIA: posts small blind $0.05
Vrinni: posts big blind $0.10
*** HOLE CARDS ***
hg123454321: raises $0.10 to $0.20
GESPERIA: folds 
Vrinni: calls $0.10
*** FLOP *** [Tc Td 9s]
Vrinni: checks 
hg123454321: checks 
*** TURN *** [Tc Td 9s] [As]
Vrinni: checks 
hg123454321: checks 
*** RIVER *** [Tc Td 9s As] [7s]
Vrinni: checks 
hg123454321: bets $0.40
Vrinni: folds 
Uncalled bet ($0.40) returned to hg123454321
hg123454321 collected $0.43 from pot
*** SUMMARY ***
Total pot $0.45 | Rake $0.02 
Board [Tc Td 9s As 7s]
Seat 1: Vrinni (big blind) folded on the River
Seat 2: hg123454321 (button) collected ($0.43)
Seat 6: GESPERIA (small blind) folded before Flop



PokerStars Hand #166667871681:  Hold'em No Limit ($0.05/$0.10 USD) - 2017/02/23 16:09:03 ET
Table 'Vesta II' 6-max Seat #1 is the button
Seat 1: Yabidooo ($17.27 in chips) 
Seat 2: Dimka4 ($10.05 in chips) 
Seat 3: Pokeaster ($12.71 in chips) 
Seat 4: Dcaro31 ($10 in chips) 
Seat 5: ChuikaPridi ($10 in chips) 
Seat 6: XaXaTyH4uK ($10.86 in chips) 
Dimka4: posts small blind $0.05
Pokeaster: posts big blind $0.10
*** HOLE CARDS ***
Dcaro31: folds 
ChuikaPridi: folds 
XaXaTyH4uK: folds 
Yabidooo: raises $0.10 to $0.20
Dimka4: folds 
Pokeaster: folds 
Uncalled bet ($0.10) returned to Yabidooo
Yabidooo collected $0.25 from pot
*** SUMMARY ***
Total pot $0.25 | Rake $0 
Seat 1: Yabidooo (button) collected ($0.25)
Seat 2: Dimka4 (small blind) folded before Flop
Seat 3: Pokeaster (big blind) folded before Flop
Seat 4: Dcaro31 folded before Flop (didn't bet)
Seat 5: ChuikaPridi folded before Flop (didn't bet)
Seat 6: XaXaTyH4uK folded before Flop (didn't bet)



PokerStars Hand #166667872142:  Hold'em No Limit ($0.05/$0.10 USD) - 2017/02/23 16:09:03 ET
Table 'Markab II' 6-max Seat #4 is the button
Seat 1: david_sara83 ($10.22 in chips) 
Seat 2: truck1234 ($11.27 in chips) 
Seat 3: sexy_seagull ($10.15 in chips) 
Seat 4: Crafty23@PS ($11.29 in chips) 
Seat 5: Rodik002 ($19.82 in chips) 
Seat 6: Comeback3392 ($10 in chips) 
Rodik002: posts small blind $0.05
Comeback3392: posts big blind $0.10
*** HOLE CARDS ***
david_sara83: raises $0.20 to $0.30
truck1234: calls $0.30
sexy_seagull: folds 
Crafty23@PS: folds 
Rodik002: folds 
Comeback3392: folds 
*** FLOP *** [Ah 7d Ac]
david_sara83: bets $0.35
truck1234: folds 
Uncalled bet ($0.35) returned to david_sara83
david_sara83 collected $0.72 from pot
*** SUMMARY ***
Total pot $0.75 | Rake $0.03 
Board [Ah 7d Ac]
Seat 1: david_sara83 collected ($0.72)
Seat 2: truck1234 folded on the Flop
Seat 3: sexy_seagull folded before Flop (didn't bet)
Seat 4: Crafty23@PS (button) folded before Flop (didn't bet)
Seat 5: Rodik002 (small blind) folded before Flop
Seat 6: Comeback3392 (big blind) folded before Flop



PokerStars Hand #166667872330:  Hold'em No Limit ($0.05/$0.10 USD) - 2017/02/23 16:09:04 ET
Table 'Armenia' 6-max Seat #2 is the button
Seat 1: tr41n3r12 ($11.52 in chips) 
Seat 2: Yabidooo ($10.83 in chips) 
Seat 3: Crimsonr ($5.28 in chips) 
Seat 4: mbkongstad ($9.60 in chips) 
Seat 6: mega spasser ($7.34 in chips) 
Crimsonr: posts small blind $0.05
mbkongstad: posts big blind $0.10
DrVzad: sits out 
*** HOLE CARDS ***
mega spasser: folds 
tr41n3r12: folds 
Yabidooo: folds 
Crimsonr: raises $0.40 to $0.50
mbkongstad: calls $0.40
*** FLOP *** [7c 2s 6d]
Crimsonr: bets $1.60
mbkongstad: folds 
Uncalled bet ($1.60) returned to Crimsonr
Crimsonr collected $0.96 from pot
*** SUMMARY ***
Total pot $1 | Rake $0.04 
Board [7c 2s 6d]
Seat 1: tr41n3r12 folded before Flop (didn't bet)
Seat 2: Yabidooo (button) folded before Flop (didn't bet)
Seat 3: Crimsonr (small blind) collected ($0.96)
Seat 4: mbkongstad (big blind) folded on the Flop
Seat 6: mega spasser folded before Flop (didn't bet)



PokerStars Hand #166667872509:  Hold'em No Limit ($0.05/$0.10 USD) - 2017/02/23 16:09:04 ET
Table 'Deflotte' 6-max Seat #5 is the button
Seat 1: Zooplack ($16.16 in chips) 
Seat 2: MonteCris92 ($10.15 in chips) 
Seat 4: 8th wonders ($10.37 in chips) 
Seat 5: Pokeaster ($11.47 in chips) 
Seat 6: Iarlei ($11.50 in chips) 
Iarlei: posts small blind $0.05
Zooplack: posts big blind $0.10
*** HOLE CARDS ***
MonteCris92: folds 
8th wonders: folds 
JahSoldier69 joins the table at seat #3 
Pokeaster: folds 
JahSoldier69 leaves the table
Iarlei: raises $0.20 to $0.30
Yspenyanin joins the table at seat #3 
Zooplack: calls $0.20
*** FLOP *** [7d 9h Ks]
Iarlei: bets $0.30
Zooplack: calls $0.30
*** TURN *** [7d 9h Ks] [6h]
Iarlei: bets $0.60
Zooplack: calls $0.60
*** RIVER *** [7d 9h Ks 6h] [Js]
Iarlei: checks 
Zooplack: bets $1.37
Yspenyanin is disconnected 
Iarlei: folds 
Uncalled bet ($1.37) returned to Zooplack
Zooplack collected $2.29 from pot
*** SUMMARY ***
Total pot $2.40 | Rake $0.11 
Board [7d 9h Ks 6h Js]
Seat 1: Zooplack (big blind) collected ($2.29)
Seat 2: MonteCris92 folded before Flop (didn't bet)
Seat 4: 8th wonders folded before Flop (didn't bet)
Seat 5: Pokeaster (button) folded before Flop (didn't bet)
Seat 6: Iarlei (small blind) folded on the River



PokerStars Hand #166667872628:  Hold'em No Limit ($0.05/$0.10 USD) - 2017/02/23 16:09:04 ET
Table 'California II' 6-max Seat #4 is the button
Seat 1: fedorka rus ($10 in chips) 
Seat 2: homelessdan ($10 in chips) 
Seat 3: Bird et al ($10 in chips) 
Seat 4: pokekrk ($14.27 in chips) 
Seat 5: Nikolai77798 ($3.95 in chips) 
Seat 6: chiko4040 ($8.98 in chips) 
Nikolai77798: posts small blind $0.05
chiko4040: posts big blind $0.10
*** HOLE CARDS ***
fedorka rus: raises $0.20 to $0.30
homelessdan: folds 
Bird et al: folds 
pokekrk: calls $0.30
Nikolai77798: folds 
chiko4040: folds 
*** FLOP *** [Qc 3s 3d]
fedorka rus: bets $0.54
pokekrk: folds 
Uncalled bet ($0.54) returned to fedorka rus
fedorka rus collected $0.72 from pot
*** SUMMARY ***
Total pot $0.75 | Rake $0.03 
Board [Qc 3s 3d]
Seat 1: fedorka rus collected ($0.72)
Seat 2: homelessdan folded before Flop (didn't bet)
Seat 3: Bird et al folded before Flop (didn't bet)
Seat 4: pokekrk (button) folded on the Flop
Seat 5: Nikolai77798 (small blind) folded before Flop
Seat 6: chiko4040 (big blind) folded before Flop



PokerStars Hand #166667872661:  Hold'em No Limit ($0.05/$0.10 USD) - 2017/02/23 16:09:04 ET
Table 'Ebella II' 6-max Seat #1 is the button
Seat 1: gaHy_HaXeP ($10 in chips) 
Seat 2: Therodorus ($10 in chips) 
Seat 3: Torften2 ($17.51 in chips) 
Seat 4: ValdemorS ($11.35 in chips) 
Seat 5: Bird et al ($10 in chips) 
Seat 6: Joker51_wtf! ($11.39 in chips) 
Therodorus: posts small blind $0.05
Torften2: posts big blind $0.10
*** HOLE CARDS ***
ValdemorS: folds 
Bird et al: folds 
Joker51_wtf!: folds 
gaHy_HaXeP: raises $0.12 to $0.22
Therodorus: folds 
Torften2: calls $0.12
*** FLOP *** [6h Ac 4d]
Torften2: checks 
gaHy_HaXeP: checks 
*** TURN *** [6h Ac 4d] [7h]
Torften2: bets $0.30
gaHy_HaXeP: folds 
Uncalled bet ($0.30) returned to Torften2
Torften2 collected $0.47 from pot
*** SUMMARY ***
Total pot $0.49 | Rake $0.02 
Board [6h Ac 4d 7h]
Seat 1: gaHy_HaXeP (button) folded on the Turn
Seat 2: Therodorus (small blind) folded before Flop
Seat 3: Torften2 (big blind) collected ($0.47)
Seat 4: ValdemorS folded before Flop (didn't bet)
Seat 5: Bird et al folded before Flop (didn't bet)
Seat 6: Joker51_wtf! folded before Flop (didn't bet)



PokerStars Hand #166667872664:  Hold'em No Limit ($0.05/$0.10 USD) - 2017/02/23 16:09:04 ET
Table 'Eurydome II' 6-max Seat #1 is the button
Seat 1: rusu_rapid ($11.68 in chips) 
Seat 3: gaHy_HaXeP ($11.99 in chips) 
Seat 4: Smitty03300 ($10.07 in chips) 
Seat 5: kush-killa87 ($10.74 in chips) 
Seat 6: Jucatorul823 ($4.67 in chips) 
gaHy_HaXeP: posts small blind $0.05
Smitty03300: posts big blind $0.10
*** HOLE CARDS ***
kush-killa87: folds 
Jucatorul823: folds 
rusu_rapid: raises $0.15 to $0.25
gaHy_HaXeP: folds 
Smitty03300: folds 
Uncalled bet ($0.15) returned to rusu_rapid
rusu_rapid collected $0.25 from pot
*** SUMMARY ***
Total pot $0.25 | Rake $0 
Seat 1: rusu_rapid (button) collected ($0.25)
Seat 3: gaHy_HaXeP (small blind) folded before Flop
Seat 4: Smitty03300 (big blind) folded before Flop
Seat 5: kush-killa87 folded before Flop (didn't bet)
Seat 6: Jucatorul823 folded before Flop (didn't bet)



PokerStars Hand #166667872690:  Hold'em No Limit ($0.05/$0.10 USD) - 2017/02/23 16:09:04 ET
Table 'Syringa' 6-max Seat #3 is the button
Seat 1: bdixon_5 ($9.16 in chips) 
Seat 2: Goroshkos88 ($11.08 in chips) 
Seat 3: Yspenyanin ($13.37 in chips) 
Seat 5: Andrei ProFF ($14.81 in chips) 
Seat 6: ibara000 ($14.70 in chips) 
voledy will be allowed to play after the button
Andrei ProFF: posts small blind $0.05
ibara000: posts big blind $0.10
*** HOLE CARDS ***
bdixon_5: folds 
Goroshkos88: folds 
Yspenyanin: folds 
Andrei ProFF: raises $0.20 to $0.30
ibara000: calls $0.20
*** FLOP *** [5s 3d 7d]
Andrei ProFF: checks 
ibara000: checks 
*** TURN *** [5s 3d 7d] [Qh]
Andrei ProFF: bets $0.30
ibara000: calls $0.30
*** RIVER *** [5s 3d 7d Qh] [As]
Andrei ProFF: checks 
ibara000: checks 
*** SHOW DOWN ***
Andrei ProFF: shows [Qc Th] (a pair of Queens)
ibara000: mucks hand 
Andrei ProFF collected $1.15 from pot
*** SUMMARY ***
Total pot $1.20 | Rake $0.05 
Board [5s 3d 7d Qh As]
Seat 1: bdixon_5 folded before Flop (didn't bet)
Seat 2: Goroshkos88 folded before Flop (didn't bet)
Seat 3: Yspenyanin (button) folded before Flop (didn't bet)
Seat 5: Andrei ProFF (small blind) showed [Qc Th] and won ($1.15) with a pair of Queens
Seat 6: ibara000 (big blind) mucked



PokerStars Hand #166667873198:  Hold'em No Limit ($0.05/$0.10 USD) - 2017/02/23 16:09:05 ET
Table 'Kochera' 6-max Seat #4 is the button
Seat 1: chimera252 ($11.67 in chips) 
Seat 2: bartabs2 ($10.39 in chips) 
Seat 3: KA3AXCTAHEU, ($10.31 in chips) 
Seat 4: dany_de_vit ($9.75 in chips) 
Seat 5: univibe68 ($11.92 in chips) 
Seat 6: oddshoff ($9.63 in chips) 
univibe68: posts small blind $0.05
oddshoff: posts big blind $0.10
*** HOLE CARDS ***
chimera252: folds 
bartabs2: raises $0.10 to $0.20
KA3AXCTAHEU,: folds 
dany_de_vit: folds 
univibe68: calls $0.15
oddshoff: folds 
*** FLOP *** [Js Qh 9s]
univibe68: bets $0.50
bartabs2: folds 
Uncalled bet ($0.50) returned to univibe68
univibe68 collected $0.48 from pot
*** SUMMARY ***
Total pot $0.50 | Rake $0.02 
Board [Js Qh 9s]
Seat 1: chimera252 folded before Flop (didn't bet)
Seat 2: bartabs2 folded on the Flop
Seat 3: KA3AXCTAHEU, folded before Flop (didn't bet)
Seat 4: dany_de_vit (button) folded before Flop (didn't bet)
Seat 5: univibe68 (small blind) collected ($0.48)
Seat 6: oddshoff (big blind) folded before Flop



PokerStars Hand #166667873332:  Hold'em No Limit ($0.05/$0.10 USD) - 2017/02/23 16:09:05 ET
Table 'Landi II' 6-max Seat #4 is the button
Seat 1: dersiemer ($12.89 in chips) 
Seat 2: Aescul@pius ($10 in chips) 
Seat 4: alesi13 ($6.41 in chips) 
Seat 5: Bird et al ($10.15 in chips) 
Seat 6: arti192837 ($10 in chips) 
Bird et al: posts small blind $0.05
arti192837: posts big blind $0.10
x3ultimate: sits out 
*** HOLE CARDS ***
dersiemer: folds 
Aescul@pius: folds 
alesi13: folds 
Bird et al: raises $0.20 to $0.30
arti192837: folds 
Uncalled bet ($0.20) returned to Bird et al
Bird et al collected $0.20 from pot
*** SUMMARY ***
Total pot $0.20 | Rake $0 
Seat 1: dersiemer folded before Flop (didn't bet)
Seat 2: Aescul@pius folded before Flop (didn't bet)
Seat 4: alesi13 (button) folded before Flop (didn't bet)
Seat 5: Bird et al (small blind) collected ($0.20)
Seat 6: arti192837 (big blind) folded before Flop



PokerStars Hand #166667873596:  Hold'em No Limit ($0.05/$0.10 USD) - 2017/02/23 16:09:05 ET
Table 'Wil' 6-max Seat #5 is the button
Seat 1: jwhelan94 ($23.39 in chips) 
Seat 2: Vrinni ($21.95 in chips) 
Seat 3: Namhkal ($10 in chips) 
Seat 4: x3ultimate ($10 in chips) 
Seat 5: Feverhead ($14.78 in chips) 
Seat 6: Comeback3392 ($13.68 in chips) 
Comeback3392: posts small blind $0.05
jwhelan94: posts big blind $0.10
*** HOLE CARDS ***
Vrinni: folds 
Namhkal: folds 
x3ultimate: folds 
Feverhead: folds 
Comeback3392: folds 
Uncalled bet ($0.05) returned to jwhelan94
jwhelan94 collected $0.10 from pot
*** SUMMARY ***
Total pot $0.10 | Rake $0 
Seat 1: jwhelan94 (big blind) collected ($0.10)
Seat 2: Vrinni folded before Flop (didn't bet)
Seat 3: Namhkal folded before Flop (didn't bet)
Seat 4: x3ultimate folded before Flop (didn't bet)
Seat 5: Feverhead (button) folded before Flop (didn't bet)
Seat 6: Comeback3392 (small blind) folded before Flop



PokerStars Hand #166667873986:  Hold'em No Limit ($0.05/$0.10 USD) - 2017/02/23 16:09:05 ET
Table 'Goto II' 6-max Seat #2 is the button
Seat 1: FRAID358 ($12.01 in chips) 
Seat 2: 6ePeMeHHa9 ($11.67 in chips) 
Seat 3: Goroshkos88 ($10.86 in chips) 
Seat 4: KRZuff ($13.76 in chips) 
Seat 5: RoJ1 ($14.50 in chips) 
Seat 6: ermananb93 ($11.51 in chips) 
Goroshkos88: posts small blind $0.05
KRZuff: posts big blind $0.10
*** HOLE CARDS ***
RoJ1: folds 
ermananb93: calls $0.10
FRAID358: folds 
6ePeMeHHa9: folds 
Goroshkos88: raises $0.40 to $0.50
KRZuff: folds 
ermananb93: calls $0.40
*** FLOP *** [Ts Qd Ks]
Goroshkos88: bets $0.70
ermananb93: folds 
Uncalled bet ($0.70) returned to Goroshkos88
Goroshkos88 collected $1.05 from pot
*** SUMMARY ***
Total pot $1.10 | Rake $0.05 
Board [Ts Qd Ks]
Seat 1: FRAID358 folded before Flop (didn't bet)
Seat 2: 6ePeMeHHa9 (button) folded before Flop (didn't bet)
Seat 3: Goroshkos88 (small blind) collected ($1.05)
Seat 4: KRZuff (big blind) folded before Flop
Seat 5: RoJ1 folded before Flop (didn't bet)
Seat 6: ermananb93 folded on the Flop



PokerStars Hand #166667874159:  Hold'em No Limit ($0.05/$0.10 USD) - 2017/02/23 16:09:06 ET
Table 'Lacroute' 6-max Seat #1 is the button
Seat 1: Orlangoor ($10 in chips) 
Seat 2: Andy Wolf ($10.59 in chips) 
Seat 4: st4tion ($17.37 in chips) 
Seat 5: steepfell ($10.19 in chips) 
Seat 6: IAntikI ($11.67 in chips) 
Andy Wolf: posts small blind $0.05
st4tion: posts big blind $0.10
*** HOLE CARDS ***
Croplayer1 leaves the table
RoJ1 joins the table at seat #3 
steepfell: folds 
IAntikI: folds 
RoJ1 leaves the table
Orlangoor: raises $0.12 to $0.22
Andy Wolf: folds 
st4tion: calls $0.12
*** FLOP *** [9d 6d 7d]
st4tion: checks 
Orlangoor: bets $0.27
st4tion: folds 
Uncalled bet ($0.27) returned to Orlangoor
Orlangoor collected $0.47 from pot
*** SUMMARY ***
Total pot $0.49 | Rake $0.02 
Board [9d 6d 7d]
Seat 1: Orlangoor (button) collected ($0.47)
Seat 2: Andy Wolf (small blind) folded before Flop
Seat 4: st4tion (big blind) folded on the Flop
Seat 5: steepfell folded before Flop (didn't bet)
Seat 6: IAntikI folded before Flop (didn't bet)



PokerStars Hand #166667874289:  Hold'em No Limit ($0.05/$0.10 USD) - 2017/02/23 16:09:06 ET
Table 'Juliet II' 6-max Seat #6 is the button
Seat 1: alexpolevaja ($11.19 in chips) 
Seat 2: KA3AXCTAHEU, ($15.68 in chips) 
Seat 3: patrick19111 ($11.42 in chips) 
Seat 4: x3ultimate ($10.55 in chips) 
Seat 5: Dcaro31 ($19.91 in chips) 
Seat 6: BookWorm78 ($31.33 in chips) 
alexpolevaja: posts small blind $0.05
KA3AXCTAHEU,: posts big blind $0.10
*** HOLE CARDS ***
patrick19111: folds 
x3ultimate: folds 
Dcaro31: folds 
BookWorm78: raises $0.20 to $0.30
alexpolevaja: folds 
KA3AXCTAHEU,: folds 
Uncalled bet ($0.20) returned to BookWorm78
BookWorm78 collected $0.25 from pot
*** SUMMARY ***
Total pot $0.25 | Rake $0 
Seat 1: alexpolevaja (small blind) folded before Flop
Seat 2: KA3AXCTAHEU, (big blind) folded before Flop
Seat 3: patrick19111 folded before Flop (didn't bet)
Seat 4: x3ultimate folded before Flop (didn't bet)
Seat 5: Dcaro31 folded before Flop (didn't bet)
Seat 6: BookWorm78 (button) collected ($0.25)



PokerStars Hand #166667874475:  Hold'em No Limit ($0.05/$0.10 USD) - 2017/02/23 16:09:06 ET
Table 'Kanda' 6-max Seat #5 is the button
Seat 1: Andy Wolf ($11.57 in chips) 
Seat 2: Pelotín ($5.42 in chips) 
Seat 3: XaXaTyH4uK ($10.42 in chips) 
Seat 4: Orlangoor ($10 in chips) 
Seat 5: Dimka4 ($10 in chips) 
Seat 6: oddshoff ($9.11 in chips) 
oddshoff: posts small blind $0.05
Andy Wolf: posts big blind $0.10
*** HOLE CARDS ***
Pelotín: folds 
XaXaTyH4uK: folds 
Orlangoor: folds 
Dimka4: folds 
oddshoff: raises $0.10 to $0.20
Andy Wolf: raises $0.60 to $0.80
oddshoff: folds 
Uncalled bet ($0.60) returned to Andy Wolf
Andy Wolf collected $0.40 from pot
*** SUMMARY ***
Total pot $0.40 | Rake $0 
Seat 1: Andy Wolf (big blind) collected ($0.40)
Seat 2: Pelotín folded before Flop (didn't bet)
Seat 3: XaXaTyH4uK folded before Flop (didn't bet)
Seat 4: Orlangoor folded before Flop (didn't bet)
Seat 5: Dimka4 (button) folded before Flop (didn't bet)
Seat 6: oddshoff (small blind) folded before Flop



PokerStars Hand #166667874508:  Hold'em No Limit ($0.05/$0.10 USD) - 2017/02/23 16:09:06 ET
Table 'Lorbach' 6-max Seat #6 is the button
Seat 1: LarryTheStar ($17.49 in chips) 
Seat 2: fabadam ($12.63 in chips) 
Seat 3: ArcticBearDK ($10 in chips) 
Seat 4: McCleans ($10.79 in chips) 
Seat 6: Worlz ($15.21 in chips) 
LarryTheStar: posts small blind $0.05
fabadam: posts big blind $0.10
*** HOLE CARDS ***
ArcticBearDK: folds 
McCleans: folds 
Worlz: folds 
x3ultimate joins the table at seat #5 
LarryTheStar: folds 
Uncalled bet ($0.05) returned to fabadam
fabadam collected $0.10 from pot
*** SUMMARY ***
Total pot $0.10 | Rake $0 
Seat 1: LarryTheStar (small blind) folded before Flop
Seat 2: fabadam (big blind) collected ($0.10)
Seat 3: ArcticBearDK folded before Flop (didn't bet)
Seat 4: McCleans folded before Flop (didn't bet)
Seat 6: Worlz (button) folded before Flop (didn't bet)



PokerStars Hand #166667874558:  Hold'em No Limit ($0.05/$0.10 USD) - 2017/02/23 16:09:06 ET
Table 'Peiroos' 6-max Seat #1 is the button
Seat 1: ksandr_hom ($10 in chips) 
Seat 2: Nr847 ($10.85 in chips) 
Seat 3: atlx0711 ($25.69 in chips) 
Seat 4: Peter0087 ($4.20 in chips) 
Seat 5: sergio-cb164 ($8.20 in chips) 
Seat 6: DevonMiles88 ($11.22 in chips) 
Nr847: posts small blind $0.05
atlx0711: posts big blind $0.10
*** HOLE CARDS ***
Peter0087: folds 
sergio-cb164: calls $0.10
DevonMiles88: raises $0.10 to $0.20
ksandr_hom: folds 
Nr847: folds 
atlx0711: calls $0.10
sergio-cb164: calls $0.10
*** FLOP *** [Jh As Kh]
atlx0711: checks 
sergio-cb164: checks 
DevonMiles88: bets $0.30
atlx0711: calls $0.30
sergio-cb164: folds 
*** TURN *** [Jh As Kh] [Th]
atlx0711: checks 
DevonMiles88: checks 
*** RIVER *** [Jh As Kh Th] [4d]
atlx0711: checks 
DevonMiles88: bets $0.10
atlx0711: folds 
Uncalled bet ($0.10) returned to DevonMiles88
DevonMiles88 collected $1.19 from pot
*** SUMMARY ***
Total pot $1.25 | Rake $0.06 
Board [Jh As Kh Th 4d]
Seat 1: ksandr_hom (button) folded before Flop (didn't bet)
Seat 2: Nr847 (small blind) folded before Flop
Seat 3: atlx0711 (big blind) folded on the River
Seat 4: Peter0087 folded before Flop (didn't bet)
Seat 5: sergio-cb164 folded on the Flop
Seat 6: DevonMiles88 collected ($1.19)



PokerStars Hand #166667874605:  Hold'em No Limit ($0.05/$0.10 USD) - 2017/02/23 16:09:06 ET
Table 'Bootes' 6-max Seat #1 is the button
Seat 1: Namhkal ($11.40 in chips) 
Seat 2: Bird et al ($17.36 in chips) 
Seat 3: KA3AXCTAHEU, ($20.76 in chips) 
Seat 4: totonove ($6.88 in chips) 
Seat 5: Pekaml ($15.42 in chips) 
Seat 6: cherep61987 ($10.07 in chips) 
Bird et al: posts small blind $0.05
KA3AXCTAHEU,: posts big blind $0.10
*** HOLE CARDS ***
totonove: raises $0.20 to $0.30
Pekaml: folds 
cherep61987: folds 
Namhkal: folds 
Bird et al: folds 
KA3AXCTAHEU,: folds 
Uncalled bet ($0.20) returned to totonove
totonove collected $0.25 from pot
*** SUMMARY ***
Total pot $0.25 | Rake $0 
Seat 1: Namhkal (button) folded before Flop (didn't bet)
Seat 2: Bird et al (small blind) folded before Flop
Seat 3: KA3AXCTAHEU, (big blind) folded before Flop
Seat 4: totonove collected ($0.25)
Seat 5: Pekaml folded before Flop (didn't bet)
Seat 6: cherep61987 folded before Flop (didn't bet)



PokerStars Hand #166667874698:  Hold'em No Limit ($0.05/$0.10 USD) - 2017/02/23 16:09:06 ET
Table 'Crommelin II' 6-max Seat #3 is the button
Seat 1: THIMUCHIN ($11.42 in chips) 
Seat 2: Bird et al ($10.15 in chips) 
Seat 3: Strelok1974 ($19.78 in chips) 
Seat 4: Pequeño Clau ($12.87 in chips) 
Seat 5: Action_Gibi ($19.30 in chips) 
Pequeño Clau: posts small blind $0.05
Action_Gibi: posts big blind $0.10
*** HOLE CARDS ***
THIMUCHIN: raises $0.20 to $0.30
Bird et al: calls $0.30
Strelok1974: raises $0.80 to $1.10
Pequeño Clau: folds 
Action_Gibi: folds 
THIMUCHIN: raises $1.55 to $2.65
Bird et al: folds 
Strelok1974: raises $17.13 to $19.78 and is all-in
THIMUCHIN: folds 
Uncalled bet ($17.13) returned to Strelok1974
Strelok1974 collected $5.75 from pot
*** SUMMARY ***
Total pot $5.75 | Rake $0 
Seat 1: THIMUCHIN folded before Flop
Seat 2: Bird et al folded before Flop
Seat 3: Strelok1974 (button) collected ($5.75)
Seat 4: Pequeño Clau (small blind) folded before Flop
Seat 5: Action_Gibi (big blind) folded before Flop



PokerStars Hand #166667875226:  Hold'em No Limit ($0.05/$0.10 USD) - 2017/02/23 16:09:07 ET
Table 'Lederle' 6-max Seat #2 is the button
Seat 1: Sterjek ($9.85 in chips) 
Seat 2: truck1234 ($15.54 in chips) 
Seat 3: Kazacha ($11.40 in chips) 
Seat 4: Pokeaster ($13.66 in chips) 
Seat 5: 8th wonders ($13.68 in chips) 
Seat 6: pokekrk ($10 in chips) 
Kazacha: posts small blind $0.05
Pokeaster: posts big blind $0.10
*** HOLE CARDS ***
8th wonders: folds 
pokekrk: folds 
Sterjek: raises $0.20 to $0.30
truck1234: folds 
Kazacha: folds 
Pokeaster: folds 
Uncalled bet ($0.20) returned to Sterjek
Sterjek collected $0.25 from pot
*** SUMMARY ***
Total pot $0.25 | Rake $0 
Seat 1: Sterjek collected ($0.25)
Seat 2: truck1234 (button) folded before Flop (didn't bet)
Seat 3: Kazacha (small blind) folded before Flop
Seat 4: Pokeaster (big blind) folded before Flop
Seat 5: 8th wonders folded before Flop (didn't bet)
Seat 6: pokekrk folded before Flop (didn't bet)



PokerStars Hand #166667875265:  Hold'em No Limit ($0.05/$0.10 USD) - 2017/02/23 16:09:07 ET
Table 'Sham' 6-max Seat #5 is the button
Seat 1: pancernik21 ($10.15 in chips) 
Seat 2: ex3Lero86 ($10.30 in chips) 
Seat 3: weez3r ($14.48 in chips) 
Seat 4: VAD21 ($14.21 in chips) 
Seat 5: T9MS ($10 in chips) 
Seat 6: bdixon_5 ($19.55 in chips) 
bdixon_5: posts small blind $0.05
pancernik21: posts big blind $0.10
*** HOLE CARDS ***
ex3Lero86: raises $0.20 to $0.30
weez3r: raises $0.75 to $1.05
VAD21: folds 
T9MS: folds 
bdixon_5: folds 
pancernik21: folds 
ex3Lero86: folds 
Uncalled bet ($0.75) returned to weez3r
weez3r collected $0.75 from pot
*** SUMMARY ***
Total pot $0.75 | Rake $0 
Seat 1: pancernik21 (big blind) folded before Flop
Seat 2: ex3Lero86 folded before Flop
Seat 3: weez3r collected ($0.75)
Seat 4: VAD21 folded before Flop (didn't bet)
Seat 5: T9MS (button) folded before Flop (didn't bet)
Seat 6: bdixon_5 (small blind) folded before Flop



PokerStars Hand #166667875294:  Hold'em No Limit ($0.05/$0.10 USD) - 2017/02/23 16:09:07 ET
Table 'Duhr II' 6-max Seat #1 is the button
Seat 1: Lucky HoBBiT ($10.60 in chips) 
Seat 2: Feverhead ($37.79 in chips) 
Seat 3: Smitty03300 ($10 in chips) 
Seat 4: CHRO8 ($10 in chips) 
Seat 5: Dimka4 ($10.10 in chips) 
Seat 6: townerz1991 ($11.28 in chips) 
Feverhead: posts small blind $0.05
Smitty03300: posts big blind $0.10
*** HOLE CARDS ***
CHRO8: folds 
Dimka4: folds 
townerz1991: folds 
Lucky HoBBiT: raises $0.15 to $0.25
Feverhead: folds 
Smitty03300: calls $0.15
*** FLOP *** [8c Qc Tc]
Smitty03300: checks 
Lucky HoBBiT: bets $0.32
Smitty03300: folds 
Uncalled bet ($0.32) returned to Lucky HoBBiT
Lucky HoBBiT collected $0.53 from pot
*** SUMMARY ***
Total pot $0.55 | Rake $0.02 
Board [8c Qc Tc]
Seat 1: Lucky HoBBiT (button) collected ($0.53)
Seat 2: Feverhead (small blind) folded before Flop
Seat 3: Smitty03300 (big blind) folded on the Flop
Seat 4: CHRO8 folded before Flop (didn't bet)
Seat 5: Dimka4 folded before Flop (didn't bet)
Seat 6: townerz1991 folded before Flop (didn't bet)



PokerStars Hand #166667875425:  Hold'em No Limit ($0.05/$0.10 USD) - 2017/02/23 16:09:07 ET
Table 'Esperanto II' 6-max Seat #5 is the button
Seat 1: kurasd ($10.40 in chips) 
Seat 2: MihaGr ($10.30 in chips) 
Seat 3: Namhkal ($11.95 in chips) 
Seat 4: Andrei ProFF ($10 in chips) 
Seat 5: FRAID358 ($10.60 in chips) 
Seat 6: ArcticBearDK ($13.55 in chips) 
ArcticBearDK: posts small blind $0.05
kurasd: posts big blind $0.10
*** HOLE CARDS ***
MihaGr: folds 
Namhkal: raises $0.15 to $0.25
Andrei ProFF: folds 
FRAID358: raises $0.65 to $0.90
ArcticBearDK: folds 
kurasd: calls $0.80
Namhkal: calls $0.65
*** FLOP *** [4s 3d 6c]
kurasd: checks 
Namhkal: checks 
FRAID358: checks 
*** TURN *** [4s 3d 6c] [5s]
kurasd: checks 
Namhkal: checks 
FRAID358: checks 
*** RIVER *** [4s 3d 6c 5s] [3c]
kurasd: checks 
Namhkal: checks 
FRAID358: checks 
*** SHOW DOWN ***
kurasd: shows [Kd Tc] (a pair of Threes)
Namhkal: mucks hand 
FRAID358: shows [Qd As] (a pair of Threes - Ace kicker)
FRAID358 collected $2.63 from pot
*** SUMMARY ***
Total pot $2.75 | Rake $0.12 
Board [4s 3d 6c 5s 3c]
Seat 1: kurasd (big blind) showed [Kd Tc] and lost with a pair of Threes
Seat 2: MihaGr folded before Flop (didn't bet)
Seat 3: Namhkal mucked
Seat 4: Andrei ProFF folded before Flop (didn't bet)
Seat 5: FRAID358 (button) showed [Qd As] and won ($2.63) with a pair of Threes
Seat 6: ArcticBearDK (small blind) folded before Flop



PokerStars Hand #166667875435:  Hold'em No Limit ($0.05/$0.10 USD) - 2017/02/23 16:09:07 ET
Table 'Epimetheus' 6-max Seat #5 is the button
Seat 1: 6ePeMeHHa9 ($10.29 in chips) 
Seat 2: patrick19111 ($15.51 in chips) 
Seat 3: dineldidi ($9.84 in chips) 
Seat 4: Namhkal ($10 in chips) 
Seat 5: afca128 ($24.18 in chips) 
Seat 6: voledy ($10.50 in chips) 
voledy: posts small blind $0.05
6ePeMeHHa9: posts big blind $0.10
*** HOLE CARDS ***
patrick19111: folds 
dineldidi: folds 
Namhkal: folds 
afca128: folds 
voledy: folds 
Uncalled bet ($0.05) returned to 6ePeMeHHa9
6ePeMeHHa9 collected $0.10 from pot
*** SUMMARY ***
Total pot $0.10 | Rake $0 
Seat 1: 6ePeMeHHa9 (big blind) collected ($0.10)
Seat 2: patrick19111 folded before Flop (didn't bet)
Seat 3: dineldidi folded before Flop (didn't bet)
Seat 4: Namhkal folded before Flop (didn't bet)
Seat 5: afca128 (button) folded before Flop (didn't bet)
Seat 6: voledy (small blind) folded before Flop



PokerStars Hand #166667875438:  Hold'em No Limit ($0.05/$0.10 USD) - 2017/02/23 16:09:07 ET
Table 'Hestia' 6-max Seat #5 is the button
Seat 1: Pekaml ($10.23 in chips) 
Seat 2: Kow6oy ($10.32 in chips) 
Seat 3: MBen10 ($13.43 in chips) 
Seat 4: Lucky HoBBiT ($10 in chips) 
Seat 5: CiisCi ($17.36 in chips) 
Seat 6: Smitty03300 ($10 in chips) 
Smitty03300: posts small blind $0.05
Pekaml: posts big blind $0.10
*** HOLE CARDS ***
Kow6oy: folds 
MBen10: folds 
Lucky HoBBiT: folds 
CiisCi: raises $0.15 to $0.25
Smitty03300: raises $0.65 to $0.90
Pekaml: folds 
CiisCi: folds 
Uncalled bet ($0.65) returned to Smitty03300
Smitty03300 collected $0.60 from pot
*** SUMMARY ***
Total pot $0.60 | Rake $0 
Seat 1: Pekaml (big blind) folded before Flop
Seat 2: Kow6oy folded before Flop (didn't bet)
Seat 3: MBen10 folded before Flop (didn't bet)
Seat 4: Lucky HoBBiT folded before Flop (didn't bet)
Seat 5: CiisCi (button) folded before Flop
Seat 6: Smitty03300 (small blind) collected ($0.60)



PokerStars Hand #166667875726:  Hold'em No Limit ($0.05/$0.10 USD) - 2017/02/23 16:09:07 ET
Table 'Arduina' 6-max Seat #4 is the button
Seat 1: tauronex ($11.06 in chips) 
Seat 2: Andy Wolf ($14.45 in chips) 
Seat 3: Dcaro31 ($12.76 in chips) 
Seat 4: ChuikaPridi ($28.78 in chips) 
Seat 5: ettedallas ($7.21 in chips) 
Seat 6: dierri ($9.06 in chips) 
ettedallas: posts small blind $0.05
dierri: posts big blind $0.10
*** HOLE CARDS ***
tauronex: folds 
Andy Wolf: folds 
Dcaro31: raises $0.20 to $0.30
ChuikaPridi: calls $0.30
ettedallas: folds 
dierri: folds 
*** FLOP *** [7c 4c Ts]
Dcaro31: checks 
ChuikaPridi: bets $0.60
Dcaro31: folds 
Uncalled bet ($0.60) returned to ChuikaPridi
ChuikaPridi collected $0.72 from pot
*** SUMMARY ***
Total pot $0.75 | Rake $0.03 
Board [7c 4c Ts]
Seat 1: tauronex folded before Flop (didn't bet)
Seat 2: Andy Wolf folded before Flop (didn't bet)
Seat 3: Dcaro31 folded on the Flop
Seat 4: ChuikaPridi (button) collected ($0.72)
Seat 5: ettedallas (small blind) folded before Flop
Seat 6: dierri (big blind) folded before Flop



PokerStars Hand #166667875796:  Hold'em No Limit ($0.05/$0.10 USD) - 2017/02/23 16:09:07 ET
Table 'Peiroos III' 6-max Seat #3 is the button
Seat 1: tequila_joop ($9.61 in chips) 
Seat 3: nabatov.m ($6.24 in chips) 
Seat 4: pivanki11 ($10.56 in chips) 
Seat 5: ChuikaPridi ($10.89 in chips) 
Seat 6: CHRO8 ($10.41 in chips) 
pivanki11: posts small blind $0.05
ChuikaPridi: posts big blind $0.10
Goovr: sits out 
tequila_joop: posts the ante $0.02
nabatov.m: posts the ante $0.02
pivanki11: posts the ante $0.02
ChuikaPridi: posts the ante $0.02
CHRO8: posts the ante $0.02
*** HOLE CARDS ***
CHRO8: raises $0.20 to $0.30
tequila_joop: folds 
nabatov.m: folds 
pivanki11: folds 
ChuikaPridi: folds 
Uncalled bet ($0.20) returned to CHRO8
CHRO8 collected $0.35 from pot
*** SUMMARY ***
Total pot $0.35 | Rake $0 
Seat 1: tequila_joop folded before Flop (didn't bet)
Seat 3: nabatov.m (button) folded before Flop (didn't bet)
Seat 4: pivanki11 (small blind) folded before Flop
Seat 5: ChuikaPridi (big blind) folded before Flop
Seat 6: CHRO8 collected ($0.35)



PokerStars Hand #166667876935:  Hold'em No Limit ($0.05/$0.10 USD) - 2017/02/23 16:09:09 ET
Table 'Kobresia II' 6-max Seat #5 is the button
Seat 1: RoJ1 ($15.54 in chips) 
Seat 2: Dcaro31 ($13.14 in chips) 
Seat 3: FRAID358 ($10 in chips) 
Seat 5: Goroshkos88 ($12.32 in chips) 
RoJ1: posts small blind $0.05
Dcaro31: posts big blind $0.10
*** HOLE CARDS ***
FRAID358: folds 
Goroshkos88: raises $0.15 to $0.25
RoJ1: folds 
Dcaro31: calls $0.15
*** FLOP *** [Qs 5h 7d]
Dcaro31: bets $0.35
Vanne11 joins the table at seat #4 
Goroshkos88: folds 
Uncalled bet ($0.35) returned to Dcaro31
Dcaro31 collected $0.53 from pot
*** SUMMARY ***
Total pot $0.55 | Rake $0.02 
Board [Qs 5h 7d]
Seat 1: RoJ1 (small blind) folded before Flop
Seat 2: Dcaro31 (big blind) collected ($0.53)
Seat 3: FRAID358 folded before Flop (didn't bet)
Seat 5: Goroshkos88 (button) folded on the Flop



PokerStars Hand #166667877062:  Hold'em No Limit ($0.05/$0.10 USD) - 2017/02/23 16:09:09 ET
Table 'Sirius II' 6-max Seat #3 is the button
Seat 2: Buddy8711 ($8.41 in chips) 
Seat 3: Spud014 ($10.10 in chips) 
Seat 6: MihaGr ($10 in chips) 
Pekaml will be allowed to play after the button
MihaGr: posts small blind $0.05
Ampped87: is sitting out 
Buddy8711: posts big blind $0.10
*** HOLE CARDS ***
Ampped87 leaves the table
Spud014: folds 
manashov joins the table at seat #5 
MihaGr: folds 
Uncalled bet ($0.05) returned to Buddy8711
Buddy8711 collected $0.10 from pot
*** SUMMARY ***
Total pot $0.10 | Rake $0 
Seat 2: Buddy8711 (big blind) collected ($0.10)
Seat 3: Spud014 (button) folded before Flop (didn't bet)
Seat 6: MihaGr (small blind) folded before Flop



PokerStars Hand #166667877231:  Hold'em No Limit ($0.05/$0.10 USD) - 2017/02/23 16:09:09 ET
Table 'Pirola' 6-max Seat #4 is the button
Seat 1: Rodik002 ($10 in chips) 
Seat 2: lmlmlmlm90 ($17.34 in chips) 
Seat 4: barons89 ($11.91 in chips) 
Seat 5: Iarlei ($14.36 in chips) 
Seat 6: Hyd SK ($13.34 in chips) 
Iarlei: posts small blind $0.05
Hyd SK: posts big blind $0.10
Goroshkos88: sits out 
*** HOLE CARDS ***
Rodik002: raises $0.20 to $0.30
lmlmlmlm90: folds 
barons89: calls $0.30
Iarlei: calls $0.25
Hyd SK: folds 
*** FLOP *** [Ad Qh 9s]
Iarlei: checks 
Rodik002: bets $0.45
barons89: folds 
Iarlei: folds 
Uncalled bet ($0.45) returned to Rodik002
Rodik002 collected $0.96 from pot
*** SUMMARY ***
Total pot $1 | Rake $0.04 
Board [Ad Qh 9s]
Seat 1: Rodik002 collected ($0.96)
Seat 2: lmlmlmlm90 folded before Flop (didn't bet)
Seat 4: barons89 (button) folded on the Flop
Seat 5: Iarlei (small blind) folded on the Flop
Seat 6: Hyd SK (big blind) folded before Flop



PokerStars Hand #166667877512:  Hold'em No Limit ($0.05/$0.10 USD) - 2017/02/23 16:09:09 ET
Table 'Brambilla II' 6-max Seat #4 is the button
Seat 1: Rodik002 ($12.27 in chips) 
Seat 2: dwonder75 ($15.46 in chips) 
Seat 3: BORIS_ENEV ($14.06 in chips) 
Seat 4: david_sara83 ($11.67 in chips) 
Seat 5: FRAID358 ($10.05 in chips) 
Seat 6: boxer821 ($10 in chips) 
FRAID358: posts small blind $0.05
boxer821: posts big blind $0.10
*** HOLE CARDS ***
Rodik002: folds 
dwonder75: folds 
BORIS_ENEV: folds 
david_sara83: raises $0.15 to $0.25
FRAID358: folds 
boxer821: calls $0.15
*** FLOP *** [4d Js 5d]
boxer821: checks 
david_sara83: bets $0.29
boxer821: folds 
Uncalled bet ($0.29) returned to david_sara83
david_sara83 collected $0.53 from pot
*** SUMMARY ***
Total pot $0.55 | Rake $0.02 
Board [4d Js 5d]
Seat 1: Rodik002 folded before Flop (didn't bet)
Seat 2: dwonder75 folded before Flop (didn't bet)
Seat 3: BORIS_ENEV folded before Flop (didn't bet)
Seat 4: david_sara83 (button) collected ($0.53)
Seat 5: FRAID358 (small blind) folded before Flop
Seat 6: boxer821 (big blind) folded on the Flop



PokerStars Hand #166667878203:  Hold'em No Limit ($0.05/$0.10 USD) - 2017/02/23 16:09:10 ET
Table 'Garlena III' 6-max Seat #4 is the button
Seat 1: dittoro ($11.54 in chips) 
Seat 2: YY778 ($9.50 in chips) 
Seat 3: IAntikI ($10 in chips) 
Seat 4: mbkongstad ($10 in chips) 
Seat 5: steepfell ($10 in chips) 
Seat 6: iluzja12 ($9.85 in chips) 
steepfell: posts small blind $0.05
iluzja12: posts big blind $0.10
*** HOLE CARDS ***
dittoro: folds 
YY778: raises $0.20 to $0.30
IAntikI: folds 
mbkongstad: calls $0.30
steepfell: folds 
iluzja12: folds 
*** FLOP *** [6c Qd 5s]
YY778: bets $0.70
mbkongstad: folds 
Uncalled bet ($0.70) returned to YY778
YY778 collected $0.72 from pot
*** SUMMARY ***
Total pot $0.75 | Rake $0.03 
Board [6c Qd 5s]
Seat 1: dittoro folded before Flop (didn't bet)
Seat 2: YY778 collected ($0.72)
Seat 3: IAntikI folded before Flop (didn't bet)
Seat 4: mbkongstad (button) folded on the Flop
Seat 5: steepfell (small blind) folded before Flop
Seat 6: iluzja12 (big blind) folded before Flop



PokerStars Hand #166667878277:  Hold'em No Limit ($0.05/$0.10 USD) - 2017/02/23 16:09:10 ET
Table 'Isberga' 6-max Seat #6 is the button
Seat 1: Feverhead ($18.12 in chips) 
Seat 2: GESPERIA ($10.37 in chips) 
Seat 4: THIMUCHIN ($10.79 in chips) 
Seat 6: Goroshkos88 ($21.56 in chips) 
Feverhead: posts small blind $0.05
GESPERIA: posts big blind $0.10
HARDCORE66RU: sits out 
*** HOLE CARDS ***
THIMUCHIN: folds 
Goroshkos88: folds 
Feverhead: raises $0.15 to $0.25
GESPERIA: folds 
Uncalled bet ($0.15) returned to Feverhead
Feverhead collected $0.20 from pot
*** SUMMARY ***
Total pot $0.20 | Rake $0 
Seat 1: Feverhead (small blind) collected ($0.20)
Seat 2: GESPERIA (big blind) folded before Flop
Seat 4: THIMUCHIN folded before Flop (didn't bet)
Seat 6: Goroshkos88 (button) folded before Flop (didn't bet)



PokerStars Hand #166667878321:  Hold'em No Limit ($0.05/$0.10 USD) - 2017/02/23 16:09:10 ET
Table 'Ostara III' 6-max Seat #3 is the button
Seat 1: MühliJr ($10 in chips) 
Seat 2: Action_Gibi ($13.62 in chips) 
Seat 3: vtalian ($12.83 in chips) 
Seat 4: Goovr ($28.81 in chips) 
Seat 5: THIMUCHIN ($10 in chips) 
Seat 6: FlopsterGB ($10 in chips) 
Goovr: posts small blind $0.05
THIMUCHIN: posts big blind $0.10
*** HOLE CARDS ***
FlopsterGB: folds 
MühliJr: folds 
Action_Gibi: calls $0.10
vtalian: raises $0.35 to $0.45
Goovr: folds 
THIMUCHIN: folds 
Action_Gibi: folds 
Uncalled bet ($0.35) returned to vtalian
vtalian collected $0.35 from pot
*** SUMMARY ***
Total pot $0.35 | Rake $0 
Seat 1: MühliJr folded before Flop (didn't bet)
Seat 2: Action_Gibi folded before Flop
Seat 3: vtalian (button) collected ($0.35)
Seat 4: Goovr (small blind) folded before Flop
Seat 5: THIMUCHIN (big blind) folded before Flop
Seat 6: FlopsterGB folded before Flop (didn't bet)



PokerStars Hand #166667878439:  Hold'em No Limit ($0.05/$0.10 USD) - 2017/02/23 16:09:10 ET
Table 'Krethon' 6-max Seat #4 is the button
Seat 1: boxer821 ($10.77 in chips) 
Seat 2: manashov ($12.93 in chips) 
Seat 4: chimera252 ($14.79 in chips) 
Seat 5: popypaleta ($10 in chips) 
Seat 6: fabadam ($18.98 in chips) 
popypaleta: posts small blind $0.05
fabadam: posts big blind $0.10
*** HOLE CARDS ***
boxer821: folds 
manashov: raises $0.20 to $0.30
chimera252: folds 
popypaleta: folds 
fabadam: folds 
Uncalled bet ($0.20) returned to manashov
manashov collected $0.25 from pot
*** SUMMARY ***
Total pot $0.25 | Rake $0 
Seat 1: boxer821 folded before Flop (didn't bet)
Seat 2: manashov collected ($0.25)
Seat 4: chimera252 (button) folded before Flop (didn't bet)
Seat 5: popypaleta (small blind) folded before Flop
Seat 6: fabadam (big blind) folded before Flop



PokerStars Hand #166667878542:  Hold'em No Limit ($0.05/$0.10 USD) - 2017/02/23 16:09:10 ET
Table 'Selinur' 6-max Seat #5 is the button
Seat 1: KA3AXCTAHEU, ($10.15 in chips) 
Seat 2: hoedje72 ($7.22 in chips) 
Seat 5: DrVzad ($9.85 in chips) 
Seat 6: homelessdan ($18.40 in chips) 
homelessdan: posts small blind $0.05
KA3AXCTAHEU,: posts big blind $0.10
bambolejro: sits out 
*** HOLE CARDS ***
hoedje72: folds 
DrVzad: folds 
homelessdan: raises $0.10 to $0.20
KA3AXCTAHEU,: folds 
Uncalled bet ($0.10) returned to homelessdan
homelessdan collected $0.20 from pot
*** SUMMARY ***
Total pot $0.20 | Rake $0 
Seat 1: KA3AXCTAHEU, (big blind) folded before Flop
Seat 2: hoedje72 folded before Flop (didn't bet)
Seat 5: DrVzad (button) folded before Flop (didn't bet)
Seat 6: homelessdan (small blind) collected ($0.20)



PokerStars Hand #166667878638:  Hold'em No Limit ($0.05/$0.10 USD) - 2017/02/23 16:09:11 ET
Table 'Joella' 6-max Seat #2 is the button
Seat 1: Dcaro31 ($12.78 in chips) 
Seat 2: Kaelyns_Bark ($8.89 in chips) 
Seat 3: Joker51_wtf! ($11.56 in chips) 
Seat 4: KRZuff ($10 in chips) 
Seat 5: Anestakis777 ($1.94 in chips) 
Seat 6: dr.goofy ($12.77 in chips) 
Joker51_wtf!: posts small blind $0.05
KRZuff: posts big blind $0.10
*** HOLE CARDS ***
Anestakis777: calls $0.10
dr.goofy: folds 
Dcaro31: folds 
Kaelyns_Bark: calls $0.10
Joker51_wtf!: folds 
KRZuff: checks 
*** FLOP *** [5s 9d 7s]
KRZuff: checks 
Anestakis777: bets $0.30
Kaelyns_Bark: calls $0.30
KRZuff: calls $0.30
*** TURN *** [5s 9d 7s] [4d]
KRZuff: checks 
Anestakis777: bets $0.30
Kaelyns_Bark: calls $0.30
KRZuff: folds 
*** RIVER *** [5s 9d 7s 4d] [5c]
Anestakis777: checks 
Kaelyns_Bark: checks 
*** SHOW DOWN ***
Anestakis777: shows [4h 3c] (two pair, Fives and Fours)
Kaelyns_Bark: shows [4c Ts] (two pair, Fives and Fours - Ten kicker)
Kaelyns_Bark collected $1.77 from pot
*** SUMMARY ***
Total pot $1.85 | Rake $0.08 
Board [5s 9d 7s 4d 5c]
Seat 1: Dcaro31 folded before Flop (didn't bet)
Seat 2: Kaelyns_Bark (button) showed [4c Ts] and won ($1.77) with two pair, Fives and Fours
Seat 3: Joker51_wtf! (small blind) folded before Flop
Seat 4: KRZuff (big blind) folded on the Turn
Seat 5: Anestakis777 showed [4h 3c] and lost with two pair, Fives and Fours
Seat 6: dr.goofy folded before Flop (didn't bet)



PokerStars Hand #166667878735:  Hold'em No Limit ($0.05/$0.10 USD) - 2017/02/23 16:09:11 ET
Table 'Lampetia III' 6-max Seat #1 is the button
Seat 1: gaHy_HaXeP ($10.55 in chips) 
Seat 2: DamDatsAnAce ($10.64 in chips) 
Seat 3: Kow6oy ($10 in chips) 
Seat 4: IAntikI ($10.30 in chips) 
Seat 5: robson1235 ($20.42 in chips) 
Seat 6: bdixon_5 ($9.20 in chips) 
DamDatsAnAce: posts small blind $0.05
Kow6oy: posts big blind $0.10
*** HOLE CARDS ***
IAntikI: folds 
robson1235: raises $0.20 to $0.30
bdixon_5: folds 
gaHy_HaXeP: folds 
DamDatsAnAce: calls $0.25
Kow6oy: folds 
*** FLOP *** [Js Jc Jd]
DamDatsAnAce: checks 
robson1235: checks 
*** TURN *** [Js Jc Jd] [3h]
DamDatsAnAce: checks 
robson1235: checks 
*** RIVER *** [Js Jc Jd 3h] [9h]
DamDatsAnAce: checks 
robson1235: checks 
*** SHOW DOWN ***
DamDatsAnAce: shows [Qh Kc] (three of a kind, Jacks)
robson1235: shows [Kd Qc] (three of a kind, Jacks)
DamDatsAnAce collected $0.34 from pot
robson1235 collected $0.33 from pot
*** SUMMARY ***
Total pot $0.70 | Rake $0.03 
Board [Js Jc Jd 3h 9h]
Seat 1: gaHy_HaXeP (button) folded before Flop (didn't bet)
Seat 2: DamDatsAnAce (small blind) showed [Qh Kc] and won ($0.34) with three of a kind, Jacks
Seat 3: Kow6oy (big blind) folded before Flop
Seat 4: IAntikI folded before Flop (didn't bet)
Seat 5: robson1235 showed [Kd Qc] and won ($0.33) with three of a kind, Jacks
Seat 6: bdixon_5 folded before Flop (didn't bet)



PokerStars Hand #166667879416:  Hold'em No Limit ($0.05/$0.10 USD) - 2017/02/23 16:09:11 ET
Table 'Postrema' 6-max Seat #4 is the button
Seat 1: CHRO8 ($10.51 in chips) 
Seat 2: pancernik21 ($13.44 in chips) 
Seat 3: edcc19 ($5.10 in chips) 
Seat 4: ChuikaPridi ($13.48 in chips) 
Seat 5: Comeback3392 ($11.92 in chips) 
Seat 6: Scanner17 ($10 in chips) 
Comeback3392: posts small blind $0.05
Scanner17: posts big blind $0.10
*** HOLE CARDS ***
CHRO8: folds 
pancernik21: raises $0.20 to $0.30
edcc19: folds 
ChuikaPridi: folds 
Comeback3392: folds 
Scanner17: folds 
Uncalled bet ($0.20) returned to pancernik21
pancernik21 collected $0.25 from pot
*** SUMMARY ***
Total pot $0.25 | Rake $0 
Seat 1: CHRO8 folded before Flop (didn't bet)
Seat 2: pancernik21 collected ($0.25)
Seat 3: edcc19 folded before Flop (didn't bet)
Seat 4: ChuikaPridi (button) folded before Flop (didn't bet)
Seat 5: Comeback3392 (small blind) folded before Flop
Seat 6: Scanner17 (big blind) folded before Flop



PokerStars Hand #166667879958:  Hold'em No Limit ($0.05/$0.10 USD) - 2017/02/23 16:09:12 ET
Table 'Ruvuma' 6-max Seat #4 is the button
Seat 1: FRAID358 ($23.82 in chips) 
Seat 3: Spud014 ($10.23 in chips) 
Seat 4: DamDatsAnAce ($10 in chips) 
Seat 5: sexy_seagull ($10 in chips) 
sexy_seagull: posts small blind $0.05
FRAID358: posts big blind $0.10
Yspenyanin: sits out 
*** HOLE CARDS ***
Spud014: folds 
DamDatsAnAce: raises $0.15 to $0.25
sexy_seagull: folds 
FRAID358: calls $0.15
*** FLOP *** [6c 7c 3c]
FRAID358: checks 
DamDatsAnAce: bets $0.27
FRAID358: calls $0.27
*** TURN *** [6c 7c 3c] [4s]
FRAID358: checks 
DamDatsAnAce: checks 
*** RIVER *** [6c 7c 3c 4s] [2d]
FRAID358: checks 
DamDatsAnAce: checks 
*** SHOW DOWN ***
FRAID358: shows [9c Ah] (high card Ace)
DamDatsAnAce: mucks hand 
FRAID358 collected $1.04 from pot
*** SUMMARY ***
Total pot $1.09 | Rake $0.05 
Board [6c 7c 3c 4s 2d]
Seat 1: FRAID358 (big blind) showed [9c Ah] and won ($1.04) with high card Ace
Seat 3: Spud014 folded before Flop (didn't bet)
Seat 4: DamDatsAnAce (button) mucked
Seat 5: sexy_seagull (small blind) folded before Flop



PokerStars Hand #166667880009:  Hold'em No Limit ($0.05/$0.10 USD) - 2017/02/23 16:09:12 ET
Table 'Mesarthim' 6-max Seat #3 is the button
Seat 1: Mancuso2010 ($16.27 in chips) 
Seat 2: MühliJr ($12.99 in chips) 
Seat 3: Damage514 ($9.44 in chips) 
Seat 4: Strelok1974 ($10.01 in chips) 
Seat 5: Iarlei ($10.15 in chips) 
Seat 6: bdixon_5 ($8.51 in chips) 
Strelok1974: posts small blind $0.05
Iarlei: posts big blind $0.10
*** HOLE CARDS ***
bdixon_5: folds 
Mancuso2010: folds 
MühliJr: folds 
Damage514: folds 
Strelok1974: folds 
Uncalled bet ($0.05) returned to Iarlei
Iarlei collected $0.10 from pot
*** SUMMARY ***
Total pot $0.10 | Rake $0 
Seat 1: Mancuso2010 folded before Flop (didn't bet)
Seat 2: MühliJr folded before Flop (didn't bet)
Seat 3: Damage514 (button) folded before Flop (didn't bet)
Seat 4: Strelok1974 (small blind) folded before Flop
Seat 5: Iarlei (big blind) collected ($0.10)
Seat 6: bdixon_5 folded before Flop (didn't bet)



PokerStars Hand #166667880160:  Hold'em No Limit ($0.05/$0.10 USD) - 2017/02/23 16:09:12 ET
Table 'Pandora III' 6-max Seat #6 is the button
Seat 1: Pokeaster ($11.14 in chips) 
Seat 2: garigura ($11.54 in chips) 
Seat 3: Chodemuncher ($10 in chips) 
Seat 4: mhonielsen ($10.15 in chips) 
Seat 5: MühliJr ($10.57 in chips) 
Seat 6: yodzik ($5 in chips) 
Pokeaster: posts small blind $0.05
garigura: posts big blind $0.10
*** HOLE CARDS ***
Chodemuncher: folds 
mhonielsen: folds 
MühliJr: folds 
yodzik: folds 
Pokeaster: raises $0.20 to $0.30
garigura: folds 
Uncalled bet ($0.20) returned to Pokeaster
Pokeaster collected $0.20 from pot
*** SUMMARY ***
Total pot $0.20 | Rake $0 
Seat 1: Pokeaster (small blind) collected ($0.20)
Seat 2: garigura (big blind) folded before Flop
Seat 3: Chodemuncher folded before Flop (didn't bet)
Seat 4: mhonielsen folded before Flop (didn't bet)
Seat 5: MühliJr folded before Flop (didn't bet)
Seat 6: yodzik (button) folded before Flop (didn't bet)



PokerStars Hand #166667880189:  Hold'em No Limit ($0.05/$0.10 USD) - 2017/02/23 16:09:12 ET
Table 'Camilla II' 6-max Seat #2 is the button
Seat 1: paxit71 ($8.32 in chips) 
Seat 2: Giyorod ($13.31 in chips) 
Seat 3: Andy Wolf ($12.74 in chips) 
Seat 4: chimera252 ($12.41 in chips) 
Seat 5: LarryTheStar ($10.82 in chips) 
Seat 6: david_sara83 ($10 in chips) 
Andy Wolf: posts small blind $0.05
chimera252: posts big blind $0.10
*** HOLE CARDS ***
LarryTheStar: folds 
david_sara83: folds 
paxit71: folds 
Giyorod: folds 
Andy Wolf: folds 
Uncalled bet ($0.05) returned to chimera252
chimera252 collected $0.10 from pot
*** SUMMARY ***
Total pot $0.10 | Rake $0 
Seat 1: paxit71 folded before Flop (didn't bet)
Seat 2: Giyorod (button) folded before Flop (didn't bet)
Seat 3: Andy Wolf (small blind) folded before Flop
Seat 4: chimera252 (big blind) collected ($0.10)
Seat 5: LarryTheStar folded before Flop (didn't bet)
Seat 6: david_sara83 folded before Flop (didn't bet)



PokerStars Hand #166667880457:  Hold'em No Limit ($0.05/$0.10 USD) - 2017/02/23 16:09:13 ET
Table 'Carina' 6-max Seat #3 is the button
Seat 1: Kupi007 ($10 in chips) 
Seat 3: LarryTheStar ($12.44 in chips) 
Seat 4: steepfell ($10.61 in chips) 
Seat 5: IAntikI ($10 in chips) 
Seat 6: alexweezer ($7.73 in chips) 
steepfell: posts small blind $0.05
IAntikI: posts big blind $0.10
XwinX25: sits out 
*** HOLE CARDS ***
alexweezer: folds 
Kupi007: folds 
LarryTheStar: raises $0.10 to $0.20
steepfell: folds 
IAntikI: folds 
Uncalled bet ($0.10) returned to LarryTheStar
LarryTheStar collected $0.25 from pot
*** SUMMARY ***
Total pot $0.25 | Rake $0 
Seat 1: Kupi007 folded before Flop (didn't bet)
Seat 3: LarryTheStar (button) collected ($0.25)
Seat 4: steepfell (small blind) folded before Flop
Seat 5: IAntikI (big blind) folded before Flop
Seat 6: alexweezer folded before Flop (didn't bet)



PokerStars Hand #166667880458:  Hold'em No Limit ($0.05/$0.10 USD) - 2017/02/23 16:09:13 ET
Table 'Cassini' 6-max Seat #1 is the button
Seat 1: Pokeaster ($11.18 in chips) 
Seat 2: mhonielsen ($12.31 in chips) 
Seat 3: J1234T ($10 in chips) 
Seat 4: fortieth ($13.97 in chips) 
Seat 5: DrVzad ($10 in chips) 
Seat 6: MihaGr ($10 in chips) 
mhonielsen: posts small blind $0.05
J1234T: posts big blind $0.10
*** HOLE CARDS ***
fortieth: folds 
DrVzad: folds 
MihaGr: folds 
Pokeaster: raises $0.15 to $0.25
mhonielsen: folds 
J1234T: calls $0.15
*** FLOP *** [7d 5d 4h]
J1234T: checks 
Pokeaster: bets $0.40
J1234T: raises $0.85 to $1.25
Pokeaster: folds 
Uncalled bet ($0.85) returned to J1234T
J1234T collected $1.29 from pot
*** SUMMARY ***
Total pot $1.35 | Rake $0.06 
Board [7d 5d 4h]
Seat 1: Pokeaster (button) folded on the Flop
Seat 2: mhonielsen (small blind) folded before Flop
Seat 3: J1234T (big blind) collected ($1.29)
Seat 4: fortieth folded before Flop (didn't bet)
Seat 5: DrVzad folded before Flop (didn't bet)
Seat 6: MihaGr folded before Flop (didn't bet)



PokerStars Hand #166667880538:  Hold'em No Limit ($0.05/$0.10 USD) - 2017/02/23 16:09:13 ET
Table 'Heka II' 6-max Seat #2 is the button
Seat 1: Mamm0nism ($15.36 in chips) 
Seat 2: oddshoff ($11.07 in chips) 
Seat 3: MühliJr ($10 in chips) 
Seat 4: theNot0r1ous ($10.93 in chips) 
Seat 5: ArcticBearDK ($12.68 in chips) 
Seat 6: MonteCris92 ($10.36 in chips) 
MühliJr: posts small blind $0.05
theNot0r1ous: posts big blind $0.10
*** HOLE CARDS ***
ArcticBearDK: folds 
MonteCris92: raises $0.20 to $0.30
Mamm0nism has timed out
Mamm0nism: folds 
oddshoff: calls $0.30
MühliJr: folds 
theNot0r1ous: calls $0.20
*** FLOP *** [7c 9s 8c]
theNot0r1ous: checks 
MonteCris92: bets $0.50
oddshoff: folds 
theNot0r1ous: calls $0.50
*** TURN *** [7c 9s 8c] [4h]
theNot0r1ous: checks 
MonteCris92: bets $1.20
MühliJr leaves the table
voledy joins the table at seat #3 
theNot0r1ous: folds 
Uncalled bet ($1.20) returned to MonteCris92
MonteCris92 collected $1.86 from pot
*** SUMMARY ***
Total pot $1.95 | Rake $0.09 
Board [7c 9s 8c 4h]
Seat 1: Mamm0nism folded before Flop (didn't bet)
Seat 2: oddshoff (button) folded on the Flop
Seat 3: MühliJr (small blind) folded before Flop
Seat 4: theNot0r1ous (big blind) folded on the Turn
Seat 5: ArcticBearDK folded before Flop (didn't bet)
Seat 6: MonteCris92 collected ($1.86)



PokerStars Hand #166667880718:  Hold'em No Limit ($0.05/$0.10 USD) - 2017/02/23 16:09:13 ET
Table 'Hunnia' 6-max Seat #6 is the button
Seat 1: univibe68 ($21.23 in chips) 
Seat 2: mhonielsen ($10.94 in chips) 
Seat 3: 6ePeMeHHa9 ($10.56 in chips) 
Seat 4: Jalida3 ($11.88 in chips) 
Seat 5: Smarkon ($14.74 in chips) 
Seat 6: ChuikaPridi ($11.29 in chips) 
univibe68: posts small blind $0.05
mhonielsen: posts big blind $0.10
*** HOLE CARDS ***
6ePeMeHHa9: folds 
Jalida3: folds 
Smarkon: folds 
ChuikaPridi: folds 
univibe68: folds 
Uncalled bet ($0.05) returned to mhonielsen
mhonielsen collected $0.10 from pot
*** SUMMARY ***
Total pot $0.10 | Rake $0 
Seat 1: univibe68 (small blind) folded before Flop
Seat 2: mhonielsen (big blind) collected ($0.10)
Seat 3: 6ePeMeHHa9 folded before Flop (didn't bet)
Seat 4: Jalida3 folded before Flop (didn't bet)
Seat 5: Smarkon folded before Flop (didn't bet)
Seat 6: ChuikaPridi (button) folded before Flop (didn't bet)



PokerStars Hand #166667880872:  Hold'em No Limit ($0.05/$0.10 USD) - 2017/02/23 16:09:13 ET
Table 'Halawe II' 6-max Seat #3 is the button
Seat 1: DIGOR100 ($6.16 in chips) 
Seat 3: cherep61987 ($10.64 in chips) 
Seat 4: voledy ($12.05 in chips) 
Seat 5: takis nik ($11.98 in chips) 
Seat 6: Rodik002 ($22.01 in chips) 
voledy: posts small blind $0.05
takis nik: posts big blind $0.10
*** HOLE CARDS ***
Rodik002: folds 
DIGOR100: folds 
cherep61987: raises $0.15 to $0.25
voledy: folds 
takis nik: raises $0.65 to $0.90
cherep61987: folds 
Uncalled bet ($0.65) returned to takis nik
takis nik collected $0.55 from pot
*** SUMMARY ***
Total pot $0.55 | Rake $0 
Seat 1: DIGOR100 folded before Flop (didn't bet)
Seat 3: cherep61987 (button) folded before Flop
Seat 4: voledy (small blind) folded before Flop
Seat 5: takis nik (big blind) collected ($0.55)
Seat 6: Rodik002 folded before Flop (didn't bet)



PokerStars Hand #166667880907:  Hold'em No Limit ($0.05/$0.10 USD) - 2017/02/23 16:09:13 ET
Table 'Antinous' 6-max Seat #6 is the button
Seat 1: Andrei ProFF ($15.38 in chips) 
Seat 2: Nr847 ($13.60 in chips) 
Seat 3: dittoro ($10 in chips) 
Seat 4: Pekaml ($15.65 in chips) 
Seat 5: Covetsoles ($4.02 in chips) 
Seat 6: coolisses111 ($9.85 in chips) 
Andrei ProFF: posts small blind $0.05
Nr847: posts big blind $0.10
*** HOLE CARDS ***
dittoro: folds 
Pekaml: folds 
Covetsoles: folds 
coolisses111: raises $0.20 to $0.30
Andrei ProFF: raises $0.60 to $0.90
Nr847: folds 
coolisses111: folds 
Uncalled bet ($0.60) returned to Andrei ProFF
Andrei ProFF collected $0.70 from pot
*** SUMMARY ***
Total pot $0.70 | Rake $0 
Seat 1: Andrei ProFF (small blind) collected ($0.70)
Seat 2: Nr847 (big blind) folded before Flop
Seat 3: dittoro folded before Flop (didn't bet)
Seat 4: Pekaml folded before Flop (didn't bet)
Seat 5: Covetsoles folded before Flop (didn't bet)
Seat 6: coolisses111 (button) folded before Flop



PokerStars Hand #166667881115:  Hold'em No Limit ($0.05/$0.10 USD) - 2017/02/23 16:09:13 ET
Table 'Apollonia' 6-max Seat #6 is the button
Seat 1: ex3Lero86 ($10.16 in chips) 
Seat 2: ibara000 ($18.43 in chips) 
Seat 3: steepfell ($10.15 in chips) 
Seat 4: Goroshkos88 ($17.47 in chips) 
Seat 6: iluzja12 ($10.22 in chips) 
ex3Lero86: posts small blind $0.05
ibara000: posts big blind $0.10
bambolejro: sits out 
*** HOLE CARDS ***
steepfell: folds 
Goroshkos88: folds 
iluzja12: raises $0.20 to $0.30
ex3Lero86: folds 
ibara000: folds 
Uncalled bet ($0.20) returned to iluzja12
iluzja12 collected $0.25 from pot
*** SUMMARY ***
Total pot $0.25 | Rake $0 
Seat 1: ex3Lero86 (small blind) folded before Flop
Seat 2: ibara000 (big blind) folded before Flop
Seat 3: steepfell folded before Flop (didn't bet)
Seat 4: Goroshkos88 folded before Flop (didn't bet)
Seat 6: iluzja12 (button) collected ($0.25)



PokerStars Hand #166667881512:  Hold'em No Limit ($0.05/$0.10 USD) - 2017/02/23 16:09:14 ET
Table 'Tirela' 6-max Seat #1 is the button
Seat 1: Smitty03300 ($10 in chips) 
Seat 2: Andrei ProFF ($17.04 in chips) 
Seat 3: aim444 ($16.43 in chips) 
Seat 4: ArcticBearDK ($10 in chips) 
Seat 5: KRZuff ($13.91 in chips) 
Seat 6: coolisses111 ($9.80 in chips) 
Andrei ProFF: posts small blind $0.05
aim444: posts big blind $0.10
*** HOLE CARDS ***
ArcticBearDK: folds 
KRZuff: folds 
coolisses111: folds 
Smitty03300: raises $0.10 to $0.20
Andrei ProFF: folds 
aim444: calls $0.10
*** FLOP *** [Ks Jc 4s]
aim444: bets $0.10
Smitty03300: folds 
Uncalled bet ($0.10) returned to aim444
aim444 collected $0.43 from pot
*** SUMMARY ***
Total pot $0.45 | Rake $0.02 
Board [Ks Jc 4s]
Seat 1: Smitty03300 (button) folded on the Flop
Seat 2: Andrei ProFF (small blind) folded before Flop
Seat 3: aim444 (big blind) collected ($0.43)
Seat 4: ArcticBearDK folded before Flop (didn't bet)
Seat 5: KRZuff folded before Flop (didn't bet)
Seat 6: coolisses111 folded before Flop (didn't bet)



PokerStars Hand #166667881771:  Hold'em No Limit ($0.05/$0.10 USD) - 2017/02/23 16:09:14 ET
Table 'Wabash' 6-max Seat #3 is the button
Seat 1: pivanki11 ($8.99 in chips) 
Seat 2: ex3Lero86 ($32.48 in chips) 
Seat 3: tauronex ($10 in chips) 
Seat 4: Nr847 ($10.97 in chips) 
Seat 5: popypaleta ($13.89 in chips) 
Seat 6: weez3r ($11.22 in chips) 
Nr847: posts small blind $0.05
popypaleta: posts big blind $0.10
*** HOLE CARDS ***
weez3r: folds 
pivanki11: folds 
ex3Lero86: raises $0.15 to $0.25
tauronex: folds 
Nr847: folds 
popypaleta: folds 
Uncalled bet ($0.15) returned to ex3Lero86
ex3Lero86 collected $0.25 from pot
*** SUMMARY ***
Total pot $0.25 | Rake $0 
Seat 1: pivanki11 folded before Flop (didn't bet)
Seat 2: ex3Lero86 collected ($0.25)
Seat 3: tauronex (button) folded before Flop (didn't bet)
Seat 4: Nr847 (small blind) folded before Flop
Seat 5: popypaleta (big blind) folded before Flop
Seat 6: weez3r folded before Flop (didn't bet)



PokerStars Hand #166667882028:  Hold'em No Limit ($0.05/$0.10 USD) - 2017/02/23 16:09:14 ET
Table 'Vaisala' 6-max Seat #2 is the button
Seat 2: XaXaTyH4uK ($12.24 in chips) 
Seat 4: sexy_seagull ($10 in chips) 
univibe68 will be allowed to play after the button
XaXaTyH4uK: posts small blind $0.05
x3ultimate: is sitting out 
x3ultimate leaves the table
sexy_seagull: posts big blind $0.10
*** HOLE CARDS ***
XaXaTyH4uK: raises $0.20 to $0.30
sexy_seagull: calls $0.20
*** FLOP *** [4c 8h Td]
sexy_seagull: checks 
XaXaTyH4uK: bets $0.40
sexy_seagull: calls $0.40
*** TURN *** [4c 8h Td] [Ac]
sexy_seagull: checks 
XaXaTyH4uK: bets $0.80
sexy_seagull: raises $1.60 to $2.40
fábiu joins the table at seat #6 
ksandr_hom joins the table at seat #1 
Elinaattor joins the table at seat #3 
XaXaTyH4uK: folds 
Uncalled bet ($1.60) returned to sexy_seagull
sexy_seagull collected $2.86 from pot
*** SUMMARY ***
Total pot $3 | Rake $0.14 
Board [4c 8h Td Ac]
Seat 2: XaXaTyH4uK (button) (small blind) folded on the Turn
Seat 4: sexy_seagull (big blind) collected ($2.86)



PokerStars Hand #166667882083:  Hold'em No Limit ($0.05/$0.10 USD) - 2017/02/23 16:09:14 ET
Table 'Fechtig III' 6-max Seat #1 is the button
Seat 1: Scanner17 ($12.04 in chips) 
Seat 2: GV82 ($16.79 in chips) 
Seat 3: eniksenik ($10 in chips) 
Seat 4: Kow6oy ($10 in chips) 
Seat 5: ksandr_hom ($10.10 in chips) 
Seat 6: Glatzemandse ($18.46 in chips) 
GV82: posts small blind $0.05
eniksenik: posts big blind $0.10
*** HOLE CARDS ***
Kow6oy: folds 
ksandr_hom: folds 
Glatzemandse: calls $0.10
Scanner17: folds 
GV82: raises $0.20 to $0.30
eniksenik: folds 
Glatzemandse: calls $0.20
*** FLOP *** [2h Jc 9s]
GV82: bets $0.34
Glatzemandse: calls $0.34
*** TURN *** [2h Jc 9s] [5h]
GV82: bets $0.66
Glatzemandse: calls $0.66
*** RIVER *** [2h Jc 9s 5h] [6d]
GV82: bets $1.29
Glatzemandse: calls $1.29
*** SHOW DOWN ***
GV82: shows [Kd 9d] (a pair of Nines)
Glatzemandse: mucks hand 
GV82 collected $5.04 from pot
*** SUMMARY ***
Total pot $5.28 | Rake $0.24 
Board [2h Jc 9s 5h 6d]
Seat 1: Scanner17 (button) folded before Flop (didn't bet)
Seat 2: GV82 (small blind) showed [Kd 9d] and won ($5.04) with a pair of Nines
Seat 3: eniksenik (big blind) folded before Flop
Seat 4: Kow6oy folded before Flop (didn't bet)
Seat 5: ksandr_hom folded before Flop (didn't bet)
Seat 6: Glatzemandse mucked



PokerStars Hand #166667882481:  Hold'em No Limit ($0.05/$0.10 USD) - 2017/02/23 16:09:15 ET
Table 'Lorbach' 6-max Seat #1 is the button
Seat 1: LarryTheStar ($17.44 in chips) 
Seat 2: fabadam ($12.68 in chips) 
Seat 3: ArcticBearDK ($10 in chips) 
Seat 4: McCleans ($10.79 in chips) 
Seat 6: Worlz ($15.21 in chips) 
fabadam: posts small blind $0.05
ArcticBearDK: posts big blind $0.10
*** HOLE CARDS ***
McCleans: folds 
x3ultimate leaves the table
Worlz: raises $0.20 to $0.30
LarryTheStar: folds 
brotherluck joins the table at seat #5 
fabadam: raises $0.70 to $1
ArcticBearDK: folds 
Worlz: calls $0.70
*** FLOP *** [9d 6c 7s]
fabadam: checks 
Worlz: bets $1.01
McCleans leaves the table
fabadam: folds 
Uncalled bet ($1.01) returned to Worlz
Worlz collected $2.01 from pot
*** SUMMARY ***
Total pot $2.10 | Rake $0.09 
Board [9d 6c 7s]
Seat 1: LarryTheStar (button) folded before Flop (didn't bet)
Seat 2: fabadam (small blind) folded on the Flop
Seat 3: ArcticBearDK (big blind) folded before Flop
Seat 4: McCleans folded before Flop (didn't bet)
Seat 6: Worlz collected ($2.01)



PokerStars Hand #166667882484:  Hold'em No Limit ($0.05/$0.10 USD) - 2017/02/23 16:09:15 ET
Table 'Xanthippe II' 6-max Seat #6 is the button
Seat 2: Bird et al ($10.13 in chips) 
Seat 3: Dcaro31 ($14.76 in chips) 
Seat 6: Orlangoor ($13.03 in chips) 
Bird et al: posts small blind $0.05
Dcaro31: posts big blind $0.10
*** HOLE CARDS ***
Orlangoor: folds 
XaXaTyH4uK joins the table at seat #5 
Bird et al: folds 
Uncalled bet ($0.05) returned to Dcaro31
Dcaro31 collected $0.10 from pot
*** SUMMARY ***
Total pot $0.10 | Rake $0 
Seat 2: Bird et al (small blind) folded before Flop
Seat 3: Dcaro31 (big blind) collected ($0.10)
Seat 6: Orlangoor (button) folded before Flop (didn't bet)



PokerStars Hand #166667882683:  Hold'em No Limit ($0.05/$0.10 USD) - 2017/02/23 16:09:15 ET
Table 'Arkab' 6-max Seat #6 is the button
Seat 1: iamkakaroto ($10.05 in chips) 
Seat 2: aktion4ik ($12.24 in chips) 
Seat 3: sexy_seagull ($10 in chips) 
Seat 5: OrionYusupov ($9.83 in chips) 
Seat 6: MihaGr ($11.20 in chips) 
iamkakaroto: posts small blind $0.05
aktion4ik: posts big blind $0.10
*** HOLE CARDS ***
sexy_seagull: folds 
OrionYusupov: folds 
dincimus joins the table at seat #4 
MihaGr: folds 
iamkakaroto: folds 
Uncalled bet ($0.05) returned to aktion4ik
aktion4ik collected $0.10 from pot
*** SUMMARY ***
Total pot $0.10 | Rake $0 
Seat 1: iamkakaroto (small blind) folded before Flop
Seat 2: aktion4ik (big blind) collected ($0.10)
Seat 3: sexy_seagull folded before Flop (didn't bet)
Seat 5: OrionYusupov folded before Flop (didn't bet)
Seat 6: MihaGr (button) folded before Flop (didn't bet)



PokerStars Hand #166667883294:  Hold'em No Limit ($0.05/$0.10 USD) - 2017/02/23 16:09:16 ET
Table 'Hercynia III' 6-max Seat #1 is the button
Seat 1: Bird et al ($14.63 in chips) 
Seat 2: Action_Gibi ($7.18 in chips) 
Seat 3: Dcaro31 ($20.02 in chips) 
Seat 5: THIMUCHIN ($15.30 in chips) 
Seat 6: bdixon_5 ($11.59 in chips) 
Action_Gibi: posts small blind $0.05
Dcaro31: posts big blind $0.10
*** HOLE CARDS ***
THIMUCHIN: folds 
bdixon_5: raises $0.20 to $0.30
Bird et al: raises $0.75 to $1.05
Action_Gibi: folds 
Dcaro31: folds 
bdixon_5: folds 
Uncalled bet ($0.75) returned to Bird et al
Bird et al collected $0.75 from pot
*** SUMMARY ***
Total pot $0.75 | Rake $0 
Seat 1: Bird et al (button) collected ($0.75)
Seat 2: Action_Gibi (small blind) folded before Flop
Seat 3: Dcaro31 (big blind) folded before Flop
Seat 5: THIMUCHIN folded before Flop (didn't bet)
Seat 6: bdixon_5 folded before Flop



PokerStars Hand #166667883970:  Hold'em No Limit ($0.05/$0.10 USD) - 2017/02/23 16:09:16 ET
Table 'Risha II' 6-max Seat #4 is the button
Seat 1: R. Lemonte ($14.55 in chips) 
Seat 2: KA3AXCTAHEU, ($12.25 in chips) 
Seat 3: steepfell ($10.40 in chips) 
Seat 4: Comeback3392 ($19.53 in chips) 
Seat 5: m.c-alkatraz ($9.95 in chips) 
Seat 6: univibe68 ($10.76 in chips) 
m.c-alkatraz: posts small blind $0.05
univibe68: posts big blind $0.10
*** HOLE CARDS ***
R. Lemonte: folds 
KA3AXCTAHEU,: folds 
steepfell: raises $0.15 to $0.25
Comeback3392: folds 
R. Lemonte leaves the table
m.c-alkatraz: folds 
marianoboni joins the table at seat #1 
univibe68: raises $0.65 to $0.90
steepfell: folds 
Uncalled bet ($0.65) returned to univibe68
univibe68 collected $0.55 from pot
*** SUMMARY ***
Total pot $0.55 | Rake $0 
Seat 1: R. Lemonte folded before Flop (didn't bet)
Seat 2: KA3AXCTAHEU, folded before Flop (didn't bet)
Seat 3: steepfell folded before Flop
Seat 4: Comeback3392 (button) folded before Flop (didn't bet)
Seat 5: m.c-alkatraz (small blind) folded before Flop
Seat 6: univibe68 (big blind) collected ($0.55)



PokerStars Hand #166667883980:  Hold'em No Limit ($0.05/$0.10 USD) - 2017/02/23 16:09:16 ET
Table 'Sinon II' 6-max Seat #3 is the button
Seat 1: Aescul@pius ($10 in chips) 
Seat 2: ÄissesHai ($24.83 in chips) 
Seat 3: crazydevill ($10 in chips) 
Seat 4: Bandyaev ($14.73 in chips) 
Seat 5: ab260414 ($11.06 in chips) 
Seat 6: hartmut2012 ($6.72 in chips) 
Bandyaev: posts small blind $0.05
ab260414: posts big blind $0.10
*** HOLE CARDS ***
hartmut2012: calls $0.10
Aescul@pius: folds 
ÄissesHai: calls $0.10
crazydevill: raises $0.30 to $0.40
Bandyaev: folds 
ab260414: folds 
hartmut2012: calls $0.30
ÄissesHai: calls $0.30
*** FLOP *** [6s Ts 7d]
hartmut2012: checks 
ÄissesHai: checks 
crazydevill: checks 
*** TURN *** [6s Ts 7d] [Kh]
hartmut2012: checks 
ÄissesHai: checks 
crazydevill: bets $0.90
hartmut2012: folds 
ÄissesHai: calls $0.90
*** RIVER *** [6s Ts 7d Kh] [Td]
ÄissesHai: checks 
crazydevill: bets $2
ÄissesHai: calls $2
*** SHOW DOWN ***
crazydevill: shows [Kc Qh] (two pair, Kings and Tens)
ÄissesHai: shows [Ks Ac] (two pair, Kings and Tens - Ace kicker)
ÄissesHai collected $6.83 from pot
*** SUMMARY ***
Total pot $7.15 | Rake $0.32 
Board [6s Ts 7d Kh Td]
Seat 1: Aescul@pius folded before Flop (didn't bet)
Seat 2: ÄissesHai showed [Ks Ac] and won ($6.83) with two pair, Kings and Tens
Seat 3: crazydevill (button) showed [Kc Qh] and lost with two pair, Kings and Tens
Seat 4: Bandyaev (small blind) folded before Flop
Seat 5: ab260414 (big blind) folded before Flop
Seat 6: hartmut2012 folded on the Turn



PokerStars Hand #166667884657:  Hold'em No Limit ($0.05/$0.10 USD) - 2017/02/23 16:09:17 ET
Table 'Tyndareus II' 6-max Seat #4 is the button
Seat 1: Makc1705 ($4.39 in chips) 
Seat 2: fishhook5 ($10 in chips) 
Seat 3: McCleans ($11.40 in chips) 
Seat 4: gaHy_HaXeP ($10.21 in chips) 
Seat 5: vtalian ($10.12 in chips) 
Seat 6: sexy_seagull ($10.30 in chips) 
vtalian: posts small blind $0.05
sexy_seagull: posts big blind $0.10
*** HOLE CARDS ***
Makc1705: folds 
fishhook5: folds 
McCleans: folds 
gaHy_HaXeP: raises $0.12 to $0.22
vtalian: folds 
McCleans is disconnected 
sexy_seagull: folds 
Uncalled bet ($0.12) returned to gaHy_HaXeP
gaHy_HaXeP collected $0.25 from pot
*** SUMMARY ***
Total pot $0.25 | Rake $0 
Seat 1: Makc1705 folded before Flop (didn't bet)
Seat 2: fishhook5 folded before Flop (didn't bet)
Seat 3: McCleans folded before Flop (didn't bet)
Seat 4: gaHy_HaXeP (button) collected ($0.25)
Seat 5: vtalian (small blind) folded before Flop
Seat 6: sexy_seagull (big blind) folded before Flop



PokerStars Hand #166667884832:  Hold'em No Limit ($0.05/$0.10 USD) - 2017/02/23 16:09:17 ET
Table 'Rostia' 6-max Seat #6 is the button
Seat 1: paxit71 ($6.47 in chips) 
Seat 2: david_sara83 ($20.07 in chips) 
Seat 3: iThreeBarrel ($10.15 in chips) 
Seat 4: Hyd SK ($11.68 in chips) 
Seat 5: silsilviu ($7.67 in chips) 
Seat 6: Giyorod ($10.55 in chips) 
paxit71: posts small blind $0.05
david_sara83: posts big blind $0.10
*** HOLE CARDS ***
iThreeBarrel: folds 
Hyd SK: folds 
silsilviu: folds 
Giyorod: raises $0.15 to $0.25
paxit71: raises $0.15 to $0.40
david_sara83: folds 
Giyorod: calls $0.15
*** FLOP *** [Qs 6d Th]
paxit71: bets $0.50
Giyorod: raises $0.55 to $1.05
paxit71: raises $5.02 to $6.07 and is all-in
david_sara83 leaves the table
Giyorod: calls $5.02
*** TURN *** [Qs 6d Th] [2d]
*** RIVER *** [Qs 6d Th 2d] [8c]
*** SHOW DOWN ***
paxit71: shows [Qh Ac] (a pair of Queens)
Giyorod: shows [Ts Qd] (two pair, Queens and Tens)
Giyorod collected $12.45 from pot
*** SUMMARY ***
Total pot $13.04 | Rake $0.59 
Board [Qs 6d Th 2d 8c]
Seat 1: paxit71 (small blind) showed [Qh Ac] and lost with a pair of Queens
Seat 2: david_sara83 (big blind) folded before Flop
Seat 3: iThreeBarrel folded before Flop (didn't bet)
Seat 4: Hyd SK folded before Flop (didn't bet)
Seat 5: silsilviu folded before Flop (didn't bet)
Seat 6: Giyorod (button) showed [Ts Qd] and won ($12.45) with two pair, Queens and Tens



PokerStars Hand #166667884973:  Hold'em No Limit ($0.05/$0.10 USD) - 2017/02/23 16:09:18 ET
Table 'Euryalos II' 6-max Seat #3 is the button
Seat 2: silsilviu ($16.37 in chips) 
Seat 3: Hyd SK ($10.50 in chips) 
Seat 4: popypaleta ($12.13 in chips) 
Seat 5: horang2 ($1.97 in chips) 
Seat 6: MihaGr ($10.07 in chips) 
popypaleta: posts small blind $0.05
horang2: posts big blind $0.10
voledy: sits out 
*** HOLE CARDS ***
MihaGr: folds 
silsilviu: raises $0.20 to $0.30
Hyd SK: folds 
popypaleta: folds 
horang2: folds 
Uncalled bet ($0.20) returned to silsilviu
silsilviu collected $0.25 from pot
*** SUMMARY ***
Total pot $0.25 | Rake $0 
Seat 2: silsilviu collected ($0.25)
Seat 3: Hyd SK (button) folded before Flop (didn't bet)
Seat 4: popypaleta (small blind) folded before Flop
Seat 5: horang2 (big blind) folded before Flop
Seat 6: MihaGr folded before Flop (didn't bet)



PokerStars Hand #166667885032:  Hold'em No Limit ($0.05/$0.10 USD) - 2017/02/23 16:09:18 ET
Table 'Pulcova II' 6-max Seat #2 is the button
Seat 1: sexy_seagull ($11.23 in chips) 
Seat 2: Kazacha ($10.40 in chips) 
Seat 3: Lao Tsy ($14.12 in chips) 
Seat 5: mdelfin0 ($10.09 in chips) 
Seat 6: Ice_Isayev ($10 in chips) 
Lao Tsy: posts small blind $0.05
mdelfin0: posts big blind $0.10
*** HOLE CARDS ***
Ice_Isayev: folds 
sexy_seagull: raises $0.20 to $0.30
Kazacha: folds 
Lao Tsy: folds 
mdelfin0: folds 
Uncalled bet ($0.20) returned to sexy_seagull
sexy_seagull collected $0.25 from pot
*** SUMMARY ***
Total pot $0.25 | Rake $0 
Seat 1: sexy_seagull collected ($0.25)
Seat 2: Kazacha (button) folded before Flop (didn't bet)
Seat 3: Lao Tsy (small blind) folded before Flop
Seat 5: mdelfin0 (big blind) folded before Flop
Seat 6: Ice_Isayev folded before Flop (didn't bet)



PokerStars Hand #166667885167:  Hold'em No Limit ($0.05/$0.10 USD) - 2017/02/23 16:09:18 ET
Table 'Sirius II' 6-max Seat #6 is the button
Seat 2: Buddy8711 ($8.46 in chips) 
Seat 3: Spud014 ($10.10 in chips) 
Seat 6: MihaGr ($10 in chips) 
Buddy8711: posts small blind $0.05
Spud014: posts big blind $0.10
Pekaml: sits out 
manashov: sits out 
*** HOLE CARDS ***
MihaGr: raises $0.20 to $0.30
Buddy8711: calls $0.25
Spud014: folds 
*** FLOP *** [2s Qc Th]
Cluckh joins the table at seat #1 
Buddy8711: bets $0.70
MihaGr: folds 
Uncalled bet ($0.70) returned to Buddy8711
Buddy8711 collected $0.67 from pot
*** SUMMARY ***
Total pot $0.70 | Rake $0.03 
Board [2s Qc Th]
Seat 2: Buddy8711 (small blind) collected ($0.67)
Seat 3: Spud014 (big blind) folded before Flop
Seat 6: MihaGr (button) folded on the Flop



PokerStars Hand #166667885263:  Hold'em No Limit ($0.05/$0.10 USD) - 2017/02/23 16:09:18 ET
Table 'Walpurga' 6-max Seat #1 is the button
Seat 1: chimera252 ($12.07 in chips) 
Seat 2: paxit71 ($5.15 in chips) 
Seat 3: marianoboni ($16.21 in chips) 
Seat 4: oddshoff ($12.89 in chips) 
Seat 5: Fremara ($9.90 in chips) 
paxit71: posts small blind $0.05
marianoboni: posts big blind $0.10
*** HOLE CARDS ***
oddshoff: folds 
x3ultimate joins the table at seat #6 
Fremara: raises $0.20 to $0.30
x3ultimate leaves the table
chimera252: folds 
paxit71: folds 
marianoboni: folds 
Uncalled bet ($0.20) returned to Fremara
Fremara collected $0.25 from pot
*** SUMMARY ***
Total pot $0.25 | Rake $0 
Seat 1: chimera252 (button) folded before Flop (didn't bet)
Seat 2: paxit71 (small blind) folded before Flop
Seat 3: marianoboni (big blind) folded before Flop
Seat 4: oddshoff folded before Flop (didn't bet)
Seat 5: Fremara collected ($0.25)



PokerStars Hand #166667885333:  Hold'em No Limit ($0.05/$0.10 USD) - 2017/02/23 16:09:18 ET
Table 'Huberta II' 6-max Seat #4 is the button
Seat 1: tr41n3r12 ($10 in chips) 
Seat 2: Ice_Isayev ($11.88 in chips) 
Seat 3: patrick19111 ($10.41 in chips) 
Seat 4: VAD21 ($11.96 in chips) 
Seat 5: Feverhead ($27.60 in chips) 
Seat 6: yodzik ($5.83 in chips) 
Feverhead: posts small blind $0.05
yodzik: posts big blind $0.10
*** HOLE CARDS ***
tr41n3r12: folds 
Ice_Isayev: raises $0.20 to $0.30
patrick19111: raises $0.70 to $1
VAD21: folds 
Feverhead: folds 
yodzik: folds 
Ice_Isayev: calls $0.70
*** FLOP *** [Kc 7d 8d]
Ice_Isayev: checks 
patrick19111: bets $1.20
Ice_Isayev: calls $1.20
*** TURN *** [Kc 7d 8d] [Td]
Ice_Isayev: checks 
patrick19111: checks 
*** RIVER *** [Kc 7d 8d Td] [6h]
Ice_Isayev: checks 
patrick19111: checks 
*** SHOW DOWN ***
Ice_Isayev: shows [Qh Qc] (a pair of Queens)
patrick19111: shows [Ks Ac] (a pair of Kings)
patrick19111 collected $4.35 from pot
*** SUMMARY ***
Total pot $4.55 | Rake $0.20 
Board [Kc 7d 8d Td 6h]
Seat 1: tr41n3r12 folded before Flop (didn't bet)
Seat 2: Ice_Isayev showed [Qh Qc] and lost with a pair of Queens
Seat 3: patrick19111 showed [Ks Ac] and won ($4.35) with a pair of Kings
Seat 4: VAD21 (button) folded before Flop (didn't bet)
Seat 5: Feverhead (small blind) folded before Flop
Seat 6: yodzik (big blind) folded before Flop



PokerStars Hand #166667885622:  Hold'em No Limit ($0.05/$0.10 USD) - 2017/02/23 16:09:18 ET
Table 'Aisakos II' 6-max Seat #1 is the button
Seat 1: Crafty23@PS ($10.35 in chips) 
Seat 2: svaika24 ($16.92 in chips) 
Seat 3: iamkakaroto ($10.82 in chips) 
Seat 4: T9MS ($10.30 in chips) 
Seat 5: KokoulinV ($11.75 in chips) 
Seat 6: LarryTheStar ($10.03 in chips) 
svaika24: posts small blind $0.05
iamkakaroto: posts big blind $0.10
*** HOLE CARDS ***
T9MS: folds 
KokoulinV: folds 
LarryTheStar: folds 
Crafty23@PS: folds 
svaika24: folds 
Uncalled bet ($0.05) returned to iamkakaroto
iamkakaroto collected $0.10 from pot
*** SUMMARY ***
Total pot $0.10 | Rake $0 
Seat 1: Crafty23@PS (button) folded before Flop (didn't bet)
Seat 2: svaika24 (small blind) folded before Flop
Seat 3: iamkakaroto (big blind) collected ($0.10)
Seat 4: T9MS folded before Flop (didn't bet)
Seat 5: KokoulinV folded before Flop (didn't bet)
Seat 6: LarryTheStar folded before Flop (didn't bet)



PokerStars Hand #166667885708:  Hold'em No Limit ($0.05/$0.10 USD) - 2017/02/23 16:09:18 ET
Table 'Vesta II' 6-max Seat #2 is the button
Seat 1: Yabidooo ($17.42 in chips) 
Seat 2: Dimka4 ($10 in chips) 
Seat 3: Pokeaster ($12.61 in chips) 
Seat 4: Dcaro31 ($10 in chips) 
Seat 5: ChuikaPridi ($10 in chips) 
Seat 6: XaXaTyH4uK ($10.86 in chips) 
Pokeaster: posts small blind $0.05
Dcaro31: posts big blind $0.10
*** HOLE CARDS ***
ChuikaPridi: raises $0.20 to $0.30
XaXaTyH4uK: folds 
Yabidooo: folds 
Dimka4: folds 
Pokeaster: folds 
Dcaro31: folds 
Uncalled bet ($0.20) returned to ChuikaPridi
ChuikaPridi collected $0.25 from pot
*** SUMMARY ***
Total pot $0.25 | Rake $0 
Seat 1: Yabidooo folded before Flop (didn't bet)
Seat 2: Dimka4 (button) folded before Flop (didn't bet)
Seat 3: Pokeaster (small blind) folded before Flop
Seat 4: Dcaro31 (big blind) folded before Flop
Seat 5: ChuikaPridi collected ($0.25)
Seat 6: XaXaTyH4uK folded before Flop (didn't bet)



PokerStars Hand #166667885717:  Hold'em No Limit ($0.05/$0.10 USD) - 2017/02/23 16:09:18 ET
Table 'Geisha' 6-max Seat #3 is the button
Seat 1: facewald ($34.49 in chips) 
Seat 3: Eddys Edge ($10 in chips) 
Seat 4: marianoboni ($10 in chips) 
Seat 6: Namhkal ($20.83 in chips) 
marianoboni: posts small blind $0.05
KRZuff: is sitting out 
Namhkal: posts big blind $0.10
MisterX413: sits out 
*** HOLE CARDS ***
KRZuff leaves the table
facewald: folds 
Kow6oy joins the table at seat #5 
Kow6oy leaves the table
crooso joins the table at seat #5 
Eddys Edge: raises $0.10 to $0.20
marianoboni: raises $0.60 to $0.80
Namhkal: folds 
Eddys Edge: folds 
Uncalled bet ($0.60) returned to marianoboni
marianoboni collected $0.50 from pot
*** SUMMARY ***
Total pot $0.50 | Rake $0 
Seat 1: facewald folded before Flop (didn't bet)
Seat 3: Eddys Edge (button) folded before Flop
Seat 4: marianoboni (small blind) collected ($0.50)
Seat 6: Namhkal (big blind) folded before Flop



PokerStars Hand #166667885864:  Hold'em No Limit ($0.05/$0.10 USD) - 2017/02/23 16:09:19 ET
Table 'Aconcagua' 6-max Seat #4 is the button
Seat 1: MLPlayer16 ($10.09 in chips) 
Seat 2: Kupi007 ($10 in chips) 
Seat 3: burtila1989 ($8.11 in chips) 
Seat 4: pivanki11 ($9.62 in chips) 
Seat 5: Andrei ProFF ($10 in chips) 
Seat 6: coolisses111 ($11.84 in chips) 
Andrei ProFF: posts small blind $0.05
coolisses111: posts big blind $0.10
MLPlayer16: posts the ante $0.02
Kupi007: posts the ante $0.02
burtila1989: posts the ante $0.02
pivanki11: posts the ante $0.02
Andrei ProFF: posts the ante $0.02
coolisses111: posts the ante $0.02
*** HOLE CARDS ***
MLPlayer16: folds 
Kupi007: folds 
burtila1989: calls $0.10
pivanki11: folds 
Andrei ProFF: raises $0.30 to $0.40
coolisses111: folds 
burtila1989: calls $0.30
*** FLOP *** [Td 5h 4h]
burtila1989 said, "salut andrei"
Andrei ProFF: checks 
burtila1989: checks 
*** TURN *** [Td 5h 4h] [2h]
Andrei ProFF: bets $0.50
burtila1989: folds 
Uncalled bet ($0.50) returned to Andrei ProFF
Andrei ProFF collected $0.97 from pot
*** SUMMARY ***
Total pot $1.02 | Rake $0.05 
Board [Td 5h 4h 2h]
Seat 1: MLPlayer16 folded before Flop (didn't bet)
Seat 2: Kupi007 folded before Flop (didn't bet)
Seat 3: burtila1989 folded on the Turn
Seat 4: pivanki11 (button) folded before Flop (didn't bet)
Seat 5: Andrei ProFF (small blind) collected ($0.97)
Seat 6: coolisses111 (big blind) folded before Flop



PokerStars Hand #166667886104:  Hold'em No Limit ($0.05/$0.10 USD) - 2017/02/23 16:09:19 ET
Table 'Nemo III' 6-max Seat #6 is the button
Seat 1: Kow6oy ($10 in chips) 
Seat 2: Bandyaev ($10.81 in chips) 
Seat 3: Dimka4 ($10 in chips) 
Seat 4: vtalian ($11.13 in chips) 
Seat 5: Joker51_wtf! ($11.58 in chips) 
Seat 6: maxiv608 ($10 in chips) 
Kow6oy: posts small blind $0.05
Bandyaev: posts big blind $0.10
*** HOLE CARDS ***
Dimka4: folds 
vtalian: folds 
Joker51_wtf!: folds 
maxiv608: folds 
Kow6oy: raises $0.20 to $0.30
Bandyaev: folds 
Uncalled bet ($0.20) returned to Kow6oy
Kow6oy collected $0.20 from pot
*** SUMMARY ***
Total pot $0.20 | Rake $0 
Seat 1: Kow6oy (small blind) collected ($0.20)
Seat 2: Bandyaev (big blind) folded before Flop
Seat 3: Dimka4 folded before Flop (didn't bet)
Seat 4: vtalian folded before Flop (didn't bet)
Seat 5: Joker51_wtf! folded before Flop (didn't bet)
Seat 6: maxiv608 (button) folded before Flop (didn't bet)



PokerStars Hand #166667886481:  Hold'em No Limit ($0.05/$0.10 USD) - 2017/02/23 16:09:19 ET
Table 'Landi II' 6-max Seat #5 is the button
Seat 1: dersiemer ($12.89 in chips) 
Seat 2: Aescul@pius ($10 in chips) 
Seat 4: alesi13 ($6.41 in chips) 
Seat 5: Bird et al ($10.25 in chips) 
Seat 6: arti192837 ($10 in chips) 
arti192837: posts small blind $0.05
dersiemer: posts big blind $0.10
x3ultimate: sits out 
*** HOLE CARDS ***
Aescul@pius: folds 
alesi13: raises $0.10 to $0.20
Bird et al: folds 
arti192837: folds 
dersiemer: calls $0.10
*** FLOP *** [6d Qd Ac]
dersiemer is disconnected 
dersiemer is connected 
dersiemer: checks 
alesi13: bets $0.22
dersiemer: calls $0.22
*** TURN *** [6d Qd Ac] [9s]
dersiemer: checks 
alesi13: checks 
*** RIVER *** [6d Qd Ac 9s] [5h]
dersiemer: bets $0.40
alesi13: calls $0.40
*** SHOW DOWN ***
dersiemer: shows [9d 6s] (two pair, Nines and Sixes)
alesi13: mucks hand 
dersiemer collected $1.61 from pot
*** SUMMARY ***
Total pot $1.69 | Rake $0.08 
Board [6d Qd Ac 9s 5h]
Seat 1: dersiemer (big blind) showed [9d 6s] and won ($1.61) with two pair, Nines and Sixes
Seat 2: Aescul@pius folded before Flop (didn't bet)
Seat 4: alesi13 mucked
Seat 5: Bird et al (button) folded before Flop (didn't bet)
Seat 6: arti192837 (small blind) folded before Flop



PokerStars Hand #166667886723:  Hold'em No Limit ($0.05/$0.10 USD) - 2017/02/23 16:09:20 ET
Table 'Jokaste II' 6-max Seat #4 is the button
Seat 1: Hyd SK ($13.70 in chips) 
Seat 2: T9MS ($12.18 in chips) 
Seat 3: crazydevill ($11.65 in chips) 
Seat 4: FRAID358 ($15.21 in chips) 
Seat 5: Vrinni ($10.03 in chips) 
Seat 6: Adailton07 ($13.70 in chips) 
Vrinni: posts small blind $0.05
Adailton07: posts big blind $0.10
*** HOLE CARDS ***
Hyd SK: raises $0.25 to $0.35
T9MS: calls $0.35
crazydevill: folds 
FRAID358: folds 
Vrinni: folds 
Adailton07: calls $0.25
*** FLOP *** [7d As Qc]
Adailton07: checks 
Hyd SK: checks 
T9MS: bets $0.79
Adailton07: folds 
Hyd SK: folds 
Uncalled bet ($0.79) returned to T9MS
T9MS collected $1.05 from pot
*** SUMMARY ***
Total pot $1.10 | Rake $0.05 
Board [7d As Qc]
Seat 1: Hyd SK folded on the Flop
Seat 2: T9MS collected ($1.05)
Seat 3: crazydevill folded before Flop (didn't bet)
Seat 4: FRAID358 (button) folded before Flop (didn't bet)
Seat 5: Vrinni (small blind) folded before Flop
Seat 6: Adailton07 (big blind) folded on the Flop



PokerStars Hand #166667886754:  Hold'em No Limit ($0.05/$0.10 USD) - 2017/02/23 16:09:20 ET
Table 'Nauheima II' 6-max Seat #2 is the button
Seat 2: Peter0087 ($10.27 in chips) 
Seat 3: KokoulinV ($13.35 in chips) 
Seat 5: bambolejro ($10 in chips) 
Seat 6: bonyo71 ($5.04 in chips) 
KokoulinV: posts small blind $0.05
martijn091 joins the table at seat #4 
bambolejro: posts big blind $0.10
HARDCORE66RU: sits out 
*** HOLE CARDS ***
bonyo71: folds 
Peter0087: folds 
KokoulinV: raises $0.20 to $0.30
bambolejro: folds 
Uncalled bet ($0.20) returned to KokoulinV
KokoulinV collected $0.20 from pot
*** SUMMARY ***
Total pot $0.20 | Rake $0 
Seat 2: Peter0087 (button) folded before Flop (didn't bet)
Seat 3: KokoulinV (small blind) collected ($0.20)
Seat 5: bambolejro (big blind) folded before Flop
Seat 6: bonyo71 folded before Flop (didn't bet)



PokerStars Hand #166667886963:  Hold'em No Limit ($0.05/$0.10 USD) - 2017/02/23 16:09:20 ET
Table 'Nuki' 6-max Seat #5 is the button
Seat 1: bdixon_5 ($7.80 in chips) 
Seat 2: ArcticBearDK ($19.03 in chips) 
Seat 3: david_sara83 ($13.24 in chips) 
Seat 4: GESPERIA ($28.43 in chips) 
Seat 5: fabadam ($11.13 in chips) 
Seat 6: Zooplack ($25.67 in chips) 
Zooplack: posts small blind $0.05
bdixon_5: posts big blind $0.10
*** HOLE CARDS ***
ArcticBearDK: raises $0.15 to $0.25
david_sara83: folds 
GESPERIA: folds 
fabadam: folds 
Zooplack: folds 
bdixon_5: folds 
Uncalled bet ($0.15) returned to ArcticBearDK
ArcticBearDK collected $0.25 from pot
*** SUMMARY ***
Total pot $0.25 | Rake $0 
Seat 1: bdixon_5 (big blind) folded before Flop
Seat 2: ArcticBearDK collected ($0.25)
Seat 3: david_sara83 folded before Flop (didn't bet)
Seat 4: GESPERIA folded before Flop (didn't bet)
Seat 5: fabadam (button) folded before Flop (didn't bet)
Seat 6: Zooplack (small blind) folded before Flop



PokerStars Hand #166667887102:  Hold'em No Limit ($0.05/$0.10 USD) - 2017/02/23 16:09:20 ET
Table 'Sheragul III' 6-max Seat #4 is the button
Seat 2: Bird et al ($10.41 in chips) 
Seat 3: FRAID358 ($10 in chips) 
Seat 4: maxiv608 ($10.43 in chips) 
Bird et al: posts small blind $0.05
RoJ1 joins the table at seat #5 
FRAID358: posts big blind $0.10
*** HOLE CARDS ***
maxiv608: raises $0.10 to $0.20
RoJ1 leaves the table
Bird et al: folds 
RGhearted joins the table at seat #5 
XaXaTyH4uK joins the table at seat #6 
FRAID358: calls $0.10
*** FLOP *** [6h 9c As]
FRAID358: checks 
maxiv608: checks 
*** TURN *** [6h 9c As] [Qd]
jsergem69 joins the table at seat #1 
FRAID358: checks 
jsergem69 leaves the table
maxiv608: checks 
*** RIVER *** [6h 9c As Qd] [6d]
FRAID358: checks 
maxiv608: checks 
*** SHOW DOWN ***
FRAID358: shows [Ks 8s] (a pair of Sixes)
maxiv608: shows [3d 3h] (two pair, Sixes and Threes)
maxiv608 collected $0.43 from pot
*** SUMMARY ***
Total pot $0.45 | Rake $0.02 
Board [6h 9c As Qd 6d]
Seat 2: Bird et al (small blind) folded before Flop
Seat 3: FRAID358 (big blind) showed [Ks 8s] and lost with a pair of Sixes
Seat 4: maxiv608 (button) showed [3d 3h] and won ($0.43) with two pair, Sixes and Threes



PokerStars Hand #166667887334:  Hold'em No Limit ($0.05/$0.10 USD) - 2017/02/23 16:09:20 ET
Table 'Laetitia II' 6-max Seat #2 is the button
Seat 1: Cluckh ($10.83 in chips) 
Seat 2: manashov ($10 in chips) 
Seat 3: 6ePeMeHHa9 ($10 in chips) 
Seat 4: Feverhead ($16.66 in chips) 
Seat 5: D3NyA ($17.36 in chips) 
Seat 6: Dima91360 ($5.80 in chips) 
6ePeMeHHa9: posts small blind $0.05
Feverhead: posts big blind $0.10
*** HOLE CARDS ***
D3NyA: folds 
Dima91360: calls $0.10
Cluckh: folds 
manashov: folds 
6ePeMeHHa9: folds 
Feverhead: checks 
*** FLOP *** [Qd Tc Kc]
Feverhead: bets $0.16
Dima91360: folds 
Uncalled bet ($0.16) returned to Feverhead
Feverhead collected $0.24 from pot
*** SUMMARY ***
Total pot $0.25 | Rake $0.01 
Board [Qd Tc Kc]
Seat 1: Cluckh folded before Flop (didn't bet)
Seat 2: manashov (button) folded before Flop (didn't bet)
Seat 3: 6ePeMeHHa9 (small blind) folded before Flop
Seat 4: Feverhead (big blind) collected ($0.24)
Seat 5: D3NyA folded before Flop (didn't bet)
Seat 6: Dima91360 folded on the Flop



PokerStars Hand #166667887436:  Hold'em No Limit ($0.05/$0.10 USD) - 2017/02/23 16:09:20 ET
Table 'Nehalennia III' 6-max Seat #2 is the button
Seat 1: boxer821 ($11.79 in chips) 
Seat 2: fortieth ($11.66 in chips) 
Seat 3: ValdemorS ($18.14 in chips) 
Seat 4: eniksenik ($10 in chips) 
Seat 5: wulffboy ($36.58 in chips) 
Seat 6: valzeny ($20.50 in chips) 
ValdemorS: posts small blind $0.05
eniksenik: posts big blind $0.10
boxer821: posts the ante $0.02
fortieth: posts the ante $0.02
ValdemorS: posts the ante $0.02
eniksenik: posts the ante $0.02
wulffboy: posts the ante $0.02
valzeny: posts the ante $0.02
*** HOLE CARDS ***
wulffboy: folds 
wulffboy leaves the table
valzeny: folds 
boxer821: raises $0.15 to $0.25
fortieth: folds 
ValdemorS: folds 
eniksenik: calls $0.15
*** FLOP *** [Kh Ks 5h]
eniksenik: checks 
boxer821: checks 
*** TURN *** [Kh Ks 5h] [Jc]
eniksenik: bets $0.49
boxer821: calls $0.49
*** RIVER *** [Kh Ks 5h Jc] [2c]
eniksenik: bets $0.52
ChuikaPridi joins the table at seat #5 
boxer821: folds 
Uncalled bet ($0.52) returned to eniksenik
eniksenik collected $1.58 from pot
*** SUMMARY ***
Total pot $1.65 | Rake $0.07 
Board [Kh Ks 5h Jc 2c]
Seat 1: boxer821 folded on the River
Seat 2: fortieth (button) folded before Flop (didn't bet)
Seat 3: ValdemorS (small blind) folded before Flop
Seat 4: eniksenik (big blind) collected ($1.58)
Seat 5: wulffboy folded before Flop (didn't bet)
Seat 6: valzeny folded before Flop (didn't bet)



PokerStars Hand #166667887762:  Hold'em No Limit ($0.05/$0.10 USD) - 2017/02/23 16:09:21 ET
Table 'Marbachia II' 6-max Seat #3 is the button
Seat 2: Yabidooo ($10 in chips) 
Seat 3: MisterX413 ($10.39 in chips) 
Seat 4: marianoboni ($10 in chips) 
Seat 6: arti192837 ($10 in chips) 
marianoboni: posts small blind $0.05
MihaGr: is sitting out 
arti192837: posts big blind $0.10
crooso: sits out 
*** HOLE CARDS ***
MihaGr leaves the table
Yabidooo: folds 
osmea joins the table at seat #5 
MisterX413: folds 
marianoboni: folds 
Uncalled bet ($0.05) returned to arti192837
arti192837 collected $0.10 from pot
*** SUMMARY ***
Total pot $0.10 | Rake $0 
Seat 2: Yabidooo folded before Flop (didn't bet)
Seat 3: MisterX413 (button) folded before Flop (didn't bet)
Seat 4: marianoboni (small blind) folded before Flop
Seat 6: arti192837 (big blind) collected ($0.10)



PokerStars Hand #166667887820:  Hold'em No Limit ($0.05/$0.10 USD) - 2017/02/23 16:09:21 ET
Table 'Lehigh' 6-max Seat #5 is the button
Seat 2: Sbozzz ($21.30 in chips) 
Seat 3: Therodorus ($12.14 in chips) 
Seat 4: Chodemuncher ($10 in chips) 
Seat 5: Xander188 ($10.32 in chips) 
RoJ1 will be allowed to play after the button
Sbozzz: posts small blind $0.05
Therodorus: posts big blind $0.10
*** HOLE CARDS ***
Chodemuncher: raises $0.20 to $0.30
Xander188: folds 
kowe4ka565 leaves the table
Sbozzz: calls $0.25
Therodorus: folds 
*** FLOP *** [8c 8d 5c]
Sbozzz: checks 
Chodemuncher: bets $0.34
Sbozzz: folds 
Uncalled bet ($0.34) returned to Chodemuncher
Chodemuncher collected $0.67 from pot
*** SUMMARY ***
Total pot $0.70 | Rake $0.03 
Board [8c 8d 5c]
Seat 2: Sbozzz (small blind) folded on the Flop
Seat 3: Therodorus (big blind) folded before Flop
Seat 4: Chodemuncher collected ($0.67)
Seat 5: Xander188 (button) folded before Flop (didn't bet)



PokerStars Hand #166667887858:  Hold'em No Limit ($0.05/$0.10 USD) - 2017/02/23 16:09:21 ET
Table 'Serpens' 6-max Seat #2 is the button
Seat 1: Namhkal ($10 in chips) 
Seat 2: KA3AXCTAHEU, ($19.48 in chips) 
Seat 3: homelessdan ($29.93 in chips) 
homelessdan: posts small blind $0.05
XwinX25: is sitting out 
XaXaTyH4uK joins the table at seat #6 
Namhkal: posts big blind $0.10
*** HOLE CARDS ***
XwinX25 leaves the table
DIENY772 joins the table at seat #4 
KA3AXCTAHEU,: folds 
homelessdan: folds 
Uncalled bet ($0.05) returned to Namhkal
Namhkal collected $0.10 from pot
*** SUMMARY ***
Total pot $0.10 | Rake $0 
Seat 1: Namhkal (big blind) collected ($0.10)
Seat 2: KA3AXCTAHEU, (button) folded before Flop (didn't bet)
Seat 3: homelessdan (small blind) folded before Flop



PokerStars Hand #166667887959:  Hold'em No Limit ($0.05/$0.10 USD) - 2017/02/23 16:09:21 ET
Table 'Jacchia' 6-max Seat #4 is the button
Seat 1: viklundm ($32.53 in chips) 
Seat 2: VAD21 ($23.02 in chips) 
Seat 3: maxiv608 ($10 in chips) 
Seat 4: paterthomas ($9.51 in chips) 
Seat 5: arti192837 ($11.49 in chips) 
Seat 6: RoJ1 ($12.11 in chips) 
arti192837: posts small blind $0.05
RoJ1: posts big blind $0.10
*** HOLE CARDS ***
viklundm: folds 
VAD21: folds 
maxiv608: raises $0.15 to $0.25
paterthomas: folds 
arti192837: calls $0.20
RoJ1: raises $0.90 to $1.15
maxiv608: folds 
arti192837: folds 
Uncalled bet ($0.90) returned to RoJ1
RoJ1 collected $0.75 from pot
*** SUMMARY ***
Total pot $0.75 | Rake $0 
Seat 1: viklundm folded before Flop (didn't bet)
Seat 2: VAD21 folded before Flop (didn't bet)
Seat 3: maxiv608 folded before Flop
Seat 4: paterthomas (button) folded before Flop (didn't bet)
Seat 5: arti192837 (small blind) folded before Flop
Seat 6: RoJ1 (big blind) collected ($0.75)



PokerStars Hand #166667888208:  Hold'em No Limit ($0.05/$0.10 USD) - 2017/02/23 16:09:21 ET
Table 'Atalante' 6-max Seat #5 is the button
Seat 1: OceanBlue100 ($4.84 in chips) 
Seat 2: CiisCi ($19.65 in chips) 
Seat 3: Kow6oy ($10 in chips) 
Seat 4: Dcaro31 ($24.47 in chips) 
Seat 5: eniksenik ($10.14 in chips) 
Seat 6: FlopsterGB ($31.41 in chips) 
FlopsterGB: posts small blind $0.05
OceanBlue100: posts big blind $0.10
*** HOLE CARDS ***
CiisCi: folds 
Kow6oy: folds 
Dcaro31: raises $0.20 to $0.30
eniksenik: calls $0.30
FlopsterGB: folds 
OceanBlue100: folds 
*** FLOP *** [2s 6d 4c]
Dcaro31: checks 
eniksenik: bets $0.40
Dcaro31: folds 
Uncalled bet ($0.40) returned to eniksenik
eniksenik collected $0.72 from pot
*** SUMMARY ***
Total pot $0.75 | Rake $0.03 
Board [2s 6d 4c]
Seat 1: OceanBlue100 (big blind) folded before Flop
Seat 2: CiisCi folded before Flop (didn't bet)
Seat 3: Kow6oy folded before Flop (didn't bet)
Seat 4: Dcaro31 folded on the Flop
Seat 5: eniksenik (button) collected ($0.72)
Seat 6: FlopsterGB (small blind) folded before Flop



PokerStars Hand #166667889061:  Hold'em No Limit ($0.05/$0.10 USD) - 2017/02/23 16:09:22 ET
Table 'Lobelia II' 6-max Seat #6 is the button
Seat 1: facewald ($22.16 in chips) 
Seat 2: Dcaro31 ($17.46 in chips) 
Seat 3: oddshoff ($19.58 in chips) 
Seat 5: Feverhead ($18.95 in chips) 
Seat 6: NvR.m1nD ($10.09 in chips) 
facewald: posts small blind $0.05
Dcaro31: posts big blind $0.10
arti192837: sits out 
*** HOLE CARDS ***
oddshoff: folds 
Feverhead: folds 
NvR.m1nD: folds 
facewald: raises $0.19 to $0.29
Dcaro31: calls $0.19
*** FLOP *** [6d Td Kh]
facewald: checks 
Dcaro31: checks 
*** TURN *** [6d Td Kh] [9d]
facewald: bets $0.35
Dcaro31: calls $0.35
*** RIVER *** [6d Td Kh 9d] [Kc]
facewald: checks 
Dcaro31: checks 
*** SHOW DOWN ***
facewald: shows [3s Ad] (a pair of Kings)
Dcaro31: shows [Qc Th] (two pair, Kings and Tens)
Dcaro31 collected $1.22 from pot
*** SUMMARY ***
Total pot $1.28 | Rake $0.06 
Board [6d Td Kh 9d Kc]
Seat 1: facewald (small blind) showed [3s Ad] and lost with a pair of Kings
Seat 2: Dcaro31 (big blind) showed [Qc Th] and won ($1.22) with two pair, Kings and Tens
Seat 3: oddshoff folded before Flop (didn't bet)
Seat 5: Feverhead folded before Flop (didn't bet)
Seat 6: NvR.m1nD (button) folded before Flop (didn't bet)



PokerStars Hand #166667889262:  Hold'em No Limit ($0.05/$0.10 USD) - 2017/02/23 16:09:22 ET
Table 'Tomita II' 6-max Seat #3 is the button
Seat 2: mhonielsen ($10 in chips) 
Seat 3: D3NyA ($10 in chips) 
Seat 4: Hyd SK ($11.66 in chips) 
Seat 5: ex3Lero86 ($10.10 in chips) 
Seat 6: saniasmir ($10 in chips) 
Hyd SK: posts small blind $0.05
ex3Lero86: posts big blind $0.10
HARDCORE66RU: sits out 
*** HOLE CARDS ***
saniasmir: raises $0.20 to $0.30
mhonielsen: folds 
D3NyA: folds 
Hyd SK: folds 
ex3Lero86: folds 
Uncalled bet ($0.20) returned to saniasmir
saniasmir collected $0.25 from pot
*** SUMMARY ***
Total pot $0.25 | Rake $0 
Seat 2: mhonielsen folded before Flop (didn't bet)
Seat 3: D3NyA (button) folded before Flop (didn't bet)
Seat 4: Hyd SK (small blind) folded before Flop
Seat 5: ex3Lero86 (big blind) folded before Flop
Seat 6: saniasmir collected ($0.25)



PokerStars Hand #166667889513:  Hold'em No Limit ($0.05/$0.10 USD) - 2017/02/23 16:09:23 ET
Table 'Clavel' 6-max Seat #5 is the button
Seat 1: KRZuff ($14.51 in chips) 
Seat 2: Namhkal ($10.15 in chips) 
Seat 4: Dcaro31 ($11.68 in chips) 
Seat 5: Vrinni ($11.33 in chips) 
Seat 6: Gra_anD77 ($3.67 in chips) 
Gra_anD77: posts small blind $0.05
KRZuff: posts big blind $0.10
*** HOLE CARDS ***
Namhkal: folds 
Dcaro31: folds 
Vrinni: folds 
Gra_anD77: calls $0.05
KRZuff: checks 
*** FLOP *** [4d Kh Kd]
Gra_anD77: checks 
KRZuff: bets $0.15
Gra_anD77: raises $0.15 to $0.30
KRZuff: raises $0.70 to $1
Gra_anD77: folds 
Uncalled bet ($0.70) returned to KRZuff
KRZuff collected $0.76 from pot
*** SUMMARY ***
Total pot $0.80 | Rake $0.04 
Board [4d Kh Kd]
Seat 1: KRZuff (big blind) collected ($0.76)
Seat 2: Namhkal folded before Flop (didn't bet)
Seat 4: Dcaro31 folded before Flop (didn't bet)
Seat 5: Vrinni (button) folded before Flop (didn't bet)
Seat 6: Gra_anD77 (small blind) folded on the Flop



PokerStars Hand #166667889575:  Hold'em No Limit ($0.05/$0.10 USD) - 2017/02/23 16:09:23 ET
Table 'Cyane' 6-max Seat #5 is the button
Seat 1: KA3AXCTAHEU, ($10.30 in chips) 
Seat 2: sashi18 ($7.86 in chips) 
Seat 3: Mamm0nism ($4 in chips) 
Seat 4: truck1234 ($32.53 in chips) 
Seat 5: RoJ1 ($10.27 in chips) 
Seat 6: 8th wonders ($11.50 in chips) 
8th wonders: posts small blind $0.05
KA3AXCTAHEU,: posts big blind $0.10
*** HOLE CARDS ***
sashi18: folds 
Mamm0nism: folds 
truck1234: folds 
RoJ1: raises $0.12 to $0.22
8th wonders: raises $0.68 to $0.90
KA3AXCTAHEU,: folds 
RoJ1: calls $0.68
*** FLOP *** [4s 4c 3s]
8th wonders: bets $1.20
RoJ1: calls $1.20
*** TURN *** [4s 4c 3s] [3c]
8th wonders: checks 
RoJ1: checks 
*** RIVER *** [4s 4c 3s 3c] [Kc]
8th wonders: checks 
RoJ1: checks 
*** SHOW DOWN ***
8th wonders: shows [Ad Qd] (two pair, Fours and Threes)
RoJ1: shows [9s As] (two pair, Fours and Threes)
8th wonders collected $2.06 from pot
RoJ1 collected $2.05 from pot
*** SUMMARY ***
Total pot $4.30 | Rake $0.19 
Board [4s 4c 3s 3c Kc]
Seat 1: KA3AXCTAHEU, (big blind) folded before Flop
Seat 2: sashi18 folded before Flop (didn't bet)
Seat 3: Mamm0nism folded before Flop (didn't bet)
Seat 4: truck1234 folded before Flop (didn't bet)
Seat 5: RoJ1 (button) showed [9s As] and won ($2.05) with two pair, Fours and Threes
Seat 6: 8th wonders (small blind) showed [Ad Qd] and won ($2.06) with two pair, Fours and Threes



PokerStars Hand #166667889885:  Hold'em No Limit ($0.05/$0.10 USD) - 2017/02/23 16:09:23 ET
Table 'Armenia' 6-max Seat #3 is the button
Seat 1: tr41n3r12 ($11.52 in chips) 
Seat 2: Yabidooo ($10.83 in chips) 
Seat 3: Crimsonr ($5.74 in chips) 
Seat 4: mbkongstad ($9.10 in chips) 
Seat 5: DrVzad ($10 in chips) 
Seat 6: mega spasser ($7.34 in chips) 
mbkongstad: posts small blind $0.05
DrVzad: posts big blind $0.10
*** HOLE CARDS ***
mega spasser: folds 
tr41n3r12: folds 
Yabidooo: folds 
Crimsonr: folds 
mbkongstad: raises $0.20 to $0.30
DrVzad: folds 
Uncalled bet ($0.20) returned to mbkongstad
mbkongstad collected $0.20 from pot
*** SUMMARY ***
Total pot $0.20 | Rake $0 
Seat 1: tr41n3r12 folded before Flop (didn't bet)
Seat 2: Yabidooo folded before Flop (didn't bet)
Seat 3: Crimsonr (button) folded before Flop (didn't bet)
Seat 4: mbkongstad (small blind) collected ($0.20)
Seat 5: DrVzad (big blind) folded before Flop
Seat 6: mega spasser folded before Flop (didn't bet)



PokerStars Hand #166667890240:  Hold'em No Limit ($0.05/$0.10 USD) - 2017/02/23 16:09:23 ET
Table 'Bengt' 6-max Seat #1 is the button
Seat 1: Lucky HoBBiT ($12.35 in chips) 
Seat 2: ChefRocco ($20.38 in chips) 
Seat 3: nantes15 ($13.29 in chips) 
Seat 4: 8th wonders ($10 in chips) 
Seat 5: RoJ1 ($10.16 in chips) 
Seat 6: Goroshkos88 ($11.06 in chips) 
ChefRocco: posts small blind $0.05
nantes15: posts big blind $0.10
*** HOLE CARDS ***
8th wonders: raises $0.20 to $0.30
RoJ1: folds 
Goroshkos88: folds 
Lucky HoBBiT: folds 
ChefRocco: folds 
nantes15: folds 
Uncalled bet ($0.20) returned to 8th wonders
8th wonders collected $0.25 from pot
*** SUMMARY ***
Total pot $0.25 | Rake $0 
Seat 1: Lucky HoBBiT (button) folded before Flop (didn't bet)
Seat 2: ChefRocco (small blind) folded before Flop
Seat 3: nantes15 (big blind) folded before Flop
Seat 4: 8th wonders collected ($0.25)
Seat 5: RoJ1 folded before Flop (didn't bet)
Seat 6: Goroshkos88 folded before Flop (didn't bet)



PokerStars Hand #166667890530:  Hold'em No Limit ($0.05/$0.10 USD) - 2017/02/23 16:09:24 ET
Table 'Hunnia' 6-max Seat #1 is the button
Seat 1: univibe68 ($21.18 in chips) 
Seat 2: mhonielsen ($10.99 in chips) 
Seat 3: 6ePeMeHHa9 ($10.56 in chips) 
Seat 4: Jalida3 ($11.88 in chips) 
Seat 5: Smarkon ($14.74 in chips) 
Seat 6: ChuikaPridi ($11.29 in chips) 
mhonielsen: posts small blind $0.05
6ePeMeHHa9: posts big blind $0.10
*** HOLE CARDS ***
Jalida3: folds 
Smarkon: folds 
ChuikaPridi: folds 
univibe68: folds 
mhonielsen: raises $0.20 to $0.30
6ePeMeHHa9: folds 
Uncalled bet ($0.20) returned to mhonielsen
mhonielsen collected $0.20 from pot
*** SUMMARY ***
Total pot $0.20 | Rake $0 
Seat 1: univibe68 (button) folded before Flop (didn't bet)
Seat 2: mhonielsen (small blind) collected ($0.20)
Seat 3: 6ePeMeHHa9 (big blind) folded before Flop
Seat 4: Jalida3 folded before Flop (didn't bet)
Seat 5: Smarkon folded before Flop (didn't bet)
Seat 6: ChuikaPridi folded before Flop (didn't bet)



PokerStars Hand #166667890731:  Hold'em No Limit ($0.05/$0.10 USD) - 2017/02/23 16:09:24 ET
Table 'Gaika II' 6-max Seat #4 is the button
Seat 1: Ice_Isayev ($10 in chips) 
Seat 2: steepfell ($11.86 in chips) 
Seat 3: iDecMate ($18.73 in chips) 
Seat 4: Hyd SK ($10.43 in chips) 
Seat 5: KokoulinV ($12.61 in chips) 
Seat 6: bartabs2 ($8.87 in chips) 
KokoulinV: posts small blind $0.05
bartabs2: posts big blind $0.10
*** HOLE CARDS ***
Ice_Isayev: folds 
steepfell: raises $0.20 to $0.30
iDecMate: folds 
Hyd SK: folds 
KokoulinV: folds 
bartabs2: folds 
Uncalled bet ($0.20) returned to steepfell
steepfell collected $0.25 from pot
*** SUMMARY ***
Total pot $0.25 | Rake $0 
Seat 1: Ice_Isayev folded before Flop (didn't bet)
Seat 2: steepfell collected ($0.25)
Seat 3: iDecMate folded before Flop (didn't bet)
Seat 4: Hyd SK (button) folded before Flop (didn't bet)
Seat 5: KokoulinV (small blind) folded before Flop
Seat 6: bartabs2 (big blind) folded before Flop



PokerStars Hand #166667890734:  Hold'em No Limit ($0.05/$0.10 USD) - 2017/02/23 16:09:24 ET
Table 'Selinur' 6-max Seat #6 is the button
Seat 1: KA3AXCTAHEU, ($10.05 in chips) 
Seat 2: hoedje72 ($7.22 in chips) 
Seat 5: DrVzad ($9.85 in chips) 
Seat 6: homelessdan ($18.50 in chips) 
KA3AXCTAHEU,: posts small blind $0.05
hoedje72: posts big blind $0.10
bambolejro: sits out 
*** HOLE CARDS ***
DrVzad: raises $0.20 to $0.30
ThuyeTD11 joins the table at seat #4 
homelessdan: folds 
KA3AXCTAHEU,: folds 
hoedje72: folds 
Uncalled bet ($0.20) returned to DrVzad
DrVzad collected $0.25 from pot
*** SUMMARY ***
Total pot $0.25 | Rake $0 
Seat 1: KA3AXCTAHEU, (small blind) folded before Flop
Seat 2: hoedje72 (big blind) folded before Flop
Seat 5: DrVzad collected ($0.25)
Seat 6: homelessdan (button) folded before Flop (didn't bet)



PokerStars Hand #166667891073:  Hold'em No Limit ($0.05/$0.10 USD) - 2017/02/23 16:09:24 ET
Table 'Lesath III' 6-max Seat #2 is the button
Seat 1: Gogeta26 ($6.59 in chips) 
Seat 2: WinninBikini ($10.17 in chips) 
Seat 3: Giyorod ($10.56 in chips) 
Seat 4: Eddys Edge ($10.66 in chips) 
Seat 5: eniksenik ($15.85 in chips) 
Seat 6: patrick19111 ($10.21 in chips) 
Giyorod: posts small blind $0.05
Eddys Edge: posts big blind $0.10
*** HOLE CARDS ***
eniksenik: folds 
patrick19111: folds 
Gogeta26: raises $0.30 to $0.40
WinninBikini: folds 
Giyorod: folds 
Eddys Edge: calls $0.30
*** FLOP *** [Th 9c 8h]
Eddys Edge: checks 
Gogeta26: checks 
*** TURN *** [Th 9c 8h] [As]
Eddys Edge: checks 
Gogeta26: checks 
*** RIVER *** [Th 9c 8h As] [Jc]
Eddys Edge: checks 
Gogeta26: checks 
*** SHOW DOWN ***
Eddys Edge: shows [6s 6c] (a pair of Sixes)
Gogeta26: shows [Ad 4s] (a pair of Aces)
Gogeta26 collected $0.81 from pot
*** SUMMARY ***
Total pot $0.85 | Rake $0.04 
Board [Th 9c 8h As Jc]
Seat 1: Gogeta26 showed [Ad 4s] and won ($0.81) with a pair of Aces
Seat 2: WinninBikini (button) folded before Flop (didn't bet)
Seat 3: Giyorod (small blind) folded before Flop
Seat 4: Eddys Edge (big blind) showed [6s 6c] and lost with a pair of Sixes
Seat 5: eniksenik folded before Flop (didn't bet)
Seat 6: patrick19111 folded before Flop (didn't bet)



PokerStars Hand #166667891192:  Hold'em No Limit ($0.05/$0.10 USD) - 2017/02/23 16:09:25 ET
Table 'Nekkar' 6-max Seat #5 is the button
Seat 1: aapokerkot ($11.97 in chips) 
Seat 2: Bird et al ($10.87 in chips) 
Seat 3: Zemz_Ru ($15.56 in chips) 
Seat 4: kingartur222 ($11.20 in chips) 
Seat 5: Vrinni ($13.54 in chips) 
Seat 6: Eddys Edge ($10.38 in chips) 
Eddys Edge: posts small blind $0.05
aapokerkot: posts big blind $0.10
*** HOLE CARDS ***
Bird et al: folds 
Zemz_Ru: raises $0.20 to $0.30
kingartur222: raises $0.60 to $0.90
Vrinni: folds 
Eddys Edge: folds 
aapokerkot is disconnected 
aapokerkot is connected 
aapokerkot: folds 
Zemz_Ru: calls $0.60
*** FLOP *** [9h Ts 4s]
Zemz_Ru: checks 
kingartur222: bets $1.39
Zemz_Ru: folds 
Uncalled bet ($1.39) returned to kingartur222
kingartur222 collected $1.86 from pot
*** SUMMARY ***
Total pot $1.95 | Rake $0.09 
Board [9h Ts 4s]
Seat 1: aapokerkot (big blind) folded before Flop
Seat 2: Bird et al folded before Flop (didn't bet)
Seat 3: Zemz_Ru folded on the Flop
Seat 4: kingartur222 collected ($1.86)
Seat 5: Vrinni (button) folded before Flop (didn't bet)
Seat 6: Eddys Edge (small blind) folded before Flop



PokerStars Hand #166667891286:  Hold'em No Limit ($0.05/$0.10 USD) - 2017/02/23 16:09:25 ET
Table 'Gyldenia II' 6-max Seat #5 is the button
Seat 1: KokoulinV ($11.59 in chips) 
Seat 5: CHRO8 ($15.42 in chips) 
Seat 6: 8th wonders ($11.68 in chips) 
8th wonders: posts small blind $0.05
KokoulinV: posts big blind $0.10
mhonielsen: sits out 
*** HOLE CARDS ***
RoJ1 leaves the table
CHRO8: raises $0.20 to $0.30
Kow6oy joins the table at seat #2 
8th wonders: folds 
KokoulinV: folds 
Uncalled bet ($0.20) returned to CHRO8
CHRO8 collected $0.25 from pot
*** SUMMARY ***
Total pot $0.25 | Rake $0 
Seat 1: KokoulinV (big blind) folded before Flop
Seat 5: CHRO8 (button) collected ($0.25)
Seat 6: 8th wonders (small blind) folded before Flop



PokerStars Hand #166667891473:  Hold'em No Limit ($0.05/$0.10 USD) - 2017/02/23 16:09:25 ET
Table 'Alzirr II' 6-max Seat #2 is the button
Seat 1: KA3AXCTAHEU, ($10.62 in chips) 
Seat 2: popypaleta ($10 in chips) 
Seat 3: devon_red ($7.40 in chips) 
Seat 5: yodzik ($6.08 in chips) 
Seat 6: AM-L-SL ($4.43 in chips) 
devon_red: posts small blind $0.05
yodzik: posts big blind $0.10
*** HOLE CARDS ***
AM-L-SL: calls $0.10
KA3AXCTAHEU,: folds 
popypaleta: raises $0.40 to $0.50
devon_red: folds 
yodzik: folds 
AM-L-SL: folds 
Uncalled bet ($0.40) returned to popypaleta
popypaleta collected $0.35 from pot
*** SUMMARY ***
Total pot $0.35 | Rake $0 
Seat 1: KA3AXCTAHEU, folded before Flop (didn't bet)
Seat 2: popypaleta (button) collected ($0.35)
Seat 3: devon_red (small blind) folded before Flop
Seat 5: yodzik (big blind) folded before Flop
Seat 6: AM-L-SL folded before Flop



PokerStars Hand #166667891545:  Hold'em No Limit ($0.05/$0.10 USD) - 2017/02/23 16:09:25 ET
Table 'Epimetheus' 6-max Seat #6 is the button
Seat 1: 6ePeMeHHa9 ($10.34 in chips) 
Seat 2: patrick19111 ($15.51 in chips) 
Seat 3: dineldidi ($9.84 in chips) 
Seat 4: Namhkal ($10 in chips) 
Seat 5: afca128 ($24.18 in chips) 
Seat 6: voledy ($10.45 in chips) 
6ePeMeHHa9: posts small blind $0.05
patrick19111: posts big blind $0.10
*** HOLE CARDS ***
dineldidi: folds 
Namhkal: folds 
afca128 has timed out
afca128: folds 
voledy: raises $0.15 to $0.25
6ePeMeHHa9 is disconnected 
6ePeMeHHa9 is connected 
6ePeMeHHa9: folds 
patrick19111: raises $0.65 to $0.90
voledy: folds 
Uncalled bet ($0.65) returned to patrick19111
patrick19111 collected $0.55 from pot
*** SUMMARY ***
Total pot $0.55 | Rake $0 
Seat 1: 6ePeMeHHa9 (small blind) folded before Flop
Seat 2: patrick19111 (big blind) collected ($0.55)
Seat 3: dineldidi folded before Flop (didn't bet)
Seat 4: Namhkal folded before Flop (didn't bet)
Seat 5: afca128 folded before Flop (didn't bet)
Seat 6: voledy (button) folded before Flop



PokerStars Hand #166667891696:  Hold'em No Limit ($0.05/$0.10 USD) - 2017/02/23 16:09:25 ET
Table 'Hirons' 6-max Seat #4 is the button
Seat 1: RoJ1 ($12.34 in chips) 
Seat 2: coolisses111 ($7.64 in chips) 
Seat 3: czeczen7 ($14.41 in chips) 
Seat 4: Smitty03300 ($10.35 in chips) 
Seat 5: Pekaml ($10.04 in chips) 
Seat 6: garigura ($13.63 in chips) 
Pekaml: posts small blind $0.05
garigura: posts big blind $0.10
*** HOLE CARDS ***
RoJ1: folds 
coolisses111: raises $0.20 to $0.30
czeczen7: calls $0.30
Smitty03300: calls $0.30
Pekaml: folds 
garigura: folds 
*** FLOP *** [7s 5s 6c]
coolisses111: checks 
czeczen7: checks 
Smitty03300: checks 
*** TURN *** [7s 5s 6c] [4s]
coolisses111: checks 
czeczen7: checks 
Smitty03300: bets $0.65
coolisses111: folds 
czeczen7: folds 
Uncalled bet ($0.65) returned to Smitty03300
Smitty03300 collected $1 from pot
*** SUMMARY ***
Total pot $1.05 | Rake $0.05 
Board [7s 5s 6c 4s]
Seat 1: RoJ1 folded before Flop (didn't bet)
Seat 2: coolisses111 folded on the Turn
Seat 3: czeczen7 folded on the Turn
Seat 4: Smitty03300 (button) collected ($1)
Seat 5: Pekaml (small blind) folded before Flop
Seat 6: garigura (big blind) folded before Flop



PokerStars Hand #166667891821:  Hold'em No Limit ($0.05/$0.10 USD) - 2017/02/23 16:09:25 ET
Table 'Oongaq' 6-max Seat #6 is the button
Seat 1: Dmitrij218 ($13.94 in chips) 
Seat 2: homelessdan ($18.40 in chips) 
Seat 3: iDecMate ($10.46 in chips) 
Seat 4: Bird et al ($10 in chips) 
Seat 5: Dizzler1991 ($5.13 in chips) 
Seat 6: boxer821 ($10 in chips) 
Dmitrij218: posts small blind $0.05
homelessdan: posts big blind $0.10
*** HOLE CARDS ***
iDecMate: folds 
Bird et al: folds 
Dizzler1991: calls $0.10
boxer821: folds 
Dmitrij218: folds 
homelessdan: checks 
*** FLOP *** [3d 5d Tc]
homelessdan: checks 
Dizzler1991: checks 
*** TURN *** [3d 5d Tc] [Kh]
homelessdan: checks 
Dizzler1991: checks 
*** RIVER *** [3d 5d Tc Kh] [Jd]
homelessdan: checks 
Dizzler1991: bets $0.10
homelessdan: folds 
Uncalled bet ($0.10) returned to Dizzler1991
Dizzler1991 collected $0.24 from pot
*** SUMMARY ***
Total pot $0.25 | Rake $0.01 
Board [3d 5d Tc Kh Jd]
Seat 1: Dmitrij218 (small blind) folded before Flop
Seat 2: homelessdan (big blind) folded on the River
Seat 3: iDecMate folded before Flop (didn't bet)
Seat 4: Bird et al folded before Flop (didn't bet)
Seat 5: Dizzler1991 collected ($0.24)
Seat 6: boxer821 (button) folded before Flop (didn't bet)



PokerStars Hand #166667891845:  Hold'em No Limit ($0.05/$0.10 USD) - 2017/02/23 16:09:25 ET
Table 'Iapetus III' 6-max Seat #5 is the button
Seat 1: Czezar Life ($6.35 in chips) 
Seat 2: Crafty23@PS ($10 in chips) 
Seat 3: Goroshkos88 ($10.70 in chips) 
Seat 4: Raggibest ($8.07 in chips) 
Seat 5: homelessdan ($15.49 in chips) 
Seat 6: tauronex ($10.15 in chips) 
tauronex: posts small blind $0.05
Czezar Life: posts big blind $0.10
*** HOLE CARDS ***
Crafty23@PS: folds 
Goroshkos88: folds 
Raggibest: calls $0.10
homelessdan: folds 
tauronex: folds 
Czezar Life is disconnected 
Czezar Life has timed out while disconnected
Czezar Life: checks 
*** FLOP *** [Jh 3s 5d]
Czezar Life is connected 
Czezar Life: checks 
Raggibest: checks 
*** TURN *** [Jh 3s 5d] [Qs]
Czezar Life: bets $0.20
Raggibest: folds 
Uncalled bet ($0.20) returned to Czezar Life
Czezar Life collected $0.24 from pot
*** SUMMARY ***
Total pot $0.25 | Rake $0.01 
Board [Jh 3s 5d Qs]
Seat 1: Czezar Life (big blind) collected ($0.24)
Seat 2: Crafty23@PS folded before Flop (didn't bet)
Seat 3: Goroshkos88 folded before Flop (didn't bet)
Seat 4: Raggibest folded on the Turn
Seat 5: homelessdan (button) folded before Flop (didn't bet)
Seat 6: tauronex (small blind) folded before Flop



PokerStars Hand #166667892225:  Hold'em No Limit ($0.05/$0.10 USD) - 2017/02/23 16:09:26 ET
Table 'Cuyo' 6-max Seat #2 is the button
Seat 1: Bandyaev ($11.54 in chips) 
Seat 2: Therodorus ($10.10 in chips) 
Seat 3: Hergie88 ($9 in chips) 
Seat 4: bambolejro ($10 in chips) 
Seat 6: iluzja12 ($9.70 in chips) 
Hergie88: posts small blind $0.05
bambolejro: posts big blind $0.10
DrVzad: sits out 
*** HOLE CARDS ***
iluzja12: folds 
Bandyaev: folds 
Therodorus: raises $0.15 to $0.25
Hergie88: calls $0.20
bambolejro: folds 
*** FLOP *** [5s Js Tc]
Hergie88: bets $0.30
Therodorus: folds 
Uncalled bet ($0.30) returned to Hergie88
Hergie88 collected $0.57 from pot
*** SUMMARY ***
Total pot $0.60 | Rake $0.03 
Board [5s Js Tc]
Seat 1: Bandyaev folded before Flop (didn't bet)
Seat 2: Therodorus (button) folded on the Flop
Seat 3: Hergie88 (small blind) collected ($0.57)
Seat 4: bambolejro (big blind) folded before Flop
Seat 6: iluzja12 folded before Flop (didn't bet)



PokerStars Hand #166667892582:  Hold'em No Limit ($0.05/$0.10 USD) - 2017/02/23 16:09:26 ET
Table 'Tomyris II' 6-max Seat #5 is the button
Seat 1: ArcticBearDK ($21.83 in chips) 
Seat 2: Yspenyanin ($12.62 in chips) 
Seat 3: robertsabb ($12.13 in chips) 
Seat 4: Dcaro31 ($10 in chips) 
Seat 5: 6ePeMeHHa9 ($11.80 in chips) 
Seat 6: StackSmakka ($9.94 in chips) 
StackSmakka: posts small blind $0.05
ArcticBearDK: posts big blind $0.10
*** HOLE CARDS ***
Yspenyanin: folds 
robertsabb: raises $0.10 to $0.20
Dcaro31: folds 
6ePeMeHHa9: folds 
StackSmakka: folds 
ArcticBearDK: calls $0.10
*** FLOP *** [2c 6c 5c]
ArcticBearDK: checks 
robertsabb: checks 
*** TURN *** [2c 6c 5c] [9d]
ArcticBearDK: bets $0.30
robertsabb: raises $0.30 to $0.60
ArcticBearDK: folds 
Uncalled bet ($0.30) returned to robertsabb
robertsabb collected $1 from pot
*** SUMMARY ***
Total pot $1.05 | Rake $0.05 
Board [2c 6c 5c 9d]
Seat 1: ArcticBearDK (big blind) folded on the Turn
Seat 2: Yspenyanin folded before Flop (didn't bet)
Seat 3: robertsabb collected ($1)
Seat 4: Dcaro31 folded before Flop (didn't bet)
Seat 5: 6ePeMeHHa9 (button) folded before Flop (didn't bet)
Seat 6: StackSmakka (small blind) folded before Flop



PokerStars Hand #166667892768:  Hold'em No Limit ($0.05/$0.10 USD) - 2017/02/23 16:09:26 ET
Table 'Arkab' 6-max Seat #1 is the button
Seat 1: iamkakaroto ($10 in chips) 
Seat 2: aktion4ik ($12.29 in chips) 
Seat 3: sexy_seagull ($10 in chips) 
Seat 5: OrionYusupov ($9.83 in chips) 
Seat 6: MihaGr ($11.20 in chips) 
aktion4ik: posts small blind $0.05
sexy_seagull: posts big blind $0.10
dincimus: sits out 
*** HOLE CARDS ***
OrionYusupov: calls $0.10
MihaGr: folds 
iamkakaroto: folds 
aktion4ik: folds 
sexy_seagull: raises $0.30 to $0.40
OrionYusupov: calls $0.30
*** FLOP *** [Ks 2d 4d]
sexy_seagull: checks 
OrionYusupov: checks 
*** TURN *** [Ks 2d 4d] [8d]
sexy_seagull: checks 
OrionYusupov: checks 
*** RIVER *** [Ks 2d 4d 8d] [5s]
sexy_seagull: checks 
OrionYusupov: checks 
*** SHOW DOWN ***
sexy_seagull: shows [9h 9s] (a pair of Nines)
OrionYusupov: mucks hand 
sexy_seagull collected $0.81 from pot
*** SUMMARY ***
Total pot $0.85 | Rake $0.04 
Board [Ks 2d 4d 8d 5s]
Seat 1: iamkakaroto (button) folded before Flop (didn't bet)
Seat 2: aktion4ik (small blind) folded before Flop
Seat 3: sexy_seagull (big blind) showed [9h 9s] and won ($0.81) with a pair of Nines
Seat 5: OrionYusupov mucked
Seat 6: MihaGr folded before Flop (didn't bet)



PokerStars Hand #166667892880:  Hold'em No Limit ($0.05/$0.10 USD) - 2017/02/23 16:09:26 ET
Table 'Juliet II' 6-max Seat #1 is the button
Seat 1: alexpolevaja ($11.14 in chips) 
Seat 2: KA3AXCTAHEU, ($15.58 in chips) 
Seat 3: patrick19111 ($11.42 in chips) 
Seat 4: x3ultimate ($10.55 in chips) 
Seat 5: Dcaro31 ($19.91 in chips) 
Seat 6: BookWorm78 ($31.48 in chips) 
KA3AXCTAHEU,: posts small blind $0.05
patrick19111: posts big blind $0.10
*** HOLE CARDS ***
x3ultimate: folds 
Dcaro31: raises $0.20 to $0.30
BookWorm78: folds 
alexpolevaja: folds 
KA3AXCTAHEU,: folds 
patrick19111: folds 
Uncalled bet ($0.20) returned to Dcaro31
Dcaro31 collected $0.25 from pot
*** SUMMARY ***
Total pot $0.25 | Rake $0 
Seat 1: alexpolevaja (button) folded before Flop (didn't bet)
Seat 2: KA3AXCTAHEU, (small blind) folded before Flop
Seat 3: patrick19111 (big blind) folded before Flop
Seat 4: x3ultimate folded before Flop (didn't bet)
Seat 5: Dcaro31 collected ($0.25)
Seat 6: BookWorm78 folded before Flop (didn't bet)



PokerStars Hand #166667893054:  Hold'em No Limit ($0.05/$0.10 USD) - 2017/02/23 16:09:27 ET
Table 'Tristan III' 6-max Seat #6 is the button
Seat 1: CHRO8 ($19.09 in chips) 
Seat 2: Hyd SK ($13.88 in chips) 
Seat 3: fedorka rus ($26.67 in chips) 
Seat 4: Feverhead ($11.18 in chips) 
Seat 6: fredrik10528 ($9.95 in chips) 
CHRO8: posts small blind $0.05
Hyd SK: posts big blind $0.10
*** HOLE CARDS ***
fedorka rus: raises $0.20 to $0.30
Feverhead: folds 
fredrik10528: calls $0.30
david_sara83 leaves the table
CHRO8: folds 
RoJ1 joins the table at seat #5 
Hyd SK: raises $1.10 to $1.40
fedorka rus: folds 
fredrik10528: folds 
Uncalled bet ($1.10) returned to Hyd SK
Hyd SK collected $0.95 from pot
*** SUMMARY ***
Total pot $0.95 | Rake $0 
Seat 1: CHRO8 (small blind) folded before Flop
Seat 2: Hyd SK (big blind) collected ($0.95)
Seat 3: fedorka rus folded before Flop
Seat 4: Feverhead folded before Flop (didn't bet)
Seat 6: fredrik10528 (button) folded before Flop



PokerStars Hand #166667893091:  Hold'em No Limit ($0.05/$0.10 USD) - 2017/02/23 16:09:27 ET
Table 'Peiroos III' 6-max Seat #4 is the button
Seat 1: tequila_joop ($9.59 in chips) 
Seat 3: nabatov.m ($6.22 in chips) 
Seat 4: pivanki11 ($10.49 in chips) 
Seat 5: ChuikaPridi ($10.77 in chips) 
Seat 6: CHRO8 ($10.64 in chips) 
ChuikaPridi: posts small blind $0.05
CHRO8: posts big blind $0.10
Goovr: sits out 
tequila_joop: posts the ante $0.02
nabatov.m: posts the ante $0.02
pivanki11: posts the ante $0.02
ChuikaPridi: posts the ante $0.02
CHRO8: posts the ante $0.02
*** HOLE CARDS ***
tequila_joop: folds 
nabatov.m: raises $0.10 to $0.20
pivanki11: raises $0.40 to $0.60
ChuikaPridi: folds 
CHRO8: folds 
nabatov.m: calls $0.40
*** FLOP *** [8h 3s Jd]
nabatov.m: bets $1.38
pivanki11: raises $4.12 to $5.50
nabatov.m: folds 
Uncalled bet ($4.12) returned to pivanki11
pivanki11 collected $4.02 from pot
*** SUMMARY ***
Total pot $4.21 | Rake $0.19 
Board [8h 3s Jd]
Seat 1: tequila_joop folded before Flop (didn't bet)
Seat 3: nabatov.m folded on the Flop
Seat 4: pivanki11 (button) collected ($4.02)
Seat 5: ChuikaPridi (small blind) folded before Flop
Seat 6: CHRO8 (big blind) folded before Flop



PokerStars Hand #166667893131:  Hold'em No Limit ($0.05/$0.10 USD) - 2017/02/23 16:09:27 ET
Table 'Isberga' 6-max Seat #1 is the button
Seat 1: Feverhead ($18.22 in chips) 
Seat 2: GESPERIA ($10.27 in chips) 
Seat 3: HARDCORE66RU ($11.13 in chips) 
Seat 4: THIMUCHIN ($10.79 in chips) 
Seat 6: Goroshkos88 ($21.56 in chips) 
GESPERIA: posts small blind $0.05
HARDCORE66RU: posts big blind $0.10
*** HOLE CARDS ***
THIMUCHIN: folds 
Goroshkos88: folds 
Feverhead: folds 
GESPERIA: raises $0.20 to $0.30
HARDCORE66RU: folds 
Uncalled bet ($0.20) returned to GESPERIA
GESPERIA collected $0.20 from pot
*** SUMMARY ***
Total pot $0.20 | Rake $0 
Seat 1: Feverhead (button) folded before Flop (didn't bet)
Seat 2: GESPERIA (small blind) collected ($0.20)
Seat 3: HARDCORE66RU (big blind) folded before Flop
Seat 4: THIMUCHIN folded before Flop (didn't bet)
Seat 6: Goroshkos88 folded before Flop (didn't bet)



PokerStars Hand #166667893278:  Hold'em No Limit ($0.05/$0.10 USD) - 2017/02/23 16:09:27 ET
Table 'Wil' 6-max Seat #6 is the button
Seat 1: jwhelan94 ($23.44 in chips) 
Seat 2: Vrinni ($21.95 in chips) 
Seat 3: Namhkal ($10 in chips) 
Seat 4: x3ultimate ($10 in chips) 
Seat 5: Feverhead ($14.78 in chips) 
Seat 6: Comeback3392 ($13.63 in chips) 
jwhelan94: posts small blind $0.05
Vrinni: posts big blind $0.10
*** HOLE CARDS ***
Namhkal: raises $0.15 to $0.25
x3ultimate: folds 
Feverhead: folds 
Comeback3392: folds 
jwhelan94: raises $0.45 to $0.70
Vrinni: folds 
Namhkal: calls $0.45
*** FLOP *** [Kd 8h 3s]
jwhelan94: bets $1
Namhkal: folds 
Uncalled bet ($1) returned to jwhelan94
jwhelan94 collected $1.43 from pot
*** SUMMARY ***
Total pot $1.50 | Rake $0.07 
Board [Kd 8h 3s]
Seat 1: jwhelan94 (small blind) collected ($1.43)
Seat 2: Vrinni (big blind) folded before Flop
Seat 3: Namhkal folded on the Flop
Seat 4: x3ultimate folded before Flop (didn't bet)
Seat 5: Feverhead folded before Flop (didn't bet)
Seat 6: Comeback3392 (button) folded before Flop (didn't bet)



PokerStars Hand #166667893591:  Hold'em No Limit ($0.05/$0.10 USD) - 2017/02/23 16:09:27 ET
Table 'Ushakaron II' 6-max Seat #3 is the button
Seat 1: Kow6oy ($10 in chips) 
Seat 2: Iarlei ($12.44 in chips) 
Seat 3: Rodik002 ($11.22 in chips) 
Seat 4: avintage176 ($29.78 in chips) 
Seat 5: 1limewax1 ($16.23 in chips) 
Seat 6: eniksenik ($10 in chips) 
avintage176: posts small blind $0.05
1limewax1: posts big blind $0.10
*** HOLE CARDS ***
eniksenik: folds 
Kow6oy: raises $0.25 to $0.35
Iarlei: folds 
Rodik002: folds 
avintage176: calls $0.30
1limewax1: calls $0.25
*** FLOP *** [Jd 7h 9d]
avintage176: checks 
1limewax1: checks 
Kow6oy: checks 
*** TURN *** [Jd 7h 9d] [4d]
avintage176: bets $0.60
1limewax1: folds 
Kow6oy: folds 
Uncalled bet ($0.60) returned to avintage176
avintage176 collected $1 from pot
*** SUMMARY ***
Total pot $1.05 | Rake $0.05 
Board [Jd 7h 9d 4d]
Seat 1: Kow6oy folded on the Turn
Seat 2: Iarlei folded before Flop (didn't bet)
Seat 3: Rodik002 (button) folded before Flop (didn't bet)
Seat 4: avintage176 (small blind) collected ($1)
Seat 5: 1limewax1 (big blind) folded on the Turn
Seat 6: eniksenik folded before Flop (didn't bet)



PokerStars Hand #166667893759:  Hold'em No Limit ($0.05/$0.10 USD) - 2017/02/23 16:09:27 ET
Table 'Siebohme' 6-max Seat #1 is the button
Seat 1: kusa4ki ($11.53 in chips) 
Seat 2: el toro 1507 ($11.28 in chips) 
Seat 3: ex3Lero86 ($10.41 in chips) 
Seat 5: Kazacha ($10 in chips) 
Seat 6: townerz1991 ($10.28 in chips) 
el toro 1507: posts small blind $0.05
ex3Lero86: posts big blind $0.10
Kow6oy: sits out 
*** HOLE CARDS ***
Kazacha: folds 
townerz1991: folds 
kusa4ki: folds 
el toro 1507: raises $0.10 to $0.20
ex3Lero86: calls $0.10
*** FLOP *** [Td 6d 9c]
el toro 1507: checks 
ex3Lero86: bets $0.25
el toro 1507: calls $0.25
*** TURN *** [Td 6d 9c] [Ks]
el toro 1507: checks 
ex3Lero86: bets $0.58
el toro 1507: raises $0.78 to $1.36
ex3Lero86: raises $1.86 to $3.22
el toro 1507: raises $7.61 to $10.83 and is all-in
ex3Lero86: calls $6.74 and is all-in
Uncalled bet ($0.87) returned to el toro 1507
*** RIVER *** [Td 6d 9c Ks] [5d]
*** SHOW DOWN ***
el toro 1507: shows [Tc Ts] (three of a kind, Tens)
ex3Lero86: shows [8c 7d] (a straight, Six to Ten)
ex3Lero86 collected $19.88 from pot
*** SUMMARY ***
Total pot $20.82 | Rake $0.94 
Board [Td 6d 9c Ks 5d]
Seat 1: kusa4ki (button) folded before Flop (didn't bet)
Seat 2: el toro 1507 (small blind) showed [Tc Ts] and lost with three of a kind, Tens
Seat 3: ex3Lero86 (big blind) showed [8c 7d] and won ($19.88) with a straight, Six to Ten
Seat 5: Kazacha folded before Flop (didn't bet)
Seat 6: townerz1991 folded before Flop (didn't bet)



PokerStars Hand #166667893797:  Hold'em No Limit ($0.05/$0.10 USD) - 2017/02/23 16:09:27 ET
Table 'Girtab' 6-max Seat #3 is the button
Seat 1: pokekrk ($17.07 in chips) 
Seat 2: MühliJr ($10.51 in chips) 
Seat 3: kingartur222 ($10.30 in chips) 
Seat 4: Hyd SK ($10.63 in chips) 
Seat 5: sexy_seagull ($11.20 in chips) 
Seat 6: iluzja12 ($10 in chips) 
Hyd SK: posts small blind $0.05
sexy_seagull: posts big blind $0.10
*** HOLE CARDS ***
iluzja12: folds 
pokekrk: folds 
MühliJr: folds 
kingartur222: raises $0.15 to $0.25
Hyd SK: raises $0.75 to $1
sexy_seagull: folds 
kingartur222: folds 
Uncalled bet ($0.75) returned to Hyd SK
Hyd SK collected $0.60 from pot
*** SUMMARY ***
Total pot $0.60 | Rake $0 
Seat 1: pokekrk folded before Flop (didn't bet)
Seat 2: MühliJr folded before Flop (didn't bet)
Seat 3: kingartur222 (button) folded before Flop
Seat 4: Hyd SK (small blind) collected ($0.60)
Seat 5: sexy_seagull (big blind) folded before Flop
Seat 6: iluzja12 folded before Flop (didn't bet)



PokerStars Hand #166667894435:  Hold'em No Limit ($0.05/$0.10 USD) - 2017/02/23 16:09:28 ET
Table 'Tyche III' 6-max Seat #5 is the button
Seat 1: milt65 ($9.66 in chips) 
Seat 3: ChuikaPridi ($10 in chips) 
Seat 4: Kazacha ($10.87 in chips) 
Seat 5: chimera252 ($14.36 in chips) 
Seat 6: Ice_Isayev ($10 in chips) 
Ice_Isayev: posts small blind $0.05
milt65: posts big blind $0.10
arti192837: sits out 
*** HOLE CARDS ***
ChuikaPridi: folds 
Kazacha: raises $0.14 to $0.24
chimera252: folds 
Ice_Isayev: folds 
milt65: raises $0.56 to $0.80
Kazacha: folds 
Uncalled bet ($0.56) returned to milt65
milt65 collected $0.53 from pot
*** SUMMARY ***
Total pot $0.53 | Rake $0 
Seat 1: milt65 (big blind) collected ($0.53)
Seat 3: ChuikaPridi folded before Flop (didn't bet)
Seat 4: Kazacha folded before Flop
Seat 5: chimera252 (button) folded before Flop (didn't bet)
Seat 6: Ice_Isayev (small blind) folded before Flop



PokerStars Hand #166667894747:  Hold'em No Limit ($0.05/$0.10 USD) - 2017/02/23 16:09:28 ET
Table 'Carina' 6-max Seat #4 is the button
Seat 1: Kupi007 ($10 in chips) 
Seat 3: LarryTheStar ($12.59 in chips) 
Seat 4: steepfell ($10.56 in chips) 
Seat 5: IAntikI ($10 in chips) 
Seat 6: alexweezer ($7.73 in chips) 
IAntikI: posts small blind $0.05
alexweezer: posts big blind $0.10
XwinX25: sits out 
*** HOLE CARDS ***
Kupi007: folds 
LarryTheStar: folds 
steepfell: folds 
IAntikI: raises $0.15 to $0.25
alexweezer: calls $0.15
*** FLOP *** [2d 9h Ac]
IAntikI: bets $0.26
alexweezer: folds 
Uncalled bet ($0.26) returned to IAntikI
IAntikI collected $0.48 from pot
*** SUMMARY ***
Total pot $0.50 | Rake $0.02 
Board [2d 9h Ac]
Seat 1: Kupi007 folded before Flop (didn't bet)
Seat 3: LarryTheStar folded before Flop (didn't bet)
Seat 4: steepfell (button) folded before Flop (didn't bet)
Seat 5: IAntikI (small blind) collected ($0.48)
Seat 6: alexweezer (big blind) folded on the Flop



PokerStars Hand #166667894848:  Hold'em No Limit ($0.05/$0.10 USD) - 2017/02/23 16:09:29 ET
Table 'Goto II' 6-max Seat #3 is the button
Seat 1: FRAID358 ($12.01 in chips) 
Seat 2: 6ePeMeHHa9 ($11.67 in chips) 
Seat 3: Goroshkos88 ($11.41 in chips) 
Seat 4: KRZuff ($13.66 in chips) 
Seat 5: RoJ1 ($14.50 in chips) 
Seat 6: ermananb93 ($11.01 in chips) 
KRZuff: posts small blind $0.05
RoJ1: posts big blind $0.10
*** HOLE CARDS ***
ermananb93: folds 
FRAID358: folds 
6ePeMeHHa9: raises $0.18 to $0.28
Goroshkos88: calls $0.28
KRZuff: folds 
RoJ1: folds 
*** FLOP *** [9s Kh 9d]
6ePeMeHHa9 is disconnected 
6ePeMeHHa9 is connected 
6ePeMeHHa9: checks 
Goroshkos88: checks 
*** TURN *** [9s Kh 9d] [Ah]
6ePeMeHHa9: bets $0.60
Goroshkos88: calls $0.60
*** RIVER *** [9s Kh 9d Ah] [Qd]
6ePeMeHHa9: bets $1.50
Goroshkos88: folds 
Uncalled bet ($1.50) returned to 6ePeMeHHa9
6ePeMeHHa9 collected $1.82 from pot
*** SUMMARY ***
Total pot $1.91 | Rake $0.09 
Board [9s Kh 9d Ah Qd]
Seat 1: FRAID358 folded before Flop (didn't bet)
Seat 2: 6ePeMeHHa9 collected ($1.82)
Seat 3: Goroshkos88 (button) folded on the River
Seat 4: KRZuff (small blind) folded before Flop
Seat 5: RoJ1 (big blind) folded before Flop
Seat 6: ermananb93 folded before Flop (didn't bet)



PokerStars Hand #166667894889:  Hold'em No Limit ($0.05/$0.10 USD) - 2017/02/23 16:09:29 ET
Table 'Mizar II' 6-max Seat #3 is the button
Seat 1: Cole Jaq ($7.49 in chips) 
Seat 2: rusu_rapid ($10 in chips) 
Seat 3: Therodorus ($10.69 in chips) 
DEraser will be allowed to play after the button
AC Evergreen will be allowed to play after the button
Cole Jaq: posts small blind $0.05
rusu_rapid: posts big blind $0.10
*** HOLE CARDS ***
Pekaml joins the table at seat #6 
Therodorus: raises $0.15 to $0.25
Cole Jaq: calls $0.20
rusu_rapid: calls $0.15
*** FLOP *** [5s 4h 3h]
Cole Jaq: bets $0.10
rusu_rapid: calls $0.10
Therodorus: calls $0.10
*** TURN *** [5s 4h 3h] [7c]
Cole Jaq: bets $0.10
rusu_rapid: raises $0.90 to $1
Therodorus: folds 
Cole Jaq: calls $0.90
*** RIVER *** [5s 4h 3h 7c] [Kh]
Cole Jaq: checks 
rusu_rapid: bets $1.45
Cole Jaq: calls $1.45
*** SHOW DOWN ***
rusu_rapid: shows [6d 5d] (a straight, Three to Seven)
Cole Jaq: shows [Qs 6c] (a straight, Three to Seven)
Cole Jaq collected $2.84 from pot
rusu_rapid collected $2.84 from pot
*** SUMMARY ***
Total pot $5.95 | Rake $0.27 
Board [5s 4h 3h 7c Kh]
Seat 1: Cole Jaq (small blind) showed [Qs 6c] and won ($2.84) with a straight, Three to Seven
Seat 2: rusu_rapid (big blind) showed [6d 5d] and won ($2.84) with a straight, Three to Seven
Seat 3: Therodorus (button) folded on the Turn



PokerStars Hand #166667895151:  Hold'em No Limit ($0.05/$0.10 USD) - 2017/02/23 16:09:29 ET
Table 'Bootes' 6-max Seat #2 is the button
Seat 1: Namhkal ($11.40 in chips) 
Seat 2: Bird et al ($17.31 in chips) 
Seat 3: KA3AXCTAHEU, ($20.66 in chips) 
Seat 4: totonove ($7.03 in chips) 
Seat 5: Pekaml ($15.42 in chips) 
Seat 6: cherep61987 ($10.07 in chips) 
KA3AXCTAHEU,: posts small blind $0.05
totonove: posts big blind $0.10
*** HOLE CARDS ***
Pekaml: folds 
cherep61987: folds 
Namhkal: folds 
Bird et al: raises $0.15 to $0.25
KA3AXCTAHEU,: folds 
totonove: folds 
Uncalled bet ($0.15) returned to Bird et al
Bird et al collected $0.25 from pot
*** SUMMARY ***
Total pot $0.25 | Rake $0 
Seat 1: Namhkal folded before Flop (didn't bet)
Seat 2: Bird et al (button) collected ($0.25)
Seat 3: KA3AXCTAHEU, (small blind) folded before Flop
Seat 4: totonove (big blind) folded before Flop
Seat 5: Pekaml folded before Flop (didn't bet)
Seat 6: cherep61987 folded before Flop (didn't bet)



PokerStars Hand #166667895561:  Hold'em No Limit ($0.05/$0.10 USD) - 2017/02/23 16:09:29 ET
Table 'Kanda' 6-max Seat #6 is the button
Seat 1: Andy Wolf ($11.77 in chips) 
Seat 2: Pelotín ($5.42 in chips) 
Seat 3: XaXaTyH4uK ($10.42 in chips) 
Seat 4: Orlangoor ($10 in chips) 
Seat 5: Dimka4 ($10 in chips) 
Seat 6: oddshoff ($8.91 in chips) 
Andy Wolf: posts small blind $0.05
Pelotín: posts big blind $0.10
*** HOLE CARDS ***
XaXaTyH4uK: folds 
Orlangoor: folds 
Dimka4: raises $0.15 to $0.25
oddshoff: folds 
Andy Wolf: folds 
Pelotín: calls $0.15
*** FLOP *** [Th Tc 5c]
Pelotín: checks 
Dimka4: bets $0.27
Pelotín: folds 
Uncalled bet ($0.27) returned to Dimka4
Dimka4 collected $0.53 from pot
*** SUMMARY ***
Total pot $0.55 | Rake $0.02 
Board [Th Tc 5c]
Seat 1: Andy Wolf (small blind) folded before Flop
Seat 2: Pelotín (big blind) folded on the Flop
Seat 3: XaXaTyH4uK folded before Flop (didn't bet)
Seat 4: Orlangoor folded before Flop (didn't bet)
Seat 5: Dimka4 collected ($0.53)
Seat 6: oddshoff (button) folded before Flop (didn't bet)



PokerStars Hand #166667895588:  Hold'em No Limit ($0.05/$0.10 USD) - 2017/02/23 16:09:29 ET
Table 'Xanthippe II' 6-max Seat #2 is the button
Seat 2: Bird et al ($10.08 in chips) 
Seat 3: Dcaro31 ($14.81 in chips) 
Seat 5: XaXaTyH4uK ($10 in chips) 
Seat 6: Orlangoor ($13.03 in chips) 
Dcaro31: posts small blind $0.05
XaXaTyH4uK: posts big blind $0.10
*** HOLE CARDS ***
Orlangoor: folds 
Bird et al: folds 
Dcaro31: raises $0.20 to $0.30
XaXaTyH4uK: calls $0.20
*** FLOP *** [Ts 7d 3c]
Dcaro31: checks 
XaXaTyH4uK: bets $0.40
Dcaro31: folds 
Uncalled bet ($0.40) returned to XaXaTyH4uK
XaXaTyH4uK collected $0.57 from pot
*** SUMMARY ***
Total pot $0.60 | Rake $0.03 
Board [Ts 7d 3c]
Seat 2: Bird et al (button) folded before Flop (didn't bet)
Seat 3: Dcaro31 (small blind) folded on the Flop
Seat 5: XaXaTyH4uK (big blind) collected ($0.57)
Seat 6: Orlangoor folded before Flop (didn't bet)



PokerStars Hand #166667895766:  Hold'em No Limit ($0.05/$0.10 USD) - 2017/02/23 16:09:30 ET
Table 'Stroobantia II' 6-max Seat #1 is the button
Seat 1: XBrosh ($8.67 in chips) 
Seat 2: IAntikI ($10 in chips) 
Seat 3: 8th wonders ($11.19 in chips) 
Seat 5: Zooplack ($12.61 in chips) 
Seat 6: CHRO8 ($12.17 in chips) 
IAntikI: posts small blind $0.05
8th wonders: posts big blind $0.10
Punzzzer: sits out 
*** HOLE CARDS ***
Zooplack: folds 
CHRO8: folds 
XBrosh: calls $0.10
IAntikI: raises $0.30 to $0.40
8th wonders: folds 
XBrosh: calls $0.30
*** FLOP *** [Jh 8d 5d]
IAntikI: bets $0.60
XBrosh: raises $0.60 to $1.20
IAntikI: folds 
Uncalled bet ($0.60) returned to XBrosh
XBrosh collected $2.01 from pot
*** SUMMARY ***
Total pot $2.10 | Rake $0.09 
Board [Jh 8d 5d]
Seat 1: XBrosh (button) collected ($2.01)
Seat 2: IAntikI (small blind) folded on the Flop
Seat 3: 8th wonders (big blind) folded before Flop
Seat 5: Zooplack folded before Flop (didn't bet)
Seat 6: CHRO8 folded before Flop (didn't bet)



PokerStars Hand #166667896046:  Hold'em No Limit ($0.05/$0.10 USD) - 2017/02/23 16:09:30 ET
Table 'Persephone' 6-max Seat #5 is the button
Seat 1: dragonste89 ($14.60 in chips) 
Seat 2: AM-L-SL ($5.50 in chips) 
Seat 4: 2G28 ($11.21 in chips) 
Seat 5: ab260414 ($10.56 in chips) 
Seat 6: popypaleta ($13.43 in chips) 
popypaleta: posts small blind $0.05
dragonste89: posts big blind $0.10
Mooneye19: sits out 
*** HOLE CARDS ***
AM-L-SL: folds 
2G28: raises $0.15 to $0.25
ab260414: folds 
popypaleta: folds 
dragonste89: folds 
Uncalled bet ($0.15) returned to 2G28
2G28 collected $0.25 from pot
*** SUMMARY ***
Total pot $0.25 | Rake $0 
Seat 1: dragonste89 (big blind) folded before Flop
Seat 2: AM-L-SL folded before Flop (didn't bet)
Seat 4: 2G28 collected ($0.25)
Seat 5: ab260414 (button) folded before Flop (didn't bet)
Seat 6: popypaleta (small blind) folded before Flop



PokerStars Hand #166667896312:  Hold'em No Limit ($0.05/$0.10 USD) - 2017/02/23 16:09:30 ET
Table 'Mesarthim' 6-max Seat #4 is the button
Seat 1: Mancuso2010 ($16.27 in chips) 
Seat 2: MühliJr ($12.99 in chips) 
Seat 3: Damage514 ($9.44 in chips) 
Seat 4: Strelok1974 ($10 in chips) 
Seat 5: Iarlei ($10.20 in chips) 
Seat 6: bdixon_5 ($8.51 in chips) 
Iarlei: posts small blind $0.05
bdixon_5: posts big blind $0.10
*** HOLE CARDS ***
Mancuso2010: folds 
MühliJr: folds 
Damage514: folds 
Strelok1974: folds 
Iarlei: raises $0.20 to $0.30
bdixon_5: folds 
Uncalled bet ($0.20) returned to Iarlei
Iarlei collected $0.20 from pot
*** SUMMARY ***
Total pot $0.20 | Rake $0 
Seat 1: Mancuso2010 folded before Flop (didn't bet)
Seat 2: MühliJr folded before Flop (didn't bet)
Seat 3: Damage514 folded before Flop (didn't bet)
Seat 4: Strelok1974 (button) folded before Flop (didn't bet)
Seat 5: Iarlei (small blind) collected ($0.20)
Seat 6: bdixon_5 (big blind) folded before Flop



PokerStars Hand #166667896523:  Hold'em No Limit ($0.05/$0.10 USD) - 2017/02/23 16:09:30 ET
Table 'Lampetia' 6-max Seat #2 is the button
Seat 1: WinninBikini ($10.18 in chips) 
Seat 2: ex3Lero86 ($10.30 in chips) 
Seat 3: Ice_Isayev ($19.79 in chips) 
Seat 4: Rodik002 ($10 in chips) 
Seat 5: luisantrs ($10.52 in chips) 
Seat 6: Scanner17 ($12.09 in chips) 
Ice_Isayev: posts small blind $0.05
Rodik002: posts big blind $0.10
*** HOLE CARDS ***
luisantrs: folds 
Scanner17: folds 
WinninBikini: raises $0.15 to $0.25
ex3Lero86: folds 
Ice_Isayev: folds 
Rodik002: folds 
Uncalled bet ($0.15) returned to WinninBikini
WinninBikini collected $0.25 from pot
*** SUMMARY ***
Total pot $0.25 | Rake $0 
Seat 1: WinninBikini collected ($0.25)
Seat 2: ex3Lero86 (button) folded before Flop (didn't bet)
Seat 3: Ice_Isayev (small blind) folded before Flop
Seat 4: Rodik002 (big blind) folded before Flop
Seat 5: luisantrs folded before Flop (didn't bet)
Seat 6: Scanner17 folded before Flop (didn't bet)



PokerStars Hand #166667896820:  Hold'em No Limit ($0.05/$0.10 USD) - 2017/02/23 16:09:31 ET
Table 'Lacroute' 6-max Seat #2 is the button
Seat 1: Orlangoor ($10.25 in chips) 
Seat 2: Andy Wolf ($10.54 in chips) 
Seat 4: st4tion ($17.15 in chips) 
Seat 5: steepfell ($10.19 in chips) 
Seat 6: IAntikI ($11.67 in chips) 
st4tion: posts small blind $0.05
steepfell: posts big blind $0.10
*** HOLE CARDS ***
IAntikI: folds 
Orlangoor: folds 
Andy Wolf: folds 
st4tion: calls $0.05
steepfell: checks 
*** FLOP *** [3d Js Td]
st4tion: checks 
steepfell: checks 
*** TURN *** [3d Js Td] [As]
st4tion: checks 
steepfell: checks 
*** RIVER *** [3d Js Td As] [8c]
st4tion: bets $0.10
KOS3573 joins the table at seat #3 
steepfell: folds 
Uncalled bet ($0.10) returned to st4tion
st4tion collected $0.19 from pot
*** SUMMARY ***
Total pot $0.20 | Rake $0.01 
Board [3d Js Td As 8c]
Seat 1: Orlangoor folded before Flop (didn't bet)
Seat 2: Andy Wolf (button) folded before Flop (didn't bet)
Seat 4: st4tion (small blind) collected ($0.19)
Seat 5: steepfell (big blind) folded on the River
Seat 6: IAntikI folded before Flop (didn't bet)



PokerStars Hand #166667896852:  Hold'em No Limit ($0.05/$0.10 USD) - 2017/02/23 16:09:31 ET
Table 'California II' 6-max Seat #5 is the button
Seat 2: homelessdan ($10 in chips) 
Seat 3: Bird et al ($10 in chips) 
Seat 4: pokekrk ($13.97 in chips) 
Seat 5: Nikolai77798 ($3.90 in chips) 
Seat 6: chiko4040 ($8.88 in chips) 
chiko4040: posts small blind $0.05
fedorka rus: is sitting out 
homelessdan: posts big blind $0.10
*** HOLE CARDS ***
Bird et al: folds 
pokekrk: folds 
Nikolai77798: calls $0.10
chiko4040: folds 
homelessdan: checks 
*** FLOP *** [2s 6c Kc]
homelessdan: checks 
Nikolai77798: bets $0.10
homelessdan: folds 
Uncalled bet ($0.10) returned to Nikolai77798
Nikolai77798 collected $0.24 from pot
*** SUMMARY ***
Total pot $0.25 | Rake $0.01 
Board [2s 6c Kc]
Seat 2: homelessdan (big blind) folded on the Flop
Seat 3: Bird et al folded before Flop (didn't bet)
Seat 4: pokekrk folded before Flop (didn't bet)
Seat 5: Nikolai77798 (button) collected ($0.24)
Seat 6: chiko4040 (small blind) folded before Flop



PokerStars Hand #166667896961:  Hold'em No Limit ($0.05/$0.10 USD) - 2017/02/23 16:09:31 ET
Table 'Siebohme II' 6-max Seat #2 is the button
Seat 1: homelessdan ($17.67 in chips) 
Seat 2: townerz1991 ($12.97 in chips) 
Seat 3: D3NyA ($11.43 in chips) 
Seat 4: POT_TRADER ($12.14 in chips) 
Seat 5: NvR.m1nD ($11.19 in chips) 
Seat 6: Fozzy690 ($9.47 in chips) 
D3NyA: posts small blind $0.05
POT_TRADER: posts big blind $0.10
*** HOLE CARDS ***
NvR.m1nD: raises $0.15 to $0.25
Fozzy690: folds 
homelessdan: folds 
townerz1991: folds 
D3NyA: folds 
POT_TRADER: folds 
Uncalled bet ($0.15) returned to NvR.m1nD
NvR.m1nD collected $0.25 from pot
*** SUMMARY ***
Total pot $0.25 | Rake $0 
Seat 1: homelessdan folded before Flop (didn't bet)
Seat 2: townerz1991 (button) folded before Flop (didn't bet)
Seat 3: D3NyA (small blind) folded before Flop
Seat 4: POT_TRADER (big blind) folded before Flop
Seat 5: NvR.m1nD collected ($0.25)
Seat 6: Fozzy690 folded before Flop (didn't bet)



PokerStars Hand #166667897326:  Hold'em No Limit ($0.05/$0.10 USD) - 2017/02/23 16:09:31 ET
Table 'Nikko II' 6-max Seat #1 is the button
Seat 1: bdixon_5 ($9.62 in chips) 
Seat 2: popypaleta ($10 in chips) 
Seat 3: Hyd SK ($11.66 in chips) 
Seat 4: Peter0087 ($10.01 in chips) 
Seat 5: Aescul@pius ($13.29 in chips) 
Seat 6: JahSoldier69 ($10 in chips) 
popypaleta: posts small blind $0.05
Hyd SK: posts big blind $0.10
*** HOLE CARDS ***
Peter0087: folds 
Aescul@pius: folds 
JahSoldier69: folds 
bdixon_5: folds 
popypaleta: folds 
Uncalled bet ($0.05) returned to Hyd SK
Hyd SK collected $0.10 from pot
*** SUMMARY ***
Total pot $0.10 | Rake $0 
Seat 1: bdixon_5 (button) folded before Flop (didn't bet)
Seat 2: popypaleta (small blind) folded before Flop
Seat 3: Hyd SK (big blind) collected ($0.10)
Seat 4: Peter0087 folded before Flop (didn't bet)
Seat 5: Aescul@pius folded before Flop (didn't bet)
Seat 6: JahSoldier69 folded before Flop (didn't bet)



PokerStars Hand #166667897355:  Hold'em No Limit ($0.05/$0.10 USD) - 2017/02/23 16:09:31 ET
Table 'Repsolda' 6-max Seat #1 is the button
Seat 1: fabadam ($10.50 in chips) 
Seat 2: MBen10 ($24.42 in chips) 
Seat 4: MihaGr ($10 in chips) 
Seat 6: RkaczoR ($11.49 in chips) 
MBen10: posts small blind $0.05
MihaGr: posts big blind $0.10
matehouse.: sits out 
*** HOLE CARDS ***
RkaczoR: folds 
fabadam: folds 
MBen10: folds 
Uncalled bet ($0.05) returned to MihaGr
MihaGr collected $0.10 from pot
*** SUMMARY ***
Total pot $0.10 | Rake $0 
Seat 1: fabadam (button) folded before Flop (didn't bet)
Seat 2: MBen10 (small blind) folded before Flop
Seat 4: MihaGr (big blind) collected ($0.10)
Seat 6: RkaczoR folded before Flop (didn't bet)



PokerStars Hand #166667897484:  Hold'em No Limit ($0.05/$0.10 USD) - 2017/02/23 16:09:31 ET
Table 'Atropos' 6-max Seat #2 is the button
Seat 1: ScorpionF39 ($2.44 in chips) 
Seat 2: yodzik ($5 in chips) 
Seat 3: NvR.m1nD ($10.43 in chips) 
Seat 4: iDecMate ($10.97 in chips) 
Seat 5: KokoulinV ($11.79 in chips) 
Seat 6: Iarlei ($12.58 in chips) 
NvR.m1nD: posts small blind $0.05
iDecMate: posts big blind $0.10
*** HOLE CARDS ***
KokoulinV: folds 
Iarlei: folds 
ScorpionF39: folds 
yodzik: raises $0.20 to $0.30
NvR.m1nD: folds 
iDecMate: folds 
Uncalled bet ($0.20) returned to yodzik
yodzik collected $0.25 from pot
*** SUMMARY ***
Total pot $0.25 | Rake $0 
Seat 1: ScorpionF39 folded before Flop (didn't bet)
Seat 2: yodzik (button) collected ($0.25)
Seat 3: NvR.m1nD (small blind) folded before Flop
Seat 4: iDecMate (big blind) folded before Flop
Seat 5: KokoulinV folded before Flop (didn't bet)
Seat 6: Iarlei folded before Flop (didn't bet)



PokerStars Hand #166667897657:  Hold'em No Limit ($0.05/$0.10 USD) - 2017/02/23 16:09:32 ET
Table 'Antinous' 6-max Seat #1 is the button
Seat 1: Andrei ProFF ($15.78 in chips) 
Seat 2: Nr847 ($13.50 in chips) 
Seat 3: dittoro ($10 in chips) 
Seat 4: Pekaml ($15.65 in chips) 
Seat 5: Covetsoles ($4.02 in chips) 
Seat 6: coolisses111 ($9.55 in chips) 
Nr847: posts small blind $0.05
dittoro: posts big blind $0.10
*** HOLE CARDS ***
Pekaml: folds 
Covetsoles: folds 
coolisses111: raises $0.20 to $0.30
Andrei ProFF: raises $0.60 to $0.90
Nr847: folds 
dittoro: folds 
coolisses111: folds 
Uncalled bet ($0.60) returned to Andrei ProFF
Andrei ProFF collected $0.75 from pot
*** SUMMARY ***
Total pot $0.75 | Rake $0 
Seat 1: Andrei ProFF (button) collected ($0.75)
Seat 2: Nr847 (small blind) folded before Flop
Seat 3: dittoro (big blind) folded before Flop
Seat 4: Pekaml folded before Flop (didn't bet)
Seat 5: Covetsoles folded before Flop (didn't bet)
Seat 6: coolisses111 folded before Flop



PokerStars Hand #166667897769:  Hold'em No Limit ($0.05/$0.10 USD) - 2017/02/23 16:09:32 ET
Table 'Themisto II' 6-max Seat #6 is the button
Seat 1: ChuikaPridi ($10 in chips) 
Seat 2: CA225 ($11.96 in chips) 
Seat 3: eniksenik ($16.06 in chips) 
Seat 5: ex3Lero86 ($10.22 in chips) 
Seat 6: noobigrok ($3.20 in chips) 
ChuikaPridi: posts small blind $0.05
CA225: posts big blind $0.10
DrVzad: sits out 
*** HOLE CARDS ***
eniksenik: folds 
ex3Lero86: raises $0.15 to $0.25
noobigrok: calls $0.25
ChuikaPridi: folds 
CA225: folds 
*** FLOP *** [3d Qs 4h]
ex3Lero86: checks 
noobigrok: checks 
*** TURN *** [3d Qs 4h] [4s]
ex3Lero86: bets $0.38
noobigrok: calls $0.38
*** RIVER *** [3d Qs 4h 4s] [4d]
ex3Lero86: checks 
noobigrok: checks 
*** SHOW DOWN ***
ex3Lero86: shows [3h 3c] (a full house, Fours full of Threes)
noobigrok: mucks hand 
ex3Lero86 collected $1.35 from pot
*** SUMMARY ***
Total pot $1.41 | Rake $0.06 
Board [3d Qs 4h 4s 4d]
Seat 1: ChuikaPridi (small blind) folded before Flop
Seat 2: CA225 (big blind) folded before Flop
Seat 3: eniksenik folded before Flop (didn't bet)
Seat 5: ex3Lero86 showed [3h 3c] and won ($1.35) with a full house, Fours full of Threes
Seat 6: noobigrok (button) mucked



PokerStars Hand #166667897839:  Hold'em No Limit ($0.05/$0.10 USD) - 2017/02/23 16:09:32 ET
Table 'Glarona' 6-max Seat #4 is the button
Seat 1: LarryTheStar ($10.20 in chips) 
Seat 2: BookWorm78 ($10 in chips) 
Seat 4: CrippledGod ($7.04 in chips) 
marianoboni will be allowed to play after the button
LarryTheStar: posts small blind $0.05
BookWorm78: posts big blind $0.10
*** HOLE CARDS ***
CrippledGod: folds 
jsergem69 joins the table at seat #3 
david_sara83 leaves the table
LarryTheStar: raises $0.20 to $0.30
BookWorm78: raises $0.60 to $0.90
jsergem69 leaves the table
LarryTheStar: folds 
Uncalled bet ($0.60) returned to BookWorm78
BookWorm78 collected $0.60 from pot
*** SUMMARY ***
Total pot $0.60 | Rake $0 
Seat 1: LarryTheStar (small blind) folded before Flop
Seat 2: BookWorm78 (big blind) collected ($0.60)
Seat 4: CrippledGod (button) folded before Flop (didn't bet)



PokerStars Hand #166667897878:  Hold'em No Limit ($0.05/$0.10 USD) - 2017/02/23 16:09:32 ET
Table 'Nerthus II' 6-max Seat #5 is the button
Seat 1: mdelfin0 ($12.30 in chips) 
Seat 2: Hovhannes990 ($9.48 in chips) 
Seat 3: Mamm0nism ($18.71 in chips) 
Seat 4: myevc ($16.53 in chips) 
Seat 5: Hyd SK ($10.47 in chips) 
Seat 6: Lucky HoBBiT ($10 in chips) 
Lucky HoBBiT: posts small blind $0.05
mdelfin0: posts big blind $0.10
*** HOLE CARDS ***
Hovhannes990: calls $0.10
Mamm0nism: folds 
myevc: folds 
Hyd SK: folds 
Lucky HoBBiT is disconnected 
Lucky HoBBiT has timed out while disconnected
Lucky HoBBiT: folds 
mdelfin0: checks 
*** FLOP *** [5h 3h Qc]
mdelfin0: bets $0.11
Hovhannes990: calls $0.11
*** TURN *** [5h 3h Qc] [5d]
mdelfin0: bets $0.30
Hovhannes990: folds 
Uncalled bet ($0.30) returned to mdelfin0
mdelfin0 collected $0.45 from pot
*** SUMMARY ***
Total pot $0.47 | Rake $0.02 
Board [5h 3h Qc 5d]
Seat 1: mdelfin0 (big blind) collected ($0.45)
Seat 2: Hovhannes990 folded on the Turn
Seat 3: Mamm0nism folded before Flop (didn't bet)
Seat 4: myevc folded before Flop (didn't bet)
Seat 5: Hyd SK (button) folded before Flop (didn't bet)
Seat 6: Lucky HoBBiT (small blind) folded before Flop



PokerStars Hand #166667897881:  Hold'em No Limit ($0.05/$0.10 USD) - 2017/02/23 16:09:32 ET
Table 'Wingolfia II' 6-max Seat #5 is the button
Seat 1: BahiaMinhaP ($10 in chips) 
Seat 2: NvR.m1nD ($10.15 in chips) 
Seat 3: truck1234 ($10.72 in chips) 
Seat 4: zlobslob ($17.87 in chips) 
Seat 5: tr41n3r12 ($11.43 in chips) 
BahiaMinhaP: posts small blind $0.05
NvR.m1nD: posts big blind $0.10
*** HOLE CARDS ***
truck1234: folds 
zlobslob: folds 
tr41n3r12: raises $0.15 to $0.25
Tom Zhangxue joins the table at seat #6 
BahiaMinhaP: folds 
NvR.m1nD: folds 
Uncalled bet ($0.15) returned to tr41n3r12
tr41n3r12 collected $0.25 from pot
*** SUMMARY ***
Total pot $0.25 | Rake $0 
Seat 1: BahiaMinhaP (small blind) folded before Flop
Seat 2: NvR.m1nD (big blind) folded before Flop
Seat 3: truck1234 folded before Flop (didn't bet)
Seat 4: zlobslob folded before Flop (didn't bet)
Seat 5: tr41n3r12 (button) collected ($0.25)



PokerStars Hand #166667898064:  Hold'em No Limit ($0.05/$0.10 USD) - 2017/02/23 16:09:32 ET
Table 'Pyrrhus III' 6-max Seat #4 is the button
Seat 2: univibe68 ($26.59 in chips) 
Seat 3: coolisses111 ($9.64 in chips) 
Seat 4: ex3Lero86 ($14.96 in chips) 
Seat 5: eniksenik ($10 in chips) 
Seat 6: MLPlayer16 ($21.36 in chips) 
eniksenik: posts small blind $0.05
MLPlayer16: posts big blind $0.10
univibe68: posts the ante $0.02
coolisses111: posts the ante $0.02
ex3Lero86: posts the ante $0.02
eniksenik: posts the ante $0.02
MLPlayer16: posts the ante $0.02
*** HOLE CARDS ***
univibe68: folds 
coolisses111: raises $0.20 to $0.30
ex3Lero86: folds 
eniksenik: folds 
MLPlayer16: folds 
Uncalled bet ($0.20) returned to coolisses111
coolisses111 collected $0.35 from pot
*** SUMMARY ***
Total pot $0.35 | Rake $0 
Seat 2: univibe68 folded before Flop (didn't bet)
Seat 3: coolisses111 collected ($0.35)
Seat 4: ex3Lero86 (button) folded before Flop (didn't bet)
Seat 5: eniksenik (small blind) folded before Flop
Seat 6: MLPlayer16 (big blind) folded before Flop



PokerStars Hand #166667898264:  Hold'em No Limit ($0.05/$0.10 USD) - 2017/02/23 16:09:32 ET
Table 'Kobresia II' 6-max Seat #1 is the button
Seat 1: RoJ1 ($15.49 in chips) 
Seat 2: Dcaro31 ($13.42 in chips) 
Seat 4: Vanne11 ($10 in chips) 
Seat 5: Goroshkos88 ($12.07 in chips) 
Dcaro31: posts small blind $0.05
FRAID358: is sitting out 
Vanne11: posts big blind $0.10
*** HOLE CARDS ***
FRAID358 leaves the table
Goroshkos88: folds 
RoJ1: folds 
Dcaro31: folds 
Uncalled bet ($0.05) returned to Vanne11
Vanne11 collected $0.10 from pot
*** SUMMARY ***
Total pot $0.10 | Rake $0 
Seat 1: RoJ1 (button) folded before Flop (didn't bet)
Seat 2: Dcaro31 (small blind) folded before Flop
Seat 4: Vanne11 (big blind) collected ($0.10)
Seat 5: Goroshkos88 folded before Flop (didn't bet)



PokerStars Hand #166667898318:  Hold'em No Limit ($0.05/$0.10 USD) - 2017/02/23 16:09:32 ET
Table 'Pallas II' 6-max Seat #6 is the button
Seat 1: mdelfin0 ($16.69 in chips) 
Seat 3: popypaleta ($10 in chips) 
Seat 4: MisterX413 ($10 in chips) 
Seat 5: gaHy_HaXeP ($10.10 in chips) 
Seat 6: Smitty03300 ($10 in chips) 
mdelfin0: posts small blind $0.05
popypaleta: posts big blind $0.10
*** HOLE CARDS ***
MisterX413: folds 
DEraser leaves the table
gaHy_HaXeP: folds 
Smitty03300: folds 
mdelfin0: calls $0.05
popypaleta: raises $0.40 to $0.50
mdelfin0: folds 
Uncalled bet ($0.40) returned to popypaleta
popypaleta collected $0.20 from pot
*** SUMMARY ***
Total pot $0.20 | Rake $0 
Seat 1: mdelfin0 (small blind) folded before Flop
Seat 3: popypaleta (big blind) collected ($0.20)
Seat 4: MisterX413 folded before Flop (didn't bet)
Seat 5: gaHy_HaXeP folded before Flop (didn't bet)
Seat 6: Smitty03300 (button) folded before Flop (didn't bet)



PokerStars Hand #166667898966:  Hold'em No Limit ($0.05/$0.10 USD) - 2017/02/23 16:09:33 ET
Table 'Aisakos II' 6-max Seat #2 is the button
Seat 1: Crafty23@PS ($10.35 in chips) 
Seat 2: svaika24 ($16.87 in chips) 
Seat 3: iamkakaroto ($10.87 in chips) 
Seat 4: T9MS ($10.30 in chips) 
Seat 5: KokoulinV ($11.75 in chips) 
Seat 6: LarryTheStar ($10.03 in chips) 
iamkakaroto: posts small blind $0.05
T9MS: posts big blind $0.10
*** HOLE CARDS ***
KokoulinV: folds 
LarryTheStar: folds 
Crafty23@PS: folds 
svaika24: folds 
iamkakaroto: folds 
Uncalled bet ($0.05) returned to T9MS
T9MS collected $0.10 from pot
*** SUMMARY ***
Total pot $0.10 | Rake $0 
Seat 1: Crafty23@PS folded before Flop (didn't bet)
Seat 2: svaika24 (button) folded before Flop (didn't bet)
Seat 3: iamkakaroto (small blind) folded before Flop
Seat 4: T9MS (big blind) collected ($0.10)
Seat 5: KokoulinV folded before Flop (didn't bet)
Seat 6: LarryTheStar folded before Flop (didn't bet)



PokerStars Hand #166667898974:  Hold'em No Limit ($0.05/$0.10 USD) - 2017/02/23 16:09:33 ET
Table 'Sirius II' 6-max Seat #2 is the button
Seat 2: Buddy8711 ($8.83 in chips) 
Seat 3: Spud014 ($10 in chips) 
Seat 4: Pekaml ($10 in chips) 
Seat 6: MihaGr ($10 in chips) 
Spud014: posts small blind $0.05
Pekaml: posts big blind $0.10
manashov: sits out 
Cluckh: sits out 
*** HOLE CARDS ***
MihaGr: raises $0.20 to $0.30
Buddy8711: folds 
Spud014: folds 
Pekaml: folds 
Uncalled bet ($0.20) returned to MihaGr
MihaGr collected $0.25 from pot
*** SUMMARY ***
Total pot $0.25 | Rake $0 
Seat 2: Buddy8711 (button) folded before Flop (didn't bet)
Seat 3: Spud014 (small blind) folded before Flop
Seat 4: Pekaml (big blind) folded before Flop
Seat 6: MihaGr collected ($0.25)



PokerStars Hand #166667899399:  Hold'em No Limit ($0.05/$0.10 USD) - 2017/02/23 16:09:34 ET
Table 'Serpens' 6-max Seat #3 is the button
Seat 1: Namhkal ($10.05 in chips) 
Seat 2: KA3AXCTAHEU, ($19.48 in chips) 
Seat 3: homelessdan ($29.88 in chips) 
DIENY772 will be allowed to play after the button
XaXaTyH4uK will be allowed to play after the button
Namhkal: posts small blind $0.05
KA3AXCTAHEU,: posts big blind $0.10
*** HOLE CARDS ***
homelessdan: folds 
Namhkal: folds 
Uncalled bet ($0.05) returned to KA3AXCTAHEU,
KA3AXCTAHEU, collected $0.10 from pot
*** SUMMARY ***
Total pot $0.10 | Rake $0 
Seat 1: Namhkal (small blind) folded before Flop
Seat 2: KA3AXCTAHEU, (big blind) collected ($0.10)
Seat 3: homelessdan (button) folded before Flop (didn't bet)



PokerStars Hand #166667899400:  Hold'em No Limit ($0.05/$0.10 USD) - 2017/02/23 16:09:34 ET
Table 'Orthos III' 6-max Seat #3 is the button
Seat 1: sexy_seagull ($11.12 in chips) 
Seat 2: Xander188 ($19.31 in chips) 
Seat 3: koka4cs ($5.30 in chips) 
Seat 4: FlopsterGB ($16.96 in chips) 
Seat 5: Bird et al ($18.31 in chips) 
Seat 6: RoJ1 ($10.64 in chips) 
FlopsterGB: posts small blind $0.05
Bird et al: posts big blind $0.10
*** HOLE CARDS ***
RoJ1: folds 
sexy_seagull: folds 
Xander188: folds 
koka4cs: folds 
FlopsterGB: raises $0.10 to $0.20
Bird et al: folds 
Uncalled bet ($0.10) returned to FlopsterGB
FlopsterGB collected $0.20 from pot
*** SUMMARY ***
Total pot $0.20 | Rake $0 
Seat 1: sexy_seagull folded before Flop (didn't bet)
Seat 2: Xander188 folded before Flop (didn't bet)
Seat 3: koka4cs (button) folded before Flop (didn't bet)
Seat 4: FlopsterGB (small blind) collected ($0.20)
Seat 5: Bird et al (big blind) folded before Flop
Seat 6: RoJ1 folded before Flop (didn't bet)



PokerStars Hand #166667899792:  Hold'em No Limit ($0.05/$0.10 USD) - 2017/02/23 16:09:34 ET
Table 'Wabash' 6-max Seat #4 is the button
Seat 1: pivanki11 ($8.99 in chips) 
Seat 2: ex3Lero86 ($32.63 in chips) 
Seat 3: tauronex ($10 in chips) 
Seat 4: Nr847 ($10.92 in chips) 
Seat 5: popypaleta ($13.79 in chips) 
Seat 6: weez3r ($11.22 in chips) 
popypaleta: posts small blind $0.05
weez3r: posts big blind $0.10
*** HOLE CARDS ***
pivanki11: calls $0.10
ex3Lero86: folds 
tauronex: raises $0.20 to $0.30
Nr847: folds 
popypaleta: folds 
weez3r: folds 
pivanki11: calls $0.20
*** FLOP *** [3d Ac 5s]
pivanki11: checks 
tauronex: bets $0.39
pivanki11: calls $0.39
*** TURN *** [3d Ac 5s] [Kh]
pivanki11: checks 
tauronex: checks 
*** RIVER *** [3d Ac 5s Kh] [Ah]
pivanki11: checks 
tauronex: checks 
*** SHOW DOWN ***
pivanki11: shows [Ad 2d] (three of a kind, Aces)
tauronex: mucks hand 
pivanki11 collected $1.46 from pot
*** SUMMARY ***
Total pot $1.53 | Rake $0.07 
Board [3d Ac 5s Kh Ah]
Seat 1: pivanki11 showed [Ad 2d] and won ($1.46) with three of a kind, Aces
Seat 2: ex3Lero86 folded before Flop (didn't bet)
Seat 3: tauronex mucked
Seat 4: Nr847 (button) folded before Flop (didn't bet)
Seat 5: popypaleta (small blind) folded before Flop
Seat 6: weez3r (big blind) folded before Flop



PokerStars Hand #166667899971:  Hold'em No Limit ($0.05/$0.10 USD) - 2017/02/23 16:09:34 ET
Table 'Kunigunde II' 6-max Seat #5 is the button
Seat 1: facewald ($10.20 in chips) 
Seat 3: pancernik21 ($16.99 in chips) 
Seat 5: mdelfin0 ($12.58 in chips) 
Seat 6: Zooplack ($10 in chips) 
Zooplack: posts small blind $0.05
facewald: posts big blind $0.10
DrVzad: sits out 
*** HOLE CARDS ***
pancernik21: raises $0.20 to $0.30
mdelfin0: folds 
Zooplack: folds 
facewald: folds 
Uncalled bet ($0.20) returned to pancernik21
pancernik21 collected $0.25 from pot
*** SUMMARY ***
Total pot $0.25 | Rake $0 
Seat 1: facewald (big blind) folded before Flop
Seat 3: pancernik21 collected ($0.25)
Seat 5: mdelfin0 (button) folded before Flop (didn't bet)
Seat 6: Zooplack (small blind) folded before Flop



PokerStars Hand #166667900060:  Hold'em No Limit ($0.05/$0.10 USD) - 2017/02/23 16:09:34 ET
Table 'Duhr II' 6-max Seat #2 is the button
Seat 1: Lucky HoBBiT ($10.88 in chips) 
Seat 2: Feverhead ($37.74 in chips) 
Seat 3: Smitty03300 ($10 in chips) 
Seat 4: CHRO8 ($10 in chips) 
Seat 5: Dimka4 ($10.10 in chips) 
Seat 6: townerz1991 ($11.28 in chips) 
Smitty03300: posts small blind $0.05
CHRO8: posts big blind $0.10
*** HOLE CARDS ***
Dimka4: folds 
townerz1991: folds 
Lucky HoBBiT: folds 
Feverhead: raises $0.10 to $0.20
Smitty03300: folds 
CHRO8: folds 
Uncalled bet ($0.10) returned to Feverhead
Feverhead collected $0.25 from pot
*** SUMMARY ***
Total pot $0.25 | Rake $0 
Seat 1: Lucky HoBBiT folded before Flop (didn't bet)
Seat 2: Feverhead (button) collected ($0.25)
Seat 3: Smitty03300 (small blind) folded before Flop
Seat 4: CHRO8 (big blind) folded before Flop
Seat 5: Dimka4 folded before Flop (didn't bet)
Seat 6: townerz1991 folded before Flop (didn't bet)



PokerStars Hand #166667900077:  Hold'em No Limit ($0.05/$0.10 USD) - 2017/02/23 16:09:34 ET
Table 'Grietje' 6-max Seat #2 is the button
Seat 1: dragonste89 ($10 in chips) 
Seat 2: Feverhead ($10 in chips) 
Seat 3: GitoValdivia ($7.63 in chips) 
Seat 4: MihaGr ($10.71 in chips) 
Seat 5: iThreeBarrel ($10 in chips) 
Seat 6: Prometheu$8 ($26.52 in chips) 
GitoValdivia: posts small blind $0.05
MihaGr: posts big blind $0.10
*** HOLE CARDS ***
iThreeBarrel: folds 
Prometheu$8: folds 
dragonste89: raises $0.20 to $0.30
Feverhead: folds 
GitoValdivia: raises $0.70 to $1
MihaGr: folds 
dragonste89: folds 
Uncalled bet ($0.70) returned to GitoValdivia
GitoValdivia collected $0.70 from pot
*** SUMMARY ***
Total pot $0.70 | Rake $0 
Seat 1: dragonste89 folded before Flop
Seat 2: Feverhead (button) folded before Flop (didn't bet)
Seat 3: GitoValdivia (small blind) collected ($0.70)
Seat 4: MihaGr (big blind) folded before Flop
Seat 5: iThreeBarrel folded before Flop (didn't bet)
Seat 6: Prometheu$8 folded before Flop (didn't bet)



PokerStars Hand #166667900092:  Hold'em No Limit ($0.05/$0.10 USD) - 2017/02/23 16:09:34 ET
Table 'Hercynia III' 6-max Seat #2 is the button
Seat 1: Bird et al ($15.08 in chips) 
Seat 2: Action_Gibi ($7.13 in chips) 
Seat 3: Dcaro31 ($19.92 in chips) 
Seat 5: THIMUCHIN ($15.30 in chips) 
Seat 6: bdixon_5 ($11.29 in chips) 
Dcaro31: posts small blind $0.05
THIMUCHIN: posts big blind $0.10
*** HOLE CARDS ***
bdixon_5: folds 
Bird et al: folds 
Action_Gibi: folds 
Dcaro31: folds 
Uncalled bet ($0.05) returned to THIMUCHIN
THIMUCHIN collected $0.10 from pot
*** SUMMARY ***
Total pot $0.10 | Rake $0 
Seat 1: Bird et al folded before Flop (didn't bet)
Seat 2: Action_Gibi (button) folded before Flop (didn't bet)
Seat 3: Dcaro31 (small blind) folded before Flop
Seat 5: THIMUCHIN (big blind) collected ($0.10)
Seat 6: bdixon_5 folded before Flop (didn't bet)



PokerStars Hand #166667900111:  Hold'em No Limit ($0.05/$0.10 USD) - 2017/02/23 16:09:34 ET
Table 'Rotraut' 6-max Seat #2 is the button
Seat 1: Hypermetal ($13.51 in chips) 
Seat 2: Newqbrown ($10.45 in chips) 
Seat 3: FlackoD ($13.26 in chips) 
Seat 5: Bird et al ($12.23 in chips) 
Seat 6: KokoulinV ($11.23 in chips) 
FlackoD: posts small blind $0.05
Bird et al: posts big blind $0.10
*** HOLE CARDS ***
KokoulinV: raises $0.20 to $0.30
Hypermetal: folds 
Newqbrown: folds 
FlackoD: calls $0.25
Bird et al: folds 
*** FLOP *** [5d 4d 2c]
FlackoD: checks 
KokoulinV: bets $0.45
FlackoD: raises $0.65 to $1.10
KokoulinV: calls $0.65
*** TURN *** [5d 4d 2c] [Qc]
FlackoD: bets $1.40
KokoulinV: calls $1.40
*** RIVER *** [5d 4d 2c Qc] [3s]
FlackoD: bets $2.80
KokoulinV: raises $5.63 to $8.43 and is all-in
FlackoD: folds 
Uncalled bet ($5.63) returned to KokoulinV
KokoulinV collected $10.79 from pot
*** SUMMARY ***
Total pot $11.30 | Rake $0.51 
Board [5d 4d 2c Qc 3s]
Seat 1: Hypermetal folded before Flop (didn't bet)
Seat 2: Newqbrown (button) folded before Flop (didn't bet)
Seat 3: FlackoD (small blind) folded on the River
Seat 5: Bird et al (big blind) folded before Flop
Seat 6: KokoulinV collected ($10.79)



PokerStars Hand #166667900861:  Hold'em No Limit ($0.05/$0.10 USD) - 2017/02/23 16:09:35 ET
Table 'Apollonia' 6-max Seat #1 is the button
Seat 1: ex3Lero86 ($10.11 in chips) 
Seat 2: ibara000 ($18.33 in chips) 
Seat 3: steepfell ($10.15 in chips) 
Seat 4: Goroshkos88 ($17.47 in chips) 
Seat 6: iluzja12 ($10.37 in chips) 
ibara000: posts small blind $0.05
steepfell: posts big blind $0.10
bambolejro: sits out 
*** HOLE CARDS ***
Goroshkos88: folds 
iluzja12: folds 
ex3Lero86: raises $0.15 to $0.25
ibara000: folds 
steepfell: calls $0.15
*** FLOP *** [Kh 5h 4h]
steepfell: checks 
ex3Lero86: checks 
*** TURN *** [Kh 5h 4h] [Tc]
steepfell: bets $0.36
ex3Lero86: folds 
Uncalled bet ($0.36) returned to steepfell
steepfell collected $0.53 from pot
*** SUMMARY ***
Total pot $0.55 | Rake $0.02 
Board [Kh 5h 4h Tc]
Seat 1: ex3Lero86 (button) folded on the Turn
Seat 2: ibara000 (small blind) folded before Flop
Seat 3: steepfell (big blind) collected ($0.53)
Seat 4: Goroshkos88 folded before Flop (didn't bet)
Seat 6: iluzja12 folded before Flop (didn't bet)



PokerStars Hand #166667900988:  Hold'em No Limit ($0.05/$0.10 USD) - 2017/02/23 16:09:35 ET
Table 'Nuki' 6-max Seat #6 is the button
Seat 1: bdixon_5 ($7.70 in chips) 
Seat 2: ArcticBearDK ($19.18 in chips) 
Seat 4: GESPERIA ($28.43 in chips) 
Seat 5: fabadam ($11.13 in chips) 
Seat 6: Zooplack ($25.62 in chips) 
bdixon_5: posts small blind $0.05
ArcticBearDK: posts big blind $0.10
*** HOLE CARDS ***
david_sara83 leaves the table
GESPERIA: folds 
Chodemuncher joins the table at seat #3 
fabadam: folds 
Zooplack: folds 
bdixon_5: folds 
Uncalled bet ($0.05) returned to ArcticBearDK
ArcticBearDK collected $0.10 from pot
*** SUMMARY ***
Total pot $0.10 | Rake $0 
Seat 1: bdixon_5 (small blind) folded before Flop
Seat 2: ArcticBearDK (big blind) collected ($0.10)
Seat 4: GESPERIA folded before Flop (didn't bet)
Seat 5: fabadam folded before Flop (didn't bet)
Seat 6: Zooplack (button) folded before Flop (didn't bet)



PokerStars Hand #166667901168:  Hold'em No Limit ($0.05/$0.10 USD) - 2017/02/23 16:09:36 ET
Table 'Gyldenia II' 6-max Seat #6 is the button
Seat 1: KokoulinV ($11.49 in chips) 
Seat 2: Kow6oy ($10 in chips) 
Seat 5: CHRO8 ($15.57 in chips) 
Seat 6: 8th wonders ($11.63 in chips) 
KokoulinV: posts small blind $0.05
Kow6oy: posts big blind $0.10
mhonielsen: sits out 
*** HOLE CARDS ***
CHRO8: folds 
8th wonders: folds 
KokoulinV: folds 
Uncalled bet ($0.05) returned to Kow6oy
Kow6oy collected $0.10 from pot
*** SUMMARY ***
Total pot $0.10 | Rake $0 
Seat 1: KokoulinV (small blind) folded before Flop
Seat 2: Kow6oy (big blind) collected ($0.10)
Seat 5: CHRO8 folded before Flop (didn't bet)
Seat 6: 8th wonders (button) folded before Flop (didn't bet)



PokerStars Hand #166667901662:  Hold'em No Limit ($0.05/$0.10 USD) - 2017/02/23 16:09:36 ET
Table 'Hyakutake' 6-max Seat #5 is the button
Seat 1: Asilvagoat ($12.32 in chips) 
Seat 2: boxer821 ($13.12 in chips) 
Seat 3: lenboysprite ($3.51 in chips) 
Seat 4: eniksenik ($14.05 in chips) 
Seat 5: RoJ1 ($10.99 in chips) 
Seat 6: maxiv608 ($13.32 in chips) 
maxiv608: posts small blind $0.05
Asilvagoat: posts big blind $0.10
*** HOLE CARDS ***
boxer821: folds 
lenboysprite: calls $0.10
eniksenik: folds 
RoJ1: raises $0.35 to $0.45
maxiv608: folds 
Asilvagoat: folds 
lenboysprite: calls $0.35
*** FLOP *** [5s Qh 5h]
lenboysprite: checks 
RoJ1: bets $0.32
lenboysprite: calls $0.32
*** TURN *** [5s Qh 5h] [4d]
lenboysprite: checks 
RoJ1: checks 
*** RIVER *** [5s Qh 5h 4d] [4c]
lenboysprite: checks 
RoJ1: checks 
*** SHOW DOWN ***
lenboysprite: shows [Qd Jh] (two pair, Queens and Fives)
RoJ1: mucks hand 
lenboysprite collected $1.61 from pot
*** SUMMARY ***
Total pot $1.69 | Rake $0.08 
Board [5s Qh 5h 4d 4c]
Seat 1: Asilvagoat (big blind) folded before Flop
Seat 2: boxer821 folded before Flop (didn't bet)
Seat 3: lenboysprite showed [Qd Jh] and won ($1.61) with two pair, Queens and Fives
Seat 4: eniksenik folded before Flop (didn't bet)
Seat 5: RoJ1 (button) mucked
Seat 6: maxiv608 (small blind) folded before Flop



PokerStars Hand #166667901667:  Hold'em No Limit ($0.05/$0.10 USD) - 2017/02/23 16:09:36 ET
Table 'Rosalia' 6-max Seat #2 is the button
Seat 1: Hyd SK ($10 in chips) 
Seat 2: Bandyaev ($10.09 in chips) 
Seat 3: Andy Wolf ($11.88 in chips) 
Seat 4: THIMUCHIN ($10 in chips) 
Seat 5: miron762 ($20.53 in chips) 
Seat 6: facewald ($17.99 in chips) 
Andy Wolf: posts small blind $0.05
THIMUCHIN: posts big blind $0.10
*** HOLE CARDS ***
miron762: folds 
facewald: raises $0.19 to $0.29
Hyd SK: folds 
Bandyaev: folds 
Andy Wolf: folds 
THIMUCHIN: folds 
Uncalled bet ($0.19) returned to facewald
facewald collected $0.25 from pot
*** SUMMARY ***
Total pot $0.25 | Rake $0 
Seat 1: Hyd SK folded before Flop (didn't bet)
Seat 2: Bandyaev (button) folded before Flop (didn't bet)
Seat 3: Andy Wolf (small blind) folded before Flop
Seat 4: THIMUCHIN (big blind) folded before Flop
Seat 5: miron762 folded before Flop (didn't bet)
Seat 6: facewald collected ($0.25)



PokerStars Hand #166667901827:  Hold'em No Limit ($0.05/$0.10 USD) - 2017/02/23 16:09:36 ET
Table 'Alnasl' 6-max Seat #1 is the button
Seat 1: KA3AXCTAHEU, ($11.05 in chips) 
Seat 2: saddur ($9.34 in chips) 
Seat 4: oddshoff ($10.50 in chips) 
Seat 5: 6ePeMeHHa9 ($10.15 in chips) 
Seat 6: Zooplack ($13.58 in chips) 
saddur: posts small blind $0.05
oddshoff: posts big blind $0.10
*** HOLE CARDS ***
6ePeMeHHa9: folds 
Zooplack: folds 
KA3AXCTAHEU,: raises $0.15 to $0.25
saddur: calls $0.20
david_sara83 leaves the table
oddshoff: folds 
*** FLOP *** [7d Jc 9d]
saddur: checks 
6ePeMeHHa9 is disconnected 
KA3AXCTAHEU,: bets $0.22
saddur: folds 
Uncalled bet ($0.22) returned to KA3AXCTAHEU,
KA3AXCTAHEU, collected $0.57 from pot
*** SUMMARY ***
Total pot $0.60 | Rake $0.03 
Board [7d Jc 9d]
Seat 1: KA3AXCTAHEU, (button) collected ($0.57)
Seat 2: saddur (small blind) folded on the Flop
Seat 4: oddshoff (big blind) folded before Flop
Seat 5: 6ePeMeHHa9 folded before Flop (didn't bet)
Seat 6: Zooplack folded before Flop (didn't bet)



PokerStars Hand #166667901834:  Hold'em No Limit ($0.05/$0.10 USD) - 2017/02/23 16:09:36 ET
Table 'Thoas' 6-max Seat #2 is the button
Seat 1: Pekaml ($11.14 in chips) 
Seat 2: themacer24 ($8.79 in chips) 
Seat 3: iamkakaroto ($10.43 in chips) 
Seat 4: Morris_Chair ($18.52 in chips) 
Seat 5: Kow6oy ($10 in chips) 
Seat 6: takis nik ($10 in chips) 
iamkakaroto: posts small blind $0.05
Morris_Chair: posts big blind $0.10
*** HOLE CARDS ***
Kow6oy: folds 
takis nik: folds 
Pekaml: folds 
themacer24: folds 
iamkakaroto: folds 
Uncalled bet ($0.05) returned to Morris_Chair
Morris_Chair collected $0.10 from pot
*** SUMMARY ***
Total pot $0.10 | Rake $0 
Seat 1: Pekaml folded before Flop (didn't bet)
Seat 2: themacer24 (button) folded before Flop (didn't bet)
Seat 3: iamkakaroto (small blind) folded before Flop
Seat 4: Morris_Chair (big blind) collected ($0.10)
Seat 5: Kow6oy folded before Flop (didn't bet)
Seat 6: takis nik folded before Flop (didn't bet)



PokerStars Hand #166667902253:  Hold'em No Limit ($0.05/$0.10 USD) - 2017/02/23 16:09:37 ET
Table 'Lampetia III' 6-max Seat #2 is the button
Seat 1: gaHy_HaXeP ($10.55 in chips) 
Seat 2: DamDatsAnAce ($10.68 in chips) 
Seat 3: Kow6oy ($10 in chips) 
Seat 4: IAntikI ($10.30 in chips) 
Seat 5: robson1235 ($20.45 in chips) 
Seat 6: bdixon_5 ($9.20 in chips) 
Kow6oy: posts small blind $0.05
IAntikI: posts big blind $0.10
*** HOLE CARDS ***
robson1235: folds 
bdixon_5: folds 
gaHy_HaXeP: folds 
DamDatsAnAce: folds 
Kow6oy: folds 
Uncalled bet ($0.05) returned to IAntikI
IAntikI collected $0.10 from pot
*** SUMMARY ***
Total pot $0.10 | Rake $0 
Seat 1: gaHy_HaXeP folded before Flop (didn't bet)
Seat 2: DamDatsAnAce (button) folded before Flop (didn't bet)
Seat 3: Kow6oy (small blind) folded before Flop
Seat 4: IAntikI (big blind) collected ($0.10)
Seat 5: robson1235 folded before Flop (didn't bet)
Seat 6: bdixon_5 folded before Flop (didn't bet)



PokerStars Hand #166667902263:  Hold'em No Limit ($0.05/$0.10 USD) - 2017/02/23 16:09:37 ET
Table 'Nemo III' 6-max Seat #1 is the button
Seat 1: Kow6oy ($10.10 in chips) 
Seat 2: Bandyaev ($10.71 in chips) 
Seat 3: Dimka4 ($10 in chips) 
Seat 4: vtalian ($11.13 in chips) 
Seat 5: Joker51_wtf! ($11.58 in chips) 
Seat 6: maxiv608 ($10 in chips) 
Bandyaev: posts small blind $0.05
Dimka4: posts big blind $0.10
*** HOLE CARDS ***
vtalian: folds 
Joker51_wtf!: raises $0.16 to $0.26
maxiv608: folds 
Kow6oy: folds 
Bandyaev: folds 
Dimka4: folds 
Uncalled bet ($0.16) returned to Joker51_wtf!
Joker51_wtf! collected $0.25 from pot
*** SUMMARY ***
Total pot $0.25 | Rake $0 
Seat 1: Kow6oy (button) folded before Flop (didn't bet)
Seat 2: Bandyaev (small blind) folded before Flop
Seat 3: Dimka4 (big blind) folded before Flop
Seat 4: vtalian folded before Flop (didn't bet)
Seat 5: Joker51_wtf! collected ($0.25)
Seat 6: maxiv608 folded before Flop (didn't bet)



PokerStars Hand #166667902394:  Hold'em No Limit ($0.05/$0.10 USD) - 2017/02/23 16:09:37 ET
Table 'Postrema' 6-max Seat #5 is the button
Seat 1: CHRO8 ($10.51 in chips) 
Seat 2: pancernik21 ($13.59 in chips) 
Seat 3: edcc19 ($5.10 in chips) 
Seat 4: ChuikaPridi ($13.48 in chips) 
Seat 5: Comeback3392 ($11.87 in chips) 
Seat 6: Scanner17 ($10 in chips) 
Scanner17: posts small blind $0.05
CHRO8: posts big blind $0.10
*** HOLE CARDS ***
pancernik21: folds 
edcc19: folds 
ChuikaPridi: raises $0.20 to $0.30
Comeback3392: folds 
Scanner17: folds 
CHRO8: calls $0.20
*** FLOP *** [4d 3d 6c]
CHRO8: checks 
ChuikaPridi: bets $0.35
CHRO8: raises $0.66 to $1.01
ChuikaPridi: folds 
Uncalled bet ($0.66) returned to CHRO8
CHRO8 collected $1.29 from pot
*** SUMMARY ***
Total pot $1.35 | Rake $0.06 
Board [4d 3d 6c]
Seat 1: CHRO8 (big blind) collected ($1.29)
Seat 2: pancernik21 folded before Flop (didn't bet)
Seat 3: edcc19 folded before Flop (didn't bet)
Seat 4: ChuikaPridi folded on the Flop
Seat 5: Comeback3392 (button) folded before Flop (didn't bet)
Seat 6: Scanner17 (small blind) folded before Flop



PokerStars Hand #166667902491:  Hold'em No Limit ($0.05/$0.10 USD) - 2017/02/23 16:09:37 ET
Table 'Crocus' 6-max Seat #4 is the button
Seat 1: truck1234 ($25.66 in chips) 
Seat 2: garigura ($11.14 in chips) 
Seat 4: patrick19111 ($12.61 in chips) 
Seat 6: Rodik002 ($10.14 in chips) 
Rodik002: posts small blind $0.05
truck1234: posts big blind $0.10
Yspenyanin: sits out 
*** HOLE CARDS ***
garigura: folds 
patrick19111: folds 
Rodik002: folds 
Uncalled bet ($0.05) returned to truck1234
truck1234 collected $0.10 from pot
*** SUMMARY ***
Total pot $0.10 | Rake $0 
Seat 1: truck1234 (big blind) collected ($0.10)
Seat 2: garigura folded before Flop (didn't bet)
Seat 4: patrick19111 (button) folded before Flop (didn't bet)
Seat 6: Rodik002 (small blind) folded before Flop



PokerStars Hand #166667902824:  Hold'em No Limit ($0.05/$0.10 USD) - 2017/02/23 16:09:37 ET
Table 'Marghanna II' 6-max Seat #4 is the button
Seat 1: Goroshkos88 ($10 in chips) 
Seat 2: Namhkal ($14.61 in chips) 
Seat 4: D3NyA ($11.87 in chips) 
Seat 5: ofl21189 ($3.47 in chips) 
Seat 6: VAD21 ($13.28 in chips) 
ofl21189: posts small blind $0.05
VAD21: posts big blind $0.10
Andrei ProFF: sits out 
*** HOLE CARDS ***
Goroshkos88: raises $0.20 to $0.30
Namhkal: folds 
D3NyA: calls $0.30
ofl21189: folds 
VAD21: folds 
*** FLOP *** [Qs Jd 2c]
Goroshkos88: checks 
D3NyA: bets $0.50
Goroshkos88: folds 
Uncalled bet ($0.50) returned to D3NyA
D3NyA collected $0.72 from pot
*** SUMMARY ***
Total pot $0.75 | Rake $0.03 
Board [Qs Jd 2c]
Seat 1: Goroshkos88 folded on the Flop
Seat 2: Namhkal folded before Flop (didn't bet)
Seat 4: D3NyA (button) collected ($0.72)
Seat 5: ofl21189 (small blind) folded before Flop
Seat 6: VAD21 (big blind) folded before Flop



PokerStars Hand #166667903001:  Hold'em No Limit ($0.05/$0.10 USD) - 2017/02/23 16:09:38 ET
Table 'Sham' 6-max Seat #6 is the button
Seat 1: pancernik21 ($10.05 in chips) 
Seat 2: ex3Lero86 ($10 in chips) 
Seat 3: weez3r ($14.93 in chips) 
Seat 4: VAD21 ($14.21 in chips) 
Seat 5: T9MS ($10 in chips) 
Seat 6: bdixon_5 ($19.50 in chips) 
pancernik21: posts small blind $0.05
ex3Lero86: posts big blind $0.10
*** HOLE CARDS ***
weez3r: folds 
VAD21: folds 
T9MS: folds 
bdixon_5: folds 
pancernik21: folds 
Uncalled bet ($0.05) returned to ex3Lero86
ex3Lero86 collected $0.10 from pot
*** SUMMARY ***
Total pot $0.10 | Rake $0 
Seat 1: pancernik21 (small blind) folded before Flop
Seat 2: ex3Lero86 (big blind) collected ($0.10)
Seat 3: weez3r folded before Flop (didn't bet)
Seat 4: VAD21 folded before Flop (didn't bet)
Seat 5: T9MS folded before Flop (didn't bet)
Seat 6: bdixon_5 (button) folded before Flop (didn't bet)



PokerStars Hand #166667903239:  Hold'em No Limit ($0.05/$0.10 USD) - 2017/02/23 16:09:38 ET
Table 'Girtab II' 6-max Seat #6 is the button
Seat 1: marianoboni ($11.21 in chips) 
Seat 2: Pokeaster ($13.59 in chips) 
Seat 3: chimera252 ($13.55 in chips) 
Seat 4: Hyd SK ($27.03 in chips) 
Seat 6: DamDatsAnAce ($10 in chips) 
marianoboni: posts small blind $0.05
Pokeaster: posts big blind $0.10
*** HOLE CARDS ***
jsergem69 joins the table at seat #5 
chimera252: folds 
Hyd SK: folds 
DamDatsAnAce: folds 
marianoboni: raises $0.24 to $0.34
jsergem69 leaves the table
Pokeaster: calls $0.24
*** FLOP *** [Ah 8s Qc]
marianoboni: checks 
Pokeaster: checks 
*** TURN *** [Ah 8s Qc] [5s]
marianoboni: bets $0.21
Pokeaster: calls $0.21
*** RIVER *** [Ah 8s Qc 5s] [2c]
marianoboni: checks 
Pokeaster: checks 
*** SHOW DOWN ***
marianoboni: shows [Js Qs] (a pair of Queens)
Pokeaster: mucks hand 
marianoboni collected $1.05 from pot
*** SUMMARY ***
Total pot $1.10 | Rake $0.05 
Board [Ah 8s Qc 5s 2c]
Seat 1: marianoboni (small blind) showed [Js Qs] and won ($1.05) with a pair of Queens
Seat 2: Pokeaster (big blind) mucked
Seat 3: chimera252 folded before Flop (didn't bet)
Seat 4: Hyd SK folded before Flop (didn't bet)
Seat 6: DamDatsAnAce (button) folded before Flop (didn't bet)



PokerStars Hand #166667903376:  Hold'em No Limit ($0.05/$0.10 USD) - 2017/02/23 16:09:38 ET
Table 'Armenia' 6-max Seat #4 is the button
Seat 1: tr41n3r12 ($11.52 in chips) 
Seat 2: Yabidooo ($10.83 in chips) 
Seat 3: Crimsonr ($5.74 in chips) 
Seat 4: mbkongstad ($9.20 in chips) 
Seat 5: DrVzad ($9.90 in chips) 
Seat 6: mega spasser ($7.34 in chips) 
DrVzad: posts small blind $0.05
mega spasser: posts big blind $0.10
*** HOLE CARDS ***
tr41n3r12: folds 
Yabidooo: folds 
Crimsonr: folds 
mbkongstad: folds 
DrVzad: folds 
Uncalled bet ($0.05) returned to mega spasser
mega spasser collected $0.10 from pot
*** SUMMARY ***
Total pot $0.10 | Rake $0 
Seat 1: tr41n3r12 folded before Flop (didn't bet)
Seat 2: Yabidooo folded before Flop (didn't bet)
Seat 3: Crimsonr folded before Flop (didn't bet)
Seat 4: mbkongstad (button) folded before Flop (didn't bet)
Seat 5: DrVzad (small blind) folded before Flop
Seat 6: mega spasser (big blind) collected ($0.10)



PokerStars Hand #166667904090:  Hold'em No Limit ($0.05/$0.10 USD) - 2017/02/23 16:09:39 ET
Table 'Iduberga II' 6-max Seat #6 is the button
Seat 1: mhonielsen ($10.76 in chips) 
Seat 2: popypaleta ($12.95 in chips) 
Seat 3: scorpionfish ($11.43 in chips) 
Seat 4: Peter0087 ($11.12 in chips) 
Seat 5: Pokeaster ($10.31 in chips) 
Seat 6: tblocos ($11.09 in chips) 
mhonielsen: posts small blind $0.05
popypaleta: posts big blind $0.10
*** HOLE CARDS ***
scorpionfish: folds 
Peter0087: folds 
Pokeaster: raises $0.20 to $0.30
tblocos: calls $0.30
mhonielsen: folds 
popypaleta: folds 
*** FLOP *** [Jd Qc Tc]
Pokeaster: checks 
tblocos: checks 
*** TURN *** [Jd Qc Tc] [7h]
Pokeaster: checks 
tblocos: checks 
*** RIVER *** [Jd Qc Tc 7h] [2h]
Pokeaster: checks 
tblocos: checks 
*** SHOW DOWN ***
Pokeaster: shows [8s 8h] (a pair of Eights)
tblocos: mucks hand 
Pokeaster collected $0.72 from pot
*** SUMMARY ***
Total pot $0.75 | Rake $0.03 
Board [Jd Qc Tc 7h 2h]
Seat 1: mhonielsen (small blind) folded before Flop
Seat 2: popypaleta (big blind) folded before Flop
Seat 3: scorpionfish folded before Flop (didn't bet)
Seat 4: Peter0087 folded before Flop (didn't bet)
Seat 5: Pokeaster showed [8s 8h] and won ($0.72) with a pair of Eights
Seat 6: tblocos (button) mucked



PokerStars Hand #166667904156:  Hold'em No Limit ($0.05/$0.10 USD) - 2017/02/23 16:09:39 ET
Table 'Arpola' 6-max Seat #2 is the button
Seat 1: dincimus ($10.97 in chips) 
Seat 2: patrick19111 ($10.25 in chips) 
Seat 4: Orlangoor ($18.65 in chips) 
Seat 5: truck1234 ($11.76 in chips) 
Seat 6: DasoII ($4.90 in chips) 
Orlangoor: posts small blind $0.05
truck1234: posts big blind $0.10
*** HOLE CARDS ***
DasoII: folds 
dincimus: raises $0.10 to $0.20
patrick19111: folds 
Orlangoor: folds 
truck1234: folds 
Uncalled bet ($0.10) returned to dincimus
dincimus collected $0.25 from pot
*** SUMMARY ***
Total pot $0.25 | Rake $0 
Seat 1: dincimus collected ($0.25)
Seat 2: patrick19111 (button) folded before Flop (didn't bet)
Seat 4: Orlangoor (small blind) folded before Flop
Seat 5: truck1234 (big blind) folded before Flop
Seat 6: DasoII folded before Flop (didn't bet)



PokerStars Hand #166667904227:  Hold'em No Limit ($0.05/$0.10 USD) - 2017/02/23 16:09:39 ET
Table 'Unitas II' 6-max Seat #3 is the button
Seat 1: Peter0087 ($9.99 in chips) 
Seat 2: steepfell ($10.10 in chips) 
Seat 3: BahiaMinhaP ($10.40 in chips) 
Seat 4: truck1234 ($10.84 in chips) 
Seat 5: chimera252 ($24.18 in chips) 
Seat 6: paxit71 ($9.58 in chips) 
truck1234: posts small blind $0.05
chimera252: posts big blind $0.10
*** HOLE CARDS ***
paxit71: folds 
Peter0087: raises $0.20 to $0.30
steepfell: folds 
BahiaMinhaP: folds 
truck1234: calls $0.25
chimera252: folds 
*** FLOP *** [6c Kd 4s]
truck1234: checks 
Peter0087: checks 
*** TURN *** [6c Kd 4s] [As]
truck1234: checks 
Peter0087: bets $0.40
truck1234: folds 
Uncalled bet ($0.40) returned to Peter0087
Peter0087 collected $0.67 from pot
*** SUMMARY ***
Total pot $0.70 | Rake $0.03 
Board [6c Kd 4s As]
Seat 1: Peter0087 collected ($0.67)
Seat 2: steepfell folded before Flop (didn't bet)
Seat 3: BahiaMinhaP (button) folded before Flop (didn't bet)
Seat 4: truck1234 (small blind) folded on the Turn
Seat 5: chimera252 (big blind) folded before Flop
Seat 6: paxit71 folded before Flop (didn't bet)



PokerStars Hand #166667904489:  Hold'em No Limit ($0.05/$0.10 USD) - 2017/02/23 16:09:39 ET
Table 'Arduina' 6-max Seat #5 is the button
Seat 1: tauronex ($11.06 in chips) 
Seat 2: Andy Wolf ($14.45 in chips) 
Seat 3: Dcaro31 ($12.46 in chips) 
Seat 4: ChuikaPridi ($29.20 in chips) 
Seat 5: ettedallas ($7.16 in chips) 
Seat 6: dierri ($8.96 in chips) 
dierri: posts small blind $0.05
tauronex: posts big blind $0.10
*** HOLE CARDS ***
Andy Wolf: folds 
Dcaro31: folds 
ChuikaPridi: folds 
ettedallas: folds 
dierri: folds 
Uncalled bet ($0.05) returned to tauronex
tauronex collected $0.10 from pot
*** SUMMARY ***
Total pot $0.10 | Rake $0 
Seat 1: tauronex (big blind) collected ($0.10)
Seat 2: Andy Wolf folded before Flop (didn't bet)
Seat 3: Dcaro31 folded before Flop (didn't bet)
Seat 4: ChuikaPridi folded before Flop (didn't bet)
Seat 5: ettedallas (button) folded before Flop (didn't bet)
Seat 6: dierri (small blind) folded before Flop



PokerStars Hand #166667904491:  Hold'em No Limit ($0.05/$0.10 USD) - 2017/02/23 16:09:39 ET
Table 'Torrence II' 6-max Seat #4 is the button
Seat 1: Starbooks ($6.91 in chips) 
Seat 2: scorpionfish ($15.82 in chips) 
Seat 3: coolisses111 ($9.89 in chips) 
Seat 4: Zooplack ($10 in chips) 
Seat 5: Kow6oy ($12.08 in chips) 
Seat 6: mhonielsen ($10.51 in chips) 
Kow6oy: posts small blind $0.05
mhonielsen: posts big blind $0.10
*** HOLE CARDS ***
Starbooks: calls $0.10
scorpionfish: folds 
coolisses111: folds 
Zooplack: folds 
Kow6oy: folds 
mhonielsen: checks 
*** FLOP *** [Ad 8s Js]
mhonielsen: checks 
Starbooks: checks 
*** TURN *** [Ad 8s Js] [Qs]
mhonielsen: bets $0.17
Starbooks: folds 
Uncalled bet ($0.17) returned to mhonielsen
mhonielsen collected $0.24 from pot
*** SUMMARY ***
Total pot $0.25 | Rake $0.01 
Board [Ad 8s Js Qs]
Seat 1: Starbooks folded on the Turn
Seat 2: scorpionfish folded before Flop (didn't bet)
Seat 3: coolisses111 folded before Flop (didn't bet)
Seat 4: Zooplack (button) folded before Flop (didn't bet)
Seat 5: Kow6oy (small blind) folded before Flop
Seat 6: mhonielsen (big blind) collected ($0.24)



PokerStars Hand #166667904661:  Hold'em No Limit ($0.05/$0.10 USD) - 2017/02/23 16:09:39 ET
Table 'Marbachia II' 6-max Seat #4 is the button
Seat 1: crooso ($10 in chips) 
Seat 2: Yabidooo ($10 in chips) 
Seat 3: MisterX413 ($10.39 in chips) 
Seat 4: marianoboni ($10 in chips) 
Seat 6: arti192837 ($10.05 in chips) 
osmea will be allowed to play after the button
arti192837: posts small blind $0.05
crooso: posts big blind $0.10
*** HOLE CARDS ***
Yabidooo: folds 
MisterX413: folds 
marianoboni: raises $0.13 to $0.23
arti192837: folds 
crooso: folds 
Uncalled bet ($0.13) returned to marianoboni
marianoboni collected $0.25 from pot
*** SUMMARY ***
Total pot $0.25 | Rake $0 
Seat 1: crooso (big blind) folded before Flop
Seat 2: Yabidooo folded before Flop (didn't bet)
Seat 3: MisterX413 folded before Flop (didn't bet)
Seat 4: marianoboni (button) collected ($0.25)
Seat 6: arti192837 (small blind) folded before Flop



PokerStars Hand #166667904677:  Hold'em No Limit ($0.05/$0.10 USD) - 2017/02/23 16:09:39 ET
Table 'Virginia II' 6-max Seat #6 is the button
Seat 1: Iarlei ($11.31 in chips) 
Seat 2: Yspenyanin ($10 in chips) 
Seat 3: garigura ($15.73 in chips) 
Seat 4: onkelottoHH ($10.58 in chips) 
Seat 5: dr.goofy ($21.79 in chips) 
Seat 6: NvR.m1nD ($10.30 in chips) 
Iarlei: posts small blind $0.05
Yspenyanin: posts big blind $0.10
*** HOLE CARDS ***
garigura: folds 
onkelottoHH: folds 
dr.goofy: folds 
NvR.m1nD: folds 
Iarlei: raises $0.20 to $0.30
Yspenyanin: folds 
Uncalled bet ($0.20) returned to Iarlei
Iarlei collected $0.20 from pot
*** SUMMARY ***
Total pot $0.20 | Rake $0 
Seat 1: Iarlei (small blind) collected ($0.20)
Seat 2: Yspenyanin (big blind) folded before Flop
Seat 3: garigura folded before Flop (didn't bet)
Seat 4: onkelottoHH folded before Flop (didn't bet)
Seat 5: dr.goofy folded before Flop (didn't bet)
Seat 6: NvR.m1nD (button) folded before Flop (didn't bet)



PokerStars Hand #166667904731:  Hold'em No Limit ($0.05/$0.10 USD) - 2017/02/23 16:09:40 ET
Table 'Pompeja III' 6-max Seat #1 is the button
Seat 1: Iarlei ($11.98 in chips) 
Seat 2: steepfell ($10.47 in chips) 
Seat 3: Yspenyanin ($12.31 in chips) 
Seat 4: Cluckh ($13.27 in chips) 
Seat 5: Spud014 ($12.45 in chips) 
Seat 6: mega spasser ($4.50 in chips) 
steepfell: posts small blind $0.05
Yspenyanin: posts big blind $0.10
*** HOLE CARDS ***
Cluckh: folds 
Spud014: raises $0.20 to $0.30
mega spasser: folds 
Iarlei: folds 
steepfell: folds 
Yspenyanin: folds 
Uncalled bet ($0.20) returned to Spud014
Spud014 collected $0.25 from pot
*** SUMMARY ***
Total pot $0.25 | Rake $0 
Seat 1: Iarlei (button) folded before Flop (didn't bet)
Seat 2: steepfell (small blind) folded before Flop
Seat 3: Yspenyanin (big blind) folded before Flop
Seat 4: Cluckh folded before Flop (didn't bet)
Seat 5: Spud014 collected ($0.25)
Seat 6: mega spasser folded before Flop (didn't bet)



PokerStars Hand #166667904980:  Hold'em No Limit ($0.05/$0.10 USD) - 2017/02/23 16:09:40 ET
Table 'Laetitia II' 6-max Seat #3 is the button
Seat 1: Cluckh ($10.83 in chips) 
Seat 2: manashov ($10 in chips) 
Seat 3: 6ePeMeHHa9 ($10 in chips) 
Seat 4: Feverhead ($16.80 in chips) 
Seat 5: D3NyA ($17.36 in chips) 
Seat 6: Dima91360 ($5.70 in chips) 
Feverhead: posts small blind $0.05
D3NyA: posts big blind $0.10
*** HOLE CARDS ***
Dima91360: raises $0.10 to $0.20
Cluckh: folds 
manashov: raises $0.40 to $0.60
6ePeMeHHa9: folds 
Feverhead: folds 
D3NyA: calls $0.50
Dima91360: calls $0.40
*** FLOP *** [Kc 8s 2d]
D3NyA: checks 
Dima91360: checks 
manashov: bets $0.90
D3NyA: folds 
Dima91360: folds 
Uncalled bet ($0.90) returned to manashov
manashov collected $1.77 from pot
*** SUMMARY ***
Total pot $1.85 | Rake $0.08 
Board [Kc 8s 2d]
Seat 1: Cluckh folded before Flop (didn't bet)
Seat 2: manashov collected ($1.77)
Seat 3: 6ePeMeHHa9 (button) folded before Flop (didn't bet)
Seat 4: Feverhead (small blind) folded before Flop
Seat 5: D3NyA (big blind) folded on the Flop
Seat 6: Dima91360 folded on the Flop



PokerStars Hand #166667905134:  Hold'em No Limit ($0.05/$0.10 USD) - 2017/02/23 16:09:40 ET
Table 'Union' 6-max Seat #5 is the button
Seat 1: IAntikI ($10 in chips) 
Seat 2: Zooplack ($10.15 in chips) 
Seat 3: Rodik002 ($12.01 in chips) 
Seat 5: Chodemuncher ($16.10 in chips) 
Seat 6: bonyo71 ($3.90 in chips) 
bonyo71: posts small blind $0.05
IAntikI: posts big blind $0.10
osmea: sits out 
*** HOLE CARDS ***
Zooplack: folds 
Rodik002: folds 
Chodemuncher: raises $0.12 to $0.22
bonyo71: folds 
IAntikI: folds 
Uncalled bet ($0.12) returned to Chodemuncher
Chodemuncher collected $0.25 from pot
*** SUMMARY ***
Total pot $0.25 | Rake $0 
Seat 1: IAntikI (big blind) folded before Flop
Seat 2: Zooplack folded before Flop (didn't bet)
Seat 3: Rodik002 folded before Flop (didn't bet)
Seat 5: Chodemuncher (button) collected ($0.25)
Seat 6: bonyo71 (small blind) folded before Flop



PokerStars Hand #166667905257:  Hold'em No Limit ($0.05/$0.10 USD) - 2017/02/23 16:09:40 ET
Table 'Walpurga' 6-max Seat #2 is the button
Seat 1: chimera252 ($12.07 in chips) 
Seat 2: paxit71 ($5.10 in chips) 
Seat 3: marianoboni ($16.11 in chips) 
Seat 4: oddshoff ($12.89 in chips) 
Seat 5: Fremara ($10.05 in chips) 
marianoboni: posts small blind $0.05
oddshoff: posts big blind $0.10
*** HOLE CARDS ***
Fremara: folds 
chimera252: folds 
paxit71: folds 
marianoboni: raises $0.20 to $0.30
oddshoff: folds 
Uncalled bet ($0.20) returned to marianoboni
marianoboni collected $0.20 from pot
*** SUMMARY ***
Total pot $0.20 | Rake $0 
Seat 1: chimera252 folded before Flop (didn't bet)
Seat 2: paxit71 (button) folded before Flop (didn't bet)
Seat 3: marianoboni (small blind) collected ($0.20)
Seat 4: oddshoff (big blind) folded before Flop
Seat 5: Fremara folded before Flop (didn't bet)



PokerStars Hand #166667905752:  Hold'em No Limit ($0.05/$0.10 USD) - 2017/02/23 16:09:41 ET
Table 'Hamal II' 6-max Seat #2 is the button
Seat 1: saxoalto2011 ($6.74 in chips) 
Seat 2: pancernik21 ($11.29 in chips) 
Seat 3: Cluckh ($10.89 in chips) 
Seat 4: ArcticBearDK ($11.06 in chips) 
Seat 5: eniksenik ($10.89 in chips) 
Seat 6: LarryTheStar ($11.34 in chips) 
Cluckh: posts small blind $0.05
ArcticBearDK: posts big blind $0.10
*** HOLE CARDS ***
eniksenik: folds 
LarryTheStar: folds 
saxoalto2011: folds 
pancernik21: raises $0.20 to $0.30
Cluckh: folds 
ArcticBearDK: raises $0.70 to $1
pancernik21: calls $0.70
*** FLOP *** [9d 8c Ad]
ArcticBearDK: bets $1.10
pancernik21: calls $1.10
*** TURN *** [9d 8c Ad] [8h]
ArcticBearDK: bets $2.80
pancernik21: calls $2.80
*** RIVER *** [9d 8c Ad 8h] [Kc]
ArcticBearDK: checks 
pancernik21: bets $6.39 and is all-in
ArcticBearDK: calls $6.16 and is all-in
Uncalled bet ($0.23) returned to pancernik21
*** SHOW DOWN ***
pancernik21: shows [8s 7s] (three of a kind, Eights)
ArcticBearDK: shows [Ac Tc] (two pair, Aces and Eights)
pancernik21 collected $21.17 from pot
*** SUMMARY ***
Total pot $22.17 | Rake $1 
Board [9d 8c Ad 8h Kc]
Seat 1: saxoalto2011 folded before Flop (didn't bet)
Seat 2: pancernik21 (button) showed [8s 7s] and won ($21.17) with three of a kind, Eights
Seat 3: Cluckh (small blind) folded before Flop
Seat 4: ArcticBearDK (big blind) showed [Ac Tc] and lost with two pair, Aces and Eights
Seat 5: eniksenik folded before Flop (didn't bet)
Seat 6: LarryTheStar folded before Flop (didn't bet)



PokerStars Hand #166667905857:  Hold'em No Limit ($0.05/$0.10 USD) - 2017/02/23 16:09:41 ET
Table 'Serpens' 6-max Seat #1 is the button
Seat 1: Namhkal ($10 in chips) 
Seat 2: KA3AXCTAHEU, ($19.53 in chips) 
Seat 3: homelessdan ($29.88 in chips) 
KA3AXCTAHEU,: posts small blind $0.05
homelessdan: posts big blind $0.10
JahSoldier69 joins the table at seat #5 
DIENY772: sits out 
XaXaTyH4uK: sits out 
*** HOLE CARDS ***
Namhkal: folds 
KA3AXCTAHEU,: folds 
Uncalled bet ($0.05) returned to homelessdan
homelessdan collected $0.10 from pot
*** SUMMARY ***
Total pot $0.10 | Rake $0 
Seat 1: Namhkal (button) folded before Flop (didn't bet)
Seat 2: KA3AXCTAHEU, (small blind) folded before Flop
Seat 3: homelessdan (big blind) collected ($0.10)



PokerStars Hand #166667905894:  Hold'em No Limit ($0.05/$0.10 USD) - 2017/02/23 16:09:41 ET
Table 'Krethon' 6-max Seat #5 is the button
Seat 1: boxer821 ($10.77 in chips) 
Seat 2: manashov ($13.08 in chips) 
Seat 4: chimera252 ($14.79 in chips) 
Seat 5: popypaleta ($10 in chips) 
Seat 6: fabadam ($18.88 in chips) 
fabadam: posts small blind $0.05
boxer821: posts big blind $0.10
*** HOLE CARDS ***
manashov: raises $0.20 to $0.30
chimera252: folds 
popypaleta: folds 
fabadam: folds 
JahSoldier69 joins the table at seat #3 
boxer821: folds 
Uncalled bet ($0.20) returned to manashov
JahSoldier69 leaves the table
manashov collected $0.25 from pot
*** SUMMARY ***
Total pot $0.25 | Rake $0 
Seat 1: boxer821 (big blind) folded before Flop
Seat 2: manashov collected ($0.25)
Seat 4: chimera252 folded before Flop (didn't bet)
Seat 5: popypaleta (button) folded before Flop (didn't bet)
Seat 6: fabadam (small blind) folded before Flop



PokerStars Hand #166667906035:  Hold'em No Limit ($0.05/$0.10 USD) - 2017/02/23 16:09:41 ET
Table 'Pirola III' 6-max Seat #3 is the button
Seat 1: bdixon_5 ($9.32 in chips) 
Seat 2: Chodemuncher ($10 in chips) 
Seat 3: kingartur222 ($10.82 in chips) 
Seat 5: tequila_joop ($7.53 in chips) 
Seat 6: T9MS ($13.11 in chips) 
McCleans: is sitting out 
McCleans leaves the table
tequila_joop: posts small blind $0.05
T9MS: posts big blind $0.10
*** HOLE CARDS ***
bdixon_5: folds 
Chodemuncher: folds 
kingartur222: folds 
tequila_joop: folds 
Uncalled bet ($0.05) returned to T9MS
tequila_joop leaves the table
T9MS collected $0.10 from pot
*** SUMMARY ***
Total pot $0.10 | Rake $0 
Seat 1: bdixon_5 folded before Flop (didn't bet)
Seat 2: Chodemuncher folded before Flop (didn't bet)
Seat 3: kingartur222 (button) folded before Flop (didn't bet)
Seat 5: tequila_joop (small blind) folded before Flop
Seat 6: T9MS (big blind) collected ($0.10)



PokerStars Hand #166667906220:  Hold'em No Limit ($0.05/$0.10 USD) - 2017/02/23 16:09:41 ET
Table 'Pandora III' 6-max Seat #1 is the button
Seat 1: Pokeaster ($11.24 in chips) 
Seat 2: garigura ($11.44 in chips) 
Seat 3: Chodemuncher ($10 in chips) 
Seat 4: mhonielsen ($10.15 in chips) 
Seat 5: MühliJr ($10.57 in chips) 
Seat 6: yodzik ($5 in chips) 
garigura: posts small blind $0.05
Chodemuncher: posts big blind $0.10
*** HOLE CARDS ***
mhonielsen: folds 
MühliJr: folds 
yodzik: raises $0.20 to $0.30
Pokeaster: folds 
garigura: folds 
Chodemuncher: calls $0.20
*** FLOP *** [Ac 5c Qc]
Chodemuncher: checks 
yodzik: bets $0.47
Chodemuncher: folds 
Uncalled bet ($0.47) returned to yodzik
yodzik collected $0.62 from pot
*** SUMMARY ***
Total pot $0.65 | Rake $0.03 
Board [Ac 5c Qc]
Seat 1: Pokeaster (button) folded before Flop (didn't bet)
Seat 2: garigura (small blind) folded before Flop
Seat 3: Chodemuncher (big blind) folded on the Flop
Seat 4: mhonielsen folded before Flop (didn't bet)
Seat 5: MühliJr folded before Flop (didn't bet)
Seat 6: yodzik collected ($0.62)



PokerStars Hand #166667906415:  Hold'em No Limit ($0.05/$0.10 USD) - 2017/02/23 16:09:41 ET
Table 'Nata II' 6-max Seat #1 is the button
Seat 1: luisantrs ($8.60 in chips) 
Seat 2: CHRO8 ($18.34 in chips) 
Seat 3: 8th wonders ($10 in chips) 
Seat 4: Comeback3392 ($10 in chips) 
Seat 5: RoJ1 ($12.08 in chips) 
CHRO8: posts small blind $0.05
8th wonders: posts big blind $0.10
RGhearted: sits out 
*** HOLE CARDS ***
Comeback3392: raises $0.20 to $0.30
RoJ1: raises $0.50 to $0.80
luisantrs: calls $0.80
CHRO8: folds 
8th wonders: folds 
Comeback3392: calls $0.50
*** FLOP *** [3c Qh 2h]
Comeback3392: checks 
RoJ1: checks 
luisantrs: checks 
*** TURN *** [3c Qh 2h] [9c]
Comeback3392: bets $1.25
RoJ1: folds 
luisantrs: calls $1.25
*** RIVER *** [3c Qh 2h 9c] [3h]
Comeback3392: checks 
luisantrs: bets $2.41
Comeback3392: calls $2.41
*** SHOW DOWN ***
luisantrs: shows [6c 6h] (two pair, Sixes and Threes)
Comeback3392: shows [Tc Th] (two pair, Tens and Threes)
Comeback3392 collected $9.43 from pot
*** SUMMARY ***
Total pot $9.87 | Rake $0.44 
Board [3c Qh 2h 9c 3h]
Seat 1: luisantrs (button) showed [6c 6h] and lost with two pair, Sixes and Threes
Seat 2: CHRO8 (small blind) folded before Flop
Seat 3: 8th wonders (big blind) folded before Flop
Seat 4: Comeback3392 showed [Tc Th] and won ($9.43) with two pair, Tens and Threes
Seat 5: RoJ1 folded on the Turn



PokerStars Hand #166667906503:  Hold'em No Limit ($0.05/$0.10 USD) - 2017/02/23 16:09:41 ET
Table 'Gaika II' 6-max Seat #5 is the button
Seat 1: Ice_Isayev ($10 in chips) 
Seat 2: steepfell ($12.01 in chips) 
Seat 3: iDecMate ($18.73 in chips) 
Seat 4: Hyd SK ($10.43 in chips) 
Seat 5: KokoulinV ($12.56 in chips) 
Seat 6: bartabs2 ($8.77 in chips) 
bartabs2: posts small blind $0.05
Ice_Isayev: posts big blind $0.10
*** HOLE CARDS ***
steepfell: folds 
iDecMate: folds 
Hyd SK: folds 
KokoulinV: raises $0.10 to $0.20
bartabs2: folds 
Ice_Isayev: folds 
Uncalled bet ($0.10) returned to KokoulinV
KokoulinV collected $0.25 from pot
*** SUMMARY ***
Total pot $0.25 | Rake $0 
Seat 1: Ice_Isayev (big blind) folded before Flop
Seat 2: steepfell folded before Flop (didn't bet)
Seat 3: iDecMate folded before Flop (didn't bet)
Seat 4: Hyd SK folded before Flop (didn't bet)
Seat 5: KokoulinV (button) collected ($0.25)
Seat 6: bartabs2 (small blind) folded before Flop



PokerStars Hand #166667906563:  Hold'em No Limit ($0.05/$0.10 USD) - 2017/02/23 16:09:42 ET
Table 'Nikko II' 6-max Seat #2 is the button
Seat 1: bdixon_5 ($9.62 in chips) 
Seat 2: popypaleta ($10 in chips) 
Seat 3: Hyd SK ($11.71 in chips) 
Seat 4: Peter0087 ($10.01 in chips) 
Seat 5: Aescul@pius ($13.29 in chips) 
Seat 6: JahSoldier69 ($10 in chips) 
Hyd SK: posts small blind $0.05
Peter0087: posts big blind $0.10
*** HOLE CARDS ***
Aescul@pius: folds 
JahSoldier69: folds 
bdixon_5: folds 
popypaleta: raises $0.20 to $0.30
Hyd SK: folds 
Peter0087: folds 
Uncalled bet ($0.20) returned to popypaleta
popypaleta collected $0.25 from pot
*** SUMMARY ***
Total pot $0.25 | Rake $0 
Seat 1: bdixon_5 folded before Flop (didn't bet)
Seat 2: popypaleta (button) collected ($0.25)
Seat 3: Hyd SK (small blind) folded before Flop
Seat 4: Peter0087 (big blind) folded before Flop
Seat 5: Aescul@pius folded before Flop (didn't bet)
Seat 6: JahSoldier69 folded before Flop (didn't bet)



PokerStars Hand #166667906804:  Hold'em No Limit ($0.05/$0.10 USD) - 2017/02/23 16:09:42 ET
Table 'Lederle' 6-max Seat #3 is the button
Seat 1: Sterjek ($10 in chips) 
Seat 2: truck1234 ($15.54 in chips) 
Seat 3: Kazacha ($11.35 in chips) 
Seat 4: Pokeaster ($13.56 in chips) 
Seat 5: 8th wonders ($13.68 in chips) 
Seat 6: pokekrk ($10 in chips) 
Pokeaster: posts small blind $0.05
8th wonders: posts big blind $0.10
*** HOLE CARDS ***
pokekrk: folds 
Sterjek: folds 
truck1234: folds 
Kazacha: folds 
Pokeaster: raises $0.20 to $0.30
8th wonders: folds 
Uncalled bet ($0.20) returned to Pokeaster
Pokeaster collected $0.20 from pot
*** SUMMARY ***
Total pot $0.20 | Rake $0 
Seat 1: Sterjek folded before Flop (didn't bet)
Seat 2: truck1234 folded before Flop (didn't bet)
Seat 3: Kazacha (button) folded before Flop (didn't bet)
Seat 4: Pokeaster (small blind) collected ($0.20)
Seat 5: 8th wonders (big blind) folded before Flop
Seat 6: pokekrk folded before Flop (didn't bet)



PokerStars Hand #166667907523:  Hold'em No Limit ($0.05/$0.10 USD) - 2017/02/23 16:09:43 ET
Table 'Luanda' 6-max Seat #2 is the button
Seat 1: AM-L-SL ($2.81 in chips) 
Seat 2: Xander188 ($10 in chips) 
Seat 4: aapokerkot ($10.13 in chips) 
Seat 5: st4tion ($12.50 in chips) 
Seat 6: KA3AXCTAHEU, ($11.43 in chips) 
pokekrk will be allowed to play after the button
aapokerkot is disconnected 
aapokerkot is connected 
aapokerkot: posts small blind $0.05
st4tion: posts big blind $0.10
*** HOLE CARDS ***
KA3AXCTAHEU,: folds 
AM-L-SL: folds 
Xander188: raises $0.20 to $0.30
aapokerkot: folds 
st4tion: folds 
Uncalled bet ($0.20) returned to Xander188
Xander188 collected $0.25 from pot
*** SUMMARY ***
Total pot $0.25 | Rake $0 
Seat 1: AM-L-SL folded before Flop (didn't bet)
Seat 2: Xander188 (button) collected ($0.25)
Seat 4: aapokerkot (small blind) folded before Flop
Seat 5: st4tion (big blind) folded before Flop
Seat 6: KA3AXCTAHEU, folded before Flop (didn't bet)



PokerStars Hand #166667908088:  Hold'em No Limit ($0.05/$0.10 USD) - 2017/02/23 16:09:43 ET
Table 'Garlena III' 6-max Seat #5 is the button
Seat 1: dittoro ($11.54 in chips) 
Seat 2: YY778 ($9.92 in chips) 
Seat 3: IAntikI ($10 in chips) 
Seat 4: mbkongstad ($9.70 in chips) 
Seat 5: steepfell ($10 in chips) 
Seat 6: iluzja12 ($10 in chips) 
iluzja12: posts small blind $0.05
dittoro: posts big blind $0.10
*** HOLE CARDS ***
YY778: raises $0.10 to $0.20
IAntikI: folds 
mbkongstad: folds 
steepfell: folds 
iluzja12: calls $0.15
dittoro: folds 
*** FLOP *** [9c 7d 9s]
iluzja12: checks 
YY778: bets $0.50
iluzja12: folds 
Uncalled bet ($0.50) returned to YY778
YY778 collected $0.48 from pot
*** SUMMARY ***
Total pot $0.50 | Rake $0.02 
Board [9c 7d 9s]
Seat 1: dittoro (big blind) folded before Flop
Seat 2: YY778 collected ($0.48)
Seat 3: IAntikI folded before Flop (didn't bet)
Seat 4: mbkongstad folded before Flop (didn't bet)
Seat 5: steepfell (button) folded before Flop (didn't bet)
Seat 6: iluzja12 (small blind) folded on the Flop



PokerStars Hand #166667908185:  Hold'em No Limit ($0.05/$0.10 USD) - 2017/02/23 16:09:43 ET
Table 'Euryalos II' 6-max Seat #4 is the button
Seat 2: silsilviu ($16.52 in chips) 
Seat 3: Hyd SK ($10.50 in chips) 
Seat 4: popypaleta ($12.08 in chips) 
Seat 5: horang2 ($1.87 in chips) 
Seat 6: MihaGr ($10.07 in chips) 
horang2: posts small blind $0.05
MihaGr: posts big blind $0.10
voledy: sits out 
*** HOLE CARDS ***
silsilviu: folds 
Hyd SK: folds 
popypaleta: raises $0.20 to $0.30
horang2: folds 
MihaGr: folds 
Uncalled bet ($0.20) returned to popypaleta
horang2 leaves the table
popypaleta collected $0.25 from pot
*** SUMMARY ***
Total pot $0.25 | Rake $0 
Seat 2: silsilviu folded before Flop (didn't bet)
Seat 3: Hyd SK folded before Flop (didn't bet)
Seat 4: popypaleta (button) collected ($0.25)
Seat 5: horang2 (small blind) folded before Flop
Seat 6: MihaGr (big blind) folded before Flop



PokerStars Hand #166667908403:  Hold'em No Limit ($0.05/$0.10 USD) - 2017/02/23 16:09:44 ET
Table 'Lagrula' 6-max Seat #4 is the button
Seat 1: Ice_Isayev ($10 in chips) 
Seat 2: KRZuff ($10 in chips) 
Seat 3: micke667 ($15.90 in chips) 
Seat 4: Calimero2408 ($12.68 in chips) 
Seat 5: Iarlei ($10.19 in chips) 
Seat 6: Spud014 ($10 in chips) 
Iarlei: posts small blind $0.05
Spud014: posts big blind $0.10
*** HOLE CARDS ***
Ice_Isayev: folds 
KRZuff: raises $0.20 to $0.30
micke667: folds 
Calimero2408: folds 
Iarlei: folds 
Spud014: folds 
Uncalled bet ($0.20) returned to KRZuff
KRZuff collected $0.25 from pot
*** SUMMARY ***
Total pot $0.25 | Rake $0 
Seat 1: Ice_Isayev folded before Flop (didn't bet)
Seat 2: KRZuff collected ($0.25)
Seat 3: micke667 folded before Flop (didn't bet)
Seat 4: Calimero2408 (button) folded before Flop (didn't bet)
Seat 5: Iarlei (small blind) folded before Flop
Seat 6: Spud014 (big blind) folded before Flop



PokerStars Hand #166667908548:  Hold'em No Limit ($0.05/$0.10 USD) - 2017/02/23 16:09:44 ET
Table 'Sirius II' 6-max Seat #3 is the button
Seat 2: Buddy8711 ($8.83 in chips) 
Seat 3: Spud014 ($10 in chips) 
Seat 4: Pekaml ($10 in chips) 
Seat 5: manashov ($10 in chips) 
Seat 6: MihaGr ($10.15 in chips) 
Pekaml: posts small blind $0.05
manashov: posts big blind $0.10
Cluckh: sits out 
*** HOLE CARDS ***
MihaGr: raises $0.20 to $0.30
Buddy8711: folds 
Spud014: folds 
Pekaml: folds 
manashov: calls $0.20
*** FLOP *** [9s Ts 3c]
manashov: checks 
MihaGr: checks 
*** TURN *** [9s Ts 3c] [9d]
manashov: bets $0.25
MihaGr: folds 
Uncalled bet ($0.25) returned to manashov
manashov collected $0.62 from pot
*** SUMMARY ***
Total pot $0.65 | Rake $0.03 
Board [9s Ts 3c 9d]
Seat 2: Buddy8711 folded before Flop (didn't bet)
Seat 3: Spud014 (button) folded before Flop (didn't bet)
Seat 4: Pekaml (small blind) folded before Flop
Seat 5: manashov (big blind) collected ($0.62)
Seat 6: MihaGr folded on the Turn



PokerStars Hand #166667908729:  Hold'em No Limit ($0.05/$0.10 USD) - 2017/02/23 16:09:44 ET
Table 'Kobresia II' 6-max Seat #2 is the button
Seat 1: RoJ1 ($15.49 in chips) 
Seat 2: Dcaro31 ($13.37 in chips) 
Seat 4: Vanne11 ($10.05 in chips) 
Vanne11: posts small blind $0.05
Goroshkos88: is sitting out 
RoJ1: posts big blind $0.10
Goroshkos88 leaves the table
*** HOLE CARDS ***
Dcaro31: raises $0.20 to $0.30
ocmarigo81 joins the table at seat #3 
Vanne11: folds 
RoJ1: folds 
Uncalled bet ($0.20) returned to Dcaro31
XaXaTyH4uK joins the table at seat #5 
Dcaro31 collected $0.25 from pot
*** SUMMARY ***
Total pot $0.25 | Rake $0 
Seat 1: RoJ1 (big blind) folded before Flop
Seat 2: Dcaro31 (button) collected ($0.25)
Seat 4: Vanne11 (small blind) folded before Flop



PokerStars Hand #166667909082:  Hold'em No Limit ($0.05/$0.10 USD) - 2017/02/23 16:09:44 ET
Table 'Mesarthim' 6-max Seat #5 is the button
Seat 1: Mancuso2010 ($16.27 in chips) 
Seat 2: MühliJr ($12.99 in chips) 
Seat 3: Damage514 ($9.44 in chips) 
Seat 4: Strelok1974 ($10 in chips) 
Seat 5: Iarlei ($10.30 in chips) 
Seat 6: bdixon_5 ($8.41 in chips) 
bdixon_5: posts small blind $0.05
Mancuso2010: posts big blind $0.10
*** HOLE CARDS ***
MühliJr: folds 
Damage514: folds 
Strelok1974: folds 
Iarlei: folds 
bdixon_5: calls $0.05
Mancuso2010: raises $0.30 to $0.40
bdixon_5: folds 
Uncalled bet ($0.30) returned to Mancuso2010
Mancuso2010 collected $0.20 from pot
*** SUMMARY ***
Total pot $0.20 | Rake $0 
Seat 1: Mancuso2010 (big blind) collected ($0.20)
Seat 2: MühliJr folded before Flop (didn't bet)
Seat 3: Damage514 folded before Flop (didn't bet)
Seat 4: Strelok1974 folded before Flop (didn't bet)
Seat 5: Iarlei (button) folded before Flop (didn't bet)
Seat 6: bdixon_5 (small blind) folded before Flop



PokerStars Hand #166667909511:  Hold'em No Limit ($0.05/$0.10 USD) - 2017/02/23 16:09:45 ET
Table 'Tyndareus III' 6-max Seat #5 is the button
Seat 1: MBen10 ($18.96 in chips) 
Seat 2: MihaGr ($10.42 in chips) 
Seat 3: XaXaTyH4uK ($10 in chips) 
Seat 4: tequila_joop ($10.93 in chips) 
Seat 5: yodzik ($5 in chips) 
Seat 6: Hb-309 ($9.46 in chips) 
Hb-309: posts small blind $0.05
MBen10: posts big blind $0.10
*** HOLE CARDS ***
MihaGr: folds 
XaXaTyH4uK: folds 
tequila_joop: raises $0.20 to $0.30
yodzik: folds 
Hb-309: folds 
MBen10: folds 
Uncalled bet ($0.20) returned to tequila_joop
tequila_joop collected $0.25 from pot
*** SUMMARY ***
Total pot $0.25 | Rake $0 
Seat 1: MBen10 (big blind) folded before Flop
Seat 2: MihaGr folded before Flop (didn't bet)
Seat 3: XaXaTyH4uK folded before Flop (didn't bet)
Seat 4: tequila_joop collected ($0.25)
Seat 5: yodzik (button) folded before Flop (didn't bet)
Seat 6: Hb-309 (small blind) folded before Flop



PokerStars Hand #166667909515:  Hold'em No Limit ($0.05/$0.10 USD) - 2017/02/23 16:09:45 ET
Table 'Azelfafage' 6-max Seat #6 is the button
Seat 1: Sbozzz ($15.51 in chips) 
Seat 2: tr41n3r12 ($10 in chips) 
Seat 3: todor1711 ($15.68 in chips) 
Seat 4: fedorka rus ($15.81 in chips) 
Seat 5: 8th wonders ($12.80 in chips) 
Seat 6: KA3AXCTAHEU, ($10 in chips) 
Sbozzz: posts small blind $0.05
tr41n3r12: posts big blind $0.10
*** HOLE CARDS ***
todor1711: calls $0.10
fedorka rus: folds 
8th wonders: raises $0.30 to $0.40
KA3AXCTAHEU,: folds 
Sbozzz: folds 
tr41n3r12: calls $0.30
todor1711: calls $0.30
*** FLOP *** [4c 2d 5h]
tr41n3r12: checks 
todor1711: checks 
8th wonders: checks 
*** TURN *** [4c 2d 5h] [Js]
tr41n3r12: bets $0.89
todor1711: calls $0.89
8th wonders: folds 
*** RIVER *** [4c 2d 5h Js] [3c]
tr41n3r12: checks 
todor1711: checks 
*** SHOW DOWN ***
tr41n3r12: shows [Kd Kc] (a pair of Kings)
todor1711: mucks hand 
tr41n3r12 collected $2.89 from pot
*** SUMMARY ***
Total pot $3.03 | Rake $0.14 
Board [4c 2d 5h Js 3c]
Seat 1: Sbozzz (small blind) folded before Flop
Seat 2: tr41n3r12 (big blind) showed [Kd Kc] and won ($2.89) with a pair of Kings
Seat 3: todor1711 mucked
Seat 4: fedorka rus folded before Flop (didn't bet)
Seat 5: 8th wonders folded on the Turn
Seat 6: KA3AXCTAHEU, (button) folded before Flop (didn't bet)



PokerStars Hand #166667909563:  Hold'em No Limit ($0.05/$0.10 USD) - 2017/02/23 16:09:45 ET
Table 'Hercynia III' 6-max Seat #3 is the button
Seat 1: Bird et al ($15.08 in chips) 
Seat 2: Action_Gibi ($7.13 in chips) 
Seat 3: Dcaro31 ($19.87 in chips) 
Seat 5: THIMUCHIN ($15.35 in chips) 
Seat 6: bdixon_5 ($11.29 in chips) 
THIMUCHIN: posts small blind $0.05
bdixon_5: posts big blind $0.10
*** HOLE CARDS ***
Bird et al: folds 
Action_Gibi: folds 
Dcaro31: raises $0.20 to $0.30
THIMUCHIN: folds 
bdixon_5: folds 
Uncalled bet ($0.20) returned to Dcaro31
Dcaro31 collected $0.25 from pot
*** SUMMARY ***
Total pot $0.25 | Rake $0 
Seat 1: Bird et al folded before Flop (didn't bet)
Seat 2: Action_Gibi folded before Flop (didn't bet)
Seat 3: Dcaro31 (button) collected ($0.25)
Seat 5: THIMUCHIN (small blind) folded before Flop
Seat 6: bdixon_5 (big blind) folded before Flop



PokerStars Hand #166667909642:  Hold'em No Limit ($0.05/$0.10 USD) - 2017/02/23 16:09:45 ET
Table 'Tirela' 6-max Seat #2 is the button
Seat 1: Smitty03300 ($10 in chips) 
Seat 2: Andrei ProFF ($16.99 in chips) 
Seat 3: aim444 ($16.66 in chips) 
Seat 4: ArcticBearDK ($10 in chips) 
Seat 5: KRZuff ($13.91 in chips) 
Seat 6: coolisses111 ($9.80 in chips) 
aim444: posts small blind $0.05
ArcticBearDK: posts big blind $0.10
*** HOLE CARDS ***
KRZuff: raises $0.20 to $0.30
coolisses111: folds 
Smitty03300: calls $0.30
Andrei ProFF: folds 
aim444: calls $0.25
ArcticBearDK: folds 
*** FLOP *** [3d 6d 5s]
aim444: bets $0.10
KRZuff: raises $0.75 to $0.85
Smitty03300: calls $0.85
aim444: folds 
*** TURN *** [3d 6d 5s] [4c]
KRZuff: bets $1.70
Smitty03300: folds 
Uncalled bet ($1.70) returned to KRZuff
KRZuff collected $2.67 from pot
*** SUMMARY ***
Total pot $2.80 | Rake $0.13 
Board [3d 6d 5s 4c]
Seat 1: Smitty03300 folded on the Turn
Seat 2: Andrei ProFF (button) folded before Flop (didn't bet)
Seat 3: aim444 (small blind) folded on the Flop
Seat 4: ArcticBearDK (big blind) folded before Flop
Seat 5: KRZuff collected ($2.67)
Seat 6: coolisses111 folded before Flop (didn't bet)



PokerStars Hand #166667909840:  Hold'em No Limit ($0.05/$0.10 USD) - 2017/02/23 16:09:45 ET
Table 'Vesta II' 6-max Seat #3 is the button
Seat 1: Yabidooo ($17.42 in chips) 
Seat 2: Dimka4 ($10 in chips) 
Seat 3: Pokeaster ($12.56 in chips) 
Seat 4: Dcaro31 ($10 in chips) 
Seat 5: ChuikaPridi ($10.15 in chips) 
Seat 6: XaXaTyH4uK ($10.86 in chips) 
Dcaro31: posts small blind $0.05
ChuikaPridi: posts big blind $0.10
*** HOLE CARDS ***
XaXaTyH4uK: folds 
Yabidooo: raises $0.15 to $0.25
Dimka4: folds 
Pokeaster: folds 
Dcaro31: folds 
ChuikaPridi: folds 
Uncalled bet ($0.15) returned to Yabidooo
Yabidooo collected $0.25 from pot
*** SUMMARY ***
Total pot $0.25 | Rake $0 
Seat 1: Yabidooo collected ($0.25)
Seat 2: Dimka4 folded before Flop (didn't bet)
Seat 3: Pokeaster (button) folded before Flop (didn't bet)
Seat 4: Dcaro31 (small blind) folded before Flop
Seat 5: ChuikaPridi (big blind) folded before Flop
Seat 6: XaXaTyH4uK folded before Flop (didn't bet)



PokerStars Hand #166667909883:  Hold'em No Limit ($0.05/$0.10 USD) - 2017/02/23 16:09:45 ET
Table 'Tomita II' 6-max Seat #4 is the button
Seat 2: mhonielsen ($10 in chips) 
Seat 3: D3NyA ($10 in chips) 
Seat 4: Hyd SK ($11.61 in chips) 
Seat 5: ex3Lero86 ($10 in chips) 
Seat 6: saniasmir ($10.15 in chips) 
ex3Lero86: posts small blind $0.05
saniasmir: posts big blind $0.10
HARDCORE66RU: sits out 
*** HOLE CARDS ***
mhonielsen: raises $0.20 to $0.30
D3NyA: folds 
Hyd SK: folds 
ex3Lero86: folds 
saniasmir: folds 
Uncalled bet ($0.20) returned to mhonielsen
mhonielsen collected $0.25 from pot
*** SUMMARY ***
Total pot $0.25 | Rake $0 
Seat 2: mhonielsen collected ($0.25)
Seat 3: D3NyA folded before Flop (didn't bet)
Seat 4: Hyd SK (button) folded before Flop (didn't bet)
Seat 5: ex3Lero86 (small blind) folded before Flop
Seat 6: saniasmir (big blind) folded before Flop



PokerStars Hand #166667910228:  Hold'em No Limit ($0.05/$0.10 USD) - 2017/02/23 16:09:46 ET
Table 'Girtab' 6-max Seat #4 is the button
Seat 1: pokekrk ($17.07 in chips) 
Seat 2: MühliJr ($10.51 in chips) 
Seat 3: kingartur222 ($10.05 in chips) 
Seat 4: Hyd SK ($10.98 in chips) 
Seat 5: sexy_seagull ($11.10 in chips) 
Seat 6: iluzja12 ($10 in chips) 
sexy_seagull: posts small blind $0.05
iluzja12: posts big blind $0.10
*** HOLE CARDS ***
pokekrk: folds 
MühliJr: raises $0.20 to $0.30
kingartur222: folds 
Hyd SK: folds 
sexy_seagull: folds 
iluzja12: folds 
Uncalled bet ($0.20) returned to MühliJr
MühliJr collected $0.25 from pot
*** SUMMARY ***
Total pot $0.25 | Rake $0 
Seat 1: pokekrk folded before Flop (didn't bet)
Seat 2: MühliJr collected ($0.25)
Seat 3: kingartur222 folded before Flop (didn't bet)
Seat 4: Hyd SK (button) folded before Flop (didn't bet)
Seat 5: sexy_seagull (small blind) folded before Flop
Seat 6: iluzja12 (big blind) folded before Flop



PokerStars Hand #166667910310:  Hold'em No Limit ($0.05/$0.10 USD) - 2017/02/23 16:09:46 ET
Table 'Thia' 6-max Seat #2 is the button
Seat 1: Eddys Edge ($10.87 in chips) 
Seat 2: sugrob86 ($19.42 in chips) 
Seat 3: northug18 ($9.27 in chips) 
Seat 4: Bandyaev ($10.10 in chips) 
Seat 5: ab260414 ($10 in chips) 
Seat 6: ex3Lero86 ($15.65 in chips) 
northug18: posts small blind $0.05
Bandyaev: posts big blind $0.10
*** HOLE CARDS ***
ab260414: folds 
ex3Lero86: folds 
Eddys Edge: raises $0.15 to $0.25
sugrob86: calls $0.25
northug18: folds 
Bandyaev: folds 
*** FLOP *** [5c Ad Ts]
Eddys Edge: bets $0.47
sugrob86: raises $8.27 to $8.74
Eddys Edge: folds 
Uncalled bet ($8.27) returned to sugrob86
sugrob86 collected $1.52 from pot
*** SUMMARY ***
Total pot $1.59 | Rake $0.07 
Board [5c Ad Ts]
Seat 1: Eddys Edge folded on the Flop
Seat 2: sugrob86 (button) collected ($1.52)
Seat 3: northug18 (small blind) folded before Flop
Seat 4: Bandyaev (big blind) folded before Flop
Seat 5: ab260414 folded before Flop (didn't bet)
Seat 6: ex3Lero86 folded before Flop (didn't bet)



PokerStars Hand #166667910322:  Hold'em No Limit ($0.05/$0.10 USD) - 2017/02/23 16:09:46 ET
Table 'Selinur' 6-max Seat #1 is the button
Seat 1: KA3AXCTAHEU, ($10 in chips) 
Seat 2: hoedje72 ($7.12 in chips) 
Seat 3: bambolejro ($11.07 in chips) 
Seat 5: DrVzad ($10 in chips) 
Seat 6: homelessdan ($18.50 in chips) 
hoedje72: posts small blind $0.05
bambolejro: posts big blind $0.10
ThuyeTD11: sits out 
*** HOLE CARDS ***
DrVzad: folds 
homelessdan: folds 
KA3AXCTAHEU,: folds 
hoedje72: folds 
Uncalled bet ($0.05) returned to bambolejro
bambolejro collected $0.10 from pot
*** SUMMARY ***
Total pot $0.10 | Rake $0 
Seat 1: KA3AXCTAHEU, (button) folded before Flop (didn't bet)
Seat 2: hoedje72 (small blind) folded before Flop
Seat 3: bambolejro (big blind) collected ($0.10)
Seat 5: DrVzad folded before Flop (didn't bet)
Seat 6: homelessdan folded before Flop (didn't bet)



PokerStars Hand #166667911698:  Hold'em No Limit ($0.05/$0.10 USD) - 2017/02/23 16:09:47 ET
Table 'Eurydome II' 6-max Seat #3 is the button
Seat 1: rusu_rapid ($11.83 in chips) 
Seat 3: gaHy_HaXeP ($11.94 in chips) 
Seat 4: Smitty03300 ($10 in chips) 
Seat 5: kush-killa87 ($10.74 in chips) 
Seat 6: Jucatorul823 ($4.67 in chips) 
Smitty03300: posts small blind $0.05
kush-killa87: posts big blind $0.10
Elinaattor: sits out 
*** HOLE CARDS ***
Jucatorul823: folds 
rusu_rapid: folds 
gaHy_HaXeP: raises $0.12 to $0.22
Smitty03300: folds 
kush-killa87: folds 
Uncalled bet ($0.12) returned to gaHy_HaXeP
gaHy_HaXeP collected $0.25 from pot
*** SUMMARY ***
Total pot $0.25 | Rake $0 
Seat 1: rusu_rapid folded before Flop (didn't bet)
Seat 3: gaHy_HaXeP (button) collected ($0.25)
Seat 4: Smitty03300 (small blind) folded before Flop
Seat 5: kush-killa87 (big blind) folded before Flop
Seat 6: Jucatorul823 folded before Flop (didn't bet)



PokerStars Hand #166667911809:  Hold'em No Limit ($0.05/$0.10 USD) - 2017/02/23 16:09:47 ET
Table 'Nuki' 6-max Seat #1 is the button
Seat 1: bdixon_5 ($7.65 in chips) 
Seat 2: ArcticBearDK ($19.23 in chips) 
Seat 3: Chodemuncher ($10 in chips) 
Seat 4: GESPERIA ($28.43 in chips) 
Seat 5: fabadam ($11.13 in chips) 
Seat 6: Zooplack ($25.62 in chips) 
ArcticBearDK: posts small blind $0.05
Chodemuncher: posts big blind $0.10
*** HOLE CARDS ***
GESPERIA: folds 
fabadam: raises $0.15 to $0.25
Zooplack: folds 
bdixon_5: raises $0.45 to $0.70
ArcticBearDK: folds 
Chodemuncher: folds 
fabadam: calls $0.45
*** FLOP *** [Ah 8s Qc]
fabadam: checks 
bdixon_5: bets $0.70
fabadam: folds 
Uncalled bet ($0.70) returned to bdixon_5
bdixon_5 collected $1.48 from pot
*** SUMMARY ***
Total pot $1.55 | Rake $0.07 
Board [Ah 8s Qc]
Seat 1: bdixon_5 (button) collected ($1.48)
Seat 2: ArcticBearDK (small blind) folded before Flop
Seat 3: Chodemuncher (big blind) folded before Flop
Seat 4: GESPERIA folded before Flop (didn't bet)
Seat 5: fabadam folded on the Flop
Seat 6: Zooplack folded before Flop (didn't bet)



PokerStars Hand #166667911895:  Hold'em No Limit ($0.05/$0.10 USD) - 2017/02/23 16:09:47 ET
Table 'Lorbach' 6-max Seat #2 is the button
Seat 1: LarryTheStar ($17.44 in chips) 
Seat 2: fabadam ($11.68 in chips) 
Seat 3: ArcticBearDK ($10 in chips) 
Seat 6: Worlz ($16.22 in chips) 
ArcticBearDK: posts small blind $0.05
Worlz: posts big blind $0.10
*** HOLE CARDS ***
LarryTheStar: raises $0.20 to $0.30
fabadam: folds 
ArcticBearDK: folds 
Worlz: folds 
Uncalled bet ($0.20) returned to LarryTheStar
LarryTheStar collected $0.25 from pot
*** SUMMARY ***
Total pot $0.25 | Rake $0 
Seat 1: LarryTheStar collected ($0.25)
Seat 2: fabadam (button) folded before Flop (didn't bet)
Seat 3: ArcticBearDK (small blind) folded before Flop
Seat 6: Worlz (big blind) folded before Flop



PokerStars Hand #166667912017:  Hold'em No Limit ($0.05/$0.10 USD) - 2017/02/23 16:09:48 ET
Table 'Wingolfia II' 6-max Seat #1 is the button
Seat 1: BahiaMinhaP ($10 in chips) 
Seat 2: NvR.m1nD ($10.05 in chips) 
Seat 3: truck1234 ($10.72 in chips) 
Seat 4: zlobslob ($17.87 in chips) 
Seat 5: tr41n3r12 ($11.58 in chips) 
Seat 6: Tom Zhangxue ($10 in chips) 
NvR.m1nD: posts small blind $0.05
truck1234: posts big blind $0.10
Tom Zhangxue: posts big blind $0.10
*** HOLE CARDS ***
zlobslob: folds 
tr41n3r12: raises $0.30 to $0.40
Tom Zhangxue: calls $0.30
BahiaMinhaP: folds 
NvR.m1nD: folds 
truck1234: folds 
*** FLOP *** [Kc 7d 2d]
tr41n3r12: checks 
Tom Zhangxue: checks 
*** TURN *** [Kc 7d 2d] [9s]
tr41n3r12: checks 
Tom Zhangxue: checks 
*** RIVER *** [Kc 7d 2d 9s] [7s]
tr41n3r12: checks 
Tom Zhangxue: checks 
*** SHOW DOWN ***
tr41n3r12: shows [Tc Ad] (a pair of Sevens)
Tom Zhangxue: mucks hand 
tr41n3r12 collected $0.91 from pot
*** SUMMARY ***
Total pot $0.95 | Rake $0.04 
Board [Kc 7d 2d 9s 7s]
Seat 1: BahiaMinhaP (button) folded before Flop (didn't bet)
Seat 2: NvR.m1nD (small blind) folded before Flop
Seat 3: truck1234 (big blind) folded before Flop
Seat 4: zlobslob folded before Flop (didn't bet)
Seat 5: tr41n3r12 showed [Tc Ad] and won ($0.91) with a pair of Sevens
Seat 6: Tom Zhangxue mucked



PokerStars Hand #166667912471:  Hold'em No Limit ($0.05/$0.10 USD) - 2017/02/23 16:09:48 ET
Table 'Alzirr II' 6-max Seat #3 is the button
Seat 1: KA3AXCTAHEU, ($10.62 in chips) 
Seat 2: popypaleta ($10.25 in chips) 
Seat 3: devon_red ($7.35 in chips) 
Seat 5: yodzik ($5.98 in chips) 
Seat 6: AM-L-SL ($4.33 in chips) 
Scanner17 will be allowed to play after the button
yodzik: posts small blind $0.05
AM-L-SL: posts big blind $0.10
*** HOLE CARDS ***
KA3AXCTAHEU,: folds 
popypaleta: folds 
devon_red: folds 
yodzik: folds 
Uncalled bet ($0.05) returned to AM-L-SL
AM-L-SL collected $0.10 from pot
*** SUMMARY ***
Total pot $0.10 | Rake $0 
Seat 1: KA3AXCTAHEU, folded before Flop (didn't bet)
Seat 2: popypaleta folded before Flop (didn't bet)
Seat 3: devon_red (button) folded before Flop (didn't bet)
Seat 5: yodzik (small blind) folded before Flop
Seat 6: AM-L-SL (big blind) collected ($0.10)



PokerStars Hand #166667912720:  Hold'em No Limit ($0.05/$0.10 USD) - 2017/02/23 16:09:48 ET
Table 'Cuyo' 6-max Seat #3 is the button
Seat 1: Bandyaev ($11.54 in chips) 
Seat 2: Therodorus ($10 in chips) 
Seat 3: Hergie88 ($9.32 in chips) 
Seat 4: bambolejro ($10 in chips) 
Seat 5: DrVzad ($10 in chips) 
Seat 6: iluzja12 ($10 in chips) 
bambolejro: posts small blind $0.05
DrVzad: posts big blind $0.10
*** HOLE CARDS ***
iluzja12: folds 
Bandyaev: folds 
Therodorus: raises $0.20 to $0.30
Hergie88: folds 
bambolejro: folds 
DrVzad: folds 
Uncalled bet ($0.20) returned to Therodorus
Therodorus collected $0.25 from pot
*** SUMMARY ***
Total pot $0.25 | Rake $0 
Seat 1: Bandyaev folded before Flop (didn't bet)
Seat 2: Therodorus collected ($0.25)
Seat 3: Hergie88 (button) folded before Flop (didn't bet)
Seat 4: bambolejro (small blind) folded before Flop
Seat 5: DrVzad (big blind) folded before Flop
Seat 6: iluzja12 folded before Flop (didn't bet)



PokerStars Hand #166667912778:  Hold'em No Limit ($0.05/$0.10 USD) - 2017/02/23 16:09:48 ET
Table 'Lampetia III' 6-max Seat #3 is the button
Seat 1: gaHy_HaXeP ($10.55 in chips) 
Seat 2: DamDatsAnAce ($10.68 in chips) 
Seat 3: Kow6oy ($10 in chips) 
Seat 4: IAntikI ($10.35 in chips) 
Seat 5: robson1235 ($20.45 in chips) 
Seat 6: bdixon_5 ($9.20 in chips) 
IAntikI: posts small blind $0.05
robson1235: posts big blind $0.10
*** HOLE CARDS ***
bdixon_5: folds 
gaHy_HaXeP: folds 
DamDatsAnAce: raises $0.20 to $0.30
Kow6oy: folds 
IAntikI: folds 
robson1235: folds 
Uncalled bet ($0.20) returned to DamDatsAnAce
DamDatsAnAce collected $0.25 from pot
*** SUMMARY ***
Total pot $0.25 | Rake $0 
Seat 1: gaHy_HaXeP folded before Flop (didn't bet)
Seat 2: DamDatsAnAce collected ($0.25)
Seat 3: Kow6oy (button) folded before Flop (didn't bet)
Seat 4: IAntikI (small blind) folded before Flop
Seat 5: robson1235 (big blind) folded before Flop
Seat 6: bdixon_5 folded before Flop (didn't bet)



PokerStars Hand #166667913008:  Hold'em No Limit ($0.05/$0.10 USD) - 2017/02/23 16:09:49 ET
Table 'Halawe II' 6-max Seat #4 is the button
Seat 1: DIGOR100 ($6.16 in chips) 
Seat 3: cherep61987 ($10.39 in chips) 
Seat 4: voledy ($12 in chips) 
Seat 5: takis nik ($12.28 in chips) 
Seat 6: Rodik002 ($22.01 in chips) 
takis nik: posts small blind $0.05
Rodik002: posts big blind $0.10
*** HOLE CARDS ***
DIGOR100: folds 
cherep61987: folds 
voledy: folds 
takis nik: raises $0.10 to $0.20
Rodik002: calls $0.10
*** FLOP *** [7d 2s 3d]
takis nik: bets $0.19
Rodik002: raises $0.27 to $0.46
takis nik: calls $0.27
*** TURN *** [7d 2s 3d] [4s]
takis nik: bets $0.95
Rodik002: folds 
Uncalled bet ($0.95) returned to takis nik
takis nik collected $1.26 from pot
*** SUMMARY ***
Total pot $1.32 | Rake $0.06 
Board [7d 2s 3d 4s]
Seat 1: DIGOR100 folded before Flop (didn't bet)
Seat 3: cherep61987 folded before Flop (didn't bet)
Seat 4: voledy (button) folded before Flop (didn't bet)
Seat 5: takis nik (small blind) collected ($1.26)
Seat 6: Rodik002 (big blind) folded on the Turn



PokerStars Hand #166667913033:  Hold'em No Limit ($0.05/$0.10 USD) - 2017/02/23 16:09:49 ET
Table 'Eudora' 6-max Seat #3 is the button
Seat 1: archer2511 ($12.40 in chips) 
Seat 2: popypaleta ($10 in chips) 
Seat 3: Ice_Isayev ($10.45 in chips) 
Seat 4: yodzik ($5 in chips) 
Seat 5: chimera252 ($11.11 in chips) 
yodzik: posts small blind $0.05
chimera252: posts big blind $0.10
HARDCORE66RU: sits out 
*** HOLE CARDS ***
archer2511: folds 
popypaleta: folds 
Ice_Isayev: folds 
yodzik: folds 
Uncalled bet ($0.05) returned to chimera252
chimera252 collected $0.10 from pot
*** SUMMARY ***
Total pot $0.10 | Rake $0 
Seat 1: archer2511 folded before Flop (didn't bet)
Seat 2: popypaleta folded before Flop (didn't bet)
Seat 3: Ice_Isayev (button) folded before Flop (didn't bet)
Seat 4: yodzik (small blind) folded before Flop
Seat 5: chimera252 (big blind) collected ($0.10)



PokerStars Hand #166667913286:  Hold'em No Limit ($0.05/$0.10 USD) - 2017/02/23 16:09:49 ET
Table 'Camilla II' 6-max Seat #3 is the button
Seat 1: paxit71 ($8.32 in chips) 
Seat 2: Giyorod ($13.31 in chips) 
Seat 3: Andy Wolf ($12.69 in chips) 
Seat 4: chimera252 ($12.46 in chips) 
Seat 5: LarryTheStar ($10.82 in chips) 
chimera252: posts small blind $0.05
LarryTheStar: posts big blind $0.10
*** HOLE CARDS ***
paxit71: folds 
Giyorod: raises $0.20 to $0.30
Andy Wolf: folds 
chimera252: folds 
LarryTheStar: calls $0.20
*** FLOP *** [9h 8c 7d]
LarryTheStar: checks 
Giyorod: checks 
*** TURN *** [9h 8c 7d] [6s]
david_sara83 leaves the table
LarryTheStar: bets $0.40
Giyorod: folds 
Uncalled bet ($0.40) returned to LarryTheStar
LarryTheStar collected $0.62 from pot
*** SUMMARY ***
Total pot $0.65 | Rake $0.03 
Board [9h 8c 7d 6s]
Seat 1: paxit71 folded before Flop (didn't bet)
Seat 2: Giyorod folded on the Turn
Seat 3: Andy Wolf (button) folded before Flop (didn't bet)
Seat 4: chimera252 (small blind) folded before Flop
Seat 5: LarryTheStar (big blind) collected ($0.62)



PokerStars Hand #166667913468:  Hold'em No Limit ($0.05/$0.10 USD) - 2017/02/23 16:09:49 ET
Table 'Hestia' 6-max Seat #1 is the button
Seat 1: Pekaml ($10.13 in chips) 
Seat 2: Kow6oy ($10.32 in chips) 
Seat 3: MBen10 ($13.43 in chips) 
Seat 4: Lucky HoBBiT ($10 in chips) 
Seat 5: CiisCi ($17.11 in chips) 
Kow6oy: posts small blind $0.05
MBen10: posts big blind $0.10
*** HOLE CARDS ***
Smitty03300 leaves the table
Lucky HoBBiT is disconnected 
Lucky HoBBiT has timed out while disconnected
Lucky HoBBiT: folds 
CiisCi: folds 
Pekaml: folds 
Kow6oy: folds 
Uncalled bet ($0.05) returned to MBen10
MBen10 collected $0.10 from pot
*** SUMMARY ***
Total pot $0.10 | Rake $0 
Seat 1: Pekaml (button) folded before Flop (didn't bet)
Seat 2: Kow6oy (small blind) folded before Flop
Seat 3: MBen10 (big blind) collected ($0.10)
Seat 4: Lucky HoBBiT folded before Flop (didn't bet)
Seat 5: CiisCi folded before Flop (didn't bet)



PokerStars Hand #166667913561:  Hold'em No Limit ($0.05/$0.10 USD) - 2017/02/23 16:09:49 ET
Table 'Thoas' 6-max Seat #3 is the button
Seat 1: Pekaml ($11.14 in chips) 
Seat 2: themacer24 ($8.79 in chips) 
Seat 3: iamkakaroto ($10.38 in chips) 
Seat 4: Morris_Chair ($18.57 in chips) 
Seat 5: Kow6oy ($10 in chips) 
Seat 6: takis nik ($10 in chips) 
Morris_Chair: posts small blind $0.05
Kow6oy: posts big blind $0.10
*** HOLE CARDS ***
takis nik: folds 
Pekaml: folds 
themacer24: calls $0.10
iamkakaroto: raises $0.40 to $0.50
Morris_Chair: calls $0.45
Kow6oy: folds 
themacer24: folds 
*** FLOP *** [As 5c Qs]
Morris_Chair: bets $1
iamkakaroto: raises $1.73 to $2.73
Morris_Chair: raises $1.73 to $4.46
iamkakaroto: folds 
Uncalled bet ($1.73) returned to Morris_Chair
Morris_Chair collected $6.36 from pot
*** SUMMARY ***
Total pot $6.66 | Rake $0.30 
Board [As 5c Qs]
Seat 1: Pekaml folded before Flop (didn't bet)
Seat 2: themacer24 folded before Flop
Seat 3: iamkakaroto (button) folded on the Flop
Seat 4: Morris_Chair (small blind) collected ($6.36)
Seat 5: Kow6oy (big blind) folded before Flop
Seat 6: takis nik folded before Flop (didn't bet)



PokerStars Hand #166667913785:  Hold'em No Limit ($0.05/$0.10 USD) - 2017/02/23 16:09:49 ET
Table 'California II' 6-max Seat #6 is the button
Seat 2: homelessdan ($10 in chips) 
Seat 3: Bird et al ($10 in chips) 
Seat 4: pokekrk ($13.97 in chips) 
Seat 5: Nikolai77798 ($4.04 in chips) 
Seat 6: chiko4040 ($8.83 in chips) 
homelessdan: posts small blind $0.05
Bird et al: posts big blind $0.10
*** HOLE CARDS ***
pokekrk: folds 
Nikolai77798: calls $0.10
chiko4040: raises $0.30 to $0.40
homelessdan: folds 
Bird et al: folds 
Nikolai77798: calls $0.30
*** FLOP *** [Js 9s 6c]
Nikolai77798: bets $0.40
chiko4040: calls $0.40
*** TURN *** [Js 9s 6c] [8c]
Nikolai77798: bets $0.90
chiko4040: folds 
Uncalled bet ($0.90) returned to Nikolai77798
Nikolai77798 collected $1.67 from pot
*** SUMMARY ***
Total pot $1.75 | Rake $0.08 
Board [Js 9s 6c 8c]
Seat 2: homelessdan (small blind) folded before Flop
Seat 3: Bird et al (big blind) folded before Flop
Seat 4: pokekrk folded before Flop (didn't bet)
Seat 5: Nikolai77798 collected ($1.67)
Seat 6: chiko4040 (button) folded on the Turn



PokerStars Hand #166667913937:  Hold'em No Limit ($0.05/$0.10 USD) - 2017/02/23 16:09:50 ET
Table 'Lampetia' 6-max Seat #3 is the button
Seat 1: WinninBikini ($10.33 in chips) 
Seat 2: ex3Lero86 ($10.30 in chips) 
Seat 3: Ice_Isayev ($19.74 in chips) 
Seat 4: Rodik002 ($10 in chips) 
Seat 5: luisantrs ($10.52 in chips) 
Seat 6: Scanner17 ($12.09 in chips) 
Rodik002: posts small blind $0.05
luisantrs: posts big blind $0.10
*** HOLE CARDS ***
Scanner17: folds 
WinninBikini: raises $0.20 to $0.30
ex3Lero86: folds 
Ice_Isayev: folds 
Rodik002: folds 
luisantrs: calls $0.20
*** FLOP *** [5d 3d Qd]
luisantrs: checks 
WinninBikini: checks 
*** TURN *** [5d 3d Qd] [6c]
luisantrs: bets $0.31
WinninBikini: folds 
Uncalled bet ($0.31) returned to luisantrs
luisantrs collected $0.62 from pot
*** SUMMARY ***
Total pot $0.65 | Rake $0.03 
Board [5d 3d Qd 6c]
Seat 1: WinninBikini folded on the Turn
Seat 2: ex3Lero86 folded before Flop (didn't bet)
Seat 3: Ice_Isayev (button) folded before Flop (didn't bet)
Seat 4: Rodik002 (small blind) folded before Flop
Seat 5: luisantrs (big blind) collected ($0.62)
Seat 6: Scanner17 folded before Flop (didn't bet)



PokerStars Hand #166667914030:  Hold'em No Limit ($0.05/$0.10 USD) - 2017/02/23 16:09:50 ET
Table 'Nauheima II' 6-max Seat #3 is the button
Seat 2: Peter0087 ($10.27 in chips) 
Seat 3: KokoulinV ($13.45 in chips) 
Seat 5: bambolejro ($10 in chips) 
Seat 6: bonyo71 ($5.04 in chips) 
martijn091 will be allowed to play after the button
bambolejro: posts small blind $0.05
bonyo71: posts big blind $0.10
HARDCORE66RU: sits out 
*** HOLE CARDS ***
Peter0087: folds 
KokoulinV: folds 
bambolejro: folds 
Uncalled bet ($0.05) returned to bonyo71
bonyo71 collected $0.10 from pot
*** SUMMARY ***
Total pot $0.10 | Rake $0 
Seat 2: Peter0087 folded before Flop (didn't bet)
Seat 3: KokoulinV (button) folded before Flop (didn't bet)
Seat 5: bambolejro (small blind) folded before Flop
Seat 6: bonyo71 (big blind) collected ($0.10)



PokerStars Hand #166667914239:  Hold'em No Limit ($0.05/$0.10 USD) - 2017/02/23 16:09:50 ET
Table 'Persephone' 6-max Seat #6 is the button
Seat 1: dragonste89 ($14.50 in chips) 
Seat 2: AM-L-SL ($5.50 in chips) 
Seat 4: 2G28 ($11.36 in chips) 
Seat 5: ab260414 ($10.56 in chips) 
Seat 6: popypaleta ($13.38 in chips) 
dragonste89: posts small blind $0.05
AM-L-SL: posts big blind $0.10
Mooneye19: sits out 
*** HOLE CARDS ***
2G28: folds 
ab260414: folds 
popypaleta: folds 
dragonste89: folds 
Uncalled bet ($0.05) returned to AM-L-SL
AM-L-SL collected $0.10 from pot
*** SUMMARY ***
Total pot $0.10 | Rake $0 
Seat 1: dragonste89 (small blind) folded before Flop
Seat 2: AM-L-SL (big blind) collected ($0.10)
Seat 4: 2G28 folded before Flop (didn't bet)
Seat 5: ab260414 folded before Flop (didn't bet)
Seat 6: popypaleta (button) folded before Flop (didn't bet)



PokerStars Hand #166667914240:  Hold'em No Limit ($0.05/$0.10 USD) - 2017/02/23 16:09:50 ET
Table 'Serpens' 6-max Seat #2 is the button
Seat 1: Namhkal ($10 in chips) 
Seat 2: KA3AXCTAHEU, ($19.48 in chips) 
Seat 3: homelessdan ($29.93 in chips) 
Seat 4: DIENY772 ($10 in chips) 
homelessdan: posts small blind $0.05
DIENY772: posts big blind $0.10
JahSoldier69: sits out 
XaXaTyH4uK: sits out 
*** HOLE CARDS ***
Namhkal: raises $0.15 to $0.25
KA3AXCTAHEU,: folds 
homelessdan: folds 
DIENY772: calls $0.15
*** FLOP *** [Kh 7d 9d]
DIENY772: checks 
Namhkal: bets $0.27
DIENY772: folds 
Uncalled bet ($0.27) returned to Namhkal
Namhkal collected $0.53 from pot
*** SUMMARY ***
Total pot $0.55 | Rake $0.02 
Board [Kh 7d 9d]
Seat 1: Namhkal collected ($0.53)
Seat 2: KA3AXCTAHEU, (button) folded before Flop (didn't bet)
Seat 3: homelessdan (small blind) folded before Flop
Seat 4: DIENY772 (big blind) folded on the Flop



PokerStars Hand #166667914365:  Hold'em No Limit ($0.05/$0.10 USD) - 2017/02/23 16:09:50 ET
Table 'Kunigunde II' 6-max Seat #6 is the button
Seat 1: facewald ($10.10 in chips) 
Seat 2: DrVzad ($10 in chips) 
Seat 3: pancernik21 ($17.14 in chips) 
Seat 5: mdelfin0 ($12.58 in chips) 
Seat 6: Zooplack ($10 in chips) 
facewald: posts small blind $0.05
DrVzad: posts big blind $0.10
*** HOLE CARDS ***
pancernik21: folds 
mdelfin0: folds 
Zooplack: folds 
facewald: raises $0.12 to $0.22
DrVzad: calls $0.12
*** FLOP *** [6d 5c Ks]
facewald: checks 
DrVzad: bets $0.30
david_sara83 leaves the table
facewald: folds 
Uncalled bet ($0.30) returned to DrVzad
DrVzad collected $0.42 from pot
*** SUMMARY ***
Total pot $0.44 | Rake $0.02 
Board [6d 5c Ks]
Seat 1: facewald (small blind) folded on the Flop
Seat 2: DrVzad (big blind) collected ($0.42)
Seat 3: pancernik21 folded before Flop (didn't bet)
Seat 5: mdelfin0 folded before Flop (didn't bet)
Seat 6: Zooplack (button) folded before Flop (didn't bet)



PokerStars Hand #166667914528:  Hold'em No Limit ($0.05/$0.10 USD) - 2017/02/23 16:09:50 ET
Table 'Kochera' 6-max Seat #5 is the button
Seat 1: chimera252 ($11.67 in chips) 
Seat 2: bartabs2 ($10.19 in chips) 
Seat 3: KA3AXCTAHEU, ($10.31 in chips) 
Seat 4: dany_de_vit ($9.75 in chips) 
Seat 5: univibe68 ($12.20 in chips) 
Seat 6: oddshoff ($9.53 in chips) 
oddshoff: posts small blind $0.05
chimera252: posts big blind $0.10
*** HOLE CARDS ***
bartabs2: calls $0.10
KA3AXCTAHEU,: raises $0.25 to $0.35
dany_de_vit: calls $0.35
univibe68: folds 
oddshoff: folds 
chimera252: folds 
bartabs2: calls $0.25
*** FLOP *** [3h Qh 2d]
bartabs2: checks 
KA3AXCTAHEU,: checks 
dany_de_vit: checks 
*** TURN *** [3h Qh 2d] [Ah]
bartabs2: bets $0.20
KA3AXCTAHEU,: raises $0.60 to $0.80
dany_de_vit: folds 
bartabs2: calls $0.60
*** RIVER *** [3h Qh 2d Ah] [5d]
bartabs2: checks 
KA3AXCTAHEU,: bets $1.35
bartabs2: calls $1.35
*** SHOW DOWN ***
KA3AXCTAHEU,: shows [Ad As] (three of a kind, Aces)
bartabs2: mucks hand 
KA3AXCTAHEU, collected $5.25 from pot
*** SUMMARY ***
Total pot $5.50 | Rake $0.25 
Board [3h Qh 2d Ah 5d]
Seat 1: chimera252 (big blind) folded before Flop
Seat 2: bartabs2 mucked
Seat 3: KA3AXCTAHEU, showed [Ad As] and won ($5.25) with three of a kind, Aces
Seat 4: dany_de_vit folded on the Turn
Seat 5: univibe68 (button) folded before Flop (didn't bet)
Seat 6: oddshoff (small blind) folded before Flop



PokerStars Hand #166667914793:  Hold'em No Limit ($0.05/$0.10 USD) - 2017/02/23 16:09:51 ET
Table 'Pulcova II' 6-max Seat #3 is the button
Seat 1: sexy_seagull ($11.38 in chips) 
Seat 2: Kazacha ($10.40 in chips) 
Seat 3: Lao Tsy ($14.07 in chips) 
Seat 5: mdelfin0 ($10 in chips) 
Seat 6: Ice_Isayev ($10 in chips) 
mdelfin0: posts small blind $0.05
Ice_Isayev: posts big blind $0.10
*** HOLE CARDS ***
sexy_seagull: folds 
Kazacha: folds 
Jalida3 joins the table at seat #4 
Lao Tsy: raises $0.20 to $0.30
mdelfin0: folds 
Ice_Isayev: folds 
Uncalled bet ($0.20) returned to Lao Tsy
Lao Tsy collected $0.25 from pot
*** SUMMARY ***
Total pot $0.25 | Rake $0 
Seat 1: sexy_seagull folded before Flop (didn't bet)
Seat 2: Kazacha folded before Flop (didn't bet)
Seat 3: Lao Tsy (button) collected ($0.25)
Seat 5: mdelfin0 (small blind) folded before Flop
Seat 6: Ice_Isayev (big blind) folded before Flop



PokerStars Hand #166667914939:  Hold'em No Limit ($0.05/$0.10 USD) - 2017/02/23 16:09:51 ET
Table 'Caupolican' 6-max Seat #6 is the button
Seat 1: kingartur222 ($12.47 in chips) 
Seat 2: garigura ($18.75 in chips) 
Seat 3: ducksheep82 ($4.80 in chips) 
Seat 4: mhonielsen ($15.07 in chips) 
Seat 5: Kazacha ($12.40 in chips) 
Seat 6: crazydevill ($10 in chips) 
kingartur222: posts small blind $0.05
garigura: posts big blind $0.10
*** HOLE CARDS ***
ducksheep82: folds 
mhonielsen: folds 
Kazacha: raises $0.14 to $0.24
crazydevill: folds 
kingartur222: folds 
garigura: folds 
Uncalled bet ($0.14) returned to Kazacha
Kazacha collected $0.25 from pot
*** SUMMARY ***
Total pot $0.25 | Rake $0 
Seat 1: kingartur222 (small blind) folded before Flop
Seat 2: garigura (big blind) folded before Flop
Seat 3: ducksheep82 folded before Flop (didn't bet)
Seat 4: mhonielsen folded before Flop (didn't bet)
Seat 5: Kazacha collected ($0.25)
Seat 6: crazydevill (button) folded before Flop (didn't bet)



PokerStars Hand #166667915133:  Hold'em No Limit ($0.05/$0.10 USD) - 2017/02/23 16:09:51 ET
Table 'Ebella II' 6-max Seat #2 is the button
Seat 1: gaHy_HaXeP ($10 in chips) 
Seat 2: Therodorus ($10 in chips) 
Seat 3: Torften2 ($17.76 in chips) 
Seat 4: ValdemorS ($11.35 in chips) 
Seat 5: Bird et al ($10 in chips) 
Seat 6: Joker51_wtf! ($11.39 in chips) 
Torften2: posts small blind $0.05
ValdemorS: posts big blind $0.10
*** HOLE CARDS ***
Bird et al: folds 
Joker51_wtf!: folds 
gaHy_HaXeP: folds 
Therodorus: folds 
Torften2: raises $0.20 to $0.30
ValdemorS: folds 
Uncalled bet ($0.20) returned to Torften2
Torften2 collected $0.20 from pot
*** SUMMARY ***
Total pot $0.20 | Rake $0 
Seat 1: gaHy_HaXeP folded before Flop (didn't bet)
Seat 2: Therodorus (button) folded before Flop (didn't bet)
Seat 3: Torften2 (small blind) collected ($0.20)
Seat 4: ValdemorS (big blind) folded before Flop
Seat 5: Bird et al folded before Flop (didn't bet)
Seat 6: Joker51_wtf! folded before Flop (didn't bet)



PokerStars Hand #166667915136:  Hold'em No Limit ($0.05/$0.10 USD) - 2017/02/23 16:09:51 ET
Table 'Armenia' 6-max Seat #5 is the button
Seat 1: tr41n3r12 ($11.52 in chips) 
Seat 2: Yabidooo ($10.83 in chips) 
Seat 3: Crimsonr ($5.74 in chips) 
Seat 4: mbkongstad ($9.20 in chips) 
Seat 5: DrVzad ($9.85 in chips) 
Seat 6: mega spasser ($7.39 in chips) 
mega spasser: posts small blind $0.05
tr41n3r12: posts big blind $0.10
*** HOLE CARDS ***
Yabidooo: folds 
Crimsonr: folds 
mbkongstad: raises $0.20 to $0.30
DrVzad: folds 
mega spasser: calls $0.25
tr41n3r12: folds 
*** FLOP *** [3c 8d Ad]
mega spasser: checks 
mbkongstad: bets $0.30
mega spasser: calls $0.30
*** TURN *** [3c 8d Ad] [Kd]
mega spasser: checks 
mbkongstad: checks 
*** RIVER *** [3c 8d Ad Kd] [6c]
mega spasser: bets $1.10
mbkongstad: folds 
Uncalled bet ($1.10) returned to mega spasser
mega spasser collected $1.24 from pot
*** SUMMARY ***
Total pot $1.30 | Rake $0.06 
Board [3c 8d Ad Kd 6c]
Seat 1: tr41n3r12 (big blind) folded before Flop
Seat 2: Yabidooo folded before Flop (didn't bet)
Seat 3: Crimsonr folded before Flop (didn't bet)
Seat 4: mbkongstad folded on the River
Seat 5: DrVzad (button) folded before Flop (didn't bet)
Seat 6: mega spasser (small blind) collected ($1.24)



PokerStars Hand #166667915641:  Hold'em No Limit ($0.05/$0.10 USD) - 2017/02/23 16:09:51 ET
Table 'Gyldenia II' 6-max Seat #1 is the button
Seat 1: KokoulinV ($11.44 in chips) 
Seat 2: Kow6oy ($10.05 in chips) 
Seat 3: mhonielsen ($10 in chips) 
Seat 5: CHRO8 ($15.57 in chips) 
Seat 6: 8th wonders ($11.63 in chips) 
Kow6oy: posts small blind $0.05
mhonielsen: posts big blind $0.10
*** HOLE CARDS ***
CHRO8: raises $0.20 to $0.30
8th wonders: calls $0.30
KokoulinV: folds 
Kow6oy: folds 
mhonielsen: folds 
*** FLOP *** [Tc Qh Kh]
CHRO8: checks 
8th wonders: checks 
*** TURN *** [Tc Qh Kh] [3d]
CHRO8: checks 
8th wonders: checks 
*** RIVER *** [Tc Qh Kh 3d] [5h]
CHRO8: checks 
8th wonders: checks 
*** SHOW DOWN ***
CHRO8: shows [Ts Ad] (a pair of Tens)
8th wonders: mucks hand 
CHRO8 collected $0.72 from pot
*** SUMMARY ***
Total pot $0.75 | Rake $0.03 
Board [Tc Qh Kh 3d 5h]
Seat 1: KokoulinV (button) folded before Flop (didn't bet)
Seat 2: Kow6oy (small blind) folded before Flop
Seat 3: mhonielsen (big blind) folded before Flop
Seat 5: CHRO8 showed [Ts Ad] and won ($0.72) with a pair of Tens
Seat 6: 8th wonders mucked



PokerStars Hand #166667915650:  Hold'em No Limit ($0.05/$0.10 USD) - 2017/02/23 16:09:51 ET
Table 'Atropos' 6-max Seat #3 is the button
Seat 1: ScorpionF39 ($2.44 in chips) 
Seat 2: yodzik ($5.15 in chips) 
Seat 3: NvR.m1nD ($10.38 in chips) 
Seat 4: iDecMate ($10.87 in chips) 
Seat 5: KokoulinV ($11.79 in chips) 
Seat 6: Iarlei ($12.58 in chips) 
iDecMate: posts small blind $0.05
KokoulinV: posts big blind $0.10
*** HOLE CARDS ***
Iarlei: folds 
ScorpionF39: folds 
yodzik: folds 
NvR.m1nD: raises $0.15 to $0.25
iDecMate: folds 
KokoulinV: folds 
Uncalled bet ($0.15) returned to NvR.m1nD
NvR.m1nD collected $0.25 from pot
*** SUMMARY ***
Total pot $0.25 | Rake $0 
Seat 1: ScorpionF39 folded before Flop (didn't bet)
Seat 2: yodzik folded before Flop (didn't bet)
Seat 3: NvR.m1nD (button) collected ($0.25)
Seat 4: iDecMate (small blind) folded before Flop
Seat 5: KokoulinV (big blind) folded before Flop
Seat 6: Iarlei folded before Flop (didn't bet)



PokerStars Hand #166667915751:  Hold'em No Limit ($0.05/$0.10 USD) - 2017/02/23 16:09:52 ET
Table 'Pirola' 6-max Seat #5 is the button
Seat 1: Rodik002 ($10.66 in chips) 
Seat 2: lmlmlmlm90 ($17.34 in chips) 
Seat 4: barons89 ($11.61 in chips) 
Seat 5: Iarlei ($14.06 in chips) 
Seat 6: Hyd SK ($13.24 in chips) 
Hyd SK: posts small blind $0.05
Rodik002: posts big blind $0.10
Goroshkos88: sits out 
*** HOLE CARDS ***
lmlmlmlm90: raises $0.20 to $0.30
barons89: folds 
Iarlei: folds 
Hyd SK: folds 
Rodik002: folds 
Uncalled bet ($0.20) returned to lmlmlmlm90
lmlmlmlm90 collected $0.25 from pot
*** SUMMARY ***
Total pot $0.25 | Rake $0 
Seat 1: Rodik002 (big blind) folded before Flop
Seat 2: lmlmlmlm90 collected ($0.25)
Seat 4: barons89 folded before Flop (didn't bet)
Seat 5: Iarlei (button) folded before Flop (didn't bet)
Seat 6: Hyd SK (small blind) folded before Flop



PokerStars Hand #166667915813:  Hold'em No Limit ($0.05/$0.10 USD) - 2017/02/23 16:09:52 ET
Table 'Hunnia' 6-max Seat #2 is the button
Seat 1: univibe68 ($21.18 in chips) 
Seat 2: mhonielsen ($11.09 in chips) 
Seat 3: 6ePeMeHHa9 ($10.46 in chips) 
Seat 4: Jalida3 ($11.88 in chips) 
Seat 5: Smarkon ($14.74 in chips) 
Seat 6: ChuikaPridi ($11.29 in chips) 
6ePeMeHHa9 is disconnected 
6ePeMeHHa9 is connected 
6ePeMeHHa9: posts small blind $0.05
Jalida3: posts big blind $0.10
*** HOLE CARDS ***
Smarkon: folds 
ChuikaPridi: folds 
univibe68: raises $0.20 to $0.30
mhonielsen: folds 
6ePeMeHHa9: folds 
Jalida3: folds 
Uncalled bet ($0.20) returned to univibe68
univibe68 collected $0.25 from pot
*** SUMMARY ***
Total pot $0.25 | Rake $0 
Seat 1: univibe68 collected ($0.25)
Seat 2: mhonielsen (button) folded before Flop (didn't bet)
Seat 3: 6ePeMeHHa9 (small blind) folded before Flop
Seat 4: Jalida3 (big blind) folded before Flop
Seat 5: Smarkon folded before Flop (didn't bet)
Seat 6: ChuikaPridi folded before Flop (didn't bet)



PokerStars Hand #166667915997:  Hold'em No Limit ($0.05/$0.10 USD) - 2017/02/23 16:09:52 ET
Table 'Manto II' 6-max Seat #1 is the button
Seat 1: ex3Lero86 ($10 in chips) 
Seat 2: voledy ($10.47 in chips) 
Seat 3: Komap511 ($7.40 in chips) 
Seat 4: dr.goofy ($17.20 in chips) 
Seat 5: ArcticBearDK ($32.54 in chips) 
Seat 6: pancernik21 ($16.20 in chips) 
voledy: posts small blind $0.05
Komap511: posts big blind $0.10
*** HOLE CARDS ***
dr.goofy: folds 
ArcticBearDK: raises $0.20 to $0.30
pancernik21: raises $0.60 to $0.90
ex3Lero86: folds 
voledy: folds 
Komap511: folds 
ArcticBearDK: calls $0.60
*** FLOP *** [5d Jc 9h]
ArcticBearDK: checks 
pancernik21: bets $0.97
ArcticBearDK: calls $0.97
*** TURN *** [5d Jc 9h] [Jh]
ArcticBearDK: checks 
pancernik21: checks 
*** RIVER *** [5d Jc 9h Jh] [Ah]
ArcticBearDK: checks 
pancernik21: checks 
*** SHOW DOWN ***
ArcticBearDK: shows [As Qs] (two pair, Aces and Jacks)
pancernik21: mucks hand 
ArcticBearDK collected $3.71 from pot
*** SUMMARY ***
Total pot $3.89 | Rake $0.18 
Board [5d Jc 9h Jh Ah]
Seat 1: ex3Lero86 (button) folded before Flop (didn't bet)
Seat 2: voledy (small blind) folded before Flop
Seat 3: Komap511 (big blind) folded before Flop
Seat 4: dr.goofy folded before Flop (didn't bet)
Seat 5: ArcticBearDK showed [As Qs] and won ($3.71) with two pair, Aces and Jacks
Seat 6: pancernik21 mucked



PokerStars Hand #166667916531:  Hold'em No Limit ($0.05/$0.10 USD) - 2017/02/23 16:09:52 ET
Table 'Repsolda' 6-max Seat #2 is the button
Seat 1: fabadam ($10.50 in chips) 
Seat 2: MBen10 ($24.37 in chips) 
Seat 4: MihaGr ($10.05 in chips) 
Seat 5: matehouse. ($10 in chips) 
Seat 6: RkaczoR ($11.49 in chips) 
MihaGr: posts small blind $0.05
matehouse.: posts big blind $0.10
*** HOLE CARDS ***
RkaczoR: raises $0.20 to $0.30
fabadam: calls $0.30
MBen10: folds 
MihaGr: calls $0.25
x3ultimate joins the table at seat #3 
matehouse.: folds 
*** FLOP *** [4s 8s As]
x3ultimate leaves the table
MihaGr: checks 
RkaczoR: bets $0.74
fabadam: calls $0.74
MihaGr: calls $0.74
*** TURN *** [4s 8s As] [Kc]
MihaGr: checks 
RkaczoR: bets $1.94
Xander188 joins the table at seat #3 
fabadam: folds 
MihaGr: raises $4.46 to $6.40
RkaczoR: folds 
Uncalled bet ($4.46) returned to MihaGr
MihaGr collected $6.78 from pot
*** SUMMARY ***
Total pot $7.10 | Rake $0.32 
Board [4s 8s As Kc]
Seat 1: fabadam folded on the Turn
Seat 2: MBen10 (button) folded before Flop (didn't bet)
Seat 4: MihaGr (small blind) collected ($6.78)
Seat 5: matehouse. (big blind) folded before Flop
Seat 6: RkaczoR folded on the Turn



PokerStars Hand #166667916558:  Hold'em No Limit ($0.05/$0.10 USD) - 2017/02/23 16:09:52 ET
Table 'Marbachia II' 6-max Seat #6 is the button
Seat 1: crooso ($9.90 in chips) 
Seat 2: Yabidooo ($10 in chips) 
Seat 3: MisterX413 ($10.39 in chips) 
Seat 4: marianoboni ($10.15 in chips) 
Seat 6: arti192837 ($10 in chips) 
crooso: posts small blind $0.05
Yabidooo: posts big blind $0.10
osmea: sits out 
*** HOLE CARDS ***
MisterX413: folds 
marianoboni: folds 
arti192837: folds 
crooso: raises $0.20 to $0.30
Yabidooo: calls $0.20
*** FLOP *** [6h 9c 6s]
crooso: checks 
Yabidooo: bets $0.29
crooso: folds 
Uncalled bet ($0.29) returned to Yabidooo
Yabidooo collected $0.57 from pot
*** SUMMARY ***
Total pot $0.60 | Rake $0.03 
Board [6h 9c 6s]
Seat 1: crooso (small blind) folded on the Flop
Seat 2: Yabidooo (big blind) collected ($0.57)
Seat 3: MisterX413 folded before Flop (didn't bet)
Seat 4: marianoboni folded before Flop (didn't bet)
Seat 6: arti192837 (button) folded before Flop (didn't bet)



PokerStars Hand #166667916624:  Hold'em No Limit ($0.05/$0.10 USD) - 2017/02/23 16:09:52 ET
Table 'Antielus II' 6-max Seat #1 is the button
Seat 1: Dcaro31 ($18.49 in chips) 
Seat 2: Orlangoor ($10 in chips) 
Seat 3: mcyi3at2 ($9.77 in chips) 
Seat 4: XwinX25 ($10 in chips) 
Seat 5: Hyd SK ($14.87 in chips) 
Seat 6: GiveTwoMe ($11.30 in chips) 
Orlangoor: posts small blind $0.05
mcyi3at2: posts big blind $0.10
*** HOLE CARDS ***
XwinX25: folds 
Hyd SK: folds 
GiveTwoMe: raises $0.20 to $0.30
Dcaro31: folds 
Orlangoor: folds 
mcyi3at2: calls $0.20
*** FLOP *** [Th 5h 5c]
mcyi3at2: checks 
GiveTwoMe: checks 
*** TURN *** [Th 5h 5c] [Qd]
mcyi3at2: bets $0.40
GiveTwoMe: calls $0.40
*** RIVER *** [Th 5h 5c Qd] [Ts]
mcyi3at2: checks 
GiveTwoMe: bets $0.82
mcyi3at2: folds 
Uncalled bet ($0.82) returned to GiveTwoMe
GiveTwoMe collected $1.38 from pot
*** SUMMARY ***
Total pot $1.45 | Rake $0.07 
Board [Th 5h 5c Qd Ts]
Seat 1: Dcaro31 (button) folded before Flop (didn't bet)
Seat 2: Orlangoor (small blind) folded before Flop
Seat 3: mcyi3at2 (big blind) folded on the River
Seat 4: XwinX25 folded before Flop (didn't bet)
Seat 5: Hyd SK folded before Flop (didn't bet)
Seat 6: GiveTwoMe collected ($1.38)



PokerStars Hand #166667916900:  Hold'em No Limit ($0.05/$0.10 USD) - 2017/02/23 16:09:53 ET
Table 'Crocus' 6-max Seat #6 is the button
Seat 1: truck1234 ($25.71 in chips) 
Seat 2: garigura ($11.14 in chips) 
Seat 4: patrick19111 ($12.61 in chips) 
Seat 6: Rodik002 ($10.09 in chips) 
truck1234: posts small blind $0.05
garigura: posts big blind $0.10
Yspenyanin: sits out 
*** HOLE CARDS ***
Golsuorsi leaves the table
patrick19111: raises $0.15 to $0.25
Rodik002: folds 
JahSoldier69 joins the table at seat #5 
truck1234: folds 
JahSoldier69 leaves the table
garigura: folds 
Uncalled bet ($0.15) returned to patrick19111
patrick19111 collected $0.25 from pot
patrick19111: doesn't show hand 
*** SUMMARY ***
Total pot $0.25 | Rake $0 
Seat 1: truck1234 (small blind) folded before Flop
Seat 2: garigura (big blind) folded before Flop
Seat 4: patrick19111 collected ($0.25)
Seat 6: Rodik002 (button) folded before Flop (didn't bet)



PokerStars Hand #166667916999:  Hold'em No Limit ($0.05/$0.10 USD) - 2017/02/23 16:09:53 ET
Table 'Juliet II' 6-max Seat #2 is the button
Seat 1: alexpolevaja ($11.14 in chips) 
Seat 2: KA3AXCTAHEU, ($15.53 in chips) 
Seat 3: patrick19111 ($11.32 in chips) 
Seat 4: x3ultimate ($10.55 in chips) 
Seat 5: Dcaro31 ($20.06 in chips) 
Seat 6: BookWorm78 ($31.48 in chips) 
patrick19111: posts small blind $0.05
x3ultimate: posts big blind $0.10
*** HOLE CARDS ***
Dcaro31: folds 
BookWorm78: folds 
alexpolevaja: raises $0.10 to $0.20
KA3AXCTAHEU,: folds 
patrick19111: folds 
x3ultimate: folds 
Uncalled bet ($0.10) returned to alexpolevaja
alexpolevaja collected $0.25 from pot
*** SUMMARY ***
Total pot $0.25 | Rake $0 
Seat 1: alexpolevaja collected ($0.25)
Seat 2: KA3AXCTAHEU, (button) folded before Flop (didn't bet)
Seat 3: patrick19111 (small blind) folded before Flop
Seat 4: x3ultimate (big blind) folded before Flop
Seat 5: Dcaro31 folded before Flop (didn't bet)
Seat 6: BookWorm78 folded before Flop (didn't bet)



PokerStars Hand #166667917427:  Hold'em No Limit ($0.05/$0.10 USD) - 2017/02/23 16:09:53 ET
Table 'Atalante' 6-max Seat #6 is the button
Seat 1: OceanBlue100 ($4.74 in chips) 
Seat 2: CiisCi ($19.65 in chips) 
Seat 3: Kow6oy ($10 in chips) 
Seat 4: Dcaro31 ($24.17 in chips) 
Seat 5: eniksenik ($10.56 in chips) 
Seat 6: FlopsterGB ($31.36 in chips) 
OceanBlue100: posts small blind $0.05
CiisCi: posts big blind $0.10
*** HOLE CARDS ***
Kow6oy: folds 
Dcaro31: folds 
eniksenik: folds 
FlopsterGB: raises $0.20 to $0.30
OceanBlue100: raises $4.44 to $4.74 and is all-in
CiisCi: folds 
FlopsterGB: folds 
Uncalled bet ($4.44) returned to OceanBlue100
OceanBlue100 collected $0.70 from pot
*** SUMMARY ***
Total pot $0.70 | Rake $0 
Seat 1: OceanBlue100 (small blind) collected ($0.70)
Seat 2: CiisCi (big blind) folded before Flop
Seat 3: Kow6oy folded before Flop (didn't bet)
Seat 4: Dcaro31 folded before Flop (didn't bet)
Seat 5: eniksenik folded before Flop (didn't bet)
Seat 6: FlopsterGB (button) folded before Flop



PokerStars Hand #166667917643:  Hold'em No Limit ($0.05/$0.10 USD) - 2017/02/23 16:09:54 ET
Table 'Stroobantia' 6-max Seat #5 is the button
Seat 1: mam9zyc ($10.38 in chips) 
Seat 2: XwinX25 ($10 in chips) 
Seat 3: Namhkal ($11.05 in chips) 
Seat 4: Yspenyanin ($10 in chips) 
Seat 5: boxer821 ($10.84 in chips) 
Seat 6: KokoulinV ($15.57 in chips) 
KokoulinV: posts small blind $0.05
mam9zyc: posts big blind $0.10
*** HOLE CARDS ***
XwinX25: raises $0.20 to $0.30
Namhkal: folds 
Yspenyanin: raises $0.75 to $1.05
boxer821: folds 
KokoulinV: folds 
mam9zyc: folds 
XwinX25: folds 
Uncalled bet ($0.75) returned to Yspenyanin
Yspenyanin is disconnected 
Yspenyanin collected $0.75 from pot
*** SUMMARY ***
Total pot $0.75 | Rake $0 
Seat 1: mam9zyc (big blind) folded before Flop
Seat 2: XwinX25 folded before Flop
Seat 3: Namhkal folded before Flop (didn't bet)
Seat 4: Yspenyanin collected ($0.75)
Seat 5: boxer821 (button) folded before Flop (didn't bet)
Seat 6: KokoulinV (small blind) folded before Flop



PokerStars Hand #166667917723:  Hold'em No Limit ($0.05/$0.10 USD) - 2017/02/23 16:09:54 ET
Table 'Arduina' 6-max Seat #6 is the button
Seat 1: tauronex ($11.11 in chips) 
Seat 2: Andy Wolf ($14.45 in chips) 
Seat 3: Dcaro31 ($12.46 in chips) 
Seat 4: ChuikaPridi ($29.20 in chips) 
Seat 5: ettedallas ($7.16 in chips) 
Seat 6: dierri ($8.91 in chips) 
tauronex: posts small blind $0.05
Andy Wolf: posts big blind $0.10
*** HOLE CARDS ***
Dcaro31: raises $0.20 to $0.30
ChuikaPridi: folds 
ettedallas: folds 
dierri: folds 
tauronex: folds 
Andy Wolf: folds 
Uncalled bet ($0.20) returned to Dcaro31
Dcaro31 collected $0.25 from pot
*** SUMMARY ***
Total pot $0.25 | Rake $0 
Seat 1: tauronex (small blind) folded before Flop
Seat 2: Andy Wolf (big blind) folded before Flop
Seat 3: Dcaro31 collected ($0.25)
Seat 4: ChuikaPridi folded before Flop (didn't bet)
Seat 5: ettedallas folded before Flop (didn't bet)
Seat 6: dierri (button) folded before Flop (didn't bet)



PokerStars Hand #166667918024:  Hold'em No Limit ($0.05/$0.10 USD) - 2017/02/23 16:09:54 ET
Table 'Aisakos II' 6-max Seat #3 is the button
Seat 1: Crafty23@PS ($10.35 in chips) 
Seat 2: svaika24 ($16.87 in chips) 
Seat 3: iamkakaroto ($10.82 in chips) 
Seat 4: T9MS ($10.35 in chips) 
Seat 5: KokoulinV ($11.75 in chips) 
Seat 6: LarryTheStar ($10.03 in chips) 
T9MS: posts small blind $0.05
KokoulinV: posts big blind $0.10
*** HOLE CARDS ***
LarryTheStar: folds 
Crafty23@PS has timed out
Crafty23@PS: folds 
svaika24: raises $0.10 to $0.20
iamkakaroto: folds 
T9MS: folds 
KokoulinV: folds 
Uncalled bet ($0.10) returned to svaika24
svaika24 collected $0.25 from pot
*** SUMMARY ***
Total pot $0.25 | Rake $0 
Seat 1: Crafty23@PS folded before Flop (didn't bet)
Seat 2: svaika24 collected ($0.25)
Seat 3: iamkakaroto (button) folded before Flop (didn't bet)
Seat 4: T9MS (small blind) folded before Flop
Seat 5: KokoulinV (big blind) folded before Flop
Seat 6: LarryTheStar folded before Flop (didn't bet)



PokerStars Hand #166667918049:  Hold'em No Limit ($0.05/$0.10 USD) - 2017/02/23 16:09:54 ET
Table 'Pallas II' 6-max Seat #1 is the button
Seat 1: mdelfin0 ($16.59 in chips) 
Seat 3: popypaleta ($10.10 in chips) 
Seat 4: MisterX413 ($10 in chips) 
Seat 5: gaHy_HaXeP ($10.10 in chips) 
Seat 6: Smitty03300 ($10 in chips) 
popypaleta: posts small blind $0.05
MisterX413: posts big blind $0.10
*** HOLE CARDS ***
gaHy_HaXeP: folds 
Smitty03300: folds 
mdelfin0: raises $0.12 to $0.22
popypaleta: folds 
MisterX413: folds 
Uncalled bet ($0.12) returned to mdelfin0
mdelfin0 collected $0.25 from pot
*** SUMMARY ***
Total pot $0.25 | Rake $0 
Seat 1: mdelfin0 (button) collected ($0.25)
Seat 3: popypaleta (small blind) folded before Flop
Seat 4: MisterX413 (big blind) folded before Flop
Seat 5: gaHy_HaXeP folded before Flop (didn't bet)
Seat 6: Smitty03300 folded before Flop (didn't bet)



PokerStars Hand #166667918583:  Hold'em No Limit ($0.05/$0.10 USD) - 2017/02/23 16:09:55 ET
Table 'Hajek III' 6-max Seat #4 is the button
Seat 1: MBen10 ($13.02 in chips) 
Seat 2: fortieth ($9.76 in chips) 
Seat 3: fedorka rus ($10.18 in chips) 
Seat 4: NvR.m1nD ($13.52 in chips) 
Seat 6: fabadam ($21.93 in chips) 
Chrips will be allowed to play after the button
fabadam: posts small blind $0.05
MBen10: posts big blind $0.10
*** HOLE CARDS ***
fortieth: folds 
fedorka rus: folds 
NvR.m1nD: folds 
fabadam: raises $0.20 to $0.30
MBen10: raises $0.66 to $0.96
fabadam: calls $0.66
*** FLOP *** [Ts 5h 8d]
fabadam: checks 
MBen10: checks 
*** TURN *** [Ts 5h 8d] [2d]
fabadam: checks 
MBen10: checks 
*** RIVER *** [Ts 5h 8d 2d] [Tc]
fabadam: checks 
MBen10: checks 
*** SHOW DOWN ***
fabadam: shows [3s Ac] (a pair of Tens)
MBen10: mucks hand 
fabadam collected $1.83 from pot
*** SUMMARY ***
Total pot $1.92 | Rake $0.09 
Board [Ts 5h 8d 2d Tc]
Seat 1: MBen10 (big blind) mucked
Seat 2: fortieth folded before Flop (didn't bet)
Seat 3: fedorka rus folded before Flop (didn't bet)
Seat 4: NvR.m1nD (button) folded before Flop (didn't bet)
Seat 6: fabadam (small blind) showed [3s Ac] and won ($1.83) with a pair of Tens



PokerStars Hand #166667918727:  Hold'em No Limit ($0.05/$0.10 USD) - 2017/02/23 16:09:55 ET
Table 'Caprera III' 6-max Seat #6 is the button
Seat 1: Vrinni ($19.09 in chips) 
Seat 2: hg123454321 ($11.10 in chips) 
Seat 6: GESPERIA ($15.41 in chips) 
Vrinni: posts small blind $0.05
hg123454321: posts big blind $0.10
*** HOLE CARDS ***
GESPERIA: raises $0.20 to $0.30
Vrinni: folds 
hg123454321: calls $0.20
*** FLOP *** [Ah 2h 3c]
hg123454321: bets $0.10
GESPERIA: folds 
Uncalled bet ($0.10) returned to hg123454321
hg123454321 collected $0.62 from pot
*** SUMMARY ***
Total pot $0.65 | Rake $0.03 
Board [Ah 2h 3c]
Seat 1: Vrinni (small blind) folded before Flop
Seat 2: hg123454321 (big blind) collected ($0.62)
Seat 6: GESPERIA (button) folded on the Flop



PokerStars Hand #166667919027:  Hold'em No Limit ($0.05/$0.10 USD) - 2017/02/23 16:09:55 ET
Table 'Izar' 6-max Seat #5 is the button
Seat 1: bambolejro ($10.52 in chips) 
Seat 2: mvp0013 ($10 in chips) 
Seat 3: Yspenyanin ($11.17 in chips) 
Seat 5: fishhook5 ($10.30 in chips) 
Seat 6: yodzik ($14.19 in chips) 
yodzik: posts small blind $0.05
bambolejro: posts big blind $0.10
*** HOLE CARDS ***
mvp0013: raises $0.20 to $0.30
Yspenyanin: folds 
fishhook5: folds 
yodzik: folds 
bambolejro: folds 
Uncalled bet ($0.20) returned to mvp0013
mvp0013 collected $0.25 from pot
*** SUMMARY ***
Total pot $0.25 | Rake $0 
Seat 1: bambolejro (big blind) folded before Flop
Seat 2: mvp0013 collected ($0.25)
Seat 3: Yspenyanin folded before Flop (didn't bet)
Seat 5: fishhook5 (button) folded before Flop (didn't bet)
Seat 6: yodzik (small blind) folded before Flop



PokerStars Hand #166667919037:  Hold'em No Limit ($0.05/$0.10 USD) - 2017/02/23 16:09:55 ET
Table 'Nymphe II' 6-max Seat #6 is the button
Seat 1: jacktayra ($2.69 in chips) 
Seat 2: Newqbrown ($10.78 in chips) 
Seat 3: THIMUCHIN ($15.75 in chips) 
Seat 4: coolisses111 ($17.15 in chips) 
Seat 6: Xander188 ($10 in chips) 
jacktayra: posts small blind $0.05
Newqbrown: posts big blind $0.10
*** HOLE CARDS ***
THIMUCHIN: raises $0.20 to $0.30
coolisses111: folds 
Xander188: folds 
jacktayra: calls $0.25
AC Evergreen joins the table at seat #5 
Newqbrown: raises $0.90 to $1.20
THIMUCHIN: folds 
jacktayra: calls $0.90
*** FLOP *** [Kc 4d 4s]
jacktayra: checks 
Newqbrown: bets $1.50
jacktayra: folds 
Uncalled bet ($1.50) returned to Newqbrown
Newqbrown collected $2.58 from pot
*** SUMMARY ***
Total pot $2.70 | Rake $0.12 
Board [Kc 4d 4s]
Seat 1: jacktayra (small blind) folded on the Flop
Seat 2: Newqbrown (big blind) collected ($2.58)
Seat 3: THIMUCHIN folded before Flop
Seat 4: coolisses111 folded before Flop (didn't bet)
Seat 6: Xander188 (button) folded before Flop (didn't bet)



PokerStars Hand #166667919369:  Hold'em No Limit ($0.05/$0.10 USD) - 2017/02/23 16:09:55 ET
Table 'Isberga' 6-max Seat #2 is the button
Seat 1: Feverhead ($18.22 in chips) 
Seat 2: GESPERIA ($10.37 in chips) 
Seat 3: HARDCORE66RU ($11.03 in chips) 
Seat 4: THIMUCHIN ($10.79 in chips) 
Seat 5: YoungGriff86 ($18.72 in chips) 
Seat 6: Goroshkos88 ($21.56 in chips) 
HARDCORE66RU: posts small blind $0.05
THIMUCHIN: posts big blind $0.10
*** HOLE CARDS ***
YoungGriff86: folds 
Goroshkos88: folds 
Feverhead: folds 
GESPERIA: raises $0.20 to $0.30
HARDCORE66RU: folds 
THIMUCHIN: folds 
Uncalled bet ($0.20) returned to GESPERIA
GESPERIA collected $0.25 from pot
*** SUMMARY ***
Total pot $0.25 | Rake $0 
Seat 1: Feverhead folded before Flop (didn't bet)
Seat 2: GESPERIA (button) collected ($0.25)
Seat 3: HARDCORE66RU (small blind) folded before Flop
Seat 4: THIMUCHIN (big blind) folded before Flop
Seat 5: YoungGriff86 folded before Flop (didn't bet)
Seat 6: Goroshkos88 folded before Flop (didn't bet)



PokerStars Hand #166667919526:  Hold'em No Limit ($0.05/$0.10 USD) - 2017/02/23 16:09:56 ET
Table 'Martha' 6-max Seat #3 is the button
Seat 1: Peter0087 ($10.29 in chips) 
Seat 2: pauli95 ($10.81 in chips) 
Seat 3: Hyd SK ($12.37 in chips) 
Seat 4: dittoro ($10 in chips) 
Seat 5: MihaGr ($10 in chips) 
Seat 6: 8th wonders ($10 in chips) 
dittoro: posts small blind $0.05
MihaGr: posts big blind $0.10
*** HOLE CARDS ***
8th wonders: raises $0.20 to $0.30
Peter0087: calls $0.30
pauli95: folds 
Hyd SK: folds 
dittoro: folds 
MihaGr: calls $0.20
*** FLOP *** [4d 2h 9s]
MihaGr: checks 
8th wonders: bets $0.68
Peter0087: folds 
MihaGr: folds 
Uncalled bet ($0.68) returned to 8th wonders
8th wonders collected $0.91 from pot
*** SUMMARY ***
Total pot $0.95 | Rake $0.04 
Board [4d 2h 9s]
Seat 1: Peter0087 folded on the Flop
Seat 2: pauli95 folded before Flop (didn't bet)
Seat 3: Hyd SK (button) folded before Flop (didn't bet)
Seat 4: dittoro (small blind) folded before Flop
Seat 5: MihaGr (big blind) folded on the Flop
Seat 6: 8th wonders collected ($0.91)



PokerStars Hand #166667919634:  Hold'em No Limit ($0.05/$0.10 USD) - 2017/02/23 16:09:56 ET
Table 'Lehigh' 6-max Seat #2 is the button
Seat 2: Sbozzz ($21 in chips) 
Seat 3: Therodorus ($12.04 in chips) 
Seat 6: RoJ1 ($10 in chips) 
Therodorus: posts small blind $0.05
Chodemuncher: is sitting out 
Xander188: is sitting out 
RoJ1: posts big blind $0.10
*** HOLE CARDS ***
Chodemuncher leaves the table
Xander188 leaves the table
Sbozzz: folds 
Therodorus: folds 
Uncalled bet ($0.05) returned to RoJ1
Therodorus leaves the table
Slavoaca693 joins the table at seat #5 
RoJ1 collected $0.10 from pot
*** SUMMARY ***
Total pot $0.10 | Rake $0 
Seat 2: Sbozzz (button) folded before Flop (didn't bet)
Seat 3: Therodorus (small blind) folded before Flop
Seat 6: RoJ1 (big blind) collected ($0.10)



PokerStars Hand #166667919810:  Hold'em No Limit ($0.05/$0.10 USD) - 2017/02/23 16:09:56 ET
Table 'Duhr II' 6-max Seat #3 is the button
Seat 1: Lucky HoBBiT ($10.88 in chips) 
Seat 2: Feverhead ($37.89 in chips) 
Seat 3: Smitty03300 ($10 in chips) 
Seat 4: CHRO8 ($9.90 in chips) 
Seat 5: Dimka4 ($10.10 in chips) 
Seat 6: townerz1991 ($11.28 in chips) 
CHRO8: posts small blind $0.05
Dimka4: posts big blind $0.10
*** HOLE CARDS ***
townerz1991: folds 
Lucky HoBBiT is disconnected 
Lucky HoBBiT has timed out while disconnected
Lucky HoBBiT: folds 
Feverhead: raises $0.15 to $0.25
Smitty03300: folds 
CHRO8: folds 
Dimka4: folds 
Uncalled bet ($0.15) returned to Feverhead
Feverhead collected $0.25 from pot
*** SUMMARY ***
Total pot $0.25 | Rake $0 
Seat 1: Lucky HoBBiT folded before Flop (didn't bet)
Seat 2: Feverhead collected ($0.25)
Seat 3: Smitty03300 (button) folded before Flop (didn't bet)
Seat 4: CHRO8 (small blind) folded before Flop
Seat 5: Dimka4 (big blind) folded before Flop
Seat 6: townerz1991 folded before Flop (didn't bet)



PokerStars Hand #166667920517:  Hold'em No Limit ($0.05/$0.10 USD) - 2017/02/23 16:09:57 ET
Table 'Emma II' 6-max Seat #1 is the button
Seat 1: LarryTheStar ($10.40 in chips) 
Seat 2: T9MS ($11.54 in chips) 
Seat 3: oddshoff ($9.47 in chips) 
Seat 4: Jucatorul823 ($6.66 in chips) 
Seat 5: Scanner17 ($10.51 in chips) 
Seat 6: CHRO8 ($14.67 in chips) 
T9MS: posts small blind $0.05
oddshoff: posts big blind $0.10
*** HOLE CARDS ***
Jucatorul823: folds 
Scanner17: folds 
CHRO8: raises $0.20 to $0.30
LarryTheStar: calls $0.30
T9MS: folds 
oddshoff: raises $0.60 to $0.90
CHRO8: folds 
LarryTheStar: folds 
Uncalled bet ($0.60) returned to oddshoff
oddshoff collected $0.95 from pot
*** SUMMARY ***
Total pot $0.95 | Rake $0 
Seat 1: LarryTheStar (button) folded before Flop
Seat 2: T9MS (small blind) folded before Flop
Seat 3: oddshoff (big blind) collected ($0.95)
Seat 4: Jucatorul823 folded before Flop (didn't bet)
Seat 5: Scanner17 folded before Flop (didn't bet)
Seat 6: CHRO8 folded before Flop



PokerStars Hand #166667920633:  Hold'em No Limit ($0.05/$0.10 USD) - 2017/02/23 16:09:57 ET
Table 'Eurykleia' 6-max Seat #2 is the button
Seat 1: Giyorod ($10.15 in chips) 
Seat 2: x3ultimate ($10.59 in chips) 
Seat 3: boxer821 ($20.31 in chips) 
Seat 4: 6ePeMeHHa9 ($18.95 in chips) 
Seat 5: fishhook5 ($10 in chips) 
Seat 6: afca128 ($4.72 in chips) 
boxer821: posts small blind $0.05
6ePeMeHHa9 is disconnected 
6ePeMeHHa9 is connected 
6ePeMeHHa9: posts big blind $0.10
*** HOLE CARDS ***
fishhook5: folds 
afca128: folds 
Giyorod: folds 
x3ultimate: raises $0.15 to $0.25
boxer821: folds 
6ePeMeHHa9: folds 
Uncalled bet ($0.15) returned to x3ultimate
x3ultimate collected $0.25 from pot
*** SUMMARY ***
Total pot $0.25 | Rake $0 
Seat 1: Giyorod folded before Flop (didn't bet)
Seat 2: x3ultimate (button) collected ($0.25)
Seat 3: boxer821 (small blind) folded before Flop
Seat 4: 6ePeMeHHa9 (big blind) folded before Flop
Seat 5: fishhook5 folded before Flop (didn't bet)
Seat 6: afca128 folded before Flop (didn't bet)



PokerStars Hand #166667920657:  Hold'em No Limit ($0.05/$0.10 USD) - 2017/02/23 16:09:57 ET
Table 'Xanthippe II' 6-max Seat #3 is the button
Seat 2: Bird et al ($10.08 in chips) 
Seat 3: Dcaro31 ($14.51 in chips) 
Seat 5: XaXaTyH4uK ($10.27 in chips) 
Seat 6: Orlangoor ($13.03 in chips) 
XaXaTyH4uK: posts small blind $0.05
Orlangoor: posts big blind $0.10
noonhill: sits out 
*** HOLE CARDS ***
Bird et al: raises $0.21 to $0.31
Dcaro31: folds 
XaXaTyH4uK: folds 
Orlangoor: calls $0.21
*** FLOP *** [6c 6d 4s]
Orlangoor: checks 
Bird et al: checks 
*** TURN *** [6c 6d 4s] [As]
Orlangoor: bets $0.40
Bird et al: calls $0.40
*** RIVER *** [6c 6d 4s As] [Qd]
Orlangoor: checks 
Bird et al: bets $0.84
Orlangoor: folds 
Uncalled bet ($0.84) returned to Bird et al
Bird et al collected $1.40 from pot
*** SUMMARY ***
Total pot $1.47 | Rake $0.07 
Board [6c 6d 4s As Qd]
Seat 2: Bird et al collected ($1.40)
Seat 3: Dcaro31 (button) folded before Flop (didn't bet)
Seat 5: XaXaTyH4uK (small blind) folded before Flop
Seat 6: Orlangoor (big blind) folded on the River



PokerStars Hand #166667920889:  Hold'em No Limit ($0.05/$0.10 USD) - 2017/02/23 16:09:57 ET
Table 'Gaika' 6-max Seat #1 is the button
Seat 1: oddshoff ($16.71 in chips) 
Seat 2: NvR.m1nD ($22.56 in chips) 
Seat 4: fortieth ($10.42 in chips) 
Seat 5: fedorka rus ($10.75 in chips) 
Seat 6: dr.goofy ($10 in chips) 
NvR.m1nD: posts small blind $0.05
fortieth: posts big blind $0.10
*** HOLE CARDS ***
fedorka rus: raises $0.20 to $0.30
dr.goofy: folds 
oddshoff: folds 
NvR.m1nD: calls $0.25
fortieth: folds 
*** FLOP *** [Qs 5h 8c]
david_sara83 leaves the table
NvR.m1nD: checks 
Namhkal joins the table at seat #3 
fedorka rus: checks 
*** TURN *** [Qs 5h 8c] [Jd]
NvR.m1nD: checks 
Namhkal leaves the table
fedorka rus: checks 
*** RIVER *** [Qs 5h 8c Jd] [3h]
NvR.m1nD: checks 
fedorka rus: checks 
*** SHOW DOWN ***
NvR.m1nD: shows [4c 4s] (a pair of Fours)
fedorka rus: shows [7s 8s] (a pair of Eights)
fedorka rus collected $0.67 from pot
*** SUMMARY ***
Total pot $0.70 | Rake $0.03 
Board [Qs 5h 8c Jd 3h]
Seat 1: oddshoff (button) folded before Flop (didn't bet)
Seat 2: NvR.m1nD (small blind) showed [4c 4s] and lost with a pair of Fours
Seat 4: fortieth (big blind) folded before Flop
Seat 5: fedorka rus showed [7s 8s] and won ($0.67) with a pair of Eights
Seat 6: dr.goofy folded before Flop (didn't bet)



PokerStars Hand #166667921389:  Hold'em No Limit ($0.05/$0.10 USD) - 2017/02/23 16:09:58 ET
Table 'Reginhild' 6-max Seat #6 is the button
Seat 1: iamkakaroto ($11.15 in chips) 
Seat 2: Kow6oy ($10 in chips) 
Seat 3: ARCHITECT83 ($8.03 in chips) 
Seat 4: Raymondo21 ($24.48 in chips) 
Seat 5: XCarlos610 ($28.73 in chips) 
Seat 6: eniksenik ($10 in chips) 
iamkakaroto: posts small blind $0.05
Kow6oy: posts big blind $0.10
*** HOLE CARDS ***
ARCHITECT83: folds 
Raymondo21: folds 
XCarlos610: calls $0.10
eniksenik: folds 
iamkakaroto: folds 
Kow6oy: checks 
*** FLOP *** [9h Ad 4c]
Kow6oy: checks 
XCarlos610: bets $0.12
Kow6oy: folds 
Uncalled bet ($0.12) returned to XCarlos610
XCarlos610 collected $0.24 from pot
*** SUMMARY ***
Total pot $0.25 | Rake $0.01 
Board [9h Ad 4c]
Seat 1: iamkakaroto (small blind) folded before Flop
Seat 2: Kow6oy (big blind) folded on the Flop
Seat 3: ARCHITECT83 folded before Flop (didn't bet)
Seat 4: Raymondo21 folded before Flop (didn't bet)
Seat 5: XCarlos610 collected ($0.24)
Seat 6: eniksenik (button) folded before Flop (didn't bet)



PokerStars Hand #166667921535:  Hold'em No Limit ($0.05/$0.10 USD) - 2017/02/23 16:09:58 ET
Table 'Grietje' 6-max Seat #3 is the button
Seat 1: dragonste89 ($10 in chips) 
Seat 2: Feverhead ($10 in chips) 
Seat 3: GitoValdivia ($8.03 in chips) 
Seat 4: MihaGr ($10.61 in chips) 
Seat 5: iThreeBarrel ($10 in chips) 
Seat 6: Prometheu$8 ($26.52 in chips) 
MihaGr: posts small blind $0.05
iThreeBarrel: posts big blind $0.10
*** HOLE CARDS ***
Prometheu$8: folds 
dragonste89: folds 
Feverhead: raises $0.15 to $0.25
GitoValdivia: folds 
MihaGr: folds 
iThreeBarrel: raises $0.65 to $0.90
Feverhead: folds 
Uncalled bet ($0.65) returned to iThreeBarrel
iThreeBarrel collected $0.55 from pot
*** SUMMARY ***
Total pot $0.55 | Rake $0 
Seat 1: dragonste89 folded before Flop (didn't bet)
Seat 2: Feverhead folded before Flop
Seat 3: GitoValdivia (button) folded before Flop (didn't bet)
Seat 4: MihaGr (small blind) folded before Flop
Seat 5: iThreeBarrel (big blind) collected ($0.55)
Seat 6: Prometheu$8 folded before Flop (didn't bet)



PokerStars Hand #166667921615:  Hold'em No Limit ($0.05/$0.10 USD) - 2017/02/23 16:09:58 ET
Table 'Walpurga' 6-max Seat #3 is the button
Seat 1: chimera252 ($12.07 in chips) 
Seat 2: paxit71 ($5.10 in chips) 
Seat 3: marianoboni ($16.21 in chips) 
Seat 4: oddshoff ($12.79 in chips) 
oddshoff: posts small blind $0.05
Fremara is disconnected 
Fremara has timed out while disconnected
Fremara: is sitting out 
chimera252: posts big blind $0.10
*** HOLE CARDS ***
paxit71: folds 
marianoboni: raises $0.13 to $0.23
oddshoff: folds 
chimera252: folds 
Uncalled bet ($0.13) returned to marianoboni
marianoboni collected $0.25 from pot
*** SUMMARY ***
Total pot $0.25 | Rake $0 
Seat 1: chimera252 (big blind) folded before Flop
Seat 2: paxit71 folded before Flop (didn't bet)
Seat 3: marianoboni (button) collected ($0.25)
Seat 4: oddshoff (small blind) folded before Flop



PokerStars Hand #166667921809:  Hold'em No Limit ($0.05/$0.10 USD) - 2017/02/23 16:09:58 ET
Table 'Selinur' 6-max Seat #2 is the button
Seat 1: KA3AXCTAHEU, ($10 in chips) 
Seat 2: hoedje72 ($7.07 in chips) 
Seat 3: bambolejro ($11.12 in chips) 
Seat 4: ThuyeTD11 ($4 in chips) 
Seat 5: DrVzad ($10 in chips) 
Seat 6: homelessdan ($18.50 in chips) 
bambolejro: posts small blind $0.05
ThuyeTD11: posts big blind $0.10
*** HOLE CARDS ***
DrVzad: folds 
homelessdan: raises $0.20 to $0.30
KA3AXCTAHEU,: folds 
hoedje72: calls $0.30
bambolejro: folds 
ThuyeTD11: calls $0.20
*** FLOP *** [9h Ad 8c]
ThuyeTD11: checks 
homelessdan: checks 
hoedje72: checks 
*** TURN *** [9h Ad 8c] [As]
ThuyeTD11: checks 
homelessdan: checks 
hoedje72: bets $1
ThuyeTD11: folds 
homelessdan: folds 
Uncalled bet ($1) returned to hoedje72
hoedje72 collected $0.91 from pot
*** SUMMARY ***
Total pot $0.95 | Rake $0.04 
Board [9h Ad 8c As]
Seat 1: KA3AXCTAHEU, folded before Flop (didn't bet)
Seat 2: hoedje72 (button) collected ($0.91)
Seat 3: bambolejro (small blind) folded before Flop
Seat 4: ThuyeTD11 (big blind) folded on the Turn
Seat 5: DrVzad folded before Flop (didn't bet)
Seat 6: homelessdan folded on the Turn



PokerStars Hand #166667922002:  Hold'em No Limit ($0.05/$0.10 USD) - 2017/02/23 16:09:58 ET
Table 'Risha II' 6-max Seat #5 is the button
Seat 1: marianoboni ($10 in chips) 
Seat 2: KA3AXCTAHEU, ($12.25 in chips) 
Seat 3: steepfell ($10.15 in chips) 
Seat 4: Comeback3392 ($19.53 in chips) 
Seat 5: m.c-alkatraz ($9.90 in chips) 
Seat 6: univibe68 ($11.06 in chips) 
univibe68: posts small blind $0.05
marianoboni: posts big blind $0.10
*** HOLE CARDS ***
KA3AXCTAHEU,: folds 
steepfell: folds 
Comeback3392: folds 
m.c-alkatraz: folds 
univibe68: folds 
Uncalled bet ($0.05) returned to marianoboni
marianoboni collected $0.10 from pot
*** SUMMARY ***
Total pot $0.10 | Rake $0 
Seat 1: marianoboni (big blind) collected ($0.10)
Seat 2: KA3AXCTAHEU, folded before Flop (didn't bet)
Seat 3: steepfell folded before Flop (didn't bet)
Seat 4: Comeback3392 folded before Flop (didn't bet)
Seat 5: m.c-alkatraz (button) folded before Flop (didn't bet)
Seat 6: univibe68 (small blind) folded before Flop



PokerStars Hand #166667922294:  Hold'em No Limit ($0.05/$0.10 USD) - 2017/02/23 16:09:59 ET
Table 'Kobresia II' 6-max Seat #4 is the button
Seat 1: RoJ1 ($15.39 in chips) 
Seat 2: Dcaro31 ($13.52 in chips) 
Seat 4: Vanne11 ($10 in chips) 
XaXaTyH4uK will be allowed to play after the button
RoJ1: posts small blind $0.05
Dcaro31: posts big blind $0.10
ocmarigo81: sits out 
*** HOLE CARDS ***
Vanne11: folds 
RoJ1: folds 
Uncalled bet ($0.05) returned to Dcaro31
Dcaro31 collected $0.10 from pot
*** SUMMARY ***
Total pot $0.10 | Rake $0 
Seat 1: RoJ1 (small blind) folded before Flop
Seat 2: Dcaro31 (big blind) collected ($0.10)
Seat 4: Vanne11 (button) folded before Flop (didn't bet)



PokerStars Hand #166667922515:  Hold'em No Limit ($0.05/$0.10 USD) - 2017/02/23 16:09:59 ET
Table 'Brambilla II' 6-max Seat #5 is the button
Seat 1: Rodik002 ($12.27 in chips) 
Seat 2: dwonder75 ($15.46 in chips) 
Seat 3: BORIS_ENEV ($14.06 in chips) 
Seat 5: FRAID358 ($10 in chips) 
Seat 6: boxer821 ($10 in chips) 
boxer821: posts small blind $0.05
Rodik002: posts big blind $0.10
*** HOLE CARDS ***
dwonder75: folds 
dwonder75 leaves the table
david_sara83 leaves the table
Namhkal joins the table at seat #2 
Namhkal leaves the table
Kow6oy joins the table at seat #2 
BORIS_ENEV has timed out
BORIS_ENEV: folds 
Kow6oy leaves the table
FRAID358: folds 
boxer821: folds 
Uncalled bet ($0.05) returned to Rodik002
Rodik002 collected $0.10 from pot
*** SUMMARY ***
Total pot $0.10 | Rake $0 
Seat 1: Rodik002 (big blind) collected ($0.10)
Seat 2: dwonder75 folded before Flop (didn't bet)
Seat 3: BORIS_ENEV folded before Flop (didn't bet)
Seat 5: FRAID358 (button) folded before Flop (didn't bet)
Seat 6: boxer821 (small blind) folded before Flop



PokerStars Hand #166667922779:  Hold'em No Limit ($0.05/$0.10 USD) - 2017/02/23 16:09:59 ET
Table 'Ostara III' 6-max Seat #4 is the button
Seat 1: MühliJr ($10 in chips) 
Seat 2: Action_Gibi ($13.52 in chips) 
Seat 3: vtalian ($13.08 in chips) 
Seat 4: Goovr ($28.76 in chips) 
Seat 5: THIMUCHIN ($10 in chips) 
Seat 6: FlopsterGB ($10 in chips) 
THIMUCHIN: posts small blind $0.05
FlopsterGB: posts big blind $0.10
*** HOLE CARDS ***
MühliJr: folds 
Action_Gibi: folds 
vtalian: folds 
Goovr: folds 
THIMUCHIN: folds 
Uncalled bet ($0.05) returned to FlopsterGB
FlopsterGB collected $0.10 from pot
*** SUMMARY ***
Total pot $0.10 | Rake $0 
Seat 1: MühliJr folded before Flop (didn't bet)
Seat 2: Action_Gibi folded before Flop (didn't bet)
Seat 3: vtalian folded before Flop (didn't bet)
Seat 4: Goovr (button) folded before Flop (didn't bet)
Seat 5: THIMUCHIN (small blind) folded before Flop
Seat 6: FlopsterGB (big blind) collected ($0.10)



PokerStars Hand #166667923073:  Hold'em No Limit ($0.05/$0.10 USD) - 2017/02/23 16:10:00 ET
Table 'Aconcagua' 6-max Seat #5 is the button
Seat 1: MLPlayer16 ($10.07 in chips) 
Seat 2: Kupi007 ($10 in chips) 
Seat 3: burtila1989 ($7.69 in chips) 
Seat 4: pivanki11 ($9.60 in chips) 
Seat 5: Andrei ProFF ($10.55 in chips) 
Seat 6: coolisses111 ($11.72 in chips) 
coolisses111: posts small blind $0.05
MLPlayer16: posts big blind $0.10
MLPlayer16: posts the ante $0.02
Kupi007: posts the ante $0.02
burtila1989: posts the ante $0.02
pivanki11: posts the ante $0.02
Andrei ProFF: posts the ante $0.02
coolisses111: posts the ante $0.02
*** HOLE CARDS ***
Kupi007: folds 
burtila1989: raises $0.10 to $0.20
pivanki11: calls $0.20
Andrei ProFF: folds 
coolisses111: folds 
MLPlayer16: folds 
*** FLOP *** [Jd 7h 6h]
burtila1989: bets $0.30
pivanki11: folds 
Uncalled bet ($0.30) returned to burtila1989
burtila1989 collected $0.64 from pot
*** SUMMARY ***
Total pot $0.67 | Rake $0.03 
Board [Jd 7h 6h]
Seat 1: MLPlayer16 (big blind) folded before Flop
Seat 2: Kupi007 folded before Flop (didn't bet)
Seat 3: burtila1989 collected ($0.64)
Seat 4: pivanki11 folded on the Flop
Seat 5: Andrei ProFF (button) folded before Flop (didn't bet)
Seat 6: coolisses111 (small blind) folded before Flop



PokerStars Hand #166667923570:  Hold'em No Limit ($0.05/$0.10 USD) - 2017/02/23 16:10:00 ET
Table 'Alnasl II' 6-max Seat #2 is the button
Seat 1: dragonste89 ($13.90 in chips) 
Seat 2: Therodorus ($10 in chips) 
Seat 3: ICBM-RS26 ($15.62 in chips) 
Seat 4: Eddys Edge ($10 in chips) 
Seat 5: mdelfin0 ($12.61 in chips) 
Seat 6: Bommer78 ($5.95 in chips) 
ICBM-RS26: posts small blind $0.05
Eddys Edge: posts big blind $0.10
*** HOLE CARDS ***
mdelfin0: folds 
Bommer78: calls $0.10
dragonste89: folds 
Therodorus: folds 
ICBM-RS26: calls $0.05
Eddys Edge: checks 
*** FLOP *** [2c 6d Qs]
ICBM-RS26: checks 
Eddys Edge: bets $0.20
Bommer78: folds 
ICBM-RS26: calls $0.20
*** TURN *** [2c 6d Qs] [Ks]
ICBM-RS26: checks 
Eddys Edge: checks 
*** RIVER *** [2c 6d Qs Ks] [Kd]
ICBM-RS26: bets $0.30
Eddys Edge: folds 
Uncalled bet ($0.30) returned to ICBM-RS26
ICBM-RS26 collected $0.67 from pot
*** SUMMARY ***
Total pot $0.70 | Rake $0.03 
Board [2c 6d Qs Ks Kd]
Seat 1: dragonste89 folded before Flop (didn't bet)
Seat 2: Therodorus (button) folded before Flop (didn't bet)
Seat 3: ICBM-RS26 (small blind) collected ($0.67)
Seat 4: Eddys Edge (big blind) folded on the River
Seat 5: mdelfin0 folded before Flop (didn't bet)
Seat 6: Bommer78 folded on the Flop



PokerStars Hand #166667923635:  Hold'em No Limit ($0.05/$0.10 USD) - 2017/02/23 16:10:00 ET
Table 'Jacchia' 6-max Seat #5 is the button
Seat 1: viklundm ($32.53 in chips) 
Seat 2: VAD21 ($23.02 in chips) 
Seat 3: maxiv608 ($10 in chips) 
Seat 4: paterthomas ($9.51 in chips) 
Seat 5: arti192837 ($11.24 in chips) 
Seat 6: RoJ1 ($12.61 in chips) 
RoJ1: posts small blind $0.05
viklundm: posts big blind $0.10
*** HOLE CARDS ***
VAD21: folds 
maxiv608: folds 
paterthomas: folds 
arti192837: folds 
RoJ1: raises $0.15 to $0.25
viklundm: calls $0.15
*** FLOP *** [Ks Kh Qh]
RoJ1: bets $0.15
viklundm: folds 
Uncalled bet ($0.15) returned to RoJ1
RoJ1 collected $0.48 from pot
*** SUMMARY ***
Total pot $0.50 | Rake $0.02 
Board [Ks Kh Qh]
Seat 1: viklundm (big blind) folded on the Flop
Seat 2: VAD21 folded before Flop (didn't bet)
Seat 3: maxiv608 folded before Flop (didn't bet)
Seat 4: paterthomas folded before Flop (didn't bet)
Seat 5: arti192837 (button) folded before Flop (didn't bet)
Seat 6: RoJ1 (small blind) collected ($0.48)



PokerStars Hand #166667923761:  Hold'em No Limit ($0.05/$0.10 USD) - 2017/02/23 16:10:00 ET
Table 'Sham' 6-max Seat #1 is the button
Seat 1: pancernik21 ($10 in chips) 
Seat 2: ex3Lero86 ($10.05 in chips) 
Seat 3: weez3r ($14.93 in chips) 
Seat 4: VAD21 ($14.21 in chips) 
Seat 5: T9MS ($10 in chips) 
Seat 6: bdixon_5 ($19.50 in chips) 
ex3Lero86: posts small blind $0.05
weez3r: posts big blind $0.10
*** HOLE CARDS ***
VAD21: folds 
T9MS: folds 
bdixon_5: folds 
pancernik21: raises $0.20 to $0.30
ex3Lero86: folds 
weez3r: calls $0.20
*** FLOP *** [Ad Kh 6c]
weez3r: checks 
pancernik21: checks 
*** TURN *** [Ad Kh 6c] [9s]
weez3r: bets $0.31
pancernik21: folds 
Uncalled bet ($0.31) returned to weez3r
weez3r collected $0.62 from pot
*** SUMMARY ***
Total pot $0.65 | Rake $0.03 
Board [Ad Kh 6c 9s]
Seat 1: pancernik21 (button) folded on the Turn
Seat 2: ex3Lero86 (small blind) folded before Flop
Seat 3: weez3r (big blind) collected ($0.62)
Seat 4: VAD21 folded before Flop (didn't bet)
Seat 5: T9MS folded before Flop (didn't bet)
Seat 6: bdixon_5 folded before Flop (didn't bet)



PokerStars Hand #166667923791:  Hold'em No Limit ($0.05/$0.10 USD) - 2017/02/23 16:10:00 ET
Table 'Vesta II' 6-max Seat #4 is the button
Seat 1: Yabidooo ($17.57 in chips) 
Seat 2: Dimka4 ($10 in chips) 
Seat 3: Pokeaster ($12.56 in chips) 
Seat 4: Dcaro31 ($10 in chips) 
Seat 5: ChuikaPridi ($10.05 in chips) 
Seat 6: XaXaTyH4uK ($10.86 in chips) 
ChuikaPridi: posts small blind $0.05
XaXaTyH4uK: posts big blind $0.10
*** HOLE CARDS ***
Yabidooo: folds 
Dimka4: folds 
Pokeaster: folds 
Dcaro31: folds 
ChuikaPridi: raises $0.20 to $0.30
XaXaTyH4uK: calls $0.20
*** FLOP *** [Qh 2d 5h]
ChuikaPridi: bets $0.30
XaXaTyH4uK: calls $0.30
*** TURN *** [Qh 2d 5h] [6s]
ChuikaPridi: checks 
XaXaTyH4uK: checks 
*** RIVER *** [Qh 2d 5h 6s] [2c]
ChuikaPridi: checks 
XaXaTyH4uK: checks 
*** SHOW DOWN ***
ChuikaPridi: shows [Kd Ad] (a pair of Deuces)
XaXaTyH4uK: shows [7d 7h] (two pair, Sevens and Deuces)
XaXaTyH4uK collected $1.15 from pot
*** SUMMARY ***
Total pot $1.20 | Rake $0.05 
Board [Qh 2d 5h 6s 2c]
Seat 1: Yabidooo folded before Flop (didn't bet)
Seat 2: Dimka4 folded before Flop (didn't bet)
Seat 3: Pokeaster folded before Flop (didn't bet)
Seat 4: Dcaro31 (button) folded before Flop (didn't bet)
Seat 5: ChuikaPridi (small blind) showed [Kd Ad] and lost with a pair of Deuces
Seat 6: XaXaTyH4uK (big blind) showed [7d 7h] and won ($1.15) with two pair, Sevens and Deuces



PokerStars Hand #166667923852:  Hold'em No Limit ($0.05/$0.10 USD) - 2017/02/23 16:10:00 ET
Table 'Tomyris II' 6-max Seat #6 is the button
Seat 1: ArcticBearDK ($21.33 in chips) 
Seat 2: Yspenyanin ($12.62 in chips) 
Seat 3: robertsabb ($12.63 in chips) 
Seat 4: Dcaro31 ($10 in chips) 
Seat 5: 6ePeMeHHa9 ($11.80 in chips) 
Seat 6: StackSmakka ($9.89 in chips) 
ArcticBearDK: posts small blind $0.05
Yspenyanin: posts big blind $0.10
*** HOLE CARDS ***
robertsabb: calls $0.10
Dcaro31: folds 
6ePeMeHHa9 is disconnected 
6ePeMeHHa9 is connected 
6ePeMeHHa9: folds 
StackSmakka: raises $0.40 to $0.50
ArcticBearDK: folds 
Yspenyanin is disconnected 
Yspenyanin is connected 
Yspenyanin: folds 
robertsabb: calls $0.40
*** FLOP *** [Td 9s 3s]
robertsabb: checks 
StackSmakka: bets $0.63
robertsabb: calls $0.63
*** TURN *** [Td 9s 3s] [5s]
robertsabb: checks 
StackSmakka: bets $1.63
robertsabb: calls $1.63
*** RIVER *** [Td 9s 3s 5s] [Js]
robertsabb: checks 
StackSmakka: bets $3.08
robertsabb: calls $3.08
*** SHOW DOWN ***
StackSmakka: shows [8s Ks] (a flush, King high)
robertsabb: mucks hand 
StackSmakka collected $11.30 from pot
*** SUMMARY ***
Total pot $11.83 | Rake $0.53 
Board [Td 9s 3s 5s Js]
Seat 1: ArcticBearDK (small blind) folded before Flop
Seat 2: Yspenyanin (big blind) folded before Flop
Seat 3: robertsabb mucked
Seat 4: Dcaro31 folded before Flop (didn't bet)
Seat 5: 6ePeMeHHa9 folded before Flop (didn't bet)
Seat 6: StackSmakka (button) showed [8s Ks] and won ($11.30) with a flush, King high



PokerStars Hand #166667923868:  Hold'em No Limit ($0.05/$0.10 USD) - 2017/02/23 16:10:01 ET
Table 'Peiroos III' 6-max Seat #5 is the button
Seat 1: tequila_joop ($9.57 in chips) 
Seat 3: nabatov.m ($4.22 in chips) 
Seat 4: pivanki11 ($12.51 in chips) 
Seat 5: ChuikaPridi ($10.70 in chips) 
Seat 6: CHRO8 ($10.52 in chips) 
CHRO8: posts small blind $0.05
tequila_joop: posts big blind $0.10
Goovr: sits out 
tequila_joop: posts the ante $0.02
nabatov.m: posts the ante $0.02
pivanki11: posts the ante $0.02
ChuikaPridi: posts the ante $0.02
CHRO8: posts the ante $0.02
*** HOLE CARDS ***
nabatov.m: raises $0.10 to $0.20
pivanki11: folds 
ChuikaPridi: folds 
CHRO8: folds 
tequila_joop: calls $0.10
*** FLOP *** [7c 5h 3c]
tequila_joop: checks 
nabatov.m: bets $0.10
tequila_joop: calls $0.10
*** TURN *** [7c 5h 3c] [6s]
tequila_joop: checks 
nabatov.m: checks 
*** RIVER *** [7c 5h 3c 6s] [Ts]
tequila_joop: checks 
nabatov.m: bets $0.36
tequila_joop: folds 
Uncalled bet ($0.36) returned to nabatov.m
nabatov.m collected $0.72 from pot
*** SUMMARY ***
Total pot $0.75 | Rake $0.03 
Board [7c 5h 3c 6s Ts]
Seat 1: tequila_joop (big blind) folded on the River
Seat 3: nabatov.m collected ($0.72)
Seat 4: pivanki11 folded before Flop (didn't bet)
Seat 5: ChuikaPridi (button) folded before Flop (didn't bet)
Seat 6: CHRO8 (small blind) folded before Flop



PokerStars Hand #166667923997:  Hold'em No Limit ($0.05/$0.10 USD) - 2017/02/23 16:10:01 ET
Table 'Glarona' 6-max Seat #1 is the button
Seat 1: LarryTheStar ($10 in chips) 
Seat 2: BookWorm78 ($10.30 in chips) 
Seat 4: CrippledGod ($7.04 in chips) 
BookWorm78: posts small blind $0.05
CrippledGod: posts big blind $0.10
marianoboni: sits out 
*** HOLE CARDS ***
LarryTheStar: raises $0.10 to $0.20
BookWorm78: folds 
CrippledGod: folds 
Uncalled bet ($0.10) returned to LarryTheStar
LarryTheStar collected $0.25 from pot
*** SUMMARY ***
Total pot $0.25 | Rake $0 
Seat 1: LarryTheStar (button) collected ($0.25)
Seat 2: BookWorm78 (small blind) folded before Flop
Seat 4: CrippledGod (big blind) folded before Flop



PokerStars Hand #166667924105:  Hold'em No Limit ($0.05/$0.10 USD) - 2017/02/23 16:10:01 ET
Table 'Lederle' 6-max Seat #4 is the button
Seat 1: Sterjek ($10 in chips) 
Seat 2: truck1234 ($15.54 in chips) 
Seat 3: Kazacha ($11.35 in chips) 
Seat 4: Pokeaster ($13.66 in chips) 
Seat 5: 8th wonders ($13.58 in chips) 
Seat 6: pokekrk ($10 in chips) 
8th wonders: posts small blind $0.05
pokekrk: posts big blind $0.10
*** HOLE CARDS ***
Sterjek: folds 
truck1234: folds 
Kazacha: raises $0.14 to $0.24
Pokeaster: folds 
8th wonders: folds 
pokekrk: calls $0.14
*** FLOP *** [8d Qs Js]
pokekrk: checks 
Kazacha: checks 
*** TURN *** [8d Qs Js] [Th]
pokekrk: bets $0.38
Kazacha: folds 
Uncalled bet ($0.38) returned to pokekrk
pokekrk collected $0.51 from pot
*** SUMMARY ***
Total pot $0.53 | Rake $0.02 
Board [8d Qs Js Th]
Seat 1: Sterjek folded before Flop (didn't bet)
Seat 2: truck1234 folded before Flop (didn't bet)
Seat 3: Kazacha folded on the Turn
Seat 4: Pokeaster (button) folded before Flop (didn't bet)
Seat 5: 8th wonders (small blind) folded before Flop
Seat 6: pokekrk (big blind) collected ($0.51)



PokerStars Hand #166667924315:  Hold'em No Limit ($0.05/$0.10 USD) - 2017/02/23 16:10:01 ET
Table 'Pompeja III' 6-max Seat #2 is the button
Seat 1: Iarlei ($11.98 in chips) 
Seat 2: steepfell ($10.42 in chips) 
Seat 3: Yspenyanin ($12.21 in chips) 
Seat 5: Spud014 ($12.60 in chips) 
Seat 6: mega spasser ($4.50 in chips) 
Yspenyanin: posts small blind $0.05
Cluckh: is sitting out 
Spud014: posts big blind $0.10
*** HOLE CARDS ***
mega spasser: folds 
Cluckh leaves the table
Iarlei: raises $0.20 to $0.30
steepfell: folds 
Yspenyanin is disconnected 
Yspenyanin is connected 
Yspenyanin: raises $0.70 to $1
Spud014: folds 
Iarlei: folds 
Uncalled bet ($0.70) returned to Yspenyanin
Yspenyanin collected $0.70 from pot
*** SUMMARY ***
Total pot $0.70 | Rake $0 
Seat 1: Iarlei folded before Flop
Seat 2: steepfell (button) folded before Flop (didn't bet)
Seat 3: Yspenyanin (small blind) collected ($0.70)
Seat 5: Spud014 (big blind) folded before Flop
Seat 6: mega spasser folded before Flop (didn't bet)



PokerStars Hand #166667924441:  Hold'em No Limit ($0.05/$0.10 USD) - 2017/02/23 16:10:01 ET
Table 'Antinous' 6-max Seat #2 is the button
Seat 1: Andrei ProFF ($16.23 in chips) 
Seat 2: Nr847 ($13.45 in chips) 
Seat 3: dittoro ($10 in chips) 
Seat 4: Pekaml ($15.65 in chips) 
Seat 5: Covetsoles ($4.02 in chips) 
Seat 6: coolisses111 ($9.25 in chips) 
dittoro: posts small blind $0.05
Pekaml: posts big blind $0.10
*** HOLE CARDS ***
Covetsoles: folds 
coolisses111: folds 
Andrei ProFF: raises $0.20 to $0.30
Nr847: folds 
dittoro: folds 
Pekaml: calls $0.20
*** FLOP *** [Th 7s 6d]
Pekaml: checks 
Andrei ProFF: bets $0.40
Pekaml: folds 
Uncalled bet ($0.40) returned to Andrei ProFF
Andrei ProFF collected $0.62 from pot
*** SUMMARY ***
Total pot $0.65 | Rake $0.03 
Board [Th 7s 6d]
Seat 1: Andrei ProFF collected ($0.62)
Seat 2: Nr847 (button) folded before Flop (didn't bet)
Seat 3: dittoro (small blind) folded before Flop
Seat 4: Pekaml (big blind) folded on the Flop
Seat 5: Covetsoles folded before Flop (didn't bet)
Seat 6: coolisses111 folded before Flop (didn't bet)



PokerStars Hand #166667924518:  Hold'em No Limit ($0.05/$0.10 USD) - 2017/02/23 16:10:01 ET
Table 'Sheragul III' 6-max Seat #2 is the button
Seat 2: Bird et al ($10.36 in chips) 
Seat 3: FRAID358 ($9.80 in chips) 
Seat 5: RGhearted ($10 in chips) 
FRAID358: posts small blind $0.05
maxiv608: is sitting out 
RGhearted: posts big blind $0.10
XaXaTyH4uK: sits out 
*** HOLE CARDS ***
Bird et al: folds 
FRAID358: folds 
Uncalled bet ($0.05) returned to RGhearted
RGhearted collected $0.10 from pot
*** SUMMARY ***
Total pot $0.10 | Rake $0 
Seat 2: Bird et al (button) folded before Flop (didn't bet)
Seat 3: FRAID358 (small blind) folded before Flop
Seat 5: RGhearted (big blind) collected ($0.10)



PokerStars Hand #166667924638:  Hold'em No Limit ($0.05/$0.10 USD) - 2017/02/23 16:10:01 ET
Table 'Tyndareus III' 6-max Seat #6 is the button
Seat 1: MBen10 ($18.86 in chips) 
Seat 2: MihaGr ($10.42 in chips) 
Seat 3: XaXaTyH4uK ($10 in chips) 
Seat 4: tequila_joop ($11.08 in chips) 
Seat 5: yodzik ($5 in chips) 
Seat 6: Hb-309 ($9.41 in chips) 
MBen10: posts small blind $0.05
MihaGr: posts big blind $0.10
*** HOLE CARDS ***
XaXaTyH4uK: folds 
tequila_joop: raises $0.20 to $0.30
yodzik: folds 
Hb-309: folds 
MBen10: folds 
MihaGr: calls $0.20
*** FLOP *** [4h Kh Kd]
MihaGr: checks 
tequila_joop: bets $0.46
MihaGr: calls $0.46
*** TURN *** [4h Kh Kd] [2h]
MihaGr: checks 
tequila_joop: checks 
*** RIVER *** [4h Kh Kd 2h] [3h]
MihaGr: checks 
tequila_joop: checks 
*** SHOW DOWN ***
MihaGr: shows [Ts Ks] (three of a kind, Kings)
tequila_joop: shows [Jh As] (a flush, King high)
tequila_joop collected $1.50 from pot
*** SUMMARY ***
Total pot $1.57 | Rake $0.07 
Board [4h Kh Kd 2h 3h]
Seat 1: MBen10 (small blind) folded before Flop
Seat 2: MihaGr (big blind) showed [Ts Ks] and lost with three of a kind, Kings
Seat 3: XaXaTyH4uK folded before Flop (didn't bet)
Seat 4: tequila_joop showed [Jh As] and won ($1.50) with a flush, King high
Seat 5: yodzik folded before Flop (didn't bet)
Seat 6: Hb-309 (button) folded before Flop (didn't bet)



PokerStars Hand #166667924784:  Hold'em No Limit ($0.05/$0.10 USD) - 2017/02/23 16:10:02 ET
Table 'Lorbach' 6-max Seat #3 is the button
Seat 1: LarryTheStar ($17.59 in chips) 
Seat 2: fabadam ($11.68 in chips) 
Seat 3: ArcticBearDK ($10 in chips) 
Seat 6: Worlz ($16.12 in chips) 
Worlz: posts small blind $0.05
LarryTheStar: posts big blind $0.10
*** HOLE CARDS ***
kpumukAA joins the table at seat #4 
fabadam: folds 
ArcticBearDK: raises $0.17 to $0.27
Worlz: calls $0.22
LarryTheStar: calls $0.17
*** FLOP *** [4c 6d 5c]
Worlz: checks 
LarryTheStar: checks 
ArcticBearDK: checks 
*** TURN *** [4c 6d 5c] [8d]
Worlz: checks 
LarryTheStar: bets $0.60
ArcticBearDK: folds 
Worlz: folds 
Uncalled bet ($0.60) returned to LarryTheStar
LarryTheStar collected $0.77 from pot
*** SUMMARY ***
Total pot $0.81 | Rake $0.04 
Board [4c 6d 5c 8d]
Seat 1: LarryTheStar (big blind) collected ($0.77)
Seat 2: fabadam folded before Flop (didn't bet)
Seat 3: ArcticBearDK (button) folded on the Turn
Seat 6: Worlz (small blind) folded on the Turn



PokerStars Hand #166667924862:  Hold'em No Limit ($0.05/$0.10 USD) - 2017/02/23 16:10:02 ET
Table 'Lacroute' 6-max Seat #4 is the button
Seat 1: Orlangoor ($10.25 in chips) 
Seat 2: Andy Wolf ($10.54 in chips) 
Seat 4: st4tion ($17.24 in chips) 
Seat 5: steepfell ($10.09 in chips) 
Seat 6: IAntikI ($11.67 in chips) 
steepfell: posts small blind $0.05
IAntikI: posts big blind $0.10
KOS3573: sits out 
*** HOLE CARDS ***
Orlangoor: folds 
Andy Wolf: folds 
st4tion: raises $0.15 to $0.25
steepfell: folds 
IAntikI: folds 
Uncalled bet ($0.15) returned to st4tion
st4tion collected $0.25 from pot
*** SUMMARY ***
Total pot $0.25 | Rake $0 
Seat 1: Orlangoor folded before Flop (didn't bet)
Seat 2: Andy Wolf folded before Flop (didn't bet)
Seat 4: st4tion (button) collected ($0.25)
Seat 5: steepfell (small blind) folded before Flop
Seat 6: IAntikI (big blind) folded before Flop



PokerStars Hand #166667924970:  Hold'em No Limit ($0.05/$0.10 USD) - 2017/02/23 16:10:02 ET
Table 'Tomita II' 6-max Seat #5 is the button
Seat 1: HARDCORE66RU ($22.78 in chips) 
Seat 2: mhonielsen ($10.15 in chips) 
Seat 3: D3NyA ($10 in chips) 
Seat 4: Hyd SK ($11.61 in chips) 
Seat 5: ex3Lero86 ($10 in chips) 
Seat 6: saniasmir ($10.05 in chips) 
saniasmir: posts small blind $0.05
HARDCORE66RU: posts big blind $0.10
*** HOLE CARDS ***
mhonielsen: raises $0.30 to $0.40
D3NyA: folds 
Hyd SK: folds 
ex3Lero86: folds 
saniasmir: folds 
HARDCORE66RU: folds 
Uncalled bet ($0.30) returned to mhonielsen
mhonielsen collected $0.25 from pot
mhonielsen: doesn't show hand 
*** SUMMARY ***
Total pot $0.25 | Rake $0 
Seat 1: HARDCORE66RU (big blind) folded before Flop
Seat 2: mhonielsen collected ($0.25)
Seat 3: D3NyA folded before Flop (didn't bet)
Seat 4: Hyd SK folded before Flop (didn't bet)
Seat 5: ex3Lero86 (button) folded before Flop (didn't bet)
Seat 6: saniasmir (small blind) folded before Flop



PokerStars Hand #166667925044:  Hold'em No Limit ($0.05/$0.10 USD) - 2017/02/23 16:10:02 ET
Table 'Bootes' 6-max Seat #3 is the button
Seat 1: Namhkal ($11.40 in chips) 
Seat 2: Bird et al ($17.46 in chips) 
Seat 3: KA3AXCTAHEU, ($20.61 in chips) 
Seat 4: totonove ($6.93 in chips) 
Seat 5: Pekaml ($15.42 in chips) 
Seat 6: cherep61987 ($10.07 in chips) 
totonove: posts small blind $0.05
Pekaml: posts big blind $0.10
*** HOLE CARDS ***
cherep61987: folds 
Namhkal: folds 
Bird et al: folds 
KA3AXCTAHEU,: folds 
totonove: calls $0.05
Pekaml: checks 
*** FLOP *** [Jd 7h 4s]
totonove: bets $0.20
Pekaml: folds 
Uncalled bet ($0.20) returned to totonove
totonove collected $0.19 from pot
*** SUMMARY ***
Total pot $0.20 | Rake $0.01 
Board [Jd 7h 4s]
Seat 1: Namhkal folded before Flop (didn't bet)
Seat 2: Bird et al folded before Flop (didn't bet)
Seat 3: KA3AXCTAHEU, (button) folded before Flop (didn't bet)
Seat 4: totonove (small blind) collected ($0.19)
Seat 5: Pekaml (big blind) folded on the Flop
Seat 6: cherep61987 folded before Flop (didn't bet)



PokerStars Hand #166667925114:  Hold'em No Limit ($0.05/$0.10 USD) - 2017/02/23 16:10:02 ET
Table 'Siebohme II' 6-max Seat #3 is the button
Seat 1: homelessdan ($17.67 in chips) 
Seat 2: townerz1991 ($12.97 in chips) 
Seat 3: D3NyA ($11.38 in chips) 
Seat 4: POT_TRADER ($12.04 in chips) 
Seat 5: NvR.m1nD ($11.34 in chips) 
Seat 6: Fozzy690 ($9.47 in chips) 
POT_TRADER: posts small blind $0.05
NvR.m1nD: posts big blind $0.10
*** HOLE CARDS ***
Fozzy690: calls $0.10
homelessdan: folds 
townerz1991: folds 
D3NyA: raises $0.33 to $0.43
POT_TRADER: folds 
NvR.m1nD: folds 
Fozzy690: calls $0.33
*** FLOP *** [Th 9c 9d]
Fozzy690: bets $0.10
D3NyA: raises $0.81 to $0.91
Fozzy690: calls $0.81
*** TURN *** [Th 9c 9d] [Ks]
Fozzy690: checks 
D3NyA: checks 
*** RIVER *** [Th 9c 9d Ks] [Tc]
Fozzy690: bets $0.50
D3NyA: folds 
Uncalled bet ($0.50) returned to Fozzy690
Fozzy690 collected $2.70 from pot
*** SUMMARY ***
Total pot $2.83 | Rake $0.13 
Board [Th 9c 9d Ks Tc]
Seat 1: homelessdan folded before Flop (didn't bet)
Seat 2: townerz1991 folded before Flop (didn't bet)
Seat 3: D3NyA (button) folded on the River
Seat 4: POT_TRADER (small blind) folded before Flop
Seat 5: NvR.m1nD (big blind) folded before Flop
Seat 6: Fozzy690 collected ($2.70)



PokerStars Hand #166667925158:  Hold'em No Limit ($0.05/$0.10 USD) - 2017/02/23 16:10:02 ET
Table 'Girtab' 6-max Seat #5 is the button
Seat 2: MühliJr ($10.66 in chips) 
Seat 3: kingartur222 ($10.05 in chips) 
Seat 4: Hyd SK ($10.98 in chips) 
Seat 5: sexy_seagull ($11.05 in chips) 
Seat 6: iluzja12 ($9.90 in chips) 
iluzja12: posts small blind $0.05
pokekrk: is sitting out 
MühliJr: posts big blind $0.10
*** HOLE CARDS ***
kingartur222: folds 
Hyd SK: folds 
sexy_seagull: raises $0.15 to $0.25
pokekrk leaves the table
iluzja12: folds 
Andrei ProFF joins the table at seat #1 
MühliJr: folds 
Uncalled bet ($0.15) returned to sexy_seagull
sexy_seagull collected $0.25 from pot
*** SUMMARY ***
Total pot $0.25 | Rake $0 
Seat 2: MühliJr (big blind) folded before Flop
Seat 3: kingartur222 folded before Flop (didn't bet)
Seat 4: Hyd SK folded before Flop (didn't bet)
Seat 5: sexy_seagull (button) collected ($0.25)
Seat 6: iluzja12 (small blind) folded before Flop



PokerStars Hand #166667925415:  Hold'em No Limit ($0.05/$0.10 USD) - 2017/02/23 16:10:02 ET
Table 'Oongaq' 6-max Seat #1 is the button
Seat 1: Dmitrij218 ($13.89 in chips) 
Seat 2: homelessdan ($18.30 in chips) 
Seat 3: iDecMate ($10.46 in chips) 
Seat 4: Bird et al ($10 in chips) 
Seat 5: Dizzler1991 ($5.27 in chips) 
Seat 6: boxer821 ($10 in chips) 
homelessdan: posts small blind $0.05
iDecMate: posts big blind $0.10
*** HOLE CARDS ***
Bird et al: folds 
Dizzler1991: calls $0.10
boxer821: folds 
Dmitrij218: folds 
homelessdan: calls $0.05
iDecMate has timed out
iDecMate: checks 
*** FLOP *** [3c 9h Td]
homelessdan: bets $0.10
iDecMate: calls $0.10
Dizzler1991: raises $0.10 to $0.20
homelessdan: calls $0.10
iDecMate: calls $0.10
*** TURN *** [3c 9h Td] [2c]
homelessdan: checks 
iDecMate: checks 
Dizzler1991: bets $0.40
homelessdan: folds 
iDecMate: folds 
Uncalled bet ($0.40) returned to Dizzler1991
Dizzler1991 collected $0.86 from pot
*** SUMMARY ***
Total pot $0.90 | Rake $0.04 
Board [3c 9h Td 2c]
Seat 1: Dmitrij218 (button) folded before Flop (didn't bet)
Seat 2: homelessdan (small blind) folded on the Turn
Seat 3: iDecMate (big blind) folded on the Turn
Seat 4: Bird et al folded before Flop (didn't bet)
Seat 5: Dizzler1991 collected ($0.86)
Seat 6: boxer821 folded before Flop (didn't bet)



PokerStars Hand #166667925524:  Hold'em No Limit ($0.05/$0.10 USD) - 2017/02/23 16:10:02 ET
Table 'Markab II' 6-max Seat #5 is the button
Seat 2: truck1234 ($10.97 in chips) 
Seat 3: sexy_seagull ($10.15 in chips) 
Seat 4: Crafty23@PS ($11.29 in chips) 
Seat 5: Rodik002 ($19.77 in chips) 
Seat 6: Comeback3392 ($10 in chips) 
Comeback3392: posts small blind $0.05
truck1234: posts big blind $0.10
*** HOLE CARDS ***
sexy_seagull: folds 
david_sara83 leaves the table
Crafty23@PS: raises $0.20 to $0.30
Rodik002: folds 
Comeback3392: folds 
Danijnho joins the table at seat #1 
truck1234: folds 
Uncalled bet ($0.20) returned to Crafty23@PS
Crafty23@PS collected $0.25 from pot
*** SUMMARY ***
Total pot $0.25 | Rake $0 
Seat 2: truck1234 (big blind) folded before Flop
Seat 3: sexy_seagull folded before Flop (didn't bet)
Seat 4: Crafty23@PS collected ($0.25)
Seat 5: Rodik002 (button) folded before Flop (didn't bet)
Seat 6: Comeback3392 (small blind) folded before Flop



PokerStars Hand #166667925604:  Hold'em No Limit ($0.05/$0.10 USD) - 2017/02/23 16:10:02 ET
Table 'Arkab' 6-max Seat #2 is the button
Seat 1: iamkakaroto ($10 in chips) 
Seat 2: aktion4ik ($12.24 in chips) 
Seat 3: sexy_seagull ($10.41 in chips) 
Seat 4: dincimus ($10 in chips) 
Seat 5: OrionYusupov ($9.43 in chips) 
Seat 6: MihaGr ($11.20 in chips) 
sexy_seagull: posts small blind $0.05
dincimus: posts big blind $0.10
*** HOLE CARDS ***
OrionYusupov: folds 
MihaGr: folds 
iamkakaroto: raises $0.20 to $0.30
aktion4ik: folds 
sexy_seagull: folds 
dincimus: folds 
Uncalled bet ($0.20) returned to iamkakaroto
iamkakaroto collected $0.25 from pot
*** SUMMARY ***
Total pot $0.25 | Rake $0 
Seat 1: iamkakaroto collected ($0.25)
Seat 2: aktion4ik (button) folded before Flop (didn't bet)
Seat 3: sexy_seagull (small blind) folded before Flop
Seat 4: dincimus (big blind) folded before Flop
Seat 5: OrionYusupov folded before Flop (didn't bet)
Seat 6: MihaGr folded before Flop (didn't bet)



PokerStars Hand #166667925684:  Hold'em No Limit ($0.05/$0.10 USD) - 2017/02/23 16:10:02 ET
Table 'Rosalia' 6-max Seat #3 is the button
Seat 1: Hyd SK ($10 in chips) 
Seat 2: Bandyaev ($10.09 in chips) 
Seat 3: Andy Wolf ($11.83 in chips) 
Seat 4: THIMUCHIN ($10 in chips) 
Seat 5: miron762 ($20.53 in chips) 
Seat 6: facewald ($18.14 in chips) 
THIMUCHIN: posts small blind $0.05
miron762: posts big blind $0.10
*** HOLE CARDS ***
facewald: folds 
Hyd SK: folds 
Bandyaev: folds 
Andy Wolf: raises $0.20 to $0.30
THIMUCHIN: folds 
miron762: raises $0.40 to $0.70
Andy Wolf: calls $0.40
*** FLOP *** [3c 3h Qs]
miron762: bets $0.50
Andy Wolf: folds 
Uncalled bet ($0.50) returned to miron762
miron762 collected $1.38 from pot
*** SUMMARY ***
Total pot $1.45 | Rake $0.07 
Board [3c 3h Qs]
Seat 1: Hyd SK folded before Flop (didn't bet)
Seat 2: Bandyaev folded before Flop (didn't bet)
Seat 3: Andy Wolf (button) folded on the Flop
Seat 4: THIMUCHIN (small blind) folded before Flop
Seat 5: miron762 (big blind) collected ($1.38)
Seat 6: facewald folded before Flop (didn't bet)



PokerStars Hand #166667925729:  Hold'em No Limit ($0.05/$0.10 USD) - 2017/02/23 16:10:03 ET
Table 'Bengt' 6-max Seat #2 is the button
Seat 1: Lucky HoBBiT ($12.35 in chips) 
Seat 2: ChefRocco ($20.33 in chips) 
Seat 3: nantes15 ($13.19 in chips) 
Seat 4: 8th wonders ($10.15 in chips) 
Seat 5: RoJ1 ($10.16 in chips) 
Seat 6: Goroshkos88 ($11.06 in chips) 
nantes15: posts small blind $0.05
8th wonders: posts big blind $0.10
*** HOLE CARDS ***
RoJ1: folds 
Goroshkos88: folds 
Lucky HoBBiT is disconnected 
Lucky HoBBiT has timed out while disconnected
Lucky HoBBiT: folds 
ChefRocco: calls $0.10
nantes15: folds 
8th wonders: checks 
*** FLOP *** [3h 5h 9c]
8th wonders: checks 
ChefRocco: bets $0.10
8th wonders: folds 
Uncalled bet ($0.10) returned to ChefRocco
ChefRocco collected $0.24 from pot
*** SUMMARY ***
Total pot $0.25 | Rake $0.01 
Board [3h 5h 9c]
Seat 1: Lucky HoBBiT folded before Flop (didn't bet)
Seat 2: ChefRocco (button) collected ($0.24)
Seat 3: nantes15 (small blind) folded before Flop
Seat 4: 8th wonders (big blind) folded on the Flop
Seat 5: RoJ1 folded before Flop (didn't bet)
Seat 6: Goroshkos88 folded before Flop (didn't bet)



PokerStars Hand #166667925989:  Hold'em No Limit ($0.05/$0.10 USD) - 2017/02/23 16:10:03 ET
Table 'Ruvuma' 6-max Seat #5 is the button
Seat 1: FRAID358 ($24.34 in chips) 
Seat 3: Spud014 ($10.23 in chips) 
Seat 4: DamDatsAnAce ($10 in chips) 
Seat 5: sexy_seagull ($10 in chips) 
Elinaattor will be allowed to play after the button
FRAID358: posts small blind $0.05
Yspenyanin is disconnected 
Elinaattor leaves the table
Yspenyanin has timed out while disconnected
Yspenyanin: is sitting out 
Spud014: posts big blind $0.10
*** HOLE CARDS ***
DamDatsAnAce: folds 
sexy_seagull: folds 
osmea joins the table at seat #6 
FRAID358: folds 
Uncalled bet ($0.05) returned to Spud014
Spud014 collected $0.10 from pot
*** SUMMARY ***
Total pot $0.10 | Rake $0 
Seat 1: FRAID358 (small blind) folded before Flop
Seat 3: Spud014 (big blind) collected ($0.10)
Seat 4: DamDatsAnAce folded before Flop (didn't bet)
Seat 5: sexy_seagull (button) folded before Flop (didn't bet)



PokerStars Hand #166667926063:  Hold'em No Limit ($0.05/$0.10 USD) - 2017/02/23 16:10:03 ET
Table 'Geisha' 6-max Seat #4 is the button
Seat 1: facewald ($34.49 in chips) 
Seat 3: Eddys Edge ($10 in chips) 
Seat 4: marianoboni ($10.30 in chips) 
Seat 6: Namhkal ($20.73 in chips) 
crooso will be allowed to play after the button
Namhkal: posts small blind $0.05
facewald: posts big blind $0.10
MisterX413: sits out 
*** HOLE CARDS ***
Eddys Edge: folds 
marianoboni: raises $0.13 to $0.23
Namhkal: folds 
facewald: calls $0.13
*** FLOP *** [5h 5d Qd]
facewald: checks 
marianoboni: bets $0.16
facewald: calls $0.16
*** TURN *** [5h 5d Qd] [5c]
facewald: checks 
marianoboni: bets $0.26
facewald: calls $0.26
*** RIVER *** [5h 5d Qd 5c] [Td]
facewald: bets $0.95
marianoboni: folds 
Uncalled bet ($0.95) returned to facewald
facewald collected $1.29 from pot
*** SUMMARY ***
Total pot $1.35 | Rake $0.06 
Board [5h 5d Qd 5c Td]
Seat 1: facewald (big blind) collected ($1.29)
Seat 3: Eddys Edge folded before Flop (didn't bet)
Seat 4: marianoboni (button) folded on the River
Seat 6: Namhkal (small blind) folded before Flop



PokerStars Hand #166667926218:  Hold'em No Limit ($0.05/$0.10 USD) - 2017/02/23 16:10:03 ET
Table 'Kanda' 6-max Seat #1 is the button
Seat 1: Andy Wolf ($11.72 in chips) 
Seat 2: Pelotín ($5.17 in chips) 
Seat 3: XaXaTyH4uK ($10.42 in chips) 
Seat 4: Orlangoor ($10 in chips) 
Seat 5: Dimka4 ($10.28 in chips) 
Seat 6: oddshoff ($8.91 in chips) 
Pelotín: posts small blind $0.05
XaXaTyH4uK: posts big blind $0.10
*** HOLE CARDS ***
Orlangoor: folds 
Dimka4: raises $0.20 to $0.30
oddshoff: folds 
Andy Wolf: folds 
Pelotín: folds 
XaXaTyH4uK: folds 
Uncalled bet ($0.20) returned to Dimka4
Dimka4 collected $0.25 from pot
*** SUMMARY ***
Total pot $0.25 | Rake $0 
Seat 1: Andy Wolf (button) folded before Flop (didn't bet)
Seat 2: Pelotín (small blind) folded before Flop
Seat 3: XaXaTyH4uK (big blind) folded before Flop
Seat 4: Orlangoor folded before Flop (didn't bet)
Seat 5: Dimka4 collected ($0.25)
Seat 6: oddshoff folded before Flop (didn't bet)



PokerStars Hand #166667926253:  Hold'em No Limit ($0.05/$0.10 USD) - 2017/02/23 16:10:03 ET
Table 'Tyndareus II' 6-max Seat #5 is the button
Seat 1: Makc1705 ($4.39 in chips) 
Seat 2: fishhook5 ($10 in chips) 
Seat 3: McCleans ($11.40 in chips) 
Seat 4: gaHy_HaXeP ($10.36 in chips) 
Seat 5: vtalian ($10.07 in chips) 
Seat 6: sexy_seagull ($10.20 in chips) 
sexy_seagull: posts small blind $0.05
Makc1705: posts big blind $0.10
*** HOLE CARDS ***
fishhook5: raises $0.19 to $0.29
McCleans is connected 
McCleans: folds 
gaHy_HaXeP: folds 
vtalian: calls $0.29
McCleans leaves the table
sexy_seagull: folds 
Chodemuncher joins the table at seat #3 
Makc1705: folds 
*** FLOP *** [8d Td Ah]
fishhook5: checks 
vtalian: bets $0.50
fishhook5: calls $0.50
*** TURN *** [8d Td Ah] [7c]
fishhook5: checks 
vtalian: bets $1.50
fishhook5: calls $1.50
*** RIVER *** [8d Td Ah 7c] [Qd]
fishhook5: checks 
vtalian: checks 
*** SHOW DOWN ***
fishhook5: shows [Kh Jh] (a straight, Ten to Ace)
vtalian: mucks hand 
fishhook5 collected $4.52 from pot
*** SUMMARY ***
Total pot $4.73 | Rake $0.21 
Board [8d Td Ah 7c Qd]
Seat 1: Makc1705 (big blind) folded before Flop
Seat 2: fishhook5 showed [Kh Jh] and won ($4.52) with a straight, Ten to Ace
Seat 3: McCleans folded before Flop (didn't bet)
Seat 4: gaHy_HaXeP folded before Flop (didn't bet)
Seat 5: vtalian (button) mucked
Seat 6: sexy_seagull (small blind) folded before Flop



PokerStars Hand #166667926631:  Hold'em No Limit ($0.05/$0.10 USD) - 2017/02/23 16:10:04 ET
Table 'Nemo III' 6-max Seat #2 is the button
Seat 1: Kow6oy ($10.10 in chips) 
Seat 2: Bandyaev ($10.66 in chips) 
Seat 3: Dimka4 ($10 in chips) 
Seat 4: vtalian ($11.13 in chips) 
Seat 5: Joker51_wtf! ($11.73 in chips) 
Seat 6: maxiv608 ($10 in chips) 
Dimka4: posts small blind $0.05
vtalian: posts big blind $0.10
*** HOLE CARDS ***
Joker51_wtf!: folds 
maxiv608: folds 
Kow6oy: folds 
Bandyaev: raises $0.20 to $0.30
Dimka4: folds 
vtalian: folds 
Uncalled bet ($0.20) returned to Bandyaev
Bandyaev collected $0.25 from pot
*** SUMMARY ***
Total pot $0.25 | Rake $0 
Seat 1: Kow6oy folded before Flop (didn't bet)
Seat 2: Bandyaev (button) collected ($0.25)
Seat 3: Dimka4 (small blind) folded before Flop
Seat 4: vtalian (big blind) folded before Flop
Seat 5: Joker51_wtf! folded before Flop (didn't bet)
Seat 6: maxiv608 folded before Flop (didn't bet)



PokerStars Hand #166667927250:  Hold'em No Limit ($0.05/$0.10 USD) - 2017/02/23 16:10:04 ET
Table 'Mesarthim' 6-max Seat #6 is the button
Seat 1: Mancuso2010 ($16.37 in chips) 
Seat 2: MühliJr ($12.99 in chips) 
Seat 3: Damage514 ($9.44 in chips) 
Seat 4: Strelok1974 ($10 in chips) 
Seat 5: Iarlei ($10.30 in chips) 
Seat 6: bdixon_5 ($8.31 in chips) 
Mancuso2010: posts small blind $0.05
MühliJr: posts big blind $0.10
*** HOLE CARDS ***
Damage514: calls $0.10
Strelok1974: folds 
Iarlei: folds 
bdixon_5: folds 
Mancuso2010: calls $0.05
MühliJr: checks 
*** FLOP *** [8c 5h 4d]
Mancuso2010: checks 
MühliJr: checks 
Damage514: checks 
*** TURN *** [8c 5h 4d] [6s]
Mancuso2010: checks 
MühliJr: checks 
Damage514: checks 
*** RIVER *** [8c 5h 4d 6s] [8h]
Mancuso2010: checks 
MühliJr: checks 
Damage514: checks 
*** SHOW DOWN ***
Mancuso2010: shows [Kh Tc] (a pair of Eights)
MühliJr: shows [Qd 4c] (two pair, Eights and Fours)
Damage514: mucks hand 
MühliJr collected $0.29 from pot
*** SUMMARY ***
Total pot $0.30 | Rake $0.01 
Board [8c 5h 4d 6s 8h]
Seat 1: Mancuso2010 (small blind) showed [Kh Tc] and lost with a pair of Eights
Seat 2: MühliJr (big blind) showed [Qd 4c] and won ($0.29) with two pair, Eights and Fours
Seat 3: Damage514 mucked
Seat 4: Strelok1974 folded before Flop (didn't bet)
Seat 5: Iarlei folded before Flop (didn't bet)
Seat 6: bdixon_5 (button) folded before Flop (didn't bet)



PokerStars Hand #166667927392:  Hold'em No Limit ($0.05/$0.10 USD) - 2017/02/23 16:10:04 ET
Table 'Alzirr II' 6-max Seat #5 is the button
Seat 2: popypaleta ($10.25 in chips) 
Seat 3: devon_red ($7.35 in chips) 
Seat 5: yodzik ($5.93 in chips) 
Seat 6: AM-L-SL ($4.38 in chips) 
AM-L-SL: posts small blind $0.05
KA3AXCTAHEU,: is sitting out 
KA3AXCTAHEU, leaves the table
popypaleta: posts big blind $0.10
Scanner17: sits out 
*** HOLE CARDS ***
devon_red: folds 
yodzik: raises $0.10 to $0.20
AM-L-SL: folds 
popypaleta: raises $0.45 to $0.65
yodzik: folds 
Uncalled bet ($0.45) returned to popypaleta
popypaleta collected $0.45 from pot
*** SUMMARY ***
Total pot $0.45 | Rake $0 
Seat 2: popypaleta (big blind) collected ($0.45)
Seat 3: devon_red folded before Flop (didn't bet)
Seat 5: yodzik (button) folded before Flop
Seat 6: AM-L-SL (small blind) folded before Flop



PokerStars Hand #166667927666:  Hold'em No Limit ($0.05/$0.10 USD) - 2017/02/23 16:10:05 ET
Table 'Union' 6-max Seat #6 is the button
Seat 1: IAntikI ($10 in chips) 
Seat 2: Zooplack ($10.15 in chips) 
Seat 3: Rodik002 ($12.01 in chips) 
Seat 5: Chodemuncher ($16.25 in chips) 
Seat 6: bonyo71 ($3.85 in chips) 
IAntikI: posts small blind $0.05
Zooplack: posts big blind $0.10
osmea: sits out 
*** HOLE CARDS ***
Rodik002: raises $0.20 to $0.30
Chodemuncher: folds 
bonyo71: folds 
IAntikI: raises $0.70 to $1
Zooplack: folds 
Rodik002: calls $0.70
*** FLOP *** [4d 8c Ah]
IAntikI: bets $1
Rodik002: calls $1
*** TURN *** [4d 8c Ah] [9h]
IAntikI: checks 
Rodik002: bets $2.16
IAntikI: folds 
Uncalled bet ($2.16) returned to Rodik002
Rodik002 collected $3.92 from pot
*** SUMMARY ***
Total pot $4.10 | Rake $0.18 
Board [4d 8c Ah 9h]
Seat 1: IAntikI (small blind) folded on the Turn
Seat 2: Zooplack (big blind) folded before Flop
Seat 3: Rodik002 collected ($3.92)
Seat 5: Chodemuncher folded before Flop (didn't bet)
Seat 6: bonyo71 (button) folded before Flop (didn't bet)



PokerStars Hand #166667928331:  Hold'em No Limit ($0.05/$0.10 USD) - 2017/02/23 16:10:05 ET
Table 'Clavel' 6-max Seat #6 is the button
Seat 1: KRZuff ($14.87 in chips) 
Seat 2: Namhkal ($10.15 in chips) 
Seat 4: Dcaro31 ($11.68 in chips) 
Seat 5: Vrinni ($11.33 in chips) 
Seat 6: Gra_anD77 ($3.27 in chips) 
KRZuff: posts small blind $0.05
Namhkal: posts big blind $0.10
*** HOLE CARDS ***
Dcaro31: folds 
Vrinni: folds 
Gra_anD77: calls $0.10
KRZuff: folds 
Namhkal: raises $0.30 to $0.40
Gra_anD77: folds 
Uncalled bet ($0.30) returned to Namhkal
Namhkal collected $0.25 from pot
*** SUMMARY ***
Total pot $0.25 | Rake $0 
Seat 1: KRZuff (small blind) folded before Flop
Seat 2: Namhkal (big blind) collected ($0.25)
Seat 4: Dcaro31 folded before Flop (didn't bet)
Seat 5: Vrinni folded before Flop (didn't bet)
Seat 6: Gra_anD77 (button) folded before Flop



PokerStars Hand #166667928502:  Hold'em No Limit ($0.05/$0.10 USD) - 2017/02/23 16:10:06 ET
Table 'Lampetia III' 6-max Seat #4 is the button
Seat 1: gaHy_HaXeP ($10.55 in chips) 
Seat 2: DamDatsAnAce ($10.83 in chips) 
Seat 3: Kow6oy ($10 in chips) 
Seat 4: IAntikI ($10.30 in chips) 
Seat 5: robson1235 ($20.35 in chips) 
Seat 6: bdixon_5 ($9.20 in chips) 
robson1235: posts small blind $0.05
bdixon_5: posts big blind $0.10
*** HOLE CARDS ***
gaHy_HaXeP: folds 
DamDatsAnAce: folds 
Kow6oy: folds 
IAntikI: raises $0.15 to $0.25
robson1235: folds 
bdixon_5: folds 
Uncalled bet ($0.15) returned to IAntikI
IAntikI collected $0.25 from pot
*** SUMMARY ***
Total pot $0.25 | Rake $0 
Seat 1: gaHy_HaXeP folded before Flop (didn't bet)
Seat 2: DamDatsAnAce folded before Flop (didn't bet)
Seat 3: Kow6oy folded before Flop (didn't bet)
Seat 4: IAntikI (button) collected ($0.25)
Seat 5: robson1235 (small blind) folded before Flop
Seat 6: bdixon_5 (big blind) folded before Flop



PokerStars Hand #166667928519:  Hold'em No Limit ($0.05/$0.10 USD) - 2017/02/23 16:10:06 ET
Table 'Ebella II' 6-max Seat #3 is the button
Seat 1: gaHy_HaXeP ($10 in chips) 
Seat 2: Therodorus ($10 in chips) 
Seat 3: Torften2 ($17.86 in chips) 
Seat 4: ValdemorS ($11.25 in chips) 
Seat 5: Bird et al ($10 in chips) 
Seat 6: Joker51_wtf! ($11.39 in chips) 
ValdemorS: posts small blind $0.05
Bird et al: posts big blind $0.10
*** HOLE CARDS ***
Joker51_wtf!: folds 
gaHy_HaXeP: folds 
Therodorus: folds 
Torften2: raises $0.10 to $0.20
ValdemorS: raises $0.80 to $1
Bird et al: folds 
Torften2: folds 
Uncalled bet ($0.80) returned to ValdemorS
ValdemorS collected $0.50 from pot
*** SUMMARY ***
Total pot $0.50 | Rake $0 
Seat 1: gaHy_HaXeP folded before Flop (didn't bet)
Seat 2: Therodorus folded before Flop (didn't bet)
Seat 3: Torften2 (button) folded before Flop
Seat 4: ValdemorS (small blind) collected ($0.50)
Seat 5: Bird et al (big blind) folded before Flop
Seat 6: Joker51_wtf! folded before Flop (didn't bet)



PokerStars Hand #166667928740:  Hold'em No Limit ($0.05/$0.10 USD) - 2017/02/23 16:10:06 ET
Table 'Euryalos II' 6-max Seat #6 is the button
Seat 2: silsilviu ($16.52 in chips) 
Seat 3: Hyd SK ($10.50 in chips) 
Seat 4: popypaleta ($12.23 in chips) 
Seat 6: MihaGr ($10 in chips) 
voledy will be allowed to play after the button
silsilviu: posts small blind $0.05
Hyd SK: posts big blind $0.10
*** HOLE CARDS ***
popypaleta: raises $0.20 to $0.30
MihaGr: folds 
silsilviu: raises $0.60 to $0.90
Hyd SK: folds 
popypaleta: folds 
Uncalled bet ($0.60) returned to silsilviu
silsilviu collected $0.70 from pot
*** SUMMARY ***
Total pot $0.70 | Rake $0 
Seat 2: silsilviu (small blind) collected ($0.70)
Seat 3: Hyd SK (big blind) folded before Flop
Seat 4: popypaleta folded before Flop
Seat 6: MihaGr (button) folded before Flop (didn't bet)



PokerStars Hand #166667928928:  Hold'em No Limit ($0.05/$0.10 USD) - 2017/02/23 16:10:06 ET
Table 'Krethon' 6-max Seat #6 is the button
Seat 1: boxer821 ($10.67 in chips) 
Seat 4: chimera252 ($14.79 in chips) 
Seat 5: popypaleta ($10 in chips) 
Seat 6: fabadam ($18.83 in chips) 
boxer821: posts small blind $0.05
manashov: is sitting out 
chimera252: posts big blind $0.10
*** HOLE CARDS ***
popypaleta: folds 
manashov leaves the table
fabadam: folds 
boxer821: folds 
Uncalled bet ($0.05) returned to chimera252
chimera252 collected $0.10 from pot
*** SUMMARY ***
Total pot $0.10 | Rake $0 
Seat 1: boxer821 (small blind) folded before Flop
Seat 4: chimera252 (big blind) collected ($0.10)
Seat 5: popypaleta folded before Flop (didn't bet)
Seat 6: fabadam (button) folded before Flop (didn't bet)



PokerStars Hand #166667929272:  Hold'em No Limit ($0.05/$0.10 USD) - 2017/02/23 16:10:06 ET
Table 'Nauheima II' 6-max Seat #5 is the button
Seat 1: HARDCORE66RU ($18.04 in chips) 
Seat 2: Peter0087 ($10.27 in chips) 
Seat 3: KokoulinV ($13.45 in chips) 
Seat 5: bambolejro ($10 in chips) 
Seat 6: bonyo71 ($5.09 in chips) 
bonyo71: posts small blind $0.05
HARDCORE66RU: posts big blind $0.10
martijn091: sits out 
*** HOLE CARDS ***
Peter0087: folds 
KokoulinV: raises $0.15 to $0.25
bambolejro: folds 
bonyo71: folds 
HARDCORE66RU: folds 
Uncalled bet ($0.15) returned to KokoulinV
KokoulinV collected $0.25 from pot
*** SUMMARY ***
Total pot $0.25 | Rake $0 
Seat 1: HARDCORE66RU (big blind) folded before Flop
Seat 2: Peter0087 folded before Flop (didn't bet)
Seat 3: KokoulinV collected ($0.25)
Seat 5: bambolejro (button) folded before Flop (didn't bet)
Seat 6: bonyo71 (small blind) folded before Flop



PokerStars Hand #166667929525:  Hold'em No Limit ($0.05/$0.10 USD) - 2017/02/23 16:10:07 ET
Table 'Crommelin II' 6-max Seat #4 is the button
Seat 1: THIMUCHIN ($10 in chips) 
Seat 2: Bird et al ($10 in chips) 
Seat 3: Strelok1974 ($22.88 in chips) 
Seat 4: Pequeño Clau ($12.82 in chips) 
Seat 5: Action_Gibi ($19.20 in chips) 
Action_Gibi: posts small blind $0.05
THIMUCHIN: posts big blind $0.10
*** HOLE CARDS ***
Bird et al: folds 
Strelok1974: folds 
Pequeño Clau: folds 
Action_Gibi: calls $0.05
THIMUCHIN: raises $0.30 to $0.40
Action_Gibi: calls $0.30
*** FLOP *** [9c Tc 8h]
Action_Gibi: checks 
THIMUCHIN: checks 
*** TURN *** [9c Tc 8h] [Js]
Action_Gibi: bets $0.76
THIMUCHIN: calls $0.76
*** RIVER *** [9c Tc 8h Js] [4s]
Action_Gibi: checks 
THIMUCHIN: checks 
*** SHOW DOWN ***
Action_Gibi: shows [7s Ts] (a straight, Seven to Jack)
THIMUCHIN: shows [7h 7d] (a straight, Seven to Jack)
Action_Gibi collected $1.11 from pot
THIMUCHIN collected $1.11 from pot
*** SUMMARY ***
Total pot $2.32 | Rake $0.10 
Board [9c Tc 8h Js 4s]
Seat 1: THIMUCHIN (big blind) showed [7h 7d] and won ($1.11) with a straight, Seven to Jack
Seat 2: Bird et al folded before Flop (didn't bet)
Seat 3: Strelok1974 folded before Flop (didn't bet)
Seat 4: Pequeño Clau (button) folded before Flop (didn't bet)
Seat 5: Action_Gibi (small blind) showed [7s Ts] and won ($1.11) with a straight, Seven to Jack



PokerStars Hand #166667929558:  Hold'em No Limit ($0.05/$0.10 USD) - 2017/02/23 16:10:07 ET
Table 'Eudora' 6-max Seat #4 is the button
Seat 1: archer2511 ($12.40 in chips) 
Seat 2: popypaleta ($10 in chips) 
Seat 3: Ice_Isayev ($10.45 in chips) 
Seat 4: yodzik ($5 in chips) 
Seat 5: chimera252 ($11.16 in chips) 
Seat 6: HARDCORE66RU ($10 in chips) 
chimera252: posts small blind $0.05
HARDCORE66RU: posts big blind $0.10
*** HOLE CARDS ***
archer2511: folds 
popypaleta: folds 
Ice_Isayev: folds 
yodzik: folds 
chimera252: folds 
Uncalled bet ($0.05) returned to HARDCORE66RU
HARDCORE66RU collected $0.10 from pot
*** SUMMARY ***
Total pot $0.10 | Rake $0 
Seat 1: archer2511 folded before Flop (didn't bet)
Seat 2: popypaleta folded before Flop (didn't bet)
Seat 3: Ice_Isayev folded before Flop (didn't bet)
Seat 4: yodzik (button) folded before Flop (didn't bet)
Seat 5: chimera252 (small blind) folded before Flop
Seat 6: HARDCORE66RU (big blind) collected ($0.10)



PokerStars Hand #166667929599:  Hold'em No Limit ($0.05/$0.10 USD) - 2017/02/23 16:10:07 ET
Table 'Peiroos' 6-max Seat #2 is the button
Seat 1: ksandr_hom ($10 in chips) 
Seat 2: Nr847 ($10.80 in chips) 
Seat 3: atlx0711 ($25.19 in chips) 
Seat 4: Peter0087 ($4.20 in chips) 
Seat 5: sergio-cb164 ($8 in chips) 
Seat 6: DevonMiles88 ($11.91 in chips) 
atlx0711: posts small blind $0.05
Peter0087: posts big blind $0.10
*** HOLE CARDS ***
sergio-cb164: folds 
DevonMiles88: calls $0.10
ksandr_hom: folds 
Nr847: folds 
atlx0711: calls $0.05
Peter0087: checks 
*** FLOP *** [Kc 7s Kh]
atlx0711: checks 
Peter0087: bets $0.20
DevonMiles88: calls $0.20
atlx0711: folds 
*** TURN *** [Kc 7s Kh] [Js]
Peter0087: bets $0.40
DevonMiles88: folds 
Uncalled bet ($0.40) returned to Peter0087
Peter0087 collected $0.67 from pot
*** SUMMARY ***
Total pot $0.70 | Rake $0.03 
Board [Kc 7s Kh Js]
Seat 1: ksandr_hom folded before Flop (didn't bet)
Seat 2: Nr847 (button) folded before Flop (didn't bet)
Seat 3: atlx0711 (small blind) folded on the Flop
Seat 4: Peter0087 (big blind) collected ($0.67)
Seat 5: sergio-cb164 folded before Flop (didn't bet)
Seat 6: DevonMiles88 folded on the Turn



PokerStars Hand #166667929602:  Hold'em No Limit ($0.05/$0.10 USD) - 2017/02/23 16:10:07 ET
Table 'Orthos III' 6-max Seat #4 is the button
Seat 1: sexy_seagull ($11.12 in chips) 
Seat 2: Xander188 ($19.31 in chips) 
Seat 3: koka4cs ($5.30 in chips) 
Seat 4: FlopsterGB ($17.06 in chips) 
Seat 5: Bird et al ($18.21 in chips) 
Seat 6: RoJ1 ($10.64 in chips) 
Bird et al: posts small blind $0.05
RoJ1: posts big blind $0.10
*** HOLE CARDS ***
sexy_seagull: folds 
Xander188: folds 
koka4cs: calls $0.10
FlopsterGB: raises $0.30 to $0.40
Bird et al: folds 
RoJ1: calls $0.30
koka4cs: calls $0.30
*** FLOP *** [Ts 5c 6c]
RoJ1: checks 
koka4cs: checks 
FlopsterGB: bets $0.57
RoJ1: folds 
koka4cs: folds 
Uncalled bet ($0.57) returned to FlopsterGB
FlopsterGB collected $1.19 from pot
*** SUMMARY ***
Total pot $1.25 | Rake $0.06 
Board [Ts 5c 6c]
Seat 1: sexy_seagull folded before Flop (didn't bet)
Seat 2: Xander188 folded before Flop (didn't bet)
Seat 3: koka4cs folded on the Flop
Seat 4: FlopsterGB (button) collected ($1.19)
Seat 5: Bird et al (small blind) folded before Flop
Seat 6: RoJ1 (big blind) folded on the Flop



PokerStars Hand #166667929648:  Hold'em No Limit ($0.05/$0.10 USD) - 2017/02/23 16:10:07 ET
Table 'Pirola' 6-max Seat #6 is the button
Seat 1: Rodik002 ($10.56 in chips) 
Seat 2: lmlmlmlm90 ($17.49 in chips) 
Seat 4: barons89 ($11.61 in chips) 
Seat 5: Iarlei ($14.06 in chips) 
Seat 6: Hyd SK ($13.19 in chips) 
Rodik002: posts small blind $0.05
lmlmlmlm90: posts big blind $0.10
Goroshkos88: sits out 
*** HOLE CARDS ***
barons89: folds 
Iarlei: raises $0.20 to $0.30
Hyd SK: folds 
Rodik002: folds 
lmlmlmlm90: calls $0.20
*** FLOP *** [5s Ts Js]
lmlmlmlm90: bets $0.30
Iarlei: folds 
Uncalled bet ($0.30) returned to lmlmlmlm90
lmlmlmlm90 collected $0.62 from pot
*** SUMMARY ***
Total pot $0.65 | Rake $0.03 
Board [5s Ts Js]
Seat 1: Rodik002 (small blind) folded before Flop
Seat 2: lmlmlmlm90 (big blind) collected ($0.62)
Seat 4: barons89 folded before Flop (didn't bet)
Seat 5: Iarlei folded on the Flop
Seat 6: Hyd SK (button) folded before Flop (didn't bet)



PokerStars Hand #166667929731:  Hold'em No Limit ($0.05/$0.10 USD) - 2017/02/23 16:10:07 ET
Table 'Themisto II' 6-max Seat #1 is the button
Seat 1: ChuikaPridi ($10 in chips) 
Seat 2: CA225 ($11.86 in chips) 
Seat 3: eniksenik ($16.06 in chips) 
Seat 5: ex3Lero86 ($10.94 in chips) 
Seat 6: noobigrok ($2.57 in chips) 
CA225: posts small blind $0.05
eniksenik: posts big blind $0.10
DrVzad: sits out 
*** HOLE CARDS ***
ex3Lero86: folds 
noobigrok: calls $0.10
ChuikaPridi: raises $0.50 to $0.60
CA225: folds 
eniksenik: folds 
noobigrok: folds 
Uncalled bet ($0.50) returned to ChuikaPridi
ChuikaPridi collected $0.35 from pot
*** SUMMARY ***
Total pot $0.35 | Rake $0 
Seat 1: ChuikaPridi (button) collected ($0.35)
Seat 2: CA225 (small blind) folded before Flop
Seat 3: eniksenik (big blind) folded before Flop
Seat 5: ex3Lero86 folded before Flop (didn't bet)
Seat 6: noobigrok folded before Flop



PokerStars Hand #166667929732:  Hold'em No Limit ($0.05/$0.10 USD) - 2017/02/23 16:10:07 ET
Table 'Virginia II' 6-max Seat #1 is the button
Seat 1: Iarlei ($11.41 in chips) 
Seat 3: garigura ($15.73 in chips) 
Seat 4: onkelottoHH ($10.58 in chips) 
Seat 5: dr.goofy ($21.79 in chips) 
Seat 6: NvR.m1nD ($10.30 in chips) 
Yspenyanin is disconnected 
Yspenyanin has timed out while disconnected
Yspenyanin: is sitting out 
garigura: posts small blind $0.05
onkelottoHH: posts big blind $0.10
*** HOLE CARDS ***
dr.goofy: folds 
NvR.m1nD: folds 
Iarlei: folds 
garigura: folds 
Uncalled bet ($0.05) returned to onkelottoHH
onkelottoHH collected $0.10 from pot
*** SUMMARY ***
Total pot $0.10 | Rake $0 
Seat 1: Iarlei (button) folded before Flop (didn't bet)
Seat 3: garigura (small blind) folded before Flop
Seat 4: onkelottoHH (big blind) collected ($0.10)
Seat 5: dr.goofy folded before Flop (didn't bet)
Seat 6: NvR.m1nD folded before Flop (didn't bet)



PokerStars Hand #166667930130:  Hold'em No Limit ($0.05/$0.10 USD) - 2017/02/23 16:10:07 ET
Table 'Nikko II' 6-max Seat #3 is the button
Seat 1: bdixon_5 ($9.62 in chips) 
Seat 2: popypaleta ($10.15 in chips) 
Seat 3: Hyd SK ($11.66 in chips) 
Seat 4: Peter0087 ($9.91 in chips) 
Seat 5: Aescul@pius ($13.29 in chips) 
Seat 6: JahSoldier69 ($10 in chips) 
Peter0087: posts small blind $0.05
Aescul@pius: posts big blind $0.10
*** HOLE CARDS ***
JahSoldier69: raises $0.20 to $0.30
bdixon_5: folds 
popypaleta: folds 
Hyd SK: calls $0.30
Peter0087: calls $0.25
Aescul@pius: folds 
*** FLOP *** [2s 3s Td]
Peter0087: checks 
JahSoldier69: bets $0.58
Hyd SK: calls $0.58
Peter0087: folds 
*** TURN *** [2s 3s Td] [5d]
JahSoldier69: bets $1.55
Hyd SK: folds 
Uncalled bet ($1.55) returned to JahSoldier69
JahSoldier69 collected $2.06 from pot
*** SUMMARY ***
Total pot $2.16 | Rake $0.10 
Board [2s 3s Td 5d]
Seat 1: bdixon_5 folded before Flop (didn't bet)
Seat 2: popypaleta folded before Flop (didn't bet)
Seat 3: Hyd SK (button) folded on the Turn
Seat 4: Peter0087 (small blind) folded on the Flop
Seat 5: Aescul@pius (big blind) folded before Flop
Seat 6: JahSoldier69 collected ($2.06)



PokerStars Hand #166667930209:  Hold'em No Limit ($0.05/$0.10 USD) - 2017/02/23 16:10:08 ET
Table 'Marghanna II' 6-max Seat #5 is the button
Seat 1: Goroshkos88 ($10 in chips) 
Seat 2: Namhkal ($14.61 in chips) 
Seat 4: D3NyA ($12.29 in chips) 
Seat 5: ofl21189 ($3.42 in chips) 
Seat 6: VAD21 ($13.18 in chips) 
VAD21: posts small blind $0.05
Goroshkos88: posts big blind $0.10
Andrei ProFF: sits out 
*** HOLE CARDS ***
Namhkal: folds 
D3NyA: folds 
ofl21189: raises $3.32 to $3.42 and is all-in
VAD21: folds 
Goroshkos88: folds 
Uncalled bet ($3.32) returned to ofl21189
ofl21189 collected $0.25 from pot
*** SUMMARY ***
Total pot $0.25 | Rake $0 
Seat 1: Goroshkos88 (big blind) folded before Flop
Seat 2: Namhkal folded before Flop (didn't bet)
Seat 4: D3NyA folded before Flop (didn't bet)
Seat 5: ofl21189 (button) collected ($0.25)
Seat 6: VAD21 (small blind) folded before Flop



PokerStars Hand #166667930510:  Hold'em No Limit ($0.05/$0.10 USD) - 2017/02/23 16:10:08 ET
Table 'Phereclos II' 6-max Seat #5 is the button
Seat 1: Vladu1986 ($10 in chips) 
Seat 2: Kazacha ($15.63 in chips) 
Seat 5: crazydevill ($12.09 in chips) 
Seat 6: mhonielsen ($16.39 in chips) 
mhonielsen: posts small blind $0.05
Vladu1986: posts big blind $0.10
BJamesB2014 leaves the table
Lucky HoBBiT is disconnected 
Lucky HoBBiT has timed out while disconnected
Lucky HoBBiT: is sitting out 
*** HOLE CARDS ***
Kazacha: folds 
crazydevill: folds 
mhonielsen: raises $0.10 to $0.20
x3ultimate joins the table at seat #3 
x3ultimate leaves the table
Vladu1986: folds 
Uncalled bet ($0.10) returned to mhonielsen
overbet666 joins the table at seat #3 
mhonielsen collected $0.20 from pot
*** SUMMARY ***
Total pot $0.20 | Rake $0 
Seat 1: Vladu1986 (big blind) folded before Flop
Seat 2: Kazacha folded before Flop (didn't bet)
Seat 5: crazydevill (button) folded before Flop (didn't bet)
Seat 6: mhonielsen (small blind) collected ($0.20)



PokerStars Hand #166667930701:  Hold'em No Limit ($0.05/$0.10 USD) - 2017/02/23 16:10:08 ET
Table 'Persephone' 6-max Seat #1 is the button
Seat 1: dragonste89 ($14.45 in chips) 
Seat 2: AM-L-SL ($5.55 in chips) 
Seat 3: Mooneye19 ($10 in chips) 
Seat 4: 2G28 ($11.36 in chips) 
Seat 5: ab260414 ($10.56 in chips) 
Seat 6: popypaleta ($13.38 in chips) 
AM-L-SL: posts small blind $0.05
Mooneye19: posts big blind $0.10
*** HOLE CARDS ***
2G28: folds 
ab260414: folds 
popypaleta: raises $0.20 to $0.30
dragonste89: folds 
AM-L-SL: folds 
Mooneye19: calls $0.20
*** FLOP *** [2h 6s 5s]
Mooneye19: checks 
popypaleta: checks 
*** TURN *** [2h 6s 5s] [9s]
Mooneye19: bets $0.30
popypaleta: calls $0.30
*** RIVER *** [2h 6s 5s 9s] [5h]
Mooneye19: bets $0.60
popypaleta: folds 
Uncalled bet ($0.60) returned to Mooneye19
Mooneye19 collected $1.19 from pot
*** SUMMARY ***
Total pot $1.25 | Rake $0.06 
Board [2h 6s 5s 9s 5h]
Seat 1: dragonste89 (button) folded before Flop (didn't bet)
Seat 2: AM-L-SL (small blind) folded before Flop
Seat 3: Mooneye19 (big blind) collected ($1.19)
Seat 4: 2G28 folded before Flop (didn't bet)
Seat 5: ab260414 folded before Flop (didn't bet)
Seat 6: popypaleta folded on the River



PokerStars Hand #166667930793:  Hold'em No Limit ($0.05/$0.10 USD) - 2017/02/23 16:10:08 ET
Table 'Pyrrhus III' 6-max Seat #5 is the button
Seat 2: univibe68 ($26.57 in chips) 
Seat 3: coolisses111 ($9.87 in chips) 
Seat 4: ex3Lero86 ($14.94 in chips) 
Seat 5: eniksenik ($10 in chips) 
Seat 6: MLPlayer16 ($21.24 in chips) 
MLPlayer16: posts small blind $0.05
univibe68: posts big blind $0.10
univibe68: posts the ante $0.02
coolisses111: posts the ante $0.02
ex3Lero86: posts the ante $0.02
eniksenik: posts the ante $0.02
MLPlayer16: posts the ante $0.02
*** HOLE CARDS ***
coolisses111: folds 
ex3Lero86: raises $0.17 to $0.27
eniksenik: folds 
MLPlayer16: raises $0.63 to $0.90
univibe68: folds 
ex3Lero86: calls $0.63
*** FLOP *** [Kc 7c 3c]
MLPlayer16: bets $0.70
ex3Lero86: folds 
Uncalled bet ($0.70) returned to MLPlayer16
MLPlayer16 collected $1.91 from pot
*** SUMMARY ***
Total pot $2 | Rake $0.09 
Board [Kc 7c 3c]
Seat 2: univibe68 (big blind) folded before Flop
Seat 3: coolisses111 folded before Flop (didn't bet)
Seat 4: ex3Lero86 folded on the Flop
Seat 5: eniksenik (button) folded before Flop (didn't bet)
Seat 6: MLPlayer16 (small blind) collected ($1.91)



PokerStars Hand #166667930946:  Hold'em No Limit ($0.05/$0.10 USD) - 2017/02/23 16:10:08 ET
Table 'Hercynia III' 6-max Seat #5 is the button
Seat 1: Bird et al ($15.08 in chips) 
Seat 2: Action_Gibi ($7.13 in chips) 
Seat 3: Dcaro31 ($20.02 in chips) 
Seat 5: THIMUCHIN ($15.30 in chips) 
Seat 6: bdixon_5 ($11.19 in chips) 
bdixon_5: posts small blind $0.05
Bird et al: posts big blind $0.10
*** HOLE CARDS ***
Action_Gibi: raises $0.20 to $0.30
Dcaro31: folds 
THIMUCHIN: folds 
bdixon_5: calls $0.25
Bird et al: folds 
*** FLOP *** [Jh 2d 9s]
bdixon_5: checks 
Action_Gibi: checks 
*** TURN *** [Jh 2d 9s] [As]
bdixon_5: bets $0.30
Action_Gibi: calls $0.30
*** RIVER *** [Jh 2d 9s As] [6d]
bdixon_5: bets $1.80
Action_Gibi: calls $1.80
*** SHOW DOWN ***
bdixon_5: shows [Jc Jd] (three of a kind, Jacks)
Action_Gibi: mucks hand 
bdixon_5 collected $4.68 from pot
*** SUMMARY ***
Total pot $4.90 | Rake $0.22 
Board [Jh 2d 9s As 6d]
Seat 1: Bird et al (big blind) folded before Flop
Seat 2: Action_Gibi mucked
Seat 3: Dcaro31 folded before Flop (didn't bet)
Seat 5: THIMUCHIN (button) folded before Flop (didn't bet)
Seat 6: bdixon_5 (small blind) showed [Jc Jd] and won ($4.68) with three of a kind, Jacks



PokerStars Hand #166667931121:  Hold'em No Limit ($0.05/$0.10 USD) - 2017/02/23 16:10:08 ET
Table 'Anhui II' 6-max Seat #5 is the button
Seat 1: kingartur222 ($17.74 in chips) 
Seat 2: kikus334 ($12.16 in chips) 
Seat 3: lochniak556 ($20.35 in chips) 
Seat 4: dragonste89 ($10 in chips) 
Seat 5: Bandyaev ($12.70 in chips) 
Seat 6: .BaRReL.1122 ($3.80 in chips) 
.BaRReL.1122: posts small blind $0.05
kingartur222: posts big blind $0.10
*** HOLE CARDS ***
kikus334: calls $0.10
lochniak556: raises $0.20 to $0.30
dragonste89: folds 
Bandyaev: folds 
.BaRReL.1122: folds 
kingartur222: folds 
lochniak556 said, "pawnie tak"
kikus334: calls $0.20
*** FLOP *** [Jc 6d Ad]
kikus334: checks 
lochniak556: checks 
*** TURN *** [Jc 6d Ad] [8s]
kikus334: checks 
lochniak556: checks 
*** RIVER *** [Jc 6d Ad 8s] [7c]
kikus334: bets $0.50
lochniak556: raises $1.72 to $2.22
kikus334: folds 
Uncalled bet ($1.72) returned to lochniak556
lochniak556 collected $1.67 from pot
*** SUMMARY ***
Total pot $1.75 | Rake $0.08 
Board [Jc 6d Ad 8s 7c]
Seat 1: kingartur222 (big blind) folded before Flop
Seat 2: kikus334 folded on the River
Seat 3: lochniak556 collected ($1.67)
Seat 4: dragonste89 folded before Flop (didn't bet)
Seat 5: Bandyaev (button) folded before Flop (didn't bet)
Seat 6: .BaRReL.1122 (small blind) folded before Flop



PokerStars Hand #166667931729:  Hold'em No Limit ($0.05/$0.10 USD) - 2017/02/23 16:10:09 ET
Table 'Laetitia II' 6-max Seat #4 is the button
Seat 1: Cluckh ($10.83 in chips) 
Seat 2: manashov ($11.17 in chips) 
Seat 3: 6ePeMeHHa9 ($10 in chips) 
Seat 4: Feverhead ($16.75 in chips) 
Seat 5: D3NyA ($16.76 in chips) 
Seat 6: Dima91360 ($5.10 in chips) 
D3NyA: posts small blind $0.05
Dima91360: posts big blind $0.10
*** HOLE CARDS ***
6ePeMeHHa9 is disconnected 
Cluckh: folds 
manashov: folds 
6ePeMeHHa9: folds 
Feverhead: raises $0.10 to $0.20
D3NyA: folds 
Dima91360: calls $0.10
*** FLOP *** [Td 8s 9d]
Dima91360: bets $0.10
Feverhead: raises $0.40 to $0.50
Dima91360: calls $0.40
*** TURN *** [Td 8s 9d] [5d]
Dima91360: checks 
Feverhead: checks 
*** RIVER *** [Td 8s 9d 5d] [As]
Dima91360: checks 
Feverhead: checks 
*** SHOW DOWN ***
Dima91360: shows [8h 7d] (a pair of Eights)
Feverhead: shows [Th Qc] (a pair of Tens)
Feverhead collected $1.38 from pot
*** SUMMARY ***
Total pot $1.45 | Rake $0.07 
Board [Td 8s 9d 5d As]
Seat 1: Cluckh folded before Flop (didn't bet)
Seat 2: manashov folded before Flop (didn't bet)
Seat 3: 6ePeMeHHa9 folded before Flop (didn't bet)
Seat 4: Feverhead (button) showed [Th Qc] and won ($1.38) with a pair of Tens
Seat 5: D3NyA (small blind) folded before Flop
Seat 6: Dima91360 (big blind) showed [8h 7d] and lost with a pair of Eights



PokerStars Hand #166667931995:  Hold'em No Limit ($0.05/$0.10 USD) - 2017/02/23 16:10:09 ET
Table 'Aludra II' 6-max Seat #1 is the button
Seat 1: voledy ($10 in chips) 
Seat 2: JahSoldier69 ($13.98 in chips) 
Seat 3: mbkongstad ($9.85 in chips) 
Seat 4: MihaGr ($10 in chips) 
Seat 5: kingartur222 ($16.17 in chips) 
Seat 6: call me haaa ($14.84 in chips) 
JahSoldier69: posts small blind $0.05
mbkongstad: posts big blind $0.10
*** HOLE CARDS ***
MihaGr: folds 
kingartur222: folds 
call me haaa: folds 
voledy: raises $0.15 to $0.25
JahSoldier69: folds 
mbkongstad: folds 
Uncalled bet ($0.15) returned to voledy
voledy collected $0.25 from pot
*** SUMMARY ***
Total pot $0.25 | Rake $0 
Seat 1: voledy (button) collected ($0.25)
Seat 2: JahSoldier69 (small blind) folded before Flop
Seat 3: mbkongstad (big blind) folded before Flop
Seat 4: MihaGr folded before Flop (didn't bet)
Seat 5: kingartur222 folded before Flop (didn't bet)
Seat 6: call me haaa folded before Flop (didn't bet)



PokerStars Hand #166667932351:  Hold'em No Limit ($0.05/$0.10 USD) - 2017/02/23 16:10:10 ET
Table 'Syringa II' 6-max Seat #6 is the button
Seat 1: GiveTwoMe ($15.07 in chips) 
Seat 2: Cluckh ($10 in chips) 
Seat 3: gaHy_HaXeP ($10.28 in chips) 
Seat 4: MBen10 ($13.93 in chips) 
Seat 5: Mishapok196 ($6.61 in chips) 
Seat 6: WinninBikini ($10 in chips) 
GiveTwoMe: posts small blind $0.05
Cluckh: posts big blind $0.10
*** HOLE CARDS ***
gaHy_HaXeP: folds 
MBen10: folds 
Mishapok196: calls $0.10
WinninBikini: raises $0.30 to $0.40
GiveTwoMe: folds 
Cluckh: folds 
Mishapok196: calls $0.30
*** FLOP *** [8s 3c 5h]
Mishapok196: checks 
WinninBikini: bets $0.51
Mishapok196: calls $0.51
*** TURN *** [8s 3c 5h] [7h]
Mishapok196: checks 
WinninBikini: bets $1.25
Mishapok196: folds 
Uncalled bet ($1.25) returned to WinninBikini
WinninBikini collected $1.88 from pot
*** SUMMARY ***
Total pot $1.97 | Rake $0.09 
Board [8s 3c 5h 7h]
Seat 1: GiveTwoMe (small blind) folded before Flop
Seat 2: Cluckh (big blind) folded before Flop
Seat 3: gaHy_HaXeP folded before Flop (didn't bet)
Seat 4: MBen10 folded before Flop (didn't bet)
Seat 5: Mishapok196 folded on the Turn
Seat 6: WinninBikini (button) collected ($1.88)



PokerStars Hand #166667932408:  Hold'em No Limit ($0.05/$0.10 USD) - 2017/02/23 16:10:10 ET
Table 'Tyche III' 6-max Seat #6 is the button
Seat 1: milt65 ($9.95 in chips) 
Seat 2: arti192837 ($12.53 in chips) 
Seat 3: ChuikaPridi ($10 in chips) 
Seat 4: Kazacha ($10.63 in chips) 
Seat 5: chimera252 ($14.36 in chips) 
Seat 6: Ice_Isayev ($10 in chips) 
milt65: posts small blind $0.05
arti192837: posts big blind $0.10
*** HOLE CARDS ***
ChuikaPridi: folds 
ChuikaPridi leaves the table
Kazacha: folds 
chimera252: folds 
FRAID358 joins the table at seat #3 
Ice_Isayev: folds 
milt65: raises $0.15 to $0.25
arti192837: folds 
Uncalled bet ($0.15) returned to milt65
milt65 collected $0.20 from pot
*** SUMMARY ***
Total pot $0.20 | Rake $0 
Seat 1: milt65 (small blind) collected ($0.20)
Seat 2: arti192837 (big blind) folded before Flop
Seat 3: ChuikaPridi folded before Flop (didn't bet)
Seat 4: Kazacha folded before Flop (didn't bet)
Seat 5: chimera252 folded before Flop (didn't bet)
Seat 6: Ice_Isayev (button) folded before Flop (didn't bet)



PokerStars Hand #166667932443:  Hold'em No Limit ($0.05/$0.10 USD) - 2017/02/23 16:10:10 ET
Table 'Aegle' 6-max Seat #6 is the button
Seat 1: phatts76 ($3.50 in chips) 
Seat 2: yodzik ($5.42 in chips) 
Seat 3: DrejAtom ($9.74 in chips) 
Seat 4: ab260414 ($12.92 in chips) 
Seat 5: KokoulinV ($11.34 in chips) 
Seat 6: CHRO8 ($20.41 in chips) 
phatts76: posts small blind $0.05
yodzik: posts big blind $0.10
*** HOLE CARDS ***
DrejAtom: folds 
ab260414: folds 
DrejAtom leaves the table
KokoulinV: raises $0.15 to $0.25
KRZuff joins the table at seat #3 
CHRO8: folds 
KRZuff leaves the table
phatts76: folds 
yodzik: folds 
Uncalled bet ($0.15) returned to KokoulinV
KokoulinV collected $0.25 from pot
*** SUMMARY ***
Total pot $0.25 | Rake $0 
Seat 1: phatts76 (small blind) folded before Flop
Seat 2: yodzik (big blind) folded before Flop
Seat 3: DrejAtom folded before Flop (didn't bet)
Seat 4: ab260414 folded before Flop (didn't bet)
Seat 5: KokoulinV collected ($0.25)
Seat 6: CHRO8 (button) folded before Flop (didn't bet)



PokerStars Hand #166667932448:  Hold'em No Limit ($0.05/$0.10 USD) - 2017/02/23 16:10:10 ET
Table 'Kraz II' 6-max Seat #2 is the button
Seat 1: bdixon_5 ($9.10 in chips) 
Seat 2: shellyld ($9.85 in chips) 
Seat 3: Eddys Edge ($10 in chips) 
Seat 4: DrVzad ($10 in chips) 
Seat 5: Joker51_wtf! ($10 in chips) 
Seat 6: tr41n3r12 ($11.58 in chips) 
Eddys Edge: posts small blind $0.05
DrVzad: posts big blind $0.10
*** HOLE CARDS ***
Joker51_wtf!: folds 
tr41n3r12: folds 
bdixon_5: folds 
shellyld: raises $0.20 to $0.30
Eddys Edge: folds 
DrVzad: folds 
Uncalled bet ($0.20) returned to shellyld
shellyld collected $0.25 from pot
*** SUMMARY ***
Total pot $0.25 | Rake $0 
Seat 1: bdixon_5 folded before Flop (didn't bet)
Seat 2: shellyld (button) collected ($0.25)
Seat 3: Eddys Edge (small blind) folded before Flop
Seat 4: DrVzad (big blind) folded before Flop
Seat 5: Joker51_wtf! folded before Flop (didn't bet)
Seat 6: tr41n3r12 folded before Flop (didn't bet)



PokerStars Hand #166667932567:  Hold'em No Limit ($0.05/$0.10 USD) - 2017/02/23 16:10:10 ET
Table 'Syringa' 6-max Seat #5 is the button
Seat 1: bdixon_5 ($9.16 in chips) 
Seat 2: Goroshkos88 ($11.08 in chips) 
Seat 3: Yspenyanin ($13.37 in chips) 
Seat 5: Andrei ProFF ($15.36 in chips) 
Seat 6: ibara000 ($14.10 in chips) 
ibara000: posts small blind $0.05
bdixon_5: posts big blind $0.10
voledy: sits out 
*** HOLE CARDS ***
Goroshkos88: folds 
Yspenyanin is disconnected 
Yspenyanin has timed out while disconnected
Yspenyanin: folds 
Andrei ProFF: raises $0.20 to $0.30
ibara000: folds 
bdixon_5: calls $0.20
*** FLOP *** [9h 9d Td]
bdixon_5: bets $0.31
Andrei ProFF: folds 
Uncalled bet ($0.31) returned to bdixon_5
bdixon_5 collected $0.62 from pot
*** SUMMARY ***
Total pot $0.65 | Rake $0.03 
Board [9h 9d Td]
Seat 1: bdixon_5 (big blind) collected ($0.62)
Seat 2: Goroshkos88 folded before Flop (didn't bet)
Seat 3: Yspenyanin folded before Flop (didn't bet)
Seat 5: Andrei ProFF (button) folded on the Flop
Seat 6: ibara000 (small blind) folded before Flop



PokerStars Hand #166667932708:  Hold'em No Limit ($0.05/$0.10 USD) - 2017/02/23 16:10:10 ET
Table 'Veniakaverin' 6-max Seat #3 is the button
Seat 1: pivanki11 ($13.48 in chips) 
Seat 3: Hyd SK ($28.23 in chips) 
Seat 5: Tox1cel ($7.43 in chips) 
Seat 6: bdixon_5 ($9.30 in chips) 
FRAID358 will be allowed to play after the button
Tox1cel: posts small blind $0.05
bdixon_5: posts big blind $0.10
*** HOLE CARDS ***
pivanki11: calls $0.10
Hyd SK: folds 
david_sara83 leaves the table
Tox1cel: raises $0.10 to $0.20
RoJ1 joins the table at seat #2 
bdixon_5: folds 
pivanki11: calls $0.10
*** FLOP *** [Ts 6s 5d]
Tox1cel: checks 
pivanki11: checks 
*** TURN *** [Ts 6s 5d] [7h]
Tox1cel: checks 
pivanki11: checks 
*** RIVER *** [Ts 6s 5d 7h] [5s]
Tox1cel: checks 
pivanki11: checks 
*** SHOW DOWN ***
Tox1cel: shows [9s 2h] (a pair of Fives)
pivanki11: shows [Qs Kd] (a pair of Fives - King kicker)
pivanki11 collected $0.48 from pot
*** SUMMARY ***
Total pot $0.50 | Rake $0.02 
Board [Ts 6s 5d 7h 5s]
Seat 1: pivanki11 showed [Qs Kd] and won ($0.48) with a pair of Fives
Seat 3: Hyd SK (button) folded before Flop (didn't bet)
Seat 5: Tox1cel (small blind) showed [9s 2h] and lost with a pair of Fives
Seat 6: bdixon_5 (big blind) folded before Flop



PokerStars Hand #166667932952:  Hold'em No Limit ($0.05/$0.10 USD) - 2017/02/23 16:10:11 ET
Table 'Wesselink II' 6-max Seat #6 is the button
Seat 2: KRZuff ($10 in chips) 
Seat 3: Wargolandros ($8.62 in chips) 
Seat 4: BahiaMinhaP ($10 in chips) 
Seat 6: bambolejro ($17.92 in chips) 
KRZuff: posts small blind $0.05
Wargolandros: posts big blind $0.10
xdjango07x: sits out 
*** HOLE CARDS ***
BahiaMinhaP: folds 
bambolejro: folds 
vladcol leaves the table
KRZuff: raises $0.20 to $0.30
6ePeMeHHa9 joins the table at seat #1 
Wargolandros: calls $0.20
*** FLOP *** [Kd 7c 6s]
6ePeMeHHa9 leaves the table
KRZuff: bets $0.40
RoJ1 joins the table at seat #1 
Wargolandros: folds 
Uncalled bet ($0.40) returned to KRZuff
KRZuff collected $0.57 from pot
*** SUMMARY ***
Total pot $0.60 | Rake $0.03 
Board [Kd 7c 6s]
Seat 2: KRZuff (small blind) collected ($0.57)
Seat 3: Wargolandros (big blind) folded on the Flop
Seat 4: BahiaMinhaP folded before Flop (didn't bet)
Seat 6: bambolejro (button) folded before Flop (didn't bet)



PokerStars Hand #166667932983:  Hold'em No Limit ($0.05/$0.10 USD) - 2017/02/23 16:10:11 ET
Table 'Senta II' 6-max Seat #5 is the button
Seat 1: Goovr ($10 in chips) 
Seat 2: NvR.m1nD ($13.75 in chips) 
Seat 3: Aescul@pius ($21.88 in chips) 
Seat 4: fedorka rus ($19.18 in chips) 
Seat 5: Algarah ($5.23 in chips) 
Seat 6: T9MS ($11.22 in chips) 
T9MS: posts small blind $0.05
Goovr: posts big blind $0.10
*** HOLE CARDS ***
NvR.m1nD: folds 
Aescul@pius: folds 
fedorka rus: folds 
Algarah: raises $0.15 to $0.25
T9MS: folds 
Goovr: folds 
Uncalled bet ($0.15) returned to Algarah
Algarah collected $0.25 from pot
*** SUMMARY ***
Total pot $0.25 | Rake $0 
Seat 1: Goovr (big blind) folded before Flop
Seat 2: NvR.m1nD folded before Flop (didn't bet)
Seat 3: Aescul@pius folded before Flop (didn't bet)
Seat 4: fedorka rus folded before Flop (didn't bet)
Seat 5: Algarah (button) collected ($0.25)
Seat 6: T9MS (small blind) folded before Flop



PokerStars Hand #166667933104:  Hold'em No Limit ($0.05/$0.10 USD) - 2017/02/23 16:10:11 ET
Table 'Sheragul III' 6-max Seat #3 is the button
Seat 2: Bird et al ($10.36 in chips) 
Seat 3: FRAID358 ($10 in chips) 
Seat 5: RGhearted ($10.05 in chips) 
Seat 6: XaXaTyH4uK ($10 in chips) 
RGhearted: posts small blind $0.05
XaXaTyH4uK: posts big blind $0.10
Cluckh: sits out 
*** HOLE CARDS ***
Bird et al: folds 
Cluckh leaves the table
FRAID358: raises $0.15 to $0.25
RGhearted: folds 
XaXaTyH4uK: raises $0.80 to $1.05
FRAID358: folds 
Uncalled bet ($0.80) returned to XaXaTyH4uK
XaXaTyH4uK collected $0.55 from pot
*** SUMMARY ***
Total pot $0.55 | Rake $0 
Seat 2: Bird et al folded before Flop (didn't bet)
Seat 3: FRAID358 (button) folded before Flop
Seat 5: RGhearted (small blind) folded before Flop
Seat 6: XaXaTyH4uK (big blind) collected ($0.55)



PokerStars Hand #166667933557:  Hold'em No Limit ($0.05/$0.10 USD) - 2017/02/23 16:10:11 ET
Table 'Risha II' 6-max Seat #6 is the button
Seat 1: marianoboni ($10.05 in chips) 
Seat 3: steepfell ($10.15 in chips) 
Seat 4: Comeback3392 ($19.53 in chips) 
Seat 5: m.c-alkatraz ($9.90 in chips) 
Seat 6: univibe68 ($11.01 in chips) 
marianoboni: posts small blind $0.05
KA3AXCTAHEU,: is sitting out 
steepfell: posts big blind $0.10
*** HOLE CARDS ***
KA3AXCTAHEU, leaves the table
Comeback3392: folds 
m.c-alkatraz: folds 
univibe68: raises $0.10 to $0.20
marianoboni: folds 
steepfell: folds 
Uncalled bet ($0.10) returned to univibe68
univibe68 collected $0.25 from pot
*** SUMMARY ***
Total pot $0.25 | Rake $0 
Seat 1: marianoboni (small blind) folded before Flop
Seat 3: steepfell (big blind) folded before Flop
Seat 4: Comeback3392 folded before Flop (didn't bet)
Seat 5: m.c-alkatraz folded before Flop (didn't bet)
Seat 6: univibe68 (button) collected ($0.25)



PokerStars Hand #166667933579:  Hold'em No Limit ($0.05/$0.10 USD) - 2017/02/23 16:10:11 ET
Table 'Lagrula' 6-max Seat #5 is the button
Seat 1: Ice_Isayev ($10 in chips) 
Seat 2: KRZuff ($10.15 in chips) 
Seat 3: micke667 ($15.90 in chips) 
Seat 4: Calimero2408 ($12.68 in chips) 
Seat 5: Iarlei ($10.14 in chips) 
Seat 6: Spud014 ($10 in chips) 
Spud014: posts small blind $0.05
Ice_Isayev: posts big blind $0.10
*** HOLE CARDS ***
KRZuff: folds 
micke667: calls $0.10
Calimero2408: calls $0.10
Iarlei: calls $0.10
Spud014: folds 
Ice_Isayev: checks 
*** FLOP *** [9d 2c Kc]
Ice_Isayev: checks 
micke667: checks 
Calimero2408: checks 
Iarlei: checks 
*** TURN *** [9d 2c Kc] [8d]
Ice_Isayev: checks 
micke667: bets $0.20
Calimero2408: calls $0.20
Iarlei: calls $0.20
Ice_Isayev: folds 
*** RIVER *** [9d 2c Kc 8d] [4c]
micke667: bets $0.50
Calimero2408: folds 
Iarlei: raises $0.85 to $1.35
micke667: calls $0.85
*** SHOW DOWN ***
Iarlei: shows [3c 5c] (a flush, King high)
micke667: mucks hand 
Iarlei collected $3.58 from pot
*** SUMMARY ***
Total pot $3.75 | Rake $0.17 
Board [9d 2c Kc 8d 4c]
Seat 1: Ice_Isayev (big blind) folded on the Turn
Seat 2: KRZuff folded before Flop (didn't bet)
Seat 3: micke667 mucked
Seat 4: Calimero2408 folded on the River
Seat 5: Iarlei (button) showed [3c 5c] and won ($3.58) with a flush, King high
Seat 6: Spud014 (small blind) folded before Flop



PokerStars Hand #166667933734:  Hold'em No Limit ($0.05/$0.10 USD) - 2017/02/23 16:10:11 ET
Table 'Pallas II' 6-max Seat #3 is the button
Seat 1: mdelfin0 ($16.74 in chips) 
Seat 3: popypaleta ($10.05 in chips) 
Seat 4: MisterX413 ($10 in chips) 
Seat 6: Smitty03300 ($10 in chips) 
manashov joins the table at seat #2 
MisterX413: posts small blind $0.05
gaHy_HaXeP: is sitting out 
Smitty03300: posts big blind $0.10
*** HOLE CARDS ***
mdelfin0: raises $0.15 to $0.25
gaHy_HaXeP leaves the table
popypaleta: raises $0.65 to $0.90
MisterX413: folds 
manashov leaves the table
Smitty03300: folds 
mdelfin0: folds 
Uncalled bet ($0.65) returned to popypaleta
popypaleta collected $0.65 from pot
*** SUMMARY ***
Total pot $0.65 | Rake $0 
Seat 1: mdelfin0 folded before Flop
Seat 3: popypaleta (button) collected ($0.65)
Seat 4: MisterX413 (small blind) folded before Flop
Seat 6: Smitty03300 (big blind) folded before Flop



PokerStars Hand #166667933950:  Hold'em No Limit ($0.05/$0.10 USD) - 2017/02/23 16:10:12 ET
Table 'Ophelia' 6-max Seat #4 is the button
Seat 1: ralfi37 ($11.14 in chips) 
Seat 2: popypaleta ($16.48 in chips) 
Seat 3: mvp0013 ($10.80 in chips) 
Seat 4: Cluckh ($11.99 in chips) 
Seat 5: truck1234 ($13.26 in chips) 
Seat 6: Yabidooo ($11.13 in chips) 
truck1234: posts small blind $0.05
Yabidooo: posts big blind $0.10
*** HOLE CARDS ***
ralfi37: folds 
popypaleta: raises $0.20 to $0.30
mvp0013: folds 
Cluckh: folds 
truck1234: folds 
Yabidooo: folds 
Uncalled bet ($0.20) returned to popypaleta
popypaleta collected $0.25 from pot
*** SUMMARY ***
Total pot $0.25 | Rake $0 
Seat 1: ralfi37 folded before Flop (didn't bet)
Seat 2: popypaleta collected ($0.25)
Seat 3: mvp0013 folded before Flop (didn't bet)
Seat 4: Cluckh (button) folded before Flop (didn't bet)
Seat 5: truck1234 (small blind) folded before Flop
Seat 6: Yabidooo (big blind) folded before Flop



PokerStars Hand #166667934364:  Hold'em No Limit ($0.05/$0.10 USD) - 2017/02/23 16:10:12 ET
Table 'Kobresia II' 6-max Seat #1 is the button
Seat 1: RoJ1 ($15.34 in chips) 
Seat 2: Dcaro31 ($13.57 in chips) 
Seat 3: ocmarigo81 ($4 in chips) 
Seat 4: Vanne11 ($10 in chips) 
Dcaro31: posts small blind $0.05
ocmarigo81: posts big blind $0.10
XaXaTyH4uK: sits out 
*** HOLE CARDS ***
Vanne11: raises $0.10 to $0.20
JahSoldier69 joins the table at seat #6 
RoJ1: folds 
Dcaro31: calls $0.15
ocmarigo81: calls $0.10
*** FLOP *** [4d As 5d]
Dcaro31: checks 
ocmarigo81: checks 
Vanne11: bets $0.57
Dcaro31: folds 
ocmarigo81: folds 
Uncalled bet ($0.57) returned to Vanne11
Vanne11 collected $0.57 from pot
*** SUMMARY ***
Total pot $0.60 | Rake $0.03 
Board [4d As 5d]
Seat 1: RoJ1 (button) folded before Flop (didn't bet)
Seat 2: Dcaro31 (small blind) folded on the Flop
Seat 3: ocmarigo81 (big blind) folded on the Flop
Seat 4: Vanne11 collected ($0.57)



PokerStars Hand #166667934422:  Hold'em No Limit ($0.05/$0.10 USD) - 2017/02/23 16:10:12 ET
Table 'Pulcova II' 6-max Seat #5 is the button
Seat 1: sexy_seagull ($11.38 in chips) 
Seat 2: Kazacha ($10.40 in chips) 
Seat 3: Lao Tsy ($14.22 in chips) 
Seat 5: mdelfin0 ($10 in chips) 
Seat 6: Ice_Isayev ($10 in chips) 
Ice_Isayev: posts small blind $0.05
sexy_seagull: posts big blind $0.10
Jalida3: sits out 
*** HOLE CARDS ***
Kazacha: folds 
Lao Tsy: folds 
mdelfin0: folds 
Ice_Isayev: folds 
Uncalled bet ($0.05) returned to sexy_seagull
sexy_seagull collected $0.10 from pot
*** SUMMARY ***
Total pot $0.10 | Rake $0 
Seat 1: sexy_seagull (big blind) collected ($0.10)
Seat 2: Kazacha folded before Flop (didn't bet)
Seat 3: Lao Tsy folded before Flop (didn't bet)
Seat 5: mdelfin0 (button) folded before Flop (didn't bet)
Seat 6: Ice_Isayev (small blind) folded before Flop



PokerStars Hand #166667934486:  Hold'em No Limit ($0.05/$0.10 USD) - 2017/02/23 16:10:12 ET
Table 'Atropos' 6-max Seat #4 is the button
Seat 1: ScorpionF39 ($2.44 in chips) 
Seat 2: yodzik ($5.15 in chips) 
Seat 3: NvR.m1nD ($10.53 in chips) 
Seat 4: iDecMate ($10.82 in chips) 
Seat 5: KokoulinV ($11.69 in chips) 
KokoulinV: posts small blind $0.05
Iarlei: is sitting out 
ScorpionF39: posts big blind $0.10
*** HOLE CARDS ***
yodzik: folds 
NvR.m1nD: raises $0.15 to $0.25
iDecMate: calls $0.25
KokoulinV: folds 
ScorpionF39: calls $0.15
*** FLOP *** [Qh 5s Qd]
ScorpionF39: checks 
NvR.m1nD: checks 
iDecMate: checks 
*** TURN *** [Qh 5s Qd] [6s]
ScorpionF39: checks 
NvR.m1nD: checks 
iDecMate: bets $0.51
ScorpionF39: folds 
NvR.m1nD: folds 
Uncalled bet ($0.51) returned to iDecMate
iDecMate collected $0.76 from pot
*** SUMMARY ***
Total pot $0.80 | Rake $0.04 
Board [Qh 5s Qd 6s]
Seat 1: ScorpionF39 (big blind) folded on the Turn
Seat 2: yodzik folded before Flop (didn't bet)
Seat 3: NvR.m1nD folded on the Turn
Seat 4: iDecMate (button) collected ($0.76)
Seat 5: KokoulinV (small blind) folded before Flop



PokerStars Hand #166667934801:  Hold'em No Limit ($0.05/$0.10 USD) - 2017/02/23 16:10:13 ET
Table 'Ostara III' 6-max Seat #5 is the button
Seat 1: MühliJr ($10 in chips) 
Seat 2: Action_Gibi ($13.52 in chips) 
Seat 3: vtalian ($13.08 in chips) 
Seat 4: Goovr ($28.76 in chips) 
Seat 5: THIMUCHIN ($10 in chips) 
Seat 6: FlopsterGB ($10.05 in chips) 
FlopsterGB: posts small blind $0.05
MühliJr: posts big blind $0.10
*** HOLE CARDS ***
Action_Gibi: folds 
vtalian: raises $0.20 to $0.30
Goovr: calls $0.30
THIMUCHIN: folds 
FlopsterGB: folds 
MühliJr: calls $0.20
*** FLOP *** [Jh 2s 6d]
MühliJr: checks 
vtalian: checks 
Goovr: checks 
*** TURN *** [Jh 2s 6d] [9d]
MühliJr: bets $0.77
vtalian: folds 
Goovr: folds 
Uncalled bet ($0.77) returned to MühliJr
MühliJr collected $0.91 from pot
*** SUMMARY ***
Total pot $0.95 | Rake $0.04 
Board [Jh 2s 6d 9d]
Seat 1: MühliJr (big blind) collected ($0.91)
Seat 2: Action_Gibi folded before Flop (didn't bet)
Seat 3: vtalian folded on the Turn
Seat 4: Goovr folded on the Turn
Seat 5: THIMUCHIN (button) folded before Flop (didn't bet)
Seat 6: FlopsterGB (small blind) folded before Flop



PokerStars Hand #166667935400:  Hold'em No Limit ($0.05/$0.10 USD) - 2017/02/23 16:10:13 ET
Table 'Glarona' 6-max Seat #2 is the button
Seat 1: LarryTheStar ($10.15 in chips) 
Seat 2: BookWorm78 ($10.25 in chips) 
Seat 4: CrippledGod ($6.94 in chips) 
Seat 6: marianoboni ($10 in chips) 
CrippledGod: posts small blind $0.05
marianoboni: posts big blind $0.10
*** HOLE CARDS ***
LarryTheStar: folds 
BookWorm78: folds 
CrippledGod: folds 
Uncalled bet ($0.05) returned to marianoboni
marianoboni collected $0.10 from pot
*** SUMMARY ***
Total pot $0.10 | Rake $0 
Seat 1: LarryTheStar folded before Flop (didn't bet)
Seat 2: BookWorm78 (button) folded before Flop (didn't bet)
Seat 4: CrippledGod (small blind) folded before Flop
Seat 6: marianoboni (big blind) collected ($0.10)



PokerStars Hand #166667936071:  Hold'em No Limit ($0.05/$0.10 USD) - 2017/02/23 16:10:14 ET
Table 'Isberga' 6-max Seat #3 is the button
Seat 1: Feverhead ($18.22 in chips) 
Seat 2: GESPERIA ($10.52 in chips) 
Seat 3: HARDCORE66RU ($10.98 in chips) 
Seat 4: THIMUCHIN ($10.69 in chips) 
Seat 5: YoungGriff86 ($18.72 in chips) 
Seat 6: Goroshkos88 ($21.56 in chips) 
THIMUCHIN: posts small blind $0.05
YoungGriff86: posts big blind $0.10
*** HOLE CARDS ***
Goroshkos88: folds 
Feverhead: folds 
GESPERIA: folds 
HARDCORE66RU: raises $0.15 to $0.25
THIMUCHIN: folds 
YoungGriff86: calls $0.15
*** FLOP *** [8d 8h Ad]
YoungGriff86: checks 
HARDCORE66RU: checks 
*** TURN *** [8d 8h Ad] [Ts]
YoungGriff86: bets $0.27
HARDCORE66RU: calls $0.27
*** RIVER *** [8d 8h Ad Ts] [6d]
YoungGriff86: checks 
HARDCORE66RU: bets $0.52
YoungGriff86: calls $0.52
*** SHOW DOWN ***
HARDCORE66RU: shows [Qd Qc] (two pair, Queens and Eights)
YoungGriff86: shows [Jc Ac] (two pair, Aces and Eights)
YoungGriff86 collected $2.03 from pot
*** SUMMARY ***
Total pot $2.13 | Rake $0.10 
Board [8d 8h Ad Ts 6d]
Seat 1: Feverhead folded before Flop (didn't bet)
Seat 2: GESPERIA folded before Flop (didn't bet)
Seat 3: HARDCORE66RU (button) showed [Qd Qc] and lost with two pair, Queens and Eights
Seat 4: THIMUCHIN (small blind) folded before Flop
Seat 5: YoungGriff86 (big blind) showed [Jc Ac] and won ($2.03) with two pair, Aces and Eights
Seat 6: Goroshkos88 folded before Flop (didn't bet)



PokerStars Hand #166667936115:  Hold'em No Limit ($0.05/$0.10 USD) - 2017/02/23 16:10:14 ET
Table 'Fechtig III' 6-max Seat #2 is the button
Seat 1: Scanner17 ($12.04 in chips) 
Seat 2: GV82 ($19.24 in chips) 
Seat 3: eniksenik ($10 in chips) 
Seat 4: Kow6oy ($10 in chips) 
Seat 5: ksandr_hom ($10.10 in chips) 
Seat 6: Glatzemandse ($15.87 in chips) 
eniksenik: posts small blind $0.05
Kow6oy: posts big blind $0.10
*** HOLE CARDS ***
ksandr_hom: folds 
Glatzemandse: calls $0.10
Scanner17: folds 
GV82: folds 
eniksenik: folds 
Kow6oy: raises $0.40 to $0.50
Glatzemandse: calls $0.40
*** FLOP *** [8h 4c Qd]
Kow6oy: bets $0.90
Glatzemandse: calls $0.90
*** TURN *** [8h 4c Qd] [9d]
Kow6oy: bets $2.70
Glatzemandse: raises $2.70 to $5.40
Kow6oy: raises $3.20 to $8.60 and is all-in
Glatzemandse: calls $3.20
*** RIVER *** [8h 4c Qd 9d] [Qc]
*** SHOW DOWN ***
Kow6oy: shows [Ts Qh] (three of a kind, Queens)
Glatzemandse: shows [8d Jc] (two pair, Queens and Eights)
Kow6oy collected $19.15 from pot
*** SUMMARY ***
Total pot $20.05 | Rake $0.90 
Board [8h 4c Qd 9d Qc]
Seat 1: Scanner17 folded before Flop (didn't bet)
Seat 2: GV82 (button) folded before Flop (didn't bet)
Seat 3: eniksenik (small blind) folded before Flop
Seat 4: Kow6oy (big blind) showed [Ts Qh] and won ($19.15) with three of a kind, Queens
Seat 5: ksandr_hom folded before Flop (didn't bet)
Seat 6: Glatzemandse showed [8d Jc] and lost with two pair, Queens and Eights



PokerStars Hand #166667936387:  Hold'em No Limit ($0.05/$0.10 USD) - 2017/02/23 16:10:14 ET
Table 'Jokaste II' 6-max Seat #5 is the button
Seat 1: Hyd SK ($13.35 in chips) 
Seat 2: T9MS ($12.88 in chips) 
Seat 3: crazydevill ($11.65 in chips) 
Seat 4: FRAID358 ($15.21 in chips) 
Seat 5: Vrinni ($10 in chips) 
Seat 6: Adailton07 ($13.35 in chips) 
Adailton07: posts small blind $0.05
Hyd SK: posts big blind $0.10
*** HOLE CARDS ***
T9MS: raises $0.20 to $0.30
crazydevill: folds 
FRAID358: folds 
Vrinni: folds 
Adailton07: calls $0.25
Hyd SK: folds 
*** FLOP *** [2h Tc 6d]
Adailton07: checks 
T9MS: checks 
*** TURN *** [2h Tc 6d] [8h]
Adailton07: bets $0.33
T9MS: calls $0.33
*** RIVER *** [2h Tc 6d 8h] [Ah]
Adailton07: bets $0.65
T9MS: calls $0.65
*** SHOW DOWN ***
Adailton07: shows [3c As] (a pair of Aces)
T9MS: shows [Ac 9c] (a pair of Aces - Ten+Nine kicker)
T9MS collected $2.54 from pot
*** SUMMARY ***
Total pot $2.66 | Rake $0.12 
Board [2h Tc 6d 8h Ah]
Seat 1: Hyd SK (big blind) folded before Flop
Seat 2: T9MS showed [Ac 9c] and won ($2.54) with a pair of Aces
Seat 3: crazydevill folded before Flop (didn't bet)
Seat 4: FRAID358 folded before Flop (didn't bet)
Seat 5: Vrinni (button) folded before Flop (didn't bet)
Seat 6: Adailton07 (small blind) showed [3c As] and lost with a pair of Aces



PokerStars Hand #166667936498:  Hold'em No Limit ($0.05/$0.10 USD) - 2017/02/23 16:10:14 ET
Table 'Caprera III' 6-max Seat #1 is the button
Seat 1: Vrinni ($19.04 in chips) 
Seat 2: hg123454321 ($11.42 in chips) 
Seat 6: GESPERIA ($15.11 in chips) 
hg123454321: posts small blind $0.05
GESPERIA: posts big blind $0.10
*** HOLE CARDS ***
Vrinni: raises $0.20 to $0.30
hg123454321: calls $0.25
GESPERIA: folds 
*** FLOP *** [Qc Js 4d]
hg123454321: checks 
Vrinni: checks 
*** TURN *** [Qc Js 4d] [2d]
hg123454321: bets $0.40
Vrinni: folds 
Uncalled bet ($0.40) returned to hg123454321
hg123454321 collected $0.67 from pot
*** SUMMARY ***
Total pot $0.70 | Rake $0.03 
Board [Qc Js 4d 2d]
Seat 1: Vrinni (button) folded on the Turn
Seat 2: hg123454321 (small blind) collected ($0.67)
Seat 6: GESPERIA (big blind) folded before Flop



PokerStars Hand #166667936995:  Hold'em No Limit ($0.05/$0.10 USD) - 2017/02/23 16:10:15 ET
Table 'Cuyo' 6-max Seat #4 is the button
Seat 1: Bandyaev ($11.54 in chips) 
Seat 2: Therodorus ($10.15 in chips) 
Seat 3: Hergie88 ($9.32 in chips) 
Seat 4: bambolejro ($10 in chips) 
Seat 5: DrVzad ($9.90 in chips) 
Seat 6: iluzja12 ($10 in chips) 
DrVzad: posts small blind $0.05
iluzja12: posts big blind $0.10
*** HOLE CARDS ***
Bandyaev: folds 
Therodorus: raises $0.20 to $0.30
Hergie88: folds 
bambolejro: folds 
DrVzad: folds 
iluzja12: calls $0.20
*** FLOP *** [6d 8d 2d]
iluzja12: checks 
Therodorus: checks 
*** TURN *** [6d 8d 2d] [Ah]
iluzja12: checks 
Therodorus: checks 
*** RIVER *** [6d 8d 2d Ah] [Td]
iluzja12: checks 
Therodorus: checks 
*** SHOW DOWN ***
iluzja12: shows [Kh 4h] (high card Ace)
Therodorus: shows [Kc Jh] (high card Ace - King+Jack kicker)
Therodorus collected $0.62 from pot
*** SUMMARY ***
Total pot $0.65 | Rake $0.03 
Board [6d 8d 2d Ah Td]
Seat 1: Bandyaev folded before Flop (didn't bet)
Seat 2: Therodorus showed [Kc Jh] and won ($0.62) with high card Ace
Seat 3: Hergie88 folded before Flop (didn't bet)
Seat 4: bambolejro (button) folded before Flop (didn't bet)
Seat 5: DrVzad (small blind) folded before Flop
Seat 6: iluzja12 (big blind) showed [Kh 4h] and lost with high card Ace



PokerStars Hand #166667937000:  Hold'em No Limit ($0.05/$0.10 USD) - 2017/02/23 16:10:15 ET
Table 'Carina' 6-max Seat #5 is the button
Seat 1: Kupi007 ($10 in chips) 
Seat 3: LarryTheStar ($12.59 in chips) 
Seat 4: steepfell ($10.56 in chips) 
Seat 5: IAntikI ($10.23 in chips) 
Seat 6: alexweezer ($7.48 in chips) 
alexweezer: posts small blind $0.05
Kupi007: posts big blind $0.10
XwinX25: sits out 
*** HOLE CARDS ***
LarryTheStar: folds 
steepfell: folds 
IAntikI: folds 
alexweezer: folds 
Uncalled bet ($0.05) returned to Kupi007
Kupi007 collected $0.10 from pot
*** SUMMARY ***
Total pot $0.10 | Rake $0 
Seat 1: Kupi007 (big blind) collected ($0.10)
Seat 3: LarryTheStar folded before Flop (didn't bet)
Seat 4: steepfell folded before Flop (didn't bet)
Seat 5: IAntikI (button) folded before Flop (didn't bet)
Seat 6: alexweezer (small blind) folded before Flop



PokerStars Hand #166667937116:  Hold'em No Limit ($0.05/$0.10 USD) - 2017/02/23 16:10:15 ET
Table 'Izar' 6-max Seat #6 is the button
Seat 1: bambolejro ($10.42 in chips) 
Seat 2: mvp0013 ($10.15 in chips) 
Seat 3: Yspenyanin ($11.17 in chips) 
Seat 4: Matee92 ($9.63 in chips) 
Seat 5: fishhook5 ($10.30 in chips) 
Seat 6: yodzik ($14.14 in chips) 
bambolejro: posts small blind $0.05
mvp0013: posts big blind $0.10
*** HOLE CARDS ***
Yspenyanin is disconnected 
Yspenyanin has timed out while disconnected
Yspenyanin: folds 
Matee92: folds 
fishhook5: folds 
yodzik: raises $0.10 to $0.20
bambolejro: calls $0.15
mvp0013: calls $0.10
*** FLOP *** [6h Td 2s]
bambolejro: checks 
mvp0013: checks 
yodzik: checks 
*** TURN *** [6h Td 2s] [Jd]
bambolejro: checks 
mvp0013: checks 
yodzik: checks 
*** RIVER *** [6h Td 2s Jd] [Qs]
bambolejro: checks 
mvp0013: bets $0.30
yodzik: folds 
bambolejro: folds 
Uncalled bet ($0.30) returned to mvp0013
mvp0013 collected $0.57 from pot
*** SUMMARY ***
Total pot $0.60 | Rake $0.03 
Board [6h Td 2s Jd Qs]
Seat 1: bambolejro (small blind) folded on the River
Seat 2: mvp0013 (big blind) collected ($0.57)
Seat 3: Yspenyanin folded before Flop (didn't bet)
Seat 4: Matee92 folded before Flop (didn't bet)
Seat 5: fishhook5 folded before Flop (didn't bet)
Seat 6: yodzik (button) folded on the River



PokerStars Hand #166667937655:  Hold'em No Limit ($0.05/$0.10 USD) - 2017/02/23 16:10:16 ET
Table 'Grietje' 6-max Seat #4 is the button
Seat 1: dragonste89 ($10 in chips) 
Seat 2: Feverhead ($10 in chips) 
Seat 3: GitoValdivia ($8.03 in chips) 
Seat 4: MihaGr ($10.56 in chips) 
Seat 5: iThreeBarrel ($10.30 in chips) 
Seat 6: Prometheu$8 ($26.52 in chips) 
iThreeBarrel: posts small blind $0.05
Prometheu$8: posts big blind $0.10
*** HOLE CARDS ***
dragonste89: folds 
Feverhead: folds 
GitoValdivia: folds 
MihaGr: folds 
iThreeBarrel: raises $0.15 to $0.25
Prometheu$8: raises $0.50 to $0.75
iThreeBarrel: calls $0.50
*** FLOP *** [5s Kc Qc]
iThreeBarrel: checks 
Prometheu$8: bets $1.43
iThreeBarrel: calls $1.43
*** TURN *** [5s Kc Qc] [Ac]
iThreeBarrel: checks 
Prometheu$8: checks 
*** RIVER *** [5s Kc Qc Ac] [Jc]
iThreeBarrel: checks 
Prometheu$8: checks 
*** SHOW DOWN ***
iThreeBarrel: shows [Ks Js] (two pair, Kings and Jacks)
Prometheu$8: shows [As 2c] (a flush, Ace high)
Prometheu$8 collected $4.16 from pot
*** SUMMARY ***
Total pot $4.36 | Rake $0.20 
Board [5s Kc Qc Ac Jc]
Seat 1: dragonste89 folded before Flop (didn't bet)
Seat 2: Feverhead folded before Flop (didn't bet)
Seat 3: GitoValdivia folded before Flop (didn't bet)
Seat 4: MihaGr (button) folded before Flop (didn't bet)
Seat 5: iThreeBarrel (small blind) showed [Ks Js] and lost with two pair, Kings and Jacks
Seat 6: Prometheu$8 (big blind) showed [As 2c] and won ($4.16) with a flush, Ace high



PokerStars Hand #166667938033:  Hold'em No Limit ($0.05/$0.10 USD) - 2017/02/23 16:10:16 ET
Table 'Alnasl' 6-max Seat #2 is the button
Seat 1: KA3AXCTAHEU, ($11.37 in chips) 
Seat 2: saddur ($9.09 in chips) 
Seat 4: oddshoff ($10.40 in chips) 
Seat 5: 6ePeMeHHa9 ($10.15 in chips) 
Seat 6: Zooplack ($13.58 in chips) 
oddshoff: posts small blind $0.05
6ePeMeHHa9: posts big blind $0.10
*** HOLE CARDS ***
Zooplack: folds 
KRZuff joins the table at seat #3 
KA3AXCTAHEU,: folds 
saddur: folds 
oddshoff: raises $0.10 to $0.20
6ePeMeHHa9: folds 
Uncalled bet ($0.10) returned to oddshoff
oddshoff collected $0.20 from pot
*** SUMMARY ***
Total pot $0.20 | Rake $0 
Seat 1: KA3AXCTAHEU, folded before Flop (didn't bet)
Seat 2: saddur (button) folded before Flop (didn't bet)
Seat 4: oddshoff (small blind) collected ($0.20)
Seat 5: 6ePeMeHHa9 (big blind) folded before Flop
Seat 6: Zooplack folded before Flop (didn't bet)



PokerStars Hand #166667938630:  Hold'em No Limit ($0.05/$0.10 USD) - 2017/02/23 16:10:17 ET
Table 'Cassini' 6-max Seat #2 is the button
Seat 1: Pokeaster ($10.53 in chips) 
Seat 2: mhonielsen ($12.26 in chips) 
Seat 3: J1234T ($10.64 in chips) 
Seat 4: fortieth ($13.97 in chips) 
Seat 5: DrVzad ($10 in chips) 
Seat 6: MihaGr ($10 in chips) 
J1234T: posts small blind $0.05
fortieth: posts big blind $0.10
*** HOLE CARDS ***
DrVzad: folds 
MihaGr: folds 
Pokeaster: folds 
mhonielsen: folds 
J1234T: raises $0.20 to $0.30
fortieth: calls $0.20
*** FLOP *** [8h Jc Qs]
J1234T: bets $0.40
fortieth: folds 
Uncalled bet ($0.40) returned to J1234T
J1234T collected $0.57 from pot
*** SUMMARY ***
Total pot $0.60 | Rake $0.03 
Board [8h Jc Qs]
Seat 1: Pokeaster folded before Flop (didn't bet)
Seat 2: mhonielsen (button) folded before Flop (didn't bet)
Seat 3: J1234T (small blind) collected ($0.57)
Seat 4: fortieth (big blind) folded on the Flop
Seat 5: DrVzad folded before Flop (didn't bet)
Seat 6: MihaGr folded before Flop (didn't bet)



PokerStars Hand #166667938698:  Hold'em No Limit ($0.05/$0.10 USD) - 2017/02/23 16:10:17 ET
Table 'Kunigunde II' 6-max Seat #1 is the button
Seat 1: facewald ($9.88 in chips) 
Seat 2: DrVzad ($10.20 in chips) 
Seat 3: pancernik21 ($17.14 in chips) 
Seat 5: mdelfin0 ($12.58 in chips) 
Seat 6: Zooplack ($10 in chips) 
DrVzad: posts small blind $0.05
pancernik21: posts big blind $0.10
*** HOLE CARDS ***
mdelfin0: folds 
Zooplack: raises $0.15 to $0.25
facewald: folds 
DrVzad: folds 
pancernik21: folds 
Uncalled bet ($0.15) returned to Zooplack
Zooplack collected $0.25 from pot
*** SUMMARY ***
Total pot $0.25 | Rake $0 
Seat 1: facewald (button) folded before Flop (didn't bet)
Seat 2: DrVzad (small blind) folded before Flop
Seat 3: pancernik21 (big blind) folded before Flop
Seat 5: mdelfin0 folded before Flop (didn't bet)
Seat 6: Zooplack collected ($0.25)



PokerStars Hand #166667938728:  Hold'em No Limit ($0.05/$0.10 USD) - 2017/02/23 16:10:17 ET
Table 'Lehigh' 6-max Seat #6 is the button
Seat 2: Sbozzz ($21 in chips) 
Seat 5: Slavoaca693 ($8 in chips) 
Seat 6: RoJ1 ($10.05 in chips) 
Sbozzz: posts small blind $0.05
Slavoaca693: posts big blind $0.10
*** HOLE CARDS ***
RoJ1: raises $0.12 to $0.22
Sbozzz: folds 
pokekrk joins the table at seat #1 
Slavoaca693: folds 
Uncalled bet ($0.12) returned to RoJ1
Cluckh joins the table at seat #3 
RoJ1 collected $0.25 from pot
*** SUMMARY ***
Total pot $0.25 | Rake $0 
Seat 2: Sbozzz (small blind) folded before Flop
Seat 5: Slavoaca693 (big blind) folded before Flop
Seat 6: RoJ1 (button) collected ($0.25)



PokerStars Hand #166667938729:  Hold'em No Limit ($0.05/$0.10 USD) - 2017/02/23 16:10:17 ET
Table 'Iapetus III' 6-max Seat #6 is the button
Seat 1: Czezar Life ($6.49 in chips) 
Seat 2: Crafty23@PS ($10 in chips) 
Seat 3: Goroshkos88 ($10.70 in chips) 
Seat 4: Raggibest ($7.97 in chips) 
Seat 5: homelessdan ($15.49 in chips) 
Seat 6: tauronex ($10.10 in chips) 
Czezar Life: posts small blind $0.05
Crafty23@PS: posts big blind $0.10
*** HOLE CARDS ***
Goroshkos88: raises $0.20 to $0.30
Raggibest: calls $0.30
homelessdan: folds 
tauronex: folds 
Czezar Life: folds 
Crafty23@PS: folds 
*** FLOP *** [5s Kc 4s]
Goroshkos88: checks 
Raggibest: bets $0.10
Goroshkos88: calls $0.10
*** TURN *** [5s Kc 4s] [5c]
Goroshkos88: checks 
Raggibest: bets $0.10
Goroshkos88: calls $0.10
*** RIVER *** [5s Kc 4s 5c] [8s]
Goroshkos88: checks 
Raggibest: bets $0.30
Goroshkos88: folds 
Uncalled bet ($0.30) returned to Raggibest
Raggibest collected $1.10 from pot
*** SUMMARY ***
Total pot $1.15 | Rake $0.05 
Board [5s Kc 4s 5c 8s]
Seat 1: Czezar Life (small blind) folded before Flop
Seat 2: Crafty23@PS (big blind) folded before Flop
Seat 3: Goroshkos88 folded on the River
Seat 4: Raggibest collected ($1.10)
Seat 5: homelessdan folded before Flop (didn't bet)
Seat 6: tauronex (button) folded before Flop (didn't bet)



PokerStars Hand #166667938758:  Hold'em No Limit ($0.05/$0.10 USD) - 2017/02/23 16:10:17 ET
Table 'Juliet II' 6-max Seat #3 is the button
Seat 1: alexpolevaja ($11.29 in chips) 
Seat 2: KA3AXCTAHEU, ($15.53 in chips) 
Seat 3: patrick19111 ($11.27 in chips) 
Seat 4: x3ultimate ($10.45 in chips) 
Seat 5: Dcaro31 ($20.06 in chips) 
Seat 6: BookWorm78 ($31.48 in chips) 
x3ultimate: posts small blind $0.05
Dcaro31: posts big blind $0.10
*** HOLE CARDS ***
BookWorm78: raises $0.20 to $0.30
alexpolevaja: folds 
KA3AXCTAHEU,: folds 
patrick19111: folds 
x3ultimate: raises $0.70 to $1
Dcaro31: folds 
BookWorm78: calls $0.70
*** FLOP *** [Jc 6s 6c]
x3ultimate: bets $1.10
BookWorm78: folds 
Uncalled bet ($1.10) returned to x3ultimate
x3ultimate collected $2.01 from pot
*** SUMMARY ***
Total pot $2.10 | Rake $0.09 
Board [Jc 6s 6c]
Seat 1: alexpolevaja folded before Flop (didn't bet)
Seat 2: KA3AXCTAHEU, folded before Flop (didn't bet)
Seat 3: patrick19111 (button) folded before Flop (didn't bet)
Seat 4: x3ultimate (small blind) collected ($2.01)
Seat 5: Dcaro31 (big blind) folded before Flop
Seat 6: BookWorm78 folded on the Flop



PokerStars Hand #166667938759:  Hold'em No Limit ($0.05/$0.10 USD) - 2017/02/23 16:10:17 ET
Table 'Serpens' 6-max Seat #3 is the button
Seat 1: Namhkal ($10.28 in chips) 
Seat 2: KA3AXCTAHEU, ($19.48 in chips) 
Seat 3: homelessdan ($29.88 in chips) 
Seat 4: DIENY772 ($9.75 in chips) 
Seat 5: JahSoldier69 ($10 in chips) 
DIENY772: posts small blind $0.05
JahSoldier69: posts big blind $0.10
XaXaTyH4uK: sits out 
*** HOLE CARDS ***
Namhkal: folds 
KA3AXCTAHEU,: folds 
homelessdan: raises $0.20 to $0.30
DIENY772: calls $0.25
JahSoldier69: folds 
*** FLOP *** [6h Jc Ah]
DIENY772: checks 
homelessdan: bets $0.40
DIENY772: folds 
Uncalled bet ($0.40) returned to homelessdan
homelessdan collected $0.67 from pot
*** SUMMARY ***
Total pot $0.70 | Rake $0.03 
Board [6h Jc Ah]
Seat 1: Namhkal folded before Flop (didn't bet)
Seat 2: KA3AXCTAHEU, folded before Flop (didn't bet)
Seat 3: homelessdan (button) collected ($0.67)
Seat 4: DIENY772 (small blind) folded on the Flop
Seat 5: JahSoldier69 (big blind) folded before Flop



PokerStars Hand #166667939048:  Hold'em No Limit ($0.05/$0.10 USD) - 2017/02/23 16:10:17 ET
Table 'Sirius II' 6-max Seat #4 is the button
Seat 2: Buddy8711 ($8.83 in chips) 
Seat 3: Spud014 ($10 in chips) 
Seat 4: Pekaml ($10 in chips) 
Seat 5: manashov ($10.32 in chips) 
Seat 6: MihaGr ($10 in chips) 
manashov: posts small blind $0.05
MihaGr: posts big blind $0.10
Cluckh: sits out 
*** HOLE CARDS ***
Buddy8711: folds 
Spud014: folds 
Pekaml: raises $0.10 to $0.20
manashov: folds 
MihaGr: folds 
Uncalled bet ($0.10) returned to Pekaml
Pekaml collected $0.25 from pot
*** SUMMARY ***
Total pot $0.25 | Rake $0 
Seat 2: Buddy8711 folded before Flop (didn't bet)
Seat 3: Spud014 folded before Flop (didn't bet)
Seat 4: Pekaml (button) collected ($0.25)
Seat 5: manashov (small blind) folded before Flop
Seat 6: MihaGr (big blind) folded before Flop



PokerStars Hand #166667939521:  Hold'em No Limit ($0.05/$0.10 USD) - 2017/02/23 16:10:18 ET
Table 'Hirons' 6-max Seat #5 is the button
Seat 1: RoJ1 ($12.34 in chips) 
Seat 2: coolisses111 ($10 in chips) 
Seat 3: czeczen7 ($14.11 in chips) 
Seat 4: Smitty03300 ($11.05 in chips) 
Seat 5: Pekaml ($10 in chips) 
Seat 6: garigura ($13.53 in chips) 
garigura: posts small blind $0.05
RoJ1: posts big blind $0.10
*** HOLE CARDS ***
coolisses111: folds 
czeczen7: folds 
Smitty03300: raises $0.15 to $0.25
Pekaml: folds 
garigura: folds 
RoJ1: folds 
Uncalled bet ($0.15) returned to Smitty03300
Smitty03300 collected $0.25 from pot
*** SUMMARY ***
Total pot $0.25 | Rake $0 
Seat 1: RoJ1 (big blind) folded before Flop
Seat 2: coolisses111 folded before Flop (didn't bet)
Seat 3: czeczen7 folded before Flop (didn't bet)
Seat 4: Smitty03300 collected ($0.25)
Seat 5: Pekaml (button) folded before Flop (didn't bet)
Seat 6: garigura (small blind) folded before Flop



PokerStars Hand #166667939595:  Hold'em No Limit ($0.05/$0.10 USD) - 2017/02/23 16:10:18 ET
Table 'Giclas' 6-max Seat #2 is the button
Seat 2: Crafty23@PS ($10 in chips) 
Seat 3: fidas1972 ($6.53 in chips) 
Seat 4: Eddys Edge ($13.94 in chips) 
Seat 5: dedea1989 ($34.73 in chips) 
Seat 6: eniksenik ($14.48 in chips) 
fidas1972: posts small blind $0.05
Eddys Edge: posts big blind $0.10
*** HOLE CARDS ***
dedea1989: calls $0.10
eniksenik: raises $0.40 to $0.50
david_sara83 leaves the table
Crafty23@PS: folds 
fidas1972: folds 
Eddys Edge: folds 
dedea1989: folds 
Uncalled bet ($0.40) returned to eniksenik
eniksenik collected $0.35 from pot
WinninBikini joins the table at seat #1 
*** SUMMARY ***
Total pot $0.35 | Rake $0 
Seat 2: Crafty23@PS (button) folded before Flop (didn't bet)
Seat 3: fidas1972 (small blind) folded before Flop
Seat 4: Eddys Edge (big blind) folded before Flop
Seat 5: dedea1989 folded before Flop
Seat 6: eniksenik collected ($0.35)



PokerStars Hand #166667939737:  Hold'em No Limit ($0.05/$0.10 USD) - 2017/02/23 16:10:18 ET
Table 'Stroobantia II' 6-max Seat #2 is the button
Seat 1: XBrosh ($9.68 in chips) 
Seat 2: IAntikI ($10 in chips) 
Seat 3: 8th wonders ($11.09 in chips) 
Seat 4: Punzzzer ($10 in chips) 
Seat 5: Zooplack ($12.61 in chips) 
Seat 6: CHRO8 ($12.17 in chips) 
8th wonders: posts small blind $0.05
Punzzzer: posts big blind $0.10
*** HOLE CARDS ***
Zooplack: folds 
CHRO8: raises $0.20 to $0.30
XBrosh: calls $0.30
IAntikI: folds 
8th wonders: folds 
Punzzzer: calls $0.20
*** FLOP *** [3h 4s 5h]
Punzzzer: checks 
CHRO8: checks 
XBrosh: bets $0.70
Punzzzer: raises $1.39 to $2.09
CHRO8: folds 
XBrosh: folds 
Uncalled bet ($1.39) returned to Punzzzer
Punzzzer collected $2.24 from pot
*** SUMMARY ***
Total pot $2.35 | Rake $0.11 
Board [3h 4s 5h]
Seat 1: XBrosh folded on the Flop
Seat 2: IAntikI (button) folded before Flop (didn't bet)
Seat 3: 8th wonders (small blind) folded before Flop
Seat 4: Punzzzer (big blind) collected ($2.24)
Seat 5: Zooplack folded before Flop (didn't bet)
Seat 6: CHRO8 folded on the Flop



PokerStars Hand #166667940141:  Hold'em No Limit ($0.05/$0.10 USD) - 2017/02/23 16:10:19 ET
Table 'Seinajoki' 6-max Seat #2 is the button
Seat 2: niukak ($10 in chips) 
Seat 3: Therodorus ($10 in chips) 
Seat 4: rusu_rapid ($10 in chips) 
Therodorus: posts small blind $0.05
rusu_rapid: posts big blind $0.10
*** HOLE CARDS ***
niukak: raises $0.20 to $0.30
Therodorus: folds 
rusu_rapid: folds 
Uncalled bet ($0.20) returned to niukak
niukak collected $0.25 from pot
*** SUMMARY ***
Total pot $0.25 | Rake $0 
Seat 2: niukak (button) collected ($0.25)
Seat 3: Therodorus (small blind) folded before Flop
Seat 4: rusu_rapid (big blind) folded before Flop



PokerStars Hand #166667940735:  Hold'em No Limit ($0.05/$0.10 USD) - 2017/02/23 16:10:20 ET
Table 'Vaisala' 6-max Seat #2 is the button
Seat 2: XaXaTyH4uK ($10.74 in chips) 
Seat 4: sexy_seagull ($11.36 in chips) 
Seat 5: univibe68 ($10 in chips) 
Seat 6: fábiu ($8 in chips) 
Elinaattor will be allowed to play after the button
sexy_seagull: posts small blind $0.05
univibe68: posts big blind $0.10
fábiu: posts big blind $0.10
ksandr_hom: sits out 
*** HOLE CARDS ***
fábiu: checks 
XaXaTyH4uK: raises $0.30 to $0.40
sexy_seagull: raises $0.70 to $1.10
univibe68: raises $8.90 to $10 and is all-in
fábiu: folds 
XaXaTyH4uK: folds 
sexy_seagull: calls $8.90
*** FIRST FLOP *** [Ts Kh 3c]
*** FIRST TURN *** [Ts Kh 3c] [Qc]
*** FIRST RIVER *** [Ts Kh 3c Qc] [8d]
*** SECOND FLOP *** [6h 6d 4d]
*** SECOND TURN *** [6h 6d 4d] [3s]
*** SECOND RIVER *** [6h 6d 4d 3s] [9h]
*** FIRST SHOW DOWN ***
sexy_seagull: shows [Ac Ah] (a pair of Aces)
univibe68: shows [As Ad] (a pair of Aces)
sexy_seagull collected $4.90 from pot
univibe68 collected $4.89 from pot
*** SECOND SHOW DOWN ***
sexy_seagull: shows [Ac Ah] (two pair, Aces and Sixes)
univibe68: shows [As Ad] (two pair, Aces and Sixes)
sexy_seagull collected $4.90 from pot
univibe68 collected $4.89 from pot
*** SUMMARY ***
Total pot $20.50 | Rake $0.92 
Hand was run twice
FIRST Board [Ts Kh 3c Qc 8d]
SECOND Board [6h 6d 4d 3s 9h]
Seat 2: XaXaTyH4uK (button) folded before Flop
Seat 4: sexy_seagull (small blind) showed [Ac Ah] and won ($4.90) with a pair of Aces, and won ($4.90) with two pair, Aces and Sixes
Seat 5: univibe68 (big blind) showed [As Ad] and won ($4.89) with a pair of Aces, and won ($4.89) with two pair, Aces and Sixes
Seat 6: fábiu folded before Flop



PokerStars Hand #166667940747:  Hold'em No Limit ($0.05/$0.10 USD) - 2017/02/23 16:10:20 ET
Table 'Camilla II' 6-max Seat #4 is the button
Seat 1: paxit71 ($8.32 in chips) 
Seat 2: Giyorod ($13.01 in chips) 
Seat 3: Andy Wolf ($12.69 in chips) 
Seat 4: chimera252 ($12.41 in chips) 
Seat 5: LarryTheStar ($11.14 in chips) 
LarryTheStar: posts small blind $0.05
paxit71: posts big blind $0.10
*** HOLE CARDS ***
Giyorod: folds 
Andy Wolf: raises $0.20 to $0.30
chimera252: folds 
DeleonBR joins the table at seat #6 
LarryTheStar: folds 
paxit71: folds 
Uncalled bet ($0.20) returned to Andy Wolf
Andy Wolf collected $0.25 from pot
*** SUMMARY ***
Total pot $0.25 | Rake $0 
Seat 1: paxit71 (big blind) folded before Flop
Seat 2: Giyorod folded before Flop (didn't bet)
Seat 3: Andy Wolf collected ($0.25)
Seat 4: chimera252 (button) folded before Flop (didn't bet)
Seat 5: LarryTheStar (small blind) folded before Flop



PokerStars Hand #166667941186:  Hold'em No Limit ($0.05/$0.10 USD) - 2017/02/23 16:10:20 ET
Table 'Joella' 6-max Seat #3 is the button
Seat 1: Dcaro31 ($12.78 in chips) 
Seat 2: Kaelyns_Bark ($9.96 in chips) 
Seat 3: Joker51_wtf! ($11.51 in chips) 
Seat 4: KRZuff ($10 in chips) 
Seat 5: Anestakis777 ($1.24 in chips) 
Seat 6: dr.goofy ($12.77 in chips) 
KRZuff: posts small blind $0.05
Anestakis777: posts big blind $0.10
*** HOLE CARDS ***
dr.goofy: folds 
Dcaro31: folds 
Kaelyns_Bark: calls $0.10
Joker51_wtf!: raises $0.25 to $0.35
KRZuff: folds 
Anestakis777: folds 
Kaelyns_Bark: calls $0.25
*** FLOP *** [Qc 6d 8c]
Kaelyns_Bark: checks 
Joker51_wtf!: checks 
*** TURN *** [Qc 6d 8c] [9c]
Kaelyns_Bark: bets $0.20
Joker51_wtf!: calls $0.20
*** RIVER *** [Qc 6d 8c 9c] [8d]
Kaelyns_Bark: bets $0.40
dr.goofy leaves the table
Joker51_wtf!: calls $0.40
*** SHOW DOWN ***
Kaelyns_Bark: shows [Js 9h] (two pair, Nines and Eights)
Joker51_wtf!: shows [As Ah] (two pair, Aces and Eights)
Joker51_wtf! collected $1.96 from pot
*** SUMMARY ***
Total pot $2.05 | Rake $0.09 
Board [Qc 6d 8c 9c 8d]
Seat 1: Dcaro31 folded before Flop (didn't bet)
Seat 2: Kaelyns_Bark showed [Js 9h] and lost with two pair, Nines and Eights
Seat 3: Joker51_wtf! (button) showed [As Ah] and won ($1.96) with two pair, Aces and Eights
Seat 4: KRZuff (small blind) folded before Flop
Seat 5: Anestakis777 (big blind) folded before Flop
Seat 6: dr.goofy folded before Flop (didn't bet)



PokerStars Hand #166667941189:  Hold'em No Limit ($0.05/$0.10 USD) - 2017/02/23 16:10:20 ET
Table 'Tomita II' 6-max Seat #6 is the button
Seat 1: HARDCORE66RU ($22.68 in chips) 
Seat 2: mhonielsen ($10.30 in chips) 
Seat 3: D3NyA ($10 in chips) 
Seat 4: Hyd SK ($11.61 in chips) 
Seat 5: ex3Lero86 ($10 in chips) 
Seat 6: saniasmir ($10 in chips) 
HARDCORE66RU: posts small blind $0.05
mhonielsen: posts big blind $0.10
*** HOLE CARDS ***
D3NyA: folds 
Hyd SK: raises $0.25 to $0.35
ex3Lero86: folds 
saniasmir: folds 
HARDCORE66RU: folds 
mhonielsen: folds 
Uncalled bet ($0.25) returned to Hyd SK
Hyd SK collected $0.25 from pot
*** SUMMARY ***
Total pot $0.25 | Rake $0 
Seat 1: HARDCORE66RU (small blind) folded before Flop
Seat 2: mhonielsen (big blind) folded before Flop
Seat 3: D3NyA folded before Flop (didn't bet)
Seat 4: Hyd SK collected ($0.25)
Seat 5: ex3Lero86 folded before Flop (didn't bet)
Seat 6: saniasmir (button) folded before Flop (didn't bet)



PokerStars Hand #166667941458:  Hold'em No Limit ($0.05/$0.10 USD) - 2017/02/23 16:10:20 ET
Table 'Crocus' 6-max Seat #1 is the button
Seat 1: truck1234 ($25.66 in chips) 
Seat 2: garigura ($11.04 in chips) 
Seat 3: Yspenyanin ($10 in chips) 
Seat 4: patrick19111 ($12.76 in chips) 
Seat 6: Rodik002 ($10.09 in chips) 
garigura: posts small blind $0.05
Yspenyanin is disconnected 
Yspenyanin is connected 
Yspenyanin: posts big blind $0.10
*** HOLE CARDS ***
patrick19111: folds 
FilK74 joins the table at seat #5 
Rodik002: raises $0.20 to $0.30
truck1234: folds 
garigura: folds 
Yspenyanin: folds 
Uncalled bet ($0.20) returned to Rodik002
Rodik002 collected $0.25 from pot
*** SUMMARY ***
Total pot $0.25 | Rake $0 
Seat 1: truck1234 (button) folded before Flop (didn't bet)
Seat 2: garigura (small blind) folded before Flop
Seat 3: Yspenyanin (big blind) folded before Flop
Seat 4: patrick19111 folded before Flop (didn't bet)
Seat 6: Rodik002 collected ($0.25)



PokerStars Hand #166667941515:  Hold'em No Limit ($0.05/$0.10 USD) - 2017/02/23 16:10:21 ET
Table 'Lobelia II' 6-max Seat #1 is the button
Seat 1: facewald ($21.52 in chips) 
Seat 2: Dcaro31 ($18.04 in chips) 
Seat 3: oddshoff ($19.58 in chips) 
Seat 5: Feverhead ($18.95 in chips) 
Seat 6: NvR.m1nD ($10.09 in chips) 
Dcaro31: posts small blind $0.05
oddshoff: posts big blind $0.10
arti192837: sits out 
*** HOLE CARDS ***
Feverhead: raises $0.20 to $0.30
NvR.m1nD: folds 
facewald: folds 
Dcaro31: calls $0.25
oddshoff: calls $0.20
*** FLOP *** [Td 8h 6d]
Dcaro31: checks 
oddshoff: bets $0.57
Feverhead: folds 
Dcaro31: raises $1.23 to $1.80
oddshoff: calls $1.23
*** TURN *** [Td 8h 6d] [Jc]
Dcaro31: bets $2.50
oddshoff: calls $2.50
*** RIVER *** [Td 8h 6d Jc] [Ac]
Dcaro31: checks 
oddshoff: checks 
*** SHOW DOWN ***
Dcaro31: shows [6c 8c] (two pair, Eights and Sixes)
oddshoff: mucks hand 
Dcaro31 collected $9.07 from pot
*** SUMMARY ***
Total pot $9.50 | Rake $0.43 
Board [Td 8h 6d Jc Ac]
Seat 1: facewald (button) folded before Flop (didn't bet)
Seat 2: Dcaro31 (small blind) showed [6c 8c] and won ($9.07) with two pair, Eights and Sixes
Seat 3: oddshoff (big blind) mucked
Seat 5: Feverhead folded on the Flop
Seat 6: NvR.m1nD folded before Flop (didn't bet)



PokerStars Hand #166667941533:  Hold'em No Limit ($0.05/$0.10 USD) - 2017/02/23 16:10:21 ET
Table 'Kanda' 6-max Seat #2 is the button
Seat 1: Andy Wolf ($11.72 in chips) 
Seat 2: Pelotín ($5.12 in chips) 
Seat 3: XaXaTyH4uK ($10.32 in chips) 
Seat 4: Orlangoor ($10 in chips) 
Seat 5: Dimka4 ($10.43 in chips) 
Seat 6: oddshoff ($8.91 in chips) 
XaXaTyH4uK: posts small blind $0.05
Orlangoor: posts big blind $0.10
*** HOLE CARDS ***
Dimka4: folds 
oddshoff: folds 
Andy Wolf: folds 
Pelotín: folds 
XaXaTyH4uK: raises $0.20 to $0.30
Orlangoor: calls $0.20
*** FLOP *** [8h As Ts]
XaXaTyH4uK: bets $0.40
Orlangoor: calls $0.40
*** TURN *** [8h As Ts] [8d]
XaXaTyH4uK: bets $0.70
Orlangoor: folds 
Uncalled bet ($0.70) returned to XaXaTyH4uK
XaXaTyH4uK collected $1.34 from pot
*** SUMMARY ***
Total pot $1.40 | Rake $0.06 
Board [8h As Ts 8d]
Seat 1: Andy Wolf folded before Flop (didn't bet)
Seat 2: Pelotín (button) folded before Flop (didn't bet)
Seat 3: XaXaTyH4uK (small blind) collected ($1.34)
Seat 4: Orlangoor (big blind) folded on the Turn
Seat 5: Dimka4 folded before Flop (didn't bet)
Seat 6: oddshoff folded before Flop (didn't bet)



PokerStars Hand #166667941550:  Hold'em No Limit ($0.05/$0.10 USD) - 2017/02/23 16:10:21 ET
Table 'Landi II' 6-max Seat #6 is the button
Seat 1: dersiemer ($13.68 in chips) 
Seat 2: Aescul@pius ($10 in chips) 
Seat 4: alesi13 ($5.59 in chips) 
Seat 5: Bird et al ($10.25 in chips) 
Seat 6: arti192837 ($10 in chips) 
dersiemer: posts small blind $0.05
Aescul@pius: posts big blind $0.10
x3ultimate: sits out 
*** HOLE CARDS ***
alesi13: raises $0.20 to $0.30
Bird et al: folds 
arti192837: folds 
dersiemer: folds 
Aescul@pius: folds 
Uncalled bet ($0.20) returned to alesi13
alesi13 collected $0.25 from pot
*** SUMMARY ***
Total pot $0.25 | Rake $0 
Seat 1: dersiemer (small blind) folded before Flop
Seat 2: Aescul@pius (big blind) folded before Flop
Seat 4: alesi13 collected ($0.25)
Seat 5: Bird et al folded before Flop (didn't bet)
Seat 6: arti192837 (button) folded before Flop (didn't bet)



PokerStars Hand #166667941654:  Hold'em No Limit ($0.05/$0.10 USD) - 2017/02/23 16:10:21 ET
Table 'Sinon II' 6-max Seat #4 is the button
Seat 1: Aescul@pius ($10 in chips) 
Seat 2: ÄissesHai ($28.36 in chips) 
Seat 3: crazydevill ($10 in chips) 
Seat 4: Bandyaev ($14.68 in chips) 
Seat 5: ab260414 ($10.96 in chips) 
Seat 6: hartmut2012 ($6.32 in chips) 
ab260414: posts small blind $0.05
hartmut2012: posts big blind $0.10
*** HOLE CARDS ***
Aescul@pius: folds 
ÄissesHai: calls $0.10
crazydevill: folds 
Bandyaev: folds 
ab260414: folds 
hartmut2012: checks 
*** FLOP *** [Ac Jh Qc]
hartmut2012: bets $0.10
ÄissesHai: calls $0.10
*** TURN *** [Ac Jh Qc] [8s]
hartmut2012: bets $0.10
ÄissesHai: calls $0.10
*** RIVER *** [Ac Jh Qc 8s] [2c]
hartmut2012: bets $0.10
ÄissesHai: calls $0.10
*** SHOW DOWN ***
hartmut2012: shows [4d Th] (high card Ace)
ÄissesHai: shows [3h Ad] (a pair of Aces)
ÄissesHai collected $0.81 from pot
*** SUMMARY ***
Total pot $0.85 | Rake $0.04 
Board [Ac Jh Qc 8s 2c]
Seat 1: Aescul@pius folded before Flop (didn't bet)
Seat 2: ÄissesHai showed [3h Ad] and won ($0.81) with a pair of Aces
Seat 3: crazydevill folded before Flop (didn't bet)
Seat 4: Bandyaev (button) folded before Flop (didn't bet)
Seat 5: ab260414 (small blind) folded before Flop
Seat 6: hartmut2012 (big blind) showed [4d Th] and lost with high card Ace



PokerStars Hand #166667941697:  Hold'em No Limit ($0.05/$0.10 USD) - 2017/02/23 16:10:21 ET
Table 'Ushakaron II' 6-max Seat #4 is the button
Seat 1: Kow6oy ($10 in chips) 
Seat 2: Iarlei ($12.44 in chips) 
Seat 3: Rodik002 ($11.22 in chips) 
Seat 4: avintage176 ($30.43 in chips) 
Seat 5: 1limewax1 ($15.88 in chips) 
Seat 6: eniksenik ($10 in chips) 
1limewax1: posts small blind $0.05
eniksenik: posts big blind $0.10
*** HOLE CARDS ***
Kow6oy: folds 
Iarlei: folds 
Rodik002: folds 
avintage176: folds 
1limewax1: calls $0.05
eniksenik: checks 
*** FLOP *** [2d 8s 8d]
1limewax1: bets $0.10
eniksenik: calls $0.10
*** TURN *** [2d 8s 8d] [Qd]
1limewax1: bets $0.10
eniksenik: calls $0.10
*** RIVER *** [2d 8s 8d Qd] [5d]
1limewax1: bets $0.30
eniksenik: raises $0.90 to $1.20
1limewax1: folds 
Uncalled bet ($0.90) returned to eniksenik
eniksenik collected $1.15 from pot
*** SUMMARY ***
Total pot $1.20 | Rake $0.05 
Board [2d 8s 8d Qd 5d]
Seat 1: Kow6oy folded before Flop (didn't bet)
Seat 2: Iarlei folded before Flop (didn't bet)
Seat 3: Rodik002 folded before Flop (didn't bet)
Seat 4: avintage176 (button) folded before Flop (didn't bet)
Seat 5: 1limewax1 (small blind) folded on the River
Seat 6: eniksenik (big blind) collected ($1.15)



PokerStars Hand #166667942071:  Hold'em No Limit ($0.05/$0.10 USD) - 2017/02/23 16:10:21 ET
Table 'Caupolican' 6-max Seat #1 is the button
Seat 1: kingartur222 ($12.42 in chips) 
Seat 2: garigura ($18.65 in chips) 
Seat 3: ducksheep82 ($4.80 in chips) 
Seat 4: mhonielsen ($15.07 in chips) 
Seat 5: Kazacha ($12.55 in chips) 
Seat 6: crazydevill ($10 in chips) 
garigura: posts small blind $0.05
ducksheep82: posts big blind $0.10
*** HOLE CARDS ***
mhonielsen: raises $0.30 to $0.40
Kazacha: folds 
crazydevill: folds 
kingartur222: folds 
garigura: folds 
ducksheep82: raises $0.30 to $0.70
mhonielsen: calls $0.30
*** FLOP *** [8c 8s 6d]
ducksheep82: bets $1.10
mhonielsen: folds 
Uncalled bet ($1.10) returned to ducksheep82
ducksheep82 collected $1.38 from pot
*** SUMMARY ***
Total pot $1.45 | Rake $0.07 
Board [8c 8s 6d]
Seat 1: kingartur222 (button) folded before Flop (didn't bet)
Seat 2: garigura (small blind) folded before Flop
Seat 3: ducksheep82 (big blind) collected ($1.38)
Seat 4: mhonielsen folded on the Flop
Seat 5: Kazacha folded before Flop (didn't bet)
Seat 6: crazydevill folded before Flop (didn't bet)



PokerStars Hand #166667942117:  Hold'em No Limit ($0.05/$0.10 USD) - 2017/02/23 16:10:21 ET
Table 'Iduberga II' 6-max Seat #1 is the button
Seat 1: mhonielsen ($10.71 in chips) 
Seat 2: popypaleta ($12.85 in chips) 
Seat 3: scorpionfish ($11.43 in chips) 
Seat 4: Peter0087 ($11.12 in chips) 
Seat 5: Pokeaster ($10.73 in chips) 
Seat 6: tblocos ($10.79 in chips) 
popypaleta: posts small blind $0.05
scorpionfish: posts big blind $0.10
*** HOLE CARDS ***
Peter0087: folds 
Pokeaster: raises $0.20 to $0.30
tblocos: folds 
mhonielsen: folds 
popypaleta: folds 
scorpionfish: folds 
Uncalled bet ($0.20) returned to Pokeaster
Pokeaster collected $0.25 from pot
*** SUMMARY ***
Total pot $0.25 | Rake $0 
Seat 1: mhonielsen (button) folded before Flop (didn't bet)
Seat 2: popypaleta (small blind) folded before Flop
Seat 3: scorpionfish (big blind) folded before Flop
Seat 4: Peter0087 folded before Flop (didn't bet)
Seat 5: Pokeaster collected ($0.25)
Seat 6: tblocos folded before Flop (didn't bet)



PokerStars Hand #166667942559:  Hold'em No Limit ($0.05/$0.10 USD) - 2017/02/23 16:10:22 ET
Table 'Arpola' 6-max Seat #4 is the button
Seat 1: dincimus ($11.12 in chips) 
Seat 2: patrick19111 ($10.25 in chips) 
Seat 4: Orlangoor ($18.60 in chips) 
Seat 5: truck1234 ($11.66 in chips) 
Seat 6: DasoII ($4.90 in chips) 
truck1234: posts small blind $0.05
DasoII: posts big blind $0.10
*** HOLE CARDS ***
dincimus: folds 
patrick19111: folds 
Orlangoor: folds 
truck1234: raises $0.30 to $0.40
DasoII: calls $0.30
*** FLOP *** [Ac Th 2s]
truck1234: bets $0.50
DasoII: folds 
Uncalled bet ($0.50) returned to truck1234
truck1234 collected $0.76 from pot
*** SUMMARY ***
Total pot $0.80 | Rake $0.04 
Board [Ac Th 2s]
Seat 1: dincimus folded before Flop (didn't bet)
Seat 2: patrick19111 folded before Flop (didn't bet)
Seat 4: Orlangoor (button) folded before Flop (didn't bet)
Seat 5: truck1234 (small blind) collected ($0.76)
Seat 6: DasoII (big blind) folded on the Flop



PokerStars Hand #166667942726:  Hold'em No Limit ($0.05/$0.10 USD) - 2017/02/23 16:10:22 ET
Table 'Arduina' 6-max Seat #1 is the button
Seat 1: tauronex ($11.06 in chips) 
Seat 2: Andy Wolf ($14.35 in chips) 
Seat 3: Dcaro31 ($12.61 in chips) 
Seat 4: ChuikaPridi ($29.20 in chips) 
Seat 5: ettedallas ($7.16 in chips) 
Seat 6: dierri ($8.91 in chips) 
Andy Wolf: posts small blind $0.05
Dcaro31: posts big blind $0.10
*** HOLE CARDS ***
ChuikaPridi: folds 
ettedallas: folds 
dierri: calls $0.10
tauronex: folds 
Andy Wolf: calls $0.05
Dcaro31: checks 
*** FLOP *** [Ks Jd 2h]
Andy Wolf: checks 
Dcaro31: checks 
dierri: checks 
*** TURN *** [Ks Jd 2h] [2s]
Andy Wolf: checks 
Dcaro31: checks 
dierri: checks 
*** RIVER *** [Ks Jd 2h 2s] [9d]
Andy Wolf: checks 
Dcaro31: bets $0.15
dierri: folds 
Andy Wolf: folds 
Uncalled bet ($0.15) returned to Dcaro31
Dcaro31 collected $0.29 from pot
*** SUMMARY ***
Total pot $0.30 | Rake $0.01 
Board [Ks Jd 2h 2s 9d]
Seat 1: tauronex (button) folded before Flop (didn't bet)
Seat 2: Andy Wolf (small blind) folded on the River
Seat 3: Dcaro31 (big blind) collected ($0.29)
Seat 4: ChuikaPridi folded before Flop (didn't bet)
Seat 5: ettedallas folded before Flop (didn't bet)
Seat 6: dierri folded on the River



PokerStars Hand #166667942767:  Hold'em No Limit ($0.05/$0.10 USD) - 2017/02/23 16:10:22 ET
Table 'Atalante' 6-max Seat #1 is the button
Seat 1: OceanBlue100 ($5.14 in chips) 
Seat 2: CiisCi ($19.55 in chips) 
Seat 3: Kow6oy ($10 in chips) 
Seat 4: Dcaro31 ($24.17 in chips) 
Seat 5: eniksenik ($10.56 in chips) 
Seat 6: FlopsterGB ($31.06 in chips) 
CiisCi: posts small blind $0.05
Kow6oy: posts big blind $0.10
*** HOLE CARDS ***
Dcaro31: folds 
eniksenik: raises $0.20 to $0.30
FlopsterGB: folds 
OceanBlue100: folds 
CiisCi: calls $0.25
Kow6oy: folds 
*** FLOP *** [Qh Kc 5h]
CiisCi: checks 
eniksenik: bets $0.22
CiisCi: folds 
Uncalled bet ($0.22) returned to eniksenik
eniksenik collected $0.67 from pot
*** SUMMARY ***
Total pot $0.70 | Rake $0.03 
Board [Qh Kc 5h]
Seat 1: OceanBlue100 (button) folded before Flop (didn't bet)
Seat 2: CiisCi (small blind) folded on the Flop
Seat 3: Kow6oy (big blind) folded before Flop
Seat 4: Dcaro31 folded before Flop (didn't bet)
Seat 5: eniksenik collected ($0.67)
Seat 6: FlopsterGB folded before Flop (didn't bet)



PokerStars Hand #166667943255:  Hold'em No Limit ($0.05/$0.10 USD) - 2017/02/23 16:10:23 ET
Table 'Unitas II' 6-max Seat #4 is the button
Seat 1: Peter0087 ($10.36 in chips) 
Seat 2: steepfell ($10.10 in chips) 
Seat 3: BahiaMinhaP ($10.40 in chips) 
Seat 4: truck1234 ($10.54 in chips) 
Seat 5: chimera252 ($24.08 in chips) 
Seat 6: paxit71 ($9.58 in chips) 
chimera252: posts small blind $0.05
paxit71: posts big blind $0.10
*** HOLE CARDS ***
Peter0087: folds 
steepfell: folds 
BahiaMinhaP: folds 
truck1234: folds 
chimera252: raises $0.20 to $0.30
paxit71: folds 
Uncalled bet ($0.20) returned to chimera252
chimera252 collected $0.20 from pot
*** SUMMARY ***
Total pot $0.20 | Rake $0 
Seat 1: Peter0087 folded before Flop (didn't bet)
Seat 2: steepfell folded before Flop (didn't bet)
Seat 3: BahiaMinhaP folded before Flop (didn't bet)
Seat 4: truck1234 (button) folded before Flop (didn't bet)
Seat 5: chimera252 (small blind) collected ($0.20)
Seat 6: paxit71 (big blind) folded before Flop



PokerStars Hand #166667943341:  Hold'em No Limit ($0.05/$0.10 USD) - 2017/02/23 16:10:23 ET
Table 'Eurydome II' 6-max Seat #4 is the button
Seat 1: rusu_rapid ($11.83 in chips) 
Seat 3: gaHy_HaXeP ($12.09 in chips) 
Seat 4: Smitty03300 ($10 in chips) 
Seat 5: kush-killa87 ($10.64 in chips) 
Seat 6: Jucatorul823 ($4.67 in chips) 
kush-killa87: posts small blind $0.05
Jucatorul823: posts big blind $0.10
Elinaattor: sits out 
*** HOLE CARDS ***
rusu_rapid: folds 
gaHy_HaXeP: folds 
Smitty03300: folds 
kush-killa87: calls $0.05
Jucatorul823: raises $0.20 to $0.30
kush-killa87: calls $0.20
*** FLOP *** [5d Kd 2d]
kush-killa87: bets $0.10
Jucatorul823: raises $0.30 to $0.40
kush-killa87: calls $0.30
*** TURN *** [5d Kd 2d] [Qd]
kush-killa87: bets $0.10
Jucatorul823: calls $0.10
*** RIVER *** [5d Kd 2d Qd] [2c]
kush-killa87: bets $0.10
Jucatorul823: raises $1.10 to $1.20
kush-killa87: calls $1.10
*** SHOW DOWN ***
Jucatorul823: shows [Ad 8d] (a flush, Ace high)
kush-killa87: mucks hand 
Jucatorul823 collected $3.82 from pot
*** SUMMARY ***
Total pot $4 | Rake $0.18 
Board [5d Kd 2d Qd 2c]
Seat 1: rusu_rapid folded before Flop (didn't bet)
Seat 3: gaHy_HaXeP folded before Flop (didn't bet)
Seat 4: Smitty03300 (button) folded before Flop (didn't bet)
Seat 5: kush-killa87 (small blind) mucked
Seat 6: Jucatorul823 (big blind) showed [Ad 8d] and won ($3.82) with a flush, Ace high



PokerStars Hand #166667944022:  Hold'em No Limit ($0.05/$0.10 USD) - 2017/02/23 16:10:23 ET
Table 'Torrence II' 6-max Seat #5 is the button
Seat 1: Starbooks ($6.81 in chips) 
Seat 2: scorpionfish ($15.82 in chips) 
Seat 3: coolisses111 ($9.89 in chips) 
Seat 4: Zooplack ($10 in chips) 
Seat 5: Kow6oy ($12.03 in chips) 
Seat 6: mhonielsen ($10.65 in chips) 
mhonielsen: posts small blind $0.05
Starbooks: posts big blind $0.10
*** HOLE CARDS ***
scorpionfish: folds 
coolisses111: folds 
Zooplack: folds 
Kow6oy: folds 
mhonielsen: raises $0.20 to $0.30
Starbooks: calls $0.20
*** FLOP *** [3s 3c Jh]
mhonielsen: bets $0.40
Starbooks: folds 
Uncalled bet ($0.40) returned to mhonielsen
mhonielsen collected $0.57 from pot
*** SUMMARY ***
Total pot $0.60 | Rake $0.03 
Board [3s 3c Jh]
Seat 1: Starbooks (big blind) folded on the Flop
Seat 2: scorpionfish folded before Flop (didn't bet)
Seat 3: coolisses111 folded before Flop (didn't bet)
Seat 4: Zooplack folded before Flop (didn't bet)
Seat 5: Kow6oy (button) folded before Flop (didn't bet)
Seat 6: mhonielsen (small blind) collected ($0.57)



PokerStars Hand #166667944051:  Hold'em No Limit ($0.05/$0.10 USD) - 2017/02/23 16:10:23 ET
Table 'Wil' 6-max Seat #1 is the button
Seat 1: jwhelan94 ($24.17 in chips) 
Seat 2: Vrinni ($21.85 in chips) 
Seat 3: Namhkal ($10 in chips) 
Seat 4: x3ultimate ($10 in chips) 
Seat 5: Feverhead ($14.78 in chips) 
Seat 6: Comeback3392 ($13.63 in chips) 
Vrinni: posts small blind $0.05
Namhkal: posts big blind $0.10
*** HOLE CARDS ***
x3ultimate: folds 
Feverhead: folds 
Comeback3392: folds 
jwhelan94: folds 
Vrinni: raises $0.15 to $0.25
Namhkal: folds 
Uncalled bet ($0.15) returned to Vrinni
Vrinni collected $0.20 from pot
*** SUMMARY ***
Total pot $0.20 | Rake $0 
Seat 1: jwhelan94 (button) folded before Flop (didn't bet)
Seat 2: Vrinni (small blind) collected ($0.20)
Seat 3: Namhkal (big blind) folded before Flop
Seat 4: x3ultimate folded before Flop (didn't bet)
Seat 5: Feverhead folded before Flop (didn't bet)
Seat 6: Comeback3392 folded before Flop (didn't bet)



PokerStars Hand #166667945102:  Hold'em No Limit ($0.05/$0.10 USD) - 2017/02/23 16:10:25 ET
Table 'Tristan III' 6-max Seat #1 is the button
Seat 1: CHRO8 ($19.04 in chips) 
Seat 2: Hyd SK ($14.53 in chips) 
Seat 4: Feverhead ($11.18 in chips) 
Seat 6: fredrik10528 ($9.65 in chips) 
Hyd SK: posts small blind $0.05
fedorka rus: is sitting out 
Feverhead: posts big blind $0.10
RoJ1: sits out 
*** HOLE CARDS ***
fredrik10528: folds 
CHRO8: folds 
Hyd SK: folds 
Uncalled bet ($0.05) returned to Feverhead
Feverhead collected $0.10 from pot
*** SUMMARY ***
Total pot $0.10 | Rake $0 
Seat 1: CHRO8 (button) folded before Flop (didn't bet)
Seat 2: Hyd SK (small blind) folded before Flop
Seat 4: Feverhead (big blind) collected ($0.10)
Seat 6: fredrik10528 folded before Flop (didn't bet)



PokerStars Hand #166667945280:  Hold'em No Limit ($0.05/$0.10 USD) - 2017/02/23 16:10:25 ET
Table 'Girtab' 6-max Seat #6 is the button
Seat 2: MühliJr ($10.56 in chips) 
Seat 3: kingartur222 ($10.05 in chips) 
Seat 4: Hyd SK ($10.98 in chips) 
Seat 5: sexy_seagull ($11.20 in chips) 
Seat 6: iluzja12 ($9.85 in chips) 
Andrei ProFF will be allowed to play after the button
MühliJr: posts small blind $0.05
kingartur222: posts big blind $0.10
*** HOLE CARDS ***
Andrei ProFF leaves the table
Hyd SK: folds 
sexy_seagull: folds 
iluzja12: raises $0.20 to $0.30
MühliJr: raises $0.70 to $1
kingartur222: folds 
iluzja12: raises $1 to $2
MühliJr: folds 
Uncalled bet ($1) returned to iluzja12
iluzja12 collected $2.10 from pot
*** SUMMARY ***
Total pot $2.10 | Rake $0 
Seat 2: MühliJr (small blind) folded before Flop
Seat 3: kingartur222 (big blind) folded before Flop
Seat 4: Hyd SK folded before Flop (didn't bet)
Seat 5: sexy_seagull folded before Flop (didn't bet)
Seat 6: iluzja12 (button) collected ($2.10)



PokerStars Hand #166667945311:  Hold'em No Limit ($0.05/$0.10 USD) - 2017/02/23 16:10:25 ET
Table 'Apollonia' 6-max Seat #2 is the button
Seat 1: ex3Lero86 ($10 in chips) 
Seat 2: ibara000 ($18.28 in chips) 
Seat 3: steepfell ($10.43 in chips) 
Seat 4: Goroshkos88 ($17.47 in chips) 
Seat 6: iluzja12 ($10.37 in chips) 
steepfell: posts small blind $0.05
Goroshkos88: posts big blind $0.10
bambolejro: sits out 
*** HOLE CARDS ***
iluzja12: folds 
ex3Lero86: folds 
ibara000: raises $0.16 to $0.26
steepfell: folds 
Goroshkos88: calls $0.16
*** FLOP *** [Ts Ah Qd]
Goroshkos88: checks 
ibara000: bets $0.17
Goroshkos88: calls $0.17
*** TURN *** [Ts Ah Qd] [7h]
Goroshkos88: bets $0.58
ibara000: folds 
Uncalled bet ($0.58) returned to Goroshkos88
Goroshkos88 collected $0.87 from pot
*** SUMMARY ***
Total pot $0.91 | Rake $0.04 
Board [Ts Ah Qd 7h]
Seat 1: ex3Lero86 folded before Flop (didn't bet)
Seat 2: ibara000 (button) folded on the Turn
Seat 3: steepfell (small blind) folded before Flop
Seat 4: Goroshkos88 (big blind) collected ($0.87)
Seat 6: iluzja12 folded before Flop (didn't bet)



PokerStars Hand #166667945376:  Hold'em No Limit ($0.05/$0.10 USD) - 2017/02/23 16:10:25 ET
Table 'Stroobantia' 6-max Seat #6 is the button
Seat 1: mam9zyc ($10.28 in chips) 
Seat 2: XwinX25 ($10 in chips) 
Seat 3: Namhkal ($11.05 in chips) 
Seat 4: Yspenyanin ($10.45 in chips) 
Seat 5: boxer821 ($10.84 in chips) 
Seat 6: KokoulinV ($15.52 in chips) 
mam9zyc: posts small blind $0.05
XwinX25: posts big blind $0.10
*** HOLE CARDS ***
Namhkal: folds 
Yspenyanin is connected 
Yspenyanin: folds 
boxer821: folds 
KokoulinV: folds 
mam9zyc: calls $0.05
XwinX25: checks 
*** FLOP *** [4s 9s As]
mam9zyc: bets $0.10
XwinX25: folds 
Uncalled bet ($0.10) returned to mam9zyc
mam9zyc collected $0.19 from pot
*** SUMMARY ***
Total pot $0.20 | Rake $0.01 
Board [4s 9s As]
Seat 1: mam9zyc (small blind) collected ($0.19)
Seat 2: XwinX25 (big blind) folded on the Flop
Seat 3: Namhkal folded before Flop (didn't bet)
Seat 4: Yspenyanin folded before Flop (didn't bet)
Seat 5: boxer821 folded before Flop (didn't bet)
Seat 6: KokoulinV (button) folded before Flop (didn't bet)



PokerStars Hand #166667946520:  Hold'em No Limit ($0.05/$0.10 USD) - 2017/02/23 16:10:26 ET
Table 'Huberta II' 6-max Seat #5 is the button
Seat 1: tr41n3r12 ($10 in chips) 
Seat 2: Ice_Isayev ($10 in chips) 
Seat 3: patrick19111 ($12.56 in chips) 
Seat 4: VAD21 ($11.96 in chips) 
Seat 5: Feverhead ($27.55 in chips) 
Seat 6: yodzik ($5.73 in chips) 
yodzik: posts small blind $0.05
tr41n3r12: posts big blind $0.10
*** HOLE CARDS ***
Ice_Isayev: folds 
patrick19111: raises $0.20 to $0.30
VAD21: folds 
Feverhead: folds 
yodzik: folds 
tr41n3r12: folds 
Uncalled bet ($0.20) returned to patrick19111
patrick19111 collected $0.25 from pot
*** SUMMARY ***
Total pot $0.25 | Rake $0 
Seat 1: tr41n3r12 (big blind) folded before Flop
Seat 2: Ice_Isayev folded before Flop (didn't bet)
Seat 3: patrick19111 collected ($0.25)
Seat 4: VAD21 folded before Flop (didn't bet)
Seat 5: Feverhead (button) folded before Flop (didn't bet)
Seat 6: yodzik (small blind) folded before Flop



PokerStars Hand #166667946591:  Hold'em No Limit ($0.05/$0.10 USD) - 2017/02/23 16:10:26 ET
Table 'Gaika II' 6-max Seat #6 is the button
Seat 1: Ice_Isayev ($10 in chips) 
Seat 2: steepfell ($12.01 in chips) 
Seat 3: iDecMate ($18.73 in chips) 
Seat 4: Hyd SK ($10.43 in chips) 
Seat 5: KokoulinV ($12.71 in chips) 
Seat 6: bartabs2 ($8.72 in chips) 
Ice_Isayev: posts small blind $0.05
steepfell: posts big blind $0.10
*** HOLE CARDS ***
iDecMate: folds 
Hyd SK: folds 
KokoulinV: folds 
bartabs2: folds 
Ice_Isayev: raises $0.15 to $0.25
steepfell: folds 
Uncalled bet ($0.15) returned to Ice_Isayev
Ice_Isayev collected $0.20 from pot
*** SUMMARY ***
Total pot $0.20 | Rake $0 
Seat 1: Ice_Isayev (small blind) collected ($0.20)
Seat 2: steepfell (big blind) folded before Flop
Seat 3: iDecMate folded before Flop (didn't bet)
Seat 4: Hyd SK folded before Flop (didn't bet)
Seat 5: KokoulinV folded before Flop (didn't bet)
Seat 6: bartabs2 (button) folded before Flop (didn't bet)



PokerStars Hand #166667946630:  Hold'em No Limit ($0.05/$0.10 USD) - 2017/02/23 16:10:26 ET
Table 'Gelria' 6-max Seat #2 is the button
Seat 1: ab260414 ($10.17 in chips) 
Seat 2: fishhook5 ($11.59 in chips) 
Seat 3: Orlangoor ($10.98 in chips) 
Seat 4: eniksenik ($10.15 in chips) 
Seat 5: apenvel ($8.23 in chips) 
Orlangoor: posts small blind $0.05
eniksenik: posts big blind $0.10
x3ultimate: sits out 
*** HOLE CARDS ***
apenvel: folds 
ab260414: folds 
fishhook5: raises $0.14 to $0.24
Orlangoor: folds 
eniksenik: raises $0.56 to $0.80
fishhook5: calls $0.56
*** FLOP *** [Kh 5c 9c]
eniksenik: bets $0.52
fishhook5: calls $0.52
*** TURN *** [Kh 5c 9c] [8s]
eniksenik: checks 
fishhook5: checks 
*** RIVER *** [Kh 5c 9c 8s] [Kd]
eniksenik: checks 
fishhook5: bets $1.40
eniksenik: folds 
Uncalled bet ($1.40) returned to fishhook5
fishhook5 collected $2.57 from pot
*** SUMMARY ***
Total pot $2.69 | Rake $0.12 
Board [Kh 5c 9c 8s Kd]
Seat 1: ab260414 folded before Flop (didn't bet)
Seat 2: fishhook5 (button) collected ($2.57)
Seat 3: Orlangoor (small blind) folded before Flop
Seat 4: eniksenik (big blind) folded on the River
Seat 5: apenvel folded before Flop (didn't bet)



PokerStars Hand #166667946875:  Hold'em No Limit ($0.05/$0.10 USD) - 2017/02/23 16:10:27 ET
Table 'Garlena III' 6-max Seat #6 is the button
Seat 1: dittoro ($11.44 in chips) 
Seat 2: YY778 ($10.20 in chips) 
Seat 3: IAntikI ($10 in chips) 
Seat 4: mbkongstad ($9.70 in chips) 
Seat 5: steepfell ($10 in chips) 
Seat 6: iluzja12 ($9.80 in chips) 
dittoro: posts small blind $0.05
YY778: posts big blind $0.10
*** HOLE CARDS ***
IAntikI: folds 
mbkongstad: folds 
steepfell: folds 
iluzja12: raises $0.20 to $0.30
dittoro: folds 
YY778: calls $0.20
*** FLOP *** [8s 2d 7h]
YY778: bets $0.80
iluzja12: folds 
Uncalled bet ($0.80) returned to YY778
YY778 collected $0.62 from pot
*** SUMMARY ***
Total pot $0.65 | Rake $0.03 
Board [8s 2d 7h]
Seat 1: dittoro (small blind) folded before Flop
Seat 2: YY778 (big blind) collected ($0.62)
Seat 3: IAntikI folded before Flop (didn't bet)
Seat 4: mbkongstad folded before Flop (didn't bet)
Seat 5: steepfell folded before Flop (didn't bet)
Seat 6: iluzja12 (button) folded on the Flop



PokerStars Hand #166667946894:  Hold'em No Limit ($0.05/$0.10 USD) - 2017/02/23 16:10:27 ET
Table 'Girtab II' 6-max Seat #1 is the button
Seat 1: marianoboni ($11.71 in chips) 
Seat 2: Pokeaster ($13.04 in chips) 
Seat 3: chimera252 ($13.55 in chips) 
Seat 4: Hyd SK ($27.03 in chips) 
Seat 6: DamDatsAnAce ($10 in chips) 
Pokeaster: posts small blind $0.05
chimera252: posts big blind $0.10
*** HOLE CARDS ***
Hyd SK: folds 
DamDatsAnAce: folds 
k0chi1977 joins the table at seat #5 
marianoboni: folds 
Pokeaster: raises $0.20 to $0.30
chimera252: calls $0.20
*** FLOP *** [Ks 5h Ts]
Pokeaster: bets $0.43
chimera252: calls $0.43
*** TURN *** [Ks 5h Ts] [8d]
Pokeaster: checks 
chimera252: checks 
*** RIVER *** [Ks 5h Ts 8d] [Ah]
Pokeaster: bets $1.10
chimera252: calls $1.10
*** SHOW DOWN ***
Pokeaster: shows [Jh Ac] (a pair of Aces)
chimera252: shows [Ad 5c] (two pair, Aces and Fives)
chimera252 collected $3.50 from pot
*** SUMMARY ***
Total pot $3.66 | Rake $0.16 
Board [Ks 5h Ts 8d Ah]
Seat 1: marianoboni (button) folded before Flop (didn't bet)
Seat 2: Pokeaster (small blind) showed [Jh Ac] and lost with a pair of Aces
Seat 3: chimera252 (big blind) showed [Ad 5c] and won ($3.50) with two pair, Aces and Fives
Seat 4: Hyd SK folded before Flop (didn't bet)
Seat 6: DamDatsAnAce folded before Flop (didn't bet)



PokerStars Hand #166667946947:  Hold'em No Limit ($0.05/$0.10 USD) - 2017/02/23 16:10:27 ET
Table 'Deflotte' 6-max Seat #6 is the button
Seat 1: Zooplack ($17.25 in chips) 
Seat 2: MonteCris92 ($10.15 in chips) 
Seat 4: 8th wonders ($10.37 in chips) 
Seat 5: Pokeaster ($11.47 in chips) 
Seat 6: Iarlei ($10.30 in chips) 
Zooplack: posts small blind $0.05
MonteCris92: posts big blind $0.10
Yspenyanin is connected 
Yspenyanin: sits out 
*** HOLE CARDS ***
8th wonders: folds 
Pokeaster: raises $0.20 to $0.30
Iarlei: folds 
Zooplack: folds 
MonteCris92: folds 
Uncalled bet ($0.20) returned to Pokeaster
Pokeaster collected $0.25 from pot
*** SUMMARY ***
Total pot $0.25 | Rake $0 
Seat 1: Zooplack (small blind) folded before Flop
Seat 2: MonteCris92 (big blind) folded before Flop
Seat 4: 8th wonders folded before Flop (didn't bet)
Seat 5: Pokeaster collected ($0.25)
Seat 6: Iarlei (button) folded before Flop (didn't bet)



PokerStars Hand #166667947294:  Hold'em No Limit ($0.05/$0.10 USD) - 2017/02/23 16:10:27 ET
Table 'Lehigh' 6-max Seat #2 is the button
Seat 1: pokekrk ($10 in chips) 
Seat 2: Sbozzz ($20.95 in chips) 
Seat 5: Slavoaca693 ($7.90 in chips) 
Cluckh will be allowed to play after the button
manashov will be allowed to play after the button
Slavoaca693: posts small blind $0.05
RoJ1: is sitting out 
pokekrk: posts big blind $0.10
*** HOLE CARDS ***
Sbozzz: folds 
Slavoaca693: folds 
Uncalled bet ($0.05) returned to pokekrk
pokekrk collected $0.10 from pot
*** SUMMARY ***
Total pot $0.10 | Rake $0 
Seat 1: pokekrk (big blind) collected ($0.10)
Seat 2: Sbozzz (button) folded before Flop (didn't bet)
Seat 5: Slavoaca693 (small blind) folded before Flop



PokerStars Hand #166667948467:  Hold'em No Limit ($0.05/$0.10 USD) - 2017/02/23 16:10:29 ET
Table 'Pirola' 6-max Seat #1 is the button
Seat 1: Rodik002 ($10.51 in chips) 
Seat 2: lmlmlmlm90 ($17.81 in chips) 
Seat 3: Goroshkos88 ($10 in chips) 
Seat 4: barons89 ($11.61 in chips) 
Seat 5: Iarlei ($13.76 in chips) 
Seat 6: Hyd SK ($13.19 in chips) 
lmlmlmlm90: posts small blind $0.05
Goroshkos88: posts big blind $0.10
*** HOLE CARDS ***
barons89: folds 
Iarlei: folds 
Hyd SK: folds 
Rodik002: folds 
lmlmlmlm90: calls $0.05
Goroshkos88: raises $0.20 to $0.30
lmlmlmlm90: calls $0.20
*** FLOP *** [Qh 9c 3d]
lmlmlmlm90: checks 
Goroshkos88: bets $0.34
lmlmlmlm90: calls $0.34
*** TURN *** [Qh 9c 3d] [7d]
lmlmlmlm90: checks 
Goroshkos88: bets $0.81
lmlmlmlm90: calls $0.81
*** RIVER *** [Qh 9c 3d 7d] [As]
lmlmlmlm90: checks 
Goroshkos88: checks 
*** SHOW DOWN ***
lmlmlmlm90: shows [4d Kd] (high card Ace)
Goroshkos88: shows [Qc Tc] (a pair of Queens)
Goroshkos88 collected $2.77 from pot
*** SUMMARY ***
Total pot $2.90 | Rake $0.13 
Board [Qh 9c 3d 7d As]
Seat 1: Rodik002 (button) folded before Flop (didn't bet)
Seat 2: lmlmlmlm90 (small blind) showed [4d Kd] and lost with high card Ace
Seat 3: Goroshkos88 (big blind) showed [Qc Tc] and won ($2.77) with a pair of Queens
Seat 4: barons89 folded before Flop (didn't bet)
Seat 5: Iarlei folded before Flop (didn't bet)
Seat 6: Hyd SK folded before Flop (didn't bet)



PokerStars Hand #166667948732:  Hold'em No Limit ($0.05/$0.10 USD) - 2017/02/23 16:10:29 ET
Table 'Alzirr II' 6-max Seat #6 is the button
Seat 2: popypaleta ($10.50 in chips) 
Seat 3: devon_red ($7.35 in chips) 
Seat 5: yodzik ($5.73 in chips) 
Seat 6: AM-L-SL ($4.33 in chips) 
popypaleta: posts small blind $0.05
devon_red: posts big blind $0.10
Scanner17: sits out 
*** HOLE CARDS ***
Andrei ProFF joins the table at seat #1 
yodzik: folds 
Andrei ProFF leaves the table
AM-L-SL: folds 
popypaleta: raises $0.20 to $0.30
Kow6oy joins the table at seat #1 
devon_red: folds 
Uncalled bet ($0.20) returned to popypaleta
popypaleta collected $0.20 from pot
*** SUMMARY ***
Total pot $0.20 | Rake $0 
Seat 2: popypaleta (small blind) collected ($0.20)
Seat 3: devon_red (big blind) folded before Flop
Seat 5: yodzik folded before Flop (didn't bet)
Seat 6: AM-L-SL (button) folded before Flop (didn't bet)



PokerStars Hand #166667948738:  Hold'em No Limit ($0.05/$0.10 USD) - 2017/02/23 16:10:29 ET
Table 'Rostia' 6-max Seat #3 is the button
Seat 3: iThreeBarrel ($10.15 in chips) 
Seat 4: Hyd SK ($11.68 in chips) 
Seat 5: silsilviu ($7.67 in chips) 
Seat 6: Giyorod ($16.53 in chips) 
Hyd SK: posts small blind $0.05
silsilviu: posts big blind $0.10
*** HOLE CARDS ***
Giyorod: folds 
iThreeBarrel: raises $0.15 to $0.25
Hyd SK: raises $0.75 to $1
silsilviu: folds 
iThreeBarrel: folds 
Uncalled bet ($0.75) returned to Hyd SK
GrzesiuWilu joins the table at seat #2 
Hyd SK collected $0.60 from pot
*** SUMMARY ***
Total pot $0.60 | Rake $0 
Seat 3: iThreeBarrel (button) folded before Flop
Seat 4: Hyd SK (small blind) collected ($0.60)
Seat 5: silsilviu (big blind) folded before Flop
Seat 6: Giyorod folded before Flop (didn't bet)



PokerStars Hand #166667948783:  Hold'em No Limit ($0.05/$0.10 USD) - 2017/02/23 16:10:29 ET
Table 'Risha II' 6-max Seat #1 is the button
Seat 1: marianoboni ($10 in chips) 
Seat 3: steepfell ($10.05 in chips) 
Seat 4: Comeback3392 ($19.53 in chips) 
Seat 5: m.c-alkatraz ($9.90 in chips) 
Seat 6: univibe68 ($11.16 in chips) 
steepfell: posts small blind $0.05
Comeback3392: posts big blind $0.10
*** HOLE CARDS ***
m.c-alkatraz: folds 
univibe68: folds 
marianoboni: folds 
steepfell: folds 
Uncalled bet ($0.05) returned to Comeback3392
Comeback3392 collected $0.10 from pot
*** SUMMARY ***
Total pot $0.10 | Rake $0 
Seat 1: marianoboni (button) folded before Flop (didn't bet)
Seat 3: steepfell (small blind) folded before Flop
Seat 4: Comeback3392 (big blind) collected ($0.10)
Seat 5: m.c-alkatraz folded before Flop (didn't bet)
Seat 6: univibe68 folded before Flop (didn't bet)



PokerStars Hand #166667949472:  Hold'em No Limit ($0.05/$0.10 USD) - 2017/02/23 16:10:30 ET
Table 'Lesath III' 6-max Seat #3 is the button
Seat 1: Gogeta26 ($7 in chips) 
Seat 2: WinninBikini ($10.17 in chips) 
Seat 3: Giyorod ($10.51 in chips) 
Seat 4: Eddys Edge ($10.26 in chips) 
Seat 5: eniksenik ($15.85 in chips) 
Seat 6: patrick19111 ($10.21 in chips) 
Eddys Edge: posts small blind $0.05
eniksenik: posts big blind $0.10
*** HOLE CARDS ***
patrick19111: folds 
Gogeta26: folds 
WinninBikini: folds 
Giyorod: folds 
Eddys Edge: raises $0.15 to $0.25
eniksenik: folds 
Uncalled bet ($0.15) returned to Eddys Edge
Eddys Edge collected $0.20 from pot
*** SUMMARY ***
Total pot $0.20 | Rake $0 
Seat 1: Gogeta26 folded before Flop (didn't bet)
Seat 2: WinninBikini folded before Flop (didn't bet)
Seat 3: Giyorod (button) folded before Flop (didn't bet)
Seat 4: Eddys Edge (small blind) collected ($0.20)
Seat 5: eniksenik (big blind) folded before Flop
Seat 6: patrick19111 folded before Flop (didn't bet)



PokerStars Hand #166667949784:  Hold'em No Limit ($0.05/$0.10 USD) - 2017/02/23 16:10:30 ET
Table 'Sirius II' 6-max Seat #5 is the button
Seat 1: Cluckh ($10 in chips) 
Seat 2: Buddy8711 ($8.83 in chips) 
Seat 3: Spud014 ($10 in chips) 
Seat 4: Pekaml ($10.15 in chips) 
Seat 5: manashov ($10.27 in chips) 
Seat 6: MihaGr ($10 in chips) 
MihaGr: posts small blind $0.05
Cluckh: posts big blind $0.10
*** HOLE CARDS ***
Buddy8711: calls $0.10
Spud014: folds 
Pekaml: folds 
manashov: folds 
MihaGr: folds 
Cluckh: checks 
*** FLOP *** [3h Qs Jh]
Cluckh: bets $0.20
Buddy8711: calls $0.20
*** TURN *** [3h Qs Jh] [Ts]
Cluckh: bets $0.50
Buddy8711: folds 
Uncalled bet ($0.50) returned to Cluckh
Cluckh collected $0.62 from pot
*** SUMMARY ***
Total pot $0.65 | Rake $0.03 
Board [3h Qs Jh Ts]
Seat 1: Cluckh (big blind) collected ($0.62)
Seat 2: Buddy8711 folded on the Turn
Seat 3: Spud014 folded before Flop (didn't bet)
Seat 4: Pekaml folded before Flop (didn't bet)
Seat 5: manashov (button) folded before Flop (didn't bet)
Seat 6: MihaGr (small blind) folded before Flop



PokerStars Hand #166667949850:  Hold'em No Limit ($0.05/$0.10 USD) - 2017/02/23 16:10:30 ET
Table 'Glarona' 6-max Seat #4 is the button
Seat 1: LarryTheStar ($10.15 in chips) 
Seat 2: BookWorm78 ($10.25 in chips) 
Seat 4: CrippledGod ($6.89 in chips) 
Seat 6: marianoboni ($10.05 in chips) 
marianoboni: posts small blind $0.05
LarryTheStar: posts big blind $0.10
*** HOLE CARDS ***
BookWorm78: folds 
CrippledGod: raises $0.10 to $0.20
marianoboni: folds 
LarryTheStar: folds 
Uncalled bet ($0.10) returned to CrippledGod
CrippledGod collected $0.25 from pot
*** SUMMARY ***
Total pot $0.25 | Rake $0 
Seat 1: LarryTheStar (big blind) folded before Flop
Seat 2: BookWorm78 folded before Flop (didn't bet)
Seat 4: CrippledGod (button) collected ($0.25)
Seat 6: marianoboni (small blind) folded before Flop



PokerStars Hand #166667950092:  Hold'em No Limit ($0.05/$0.10 USD) - 2017/02/23 16:10:30 ET
Table 'Themisto II' 6-max Seat #2 is the button
Seat 1: ChuikaPridi ($10.25 in chips) 
Seat 2: CA225 ($11.81 in chips) 
Seat 3: eniksenik ($15.96 in chips) 
Seat 4: DrVzad ($10 in chips) 
Seat 5: ex3Lero86 ($10.94 in chips) 
Seat 6: noobigrok ($2.47 in chips) 
eniksenik: posts small blind $0.05
DrVzad: posts big blind $0.10
*** HOLE CARDS ***
ex3Lero86: folds 
noobigrok: folds 
ChuikaPridi: folds 
CA225: folds 
eniksenik: raises $0.20 to $0.30
DrVzad: folds 
Uncalled bet ($0.20) returned to eniksenik
eniksenik collected $0.20 from pot
*** SUMMARY ***
Total pot $0.20 | Rake $0 
Seat 1: ChuikaPridi folded before Flop (didn't bet)
Seat 2: CA225 (button) folded before Flop (didn't bet)
Seat 3: eniksenik (small blind) collected ($0.20)
Seat 4: DrVzad (big blind) folded before Flop
Seat 5: ex3Lero86 folded before Flop (didn't bet)
Seat 6: noobigrok folded before Flop (didn't bet)



PokerStars Hand #166667950208:  Hold'em No Limit ($0.05/$0.10 USD) - 2017/02/23 16:10:30 ET
Table 'Nephthys II' 6-max Seat #2 is the button
Seat 1: DamDatsAnAce ($10 in chips) 
Seat 2: Ju$tD0it ($8.34 in chips) 
Seat 3: Newqbrown ($19.56 in chips) 
Seat 4: MihaGr ($10 in chips) 
Seat 5: kingartur222 ($8.61 in chips) 
Seat 6: CHRO8 ($19.76 in chips) 
Newqbrown: posts small blind $0.05
MihaGr: posts big blind $0.10
*** HOLE CARDS ***
kingartur222: folds 
CHRO8: folds 
DamDatsAnAce: folds 
Ju$tD0it: folds 
Newqbrown: folds 
Uncalled bet ($0.05) returned to MihaGr
MihaGr collected $0.10 from pot
*** SUMMARY ***
Total pot $0.10 | Rake $0 
Seat 1: DamDatsAnAce folded before Flop (didn't bet)
Seat 2: Ju$tD0it (button) folded before Flop (didn't bet)
Seat 3: Newqbrown (small blind) folded before Flop
Seat 4: MihaGr (big blind) collected ($0.10)
Seat 5: kingartur222 folded before Flop (didn't bet)
Seat 6: CHRO8 folded before Flop (didn't bet)



PokerStars Hand #166667950425:  Hold'em No Limit ($0.05/$0.10 USD) - 2017/02/23 16:10:31 ET
Table 'Lampetia' 6-max Seat #4 is the button
Seat 1: WinninBikini ($10.03 in chips) 
Seat 2: ex3Lero86 ($10.30 in chips) 
Seat 3: Ice_Isayev ($19.74 in chips) 
Seat 4: Rodik002 ($10 in chips) 
Seat 5: luisantrs ($10.84 in chips) 
Seat 6: Scanner17 ($12.09 in chips) 
luisantrs: posts small blind $0.05
Scanner17: posts big blind $0.10
*** HOLE CARDS ***
WinninBikini: folds 
ex3Lero86: folds 
Ice_Isayev: folds 
Rodik002: raises $0.10 to $0.20
luisantrs: calls $0.15
Scanner17: folds 
*** FLOP *** [9c 7s 5c]
luisantrs: checks 
Rodik002: bets $0.26
luisantrs: calls $0.26
*** TURN *** [9c 7s 5c] [9d]
luisantrs: checks 
Rodik002: bets $0.56
luisantrs: calls $0.56
*** RIVER *** [9c 7s 5c 9d] [8d]
luisantrs: checks 
Rodik002: checks 
*** SHOW DOWN ***
luisantrs: shows [Qd Qs] (two pair, Queens and Nines)
Rodik002: mucks hand 
luisantrs collected $2.04 from pot
*** SUMMARY ***
Total pot $2.14 | Rake $0.10 
Board [9c 7s 5c 9d 8d]
Seat 1: WinninBikini folded before Flop (didn't bet)
Seat 2: ex3Lero86 folded before Flop (didn't bet)
Seat 3: Ice_Isayev folded before Flop (didn't bet)
Seat 4: Rodik002 (button) mucked
Seat 5: luisantrs (small blind) showed [Qd Qs] and won ($2.04) with two pair, Queens and Nines
Seat 6: Scanner17 (big blind) folded before Flop



PokerStars Hand #166667950567:  Hold'em No Limit ($0.05/$0.10 USD) - 2017/02/23 16:10:31 ET
Table 'Martha' 6-max Seat #4 is the button
Seat 1: Peter0087 ($9.99 in chips) 
Seat 2: pauli95 ($10.81 in chips) 
Seat 3: Hyd SK ($12.37 in chips) 
Seat 4: dittoro ($10 in chips) 
Seat 5: MihaGr ($10 in chips) 
Seat 6: 8th wonders ($10.61 in chips) 
MihaGr: posts small blind $0.05
8th wonders: posts big blind $0.10
*** HOLE CARDS ***
Peter0087: folds 
pauli95: folds 
Hyd SK: folds 
dittoro: folds 
MihaGr: folds 
Uncalled bet ($0.05) returned to 8th wonders
8th wonders collected $0.10 from pot
*** SUMMARY ***
Total pot $0.10 | Rake $0 
Seat 1: Peter0087 folded before Flop (didn't bet)
Seat 2: pauli95 folded before Flop (didn't bet)
Seat 3: Hyd SK folded before Flop (didn't bet)
Seat 4: dittoro (button) folded before Flop (didn't bet)
Seat 5: MihaGr (small blind) folded before Flop
Seat 6: 8th wonders (big blind) collected ($0.10)



PokerStars Hand #166667950591:  Hold'em No Limit ($0.05/$0.10 USD) - 2017/02/23 16:10:31 ET
Table 'Eudora' 6-max Seat #5 is the button
Seat 1: archer2511 ($12.40 in chips) 
Seat 2: popypaleta ($10 in chips) 
Seat 3: Ice_Isayev ($10.45 in chips) 
Seat 4: yodzik ($5 in chips) 
Seat 5: chimera252 ($11.11 in chips) 
Seat 6: HARDCORE66RU ($10.05 in chips) 
HARDCORE66RU: posts small blind $0.05
archer2511: posts big blind $0.10
*** HOLE CARDS ***
popypaleta: folds 
Ice_Isayev: raises $0.20 to $0.30
yodzik: folds 
chimera252: calls $0.30
HARDCORE66RU: folds 
archer2511: folds 
*** FLOP *** [Kd 5h 6s]
Ice_Isayev: checks 
chimera252: bets $0.35
Ice_Isayev: folds 
Uncalled bet ($0.35) returned to chimera252
chimera252 collected $0.72 from pot
*** SUMMARY ***
Total pot $0.75 | Rake $0.03 
Board [Kd 5h 6s]
Seat 1: archer2511 (big blind) folded before Flop
Seat 2: popypaleta folded before Flop (didn't bet)
Seat 3: Ice_Isayev folded on the Flop
Seat 4: yodzik folded before Flop (didn't bet)
Seat 5: chimera252 (button) collected ($0.72)
Seat 6: HARDCORE66RU (small blind) folded before Flop



PokerStars Hand #166667950700:  Hold'em No Limit ($0.05/$0.10 USD) - 2017/02/23 16:10:31 ET
Table 'Antinous' 6-max Seat #3 is the button
Seat 1: Andrei ProFF ($16.55 in chips) 
Seat 2: Nr847 ($13.45 in chips) 
Seat 3: dittoro ($10 in chips) 
Seat 4: Pekaml ($15.35 in chips) 
Seat 5: Covetsoles ($4.02 in chips) 
Seat 6: coolisses111 ($9.25 in chips) 
Pekaml: posts small blind $0.05
Covetsoles: posts big blind $0.10
*** HOLE CARDS ***
coolisses111: folds 
Andrei ProFF: folds 
Nr847: folds 
dittoro: folds 
Pekaml: raises $0.10 to $0.20
Covetsoles: raises $0.10 to $0.30
Pekaml: calls $0.10
*** FLOP *** [Kh Qh Kd]
Pekaml: checks 
Covetsoles: checks 
*** TURN *** [Kh Qh Kd] [Qd]
Pekaml: checks 
Covetsoles: checks 
*** RIVER *** [Kh Qh Kd Qd] [5c]
Pekaml: bets $0.38
Covetsoles: calls $0.38
*** SHOW DOWN ***
Pekaml: shows [7h 6d] (two pair, Kings and Queens)
Covetsoles: shows [8c 8s] (two pair, Kings and Queens - Eight kicker)
Covetsoles collected $1.30 from pot
*** SUMMARY ***
Total pot $1.36 | Rake $0.06 
Board [Kh Qh Kd Qd 5c]
Seat 1: Andrei ProFF folded before Flop (didn't bet)
Seat 2: Nr847 folded before Flop (didn't bet)
Seat 3: dittoro (button) folded before Flop (didn't bet)
Seat 4: Pekaml (small blind) showed [7h 6d] and lost with two pair, Kings and Queens
Seat 5: Covetsoles (big blind) showed [8c 8s] and won ($1.30) with two pair, Kings and Queens
Seat 6: coolisses111 folded before Flop (didn't bet)



PokerStars Hand #166667950764:  Hold'em No Limit ($0.05/$0.10 USD) - 2017/02/23 16:10:31 ET
Table 'Pallas II' 6-max Seat #4 is the button
Seat 1: mdelfin0 ($16.49 in chips) 
Seat 3: popypaleta ($10.45 in chips) 
Seat 4: MisterX413 ($10 in chips) 
Seat 6: Smitty03300 ($10 in chips) 
Smitty03300: posts small blind $0.05
mdelfin0: posts big blind $0.10
*** HOLE CARDS ***
popypaleta: folds 
MisterX413: folds 
Smitty03300: folds 
Uncalled bet ($0.05) returned to mdelfin0
mdelfin0 collected $0.10 from pot
*** SUMMARY ***
Total pot $0.10 | Rake $0 
Seat 1: mdelfin0 (big blind) collected ($0.10)
Seat 3: popypaleta folded before Flop (didn't bet)
Seat 4: MisterX413 (button) folded before Flop (didn't bet)
Seat 6: Smitty03300 (small blind) folded before Flop



PokerStars Hand #166667950835:  Hold'em No Limit ($0.05/$0.10 USD) - 2017/02/23 16:10:31 ET
Table 'Kunigunde II' 6-max Seat #2 is the button
Seat 1: facewald ($9.88 in chips) 
Seat 2: DrVzad ($10.15 in chips) 
Seat 3: pancernik21 ($17.04 in chips) 
Seat 5: mdelfin0 ($12.58 in chips) 
Seat 6: Zooplack ($10.15 in chips) 
pancernik21: posts small blind $0.05
mdelfin0: posts big blind $0.10
*** HOLE CARDS ***
Zooplack: folds 
facewald: folds 
DrVzad: folds 
pancernik21: folds 
Uncalled bet ($0.05) returned to mdelfin0
mdelfin0 collected $0.10 from pot
*** SUMMARY ***
Total pot $0.10 | Rake $0 
Seat 1: facewald folded before Flop (didn't bet)
Seat 2: DrVzad (button) folded before Flop (didn't bet)
Seat 3: pancernik21 (small blind) folded before Flop
Seat 5: mdelfin0 (big blind) collected ($0.10)
Seat 6: Zooplack folded before Flop (didn't bet)



PokerStars Hand #166667951142:  Hold'em No Limit ($0.05/$0.10 USD) - 2017/02/23 16:10:31 ET
Table 'Walpurga' 6-max Seat #4 is the button
Seat 1: chimera252 ($11.97 in chips) 
Seat 2: paxit71 ($5.10 in chips) 
Seat 3: marianoboni ($16.36 in chips) 
Seat 4: oddshoff ($12.74 in chips) 
Fremara will be allowed to play after the button
chimera252: posts small blind $0.05
paxit71: posts big blind $0.10
*** HOLE CARDS ***
marianoboni: folds 
marianoboni leaves the table
oddshoff: raises $0.10 to $0.20
chimera252: folds 
paxit71: folds 
Uncalled bet ($0.10) returned to oddshoff
oddshoff collected $0.25 from pot
*** SUMMARY ***
Total pot $0.25 | Rake $0 
Seat 1: chimera252 (small blind) folded before Flop
Seat 2: paxit71 (big blind) folded before Flop
Seat 3: marianoboni folded before Flop (didn't bet)
Seat 4: oddshoff (button) collected ($0.25)



PokerStars Hand #166667951195:  Hold'em No Limit ($0.05/$0.10 USD) - 2017/02/23 16:10:32 ET
Table 'Epimetheus' 6-max Seat #1 is the button
Seat 1: 6ePeMeHHa9 ($10.29 in chips) 
Seat 2: patrick19111 ($15.81 in chips) 
Seat 3: dineldidi ($9.84 in chips) 
Seat 4: Namhkal ($10 in chips) 
Seat 5: afca128 ($24.18 in chips) 
Seat 6: voledy ($10.20 in chips) 
patrick19111: posts small blind $0.05
dineldidi: posts big blind $0.10
*** HOLE CARDS ***
Namhkal: folds 
afca128: folds 
voledy: raises $0.20 to $0.30
6ePeMeHHa9: folds 
patrick19111: folds 
dineldidi: folds 
Uncalled bet ($0.20) returned to voledy
voledy collected $0.25 from pot
*** SUMMARY ***
Total pot $0.25 | Rake $0 
Seat 1: 6ePeMeHHa9 (button) folded before Flop (didn't bet)
Seat 2: patrick19111 (small blind) folded before Flop
Seat 3: dineldidi (big blind) folded before Flop
Seat 4: Namhkal folded before Flop (didn't bet)
Seat 5: afca128 folded before Flop (didn't bet)
Seat 6: voledy collected ($0.25)



PokerStars Hand #166667951201:  Hold'em No Limit ($0.05/$0.10 USD) - 2017/02/23 16:10:32 ET
Table 'Nekkar' 6-max Seat #6 is the button
Seat 1: aapokerkot ($11.87 in chips) 
Seat 2: Bird et al ($10.87 in chips) 
Seat 3: Zemz_Ru ($14.66 in chips) 
Seat 4: kingartur222 ($12.16 in chips) 
Seat 5: Vrinni ($13.54 in chips) 
Seat 6: Eddys Edge ($10.33 in chips) 
aapokerkot: posts small blind $0.05
Bird et al: posts big blind $0.10
*** HOLE CARDS ***
Zemz_Ru: calls $0.10
kingartur222: folds 
Vrinni: folds 
Eddys Edge: raises $0.30 to $0.40
aapokerkot: calls $0.35
Bird et al: folds 
Zemz_Ru: calls $0.30
*** FLOP *** [Qc 3d 3c]
aapokerkot: checks 
Zemz_Ru: checks 
Eddys Edge: bets $0.93
aapokerkot: calls $0.93
Zemz_Ru: folds 
*** TURN *** [Qc 3d 3c] [4s]
Zemz_Ru leaves the table
RoJ1 joins the table at seat #3 
aapokerkot: checks 
Eddys Edge: bets $2.27
aapokerkot: calls $2.27
*** RIVER *** [Qc 3d 3c 4s] [4d]
aapokerkot: checks 
Eddys Edge: checks 
*** SHOW DOWN ***
aapokerkot: shows [Qs Ts] (two pair, Queens and Fours)
Eddys Edge: mucks hand 
aapokerkot collected $7.35 from pot
*** SUMMARY ***
Total pot $7.70 | Rake $0.35 
Board [Qc 3d 3c 4s 4d]
Seat 1: aapokerkot (small blind) showed [Qs Ts] and won ($7.35) with two pair, Queens and Fours
Seat 2: Bird et al (big blind) folded before Flop
Seat 3: Zemz_Ru folded on the Flop
Seat 4: kingartur222 folded before Flop (didn't bet)
Seat 5: Vrinni folded before Flop (didn't bet)
Seat 6: Eddys Edge (button) mucked



PokerStars Hand #166667951257:  Hold'em No Limit ($0.05/$0.10 USD) - 2017/02/23 16:10:32 ET
Table 'Senta II' 6-max Seat #6 is the button
Seat 1: Goovr ($10 in chips) 
Seat 2: NvR.m1nD ($13.75 in chips) 
Seat 3: Aescul@pius ($21.88 in chips) 
Seat 4: fedorka rus ($19.18 in chips) 
Seat 5: Algarah ($5.38 in chips) 
Seat 6: T9MS ($11.17 in chips) 
Goovr: posts small blind $0.05
NvR.m1nD: posts big blind $0.10
*** HOLE CARDS ***
Aescul@pius: folds 
fedorka rus: folds 
Algarah: folds 
T9MS: folds 
Goovr: folds 
Uncalled bet ($0.05) returned to NvR.m1nD
NvR.m1nD collected $0.10 from pot
*** SUMMARY ***
Total pot $0.10 | Rake $0 
Seat 1: Goovr (small blind) folded before Flop
Seat 2: NvR.m1nD (big blind) collected ($0.10)
Seat 3: Aescul@pius folded before Flop (didn't bet)
Seat 4: fedorka rus folded before Flop (didn't bet)
Seat 5: Algarah folded before Flop (didn't bet)
Seat 6: T9MS (button) folded before Flop (didn't bet)



PokerStars Hand #166667951341:  Hold'em No Limit ($0.05/$0.10 USD) - 2017/02/23 16:10:32 ET
Table 'Alnasl' 6-max Seat #4 is the button
Seat 1: KA3AXCTAHEU, ($11.37 in chips) 
Seat 2: saddur ($9.09 in chips) 
Seat 4: oddshoff ($10.50 in chips) 
Seat 5: 6ePeMeHHa9 ($10.05 in chips) 
Seat 6: Zooplack ($13.58 in chips) 
6ePeMeHHa9: posts small blind $0.05
Zooplack: posts big blind $0.10
*** HOLE CARDS ***
KA3AXCTAHEU,: raises $0.30 to $0.40
saddur: folds 
oddshoff: folds 
6ePeMeHHa9: folds 
Zooplack: folds 
Uncalled bet ($0.30) returned to KA3AXCTAHEU,
KA3AXCTAHEU, collected $0.25 from pot
*** SUMMARY ***
Total pot $0.25 | Rake $0 
Seat 1: KA3AXCTAHEU, collected ($0.25)
Seat 2: saddur folded before Flop (didn't bet)
Seat 4: oddshoff (button) folded before Flop (didn't bet)
Seat 5: 6ePeMeHHa9 (small blind) folded before Flop
Seat 6: Zooplack (big blind) folded before Flop



PokerStars Hand #166667951513:  Hold'em No Limit ($0.05/$0.10 USD) - 2017/02/23 16:10:32 ET
Table 'Aconcagua' 6-max Seat #6 is the button
Seat 1: MLPlayer16 ($10 in chips) 
Seat 2: Kupi007 ($10 in chips) 
Seat 3: burtila1989 ($8.11 in chips) 
Seat 4: pivanki11 ($9.38 in chips) 
Seat 5: Andrei ProFF ($10.53 in chips) 
Seat 6: coolisses111 ($11.65 in chips) 
MLPlayer16: posts small blind $0.05
Kupi007: posts big blind $0.10
MLPlayer16: posts the ante $0.02
Kupi007: posts the ante $0.02
burtila1989: posts the ante $0.02
pivanki11: posts the ante $0.02
Andrei ProFF: posts the ante $0.02
coolisses111: posts the ante $0.02
*** HOLE CARDS ***
burtila1989: raises $0.10 to $0.20
pivanki11: calls $0.20
Andrei ProFF: folds 
coolisses111: calls $0.20
MLPlayer16: folds 
Kupi007: calls $0.10
*** FLOP *** [Ad 2d Ks]
Kupi007: checks 
burtila1989: bets $0.20
pivanki11: calls $0.20
coolisses111: folds 
Kupi007: calls $0.20
*** TURN *** [Ad 2d Ks] [9h]
Kupi007: checks 
burtila1989: checks 
pivanki11: checks 
*** RIVER *** [Ad 2d Ks 9h] [As]
Kupi007: checks 
burtila1989: bets $0.60
pivanki11: folds 
Kupi007: calls $0.60
*** SHOW DOWN ***
burtila1989: shows [8h Jd] (a pair of Aces)
Kupi007: shows [Kc Td] (two pair, Aces and Kings)
Kupi007 collected $2.65 from pot
*** SUMMARY ***
Total pot $2.77 | Rake $0.12 
Board [Ad 2d Ks 9h As]
Seat 1: MLPlayer16 (small blind) folded before Flop
Seat 2: Kupi007 (big blind) showed [Kc Td] and won ($2.65) with two pair, Aces and Kings
Seat 3: burtila1989 showed [8h Jd] and lost with a pair of Aces
Seat 4: pivanki11 folded on the River
Seat 5: Andrei ProFF folded before Flop (didn't bet)
Seat 6: coolisses111 (button) folded on the Flop



PokerStars Hand #166667951613:  Hold'em No Limit ($0.05/$0.10 USD) - 2017/02/23 16:10:32 ET
Table 'Xanthippe II' 6-max Seat #5 is the button
Seat 1: noonhill ($8 in chips) 
Seat 2: Bird et al ($10.77 in chips) 
Seat 3: Dcaro31 ($14.51 in chips) 
Seat 5: XaXaTyH4uK ($10.22 in chips) 
Seat 6: Orlangoor ($12.32 in chips) 
Orlangoor: posts small blind $0.05
noonhill: posts big blind $0.10
*** HOLE CARDS ***
Bird et al: folds 
Dcaro31: folds 
XaXaTyH4uK: raises $0.20 to $0.30
Orlangoor: folds 
noonhill: calls $0.20
*** FLOP *** [8c 9d Th]
noonhill: bets $0.20
XaXaTyH4uK: folds 
Uncalled bet ($0.20) returned to noonhill
noonhill collected $0.62 from pot
*** SUMMARY ***
Total pot $0.65 | Rake $0.03 
Board [8c 9d Th]
Seat 1: noonhill (big blind) collected ($0.62)
Seat 2: Bird et al folded before Flop (didn't bet)
Seat 3: Dcaro31 folded before Flop (didn't bet)
Seat 5: XaXaTyH4uK (button) folded on the Flop
Seat 6: Orlangoor (small blind) folded before Flop



PokerStars Hand #166667951677:  Hold'em No Limit ($0.05/$0.10 USD) - 2017/02/23 16:10:32 ET
Table 'Nuki' 6-max Seat #2 is the button
Seat 1: bdixon_5 ($8.43 in chips) 
Seat 2: ArcticBearDK ($19.18 in chips) 
Seat 3: Chodemuncher ($10 in chips) 
Seat 4: GESPERIA ($28.43 in chips) 
Seat 5: fabadam ($10.43 in chips) 
Seat 6: Zooplack ($25.62 in chips) 
Chodemuncher: posts small blind $0.05
GESPERIA: posts big blind $0.10
*** HOLE CARDS ***
fabadam: folds 
Zooplack: folds 
bdixon_5: folds 
ArcticBearDK: raises $0.17 to $0.27
Chodemuncher: folds 
GESPERIA: folds 
Uncalled bet ($0.17) returned to ArcticBearDK
ArcticBearDK collected $0.25 from pot
*** SUMMARY ***
Total pot $0.25 | Rake $0 
Seat 1: bdixon_5 folded before Flop (didn't bet)
Seat 2: ArcticBearDK (button) collected ($0.25)
Seat 3: Chodemuncher (small blind) folded before Flop
Seat 4: GESPERIA (big blind) folded before Flop
Seat 5: fabadam folded before Flop (didn't bet)
Seat 6: Zooplack folded before Flop (didn't bet)



PokerStars Hand #166667951834:  Hold'em No Limit ($0.05/$0.10 USD) - 2017/02/23 16:10:32 ET
Table 'Mizar II' 6-max Seat #1 is the button
Seat 1: Cole Jaq ($7.53 in chips) 
Seat 2: rusu_rapid ($10.04 in chips) 
Seat 3: Therodorus ($10.34 in chips) 
rusu_rapid: posts small blind $0.05
Therodorus: posts big blind $0.10
DEraser: sits out 
AC Evergreen: sits out 
Pekaml: sits out 
*** HOLE CARDS ***
Cole Jaq: calls $0.10
rusu_rapid: folds 
Therodorus: raises $0.45 to $0.55
Cole Jaq: folds 
Uncalled bet ($0.45) returned to Therodorus
Therodorus collected $0.25 from pot
*** SUMMARY ***
Total pot $0.25 | Rake $0 
Seat 1: Cole Jaq (button) folded before Flop
Seat 2: rusu_rapid (small blind) folded before Flop
Seat 3: Therodorus (big blind) collected ($0.25)



PokerStars Hand #166667951868:  Hold'em No Limit ($0.05/$0.10 USD) - 2017/02/23 16:10:32 ET
Table 'Heka II' 6-max Seat #4 is the button
Seat 1: Mamm0nism ($15.36 in chips) 
Seat 2: oddshoff ($10.77 in chips) 
Seat 4: theNot0r1ous ($10.13 in chips) 
Seat 5: ArcticBearDK ($12.68 in chips) 
Seat 6: MonteCris92 ($11.42 in chips) 
ArcticBearDK: posts small blind $0.05
MonteCris92: posts big blind $0.10
voledy: sits out 
*** HOLE CARDS ***
Mamm0nism: folds 
oddshoff: raises $0.20 to $0.30
theNot0r1ous: folds 
ArcticBearDK: folds 
MonteCris92: folds 
Uncalled bet ($0.20) returned to oddshoff
oddshoff collected $0.25 from pot
*** SUMMARY ***
Total pot $0.25 | Rake $0 
Seat 1: Mamm0nism folded before Flop (didn't bet)
Seat 2: oddshoff collected ($0.25)
Seat 4: theNot0r1ous (button) folded before Flop (didn't bet)
Seat 5: ArcticBearDK (small blind) folded before Flop
Seat 6: MonteCris92 (big blind) folded before Flop



PokerStars Hand #166667952156:  Hold'em No Limit ($0.05/$0.10 USD) - 2017/02/23 16:10:33 ET
Table 'Seinajoki' 6-max Seat #3 is the button
Seat 2: niukak ($10.15 in chips) 
Seat 3: Therodorus ($10 in chips) 
Seat 4: rusu_rapid ($10 in chips) 
rusu_rapid: posts small blind $0.05
niukak: posts big blind $0.10
*** HOLE CARDS ***
Therodorus: raises $0.15 to $0.25
rusu_rapid: folds 
niukak: folds 
Uncalled bet ($0.15) returned to Therodorus
Therodorus collected $0.25 from pot
*** SUMMARY ***
Total pot $0.25 | Rake $0 
Seat 2: niukak (big blind) folded before Flop
Seat 3: Therodorus (button) collected ($0.25)
Seat 4: rusu_rapid (small blind) folded before Flop



PokerStars Hand #166667952209:  Hold'em No Limit ($0.05/$0.10 USD) - 2017/02/23 16:10:33 ET
Table 'Pirola III' 6-max Seat #6 is the button
Seat 1: bdixon_5 ($9.32 in chips) 
Seat 2: Chodemuncher ($10 in chips) 
Seat 3: kingartur222 ($10.82 in chips) 
Seat 6: T9MS ($13.16 in chips) 
bdixon_5: posts small blind $0.05
Chodemuncher: posts big blind $0.10
*** HOLE CARDS ***
kingartur222: raises $0.15 to $0.25
T9MS: folds 
bdixon_5: raises $0.35 to $0.60
Chodemuncher: folds 
kingartur222: calls $0.35
*** FLOP *** [Qs 4h 4c]
steeev084 joins the table at seat #4 
IAntikI joins the table at seat #5 
bdixon_5: checks 
kingartur222: checks 
*** TURN *** [Qs 4h 4c] [Qc]
bdixon_5: bets $0.62
kingartur222: calls $0.62
*** RIVER *** [Qs 4h 4c Qc] [3h]
bdixon_5: checks 
kingartur222: checks 
*** SHOW DOWN ***
bdixon_5: shows [Jd Jc] (two pair, Queens and Jacks)
kingartur222: mucks hand 
bdixon_5 collected $2.43 from pot
*** SUMMARY ***
Total pot $2.54 | Rake $0.11 
Board [Qs 4h 4c Qc 3h]
Seat 1: bdixon_5 (small blind) showed [Jd Jc] and won ($2.43) with two pair, Queens and Jacks
Seat 2: Chodemuncher (big blind) folded before Flop
Seat 3: kingartur222 mucked
Seat 6: T9MS (button) folded before Flop (didn't bet)



PokerStars Hand #166667952328:  Hold'em No Limit ($0.05/$0.10 USD) - 2017/02/23 16:10:33 ET
Table 'Nehalennia III' 6-max Seat #3 is the button
Seat 1: boxer821 ($11.03 in chips) 
Seat 2: fortieth ($11.64 in chips) 
Seat 3: ValdemorS ($18.07 in chips) 
Seat 4: eniksenik ($10.82 in chips) 
Seat 5: ChuikaPridi ($10 in chips) 
Seat 6: valzeny ($20.48 in chips) 
eniksenik: posts small blind $0.05
ChuikaPridi: posts big blind $0.10
boxer821: posts the ante $0.02
fortieth: posts the ante $0.02
ValdemorS: posts the ante $0.02
eniksenik: posts the ante $0.02
ChuikaPridi: posts the ante $0.02
valzeny: posts the ante $0.02
*** HOLE CARDS ***
valzeny: folds 
boxer821: folds 
fortieth: raises $0.25 to $0.35
ValdemorS: raises $0.97 to $1.32
eniksenik: folds 
ChuikaPridi: folds 
fortieth: calls $0.97
*** FLOP *** [4c 4s 9h]
fortieth: checks 
ValdemorS: bets $2.09
fortieth: folds 
Uncalled bet ($2.09) returned to ValdemorS
ValdemorS collected $2.78 from pot
*** SUMMARY ***
Total pot $2.91 | Rake $0.13 
Board [4c 4s 9h]
Seat 1: boxer821 folded before Flop (didn't bet)
Seat 2: fortieth folded on the Flop
Seat 3: ValdemorS (button) collected ($2.78)
Seat 4: eniksenik (small blind) folded before Flop
Seat 5: ChuikaPridi (big blind) folded before Flop
Seat 6: valzeny folded before Flop (didn't bet)



PokerStars Hand #166667952333:  Hold'em No Limit ($0.05/$0.10 USD) - 2017/02/23 16:10:33 ET
Table 'Euryalos II' 6-max Seat #2 is the button
Seat 2: silsilviu ($16.92 in chips) 
Seat 3: Hyd SK ($10.40 in chips) 
Seat 4: popypaleta ($11.93 in chips) 
Seat 6: MihaGr ($10 in chips) 
Hyd SK: posts small blind $0.05
popypaleta: posts big blind $0.10
voledy: sits out 
*** HOLE CARDS ***
MihaGr: raises $0.20 to $0.30
silsilviu: folds 
Hyd SK: folds 
popypaleta: folds 
Uncalled bet ($0.20) returned to MihaGr
MihaGr collected $0.25 from pot
*** SUMMARY ***
Total pot $0.25 | Rake $0 
Seat 2: silsilviu (button) folded before Flop (didn't bet)
Seat 3: Hyd SK (small blind) folded before Flop
Seat 4: popypaleta (big blind) folded before Flop
Seat 6: MihaGr collected ($0.25)



PokerStars Hand #166667952826:  Hold'em No Limit ($0.05/$0.10 USD) - 2017/02/23 16:10:33 ET
Table 'Gyldenia II' 6-max Seat #2 is the button
Seat 1: KokoulinV ($11.44 in chips) 
Seat 2: Kow6oy ($10 in chips) 
Seat 3: mhonielsen ($10 in chips) 
Seat 5: CHRO8 ($15.99 in chips) 
Seat 6: 8th wonders ($11.33 in chips) 
mhonielsen: posts small blind $0.05
magdan206 was removed from the table for failing to post
CHRO8: posts big blind $0.10
*** HOLE CARDS ***
8th wonders: folds 
KokoulinV: folds 
univibe68 joins the table at seat #4 
Kow6oy: folds 
mhonielsen: raises $0.10 to $0.20
CHRO8: folds 
Uncalled bet ($0.10) returned to mhonielsen
mhonielsen collected $0.20 from pot
*** SUMMARY ***
Total pot $0.20 | Rake $0 
Seat 1: KokoulinV folded before Flop (didn't bet)
Seat 2: Kow6oy (button) folded before Flop (didn't bet)
Seat 3: mhonielsen (small blind) collected ($0.20)
Seat 5: CHRO8 (big blind) folded before Flop
Seat 6: 8th wonders folded before Flop (didn't bet)



PokerStars Hand #166667952848:  Hold'em No Limit ($0.05/$0.10 USD) - 2017/02/23 16:10:33 ET
Table 'Hestia' 6-max Seat #2 is the button
Seat 1: Pekaml ($10.13 in chips) 
Seat 2: Kow6oy ($10.27 in chips) 
Seat 3: MBen10 ($13.48 in chips) 
Seat 5: CiisCi ($17.11 in chips) 
MBen10: posts small blind $0.05
CiisCi: posts big blind $0.10
*** HOLE CARDS ***
Pekaml: folds 
Kow6oy: raises $0.15 to $0.25
MBen10: calls $0.20
CiisCi: raises $1.15 to $1.40
Kow6oy: folds 
MBen10: folds 
Uncalled bet ($1.15) returned to CiisCi
CiisCi collected $0.75 from pot
*** SUMMARY ***
Total pot $0.75 | Rake $0 
Seat 1: Pekaml folded before Flop (didn't bet)
Seat 2: Kow6oy (button) folded before Flop
Seat 3: MBen10 (small blind) folded before Flop
Seat 5: CiisCi (big blind) collected ($0.75)



PokerStars Hand #166667952886:  Hold'em No Limit ($0.05/$0.10 USD) - 2017/02/23 16:10:33 ET
Table 'Lampetia III' 6-max Seat #5 is the button
Seat 3: Kow6oy ($10 in chips) 
Seat 4: IAntikI ($10.45 in chips) 
Seat 5: robson1235 ($20.30 in chips) 
Seat 6: bdixon_5 ($9.10 in chips) 
bdixon_5: posts small blind $0.05
gaHy_HaXeP: is sitting out 
DamDatsAnAce: is sitting out 
DamDatsAnAce leaves the table
Kow6oy: posts big blind $0.10
*** HOLE CARDS ***
IAntikI: raises $0.20 to $0.30
robson1235: folds 
AIONCMA1988 joins the table at seat #2 
bdixon_5: folds 
gaHy_HaXeP leaves the table
Kow6oy: folds 
Uncalled bet ($0.20) returned to IAntikI
IAntikI collected $0.25 from pot
*** SUMMARY ***
Total pot $0.25 | Rake $0 
Seat 3: Kow6oy (big blind) folded before Flop
Seat 4: IAntikI collected ($0.25)
Seat 5: robson1235 (button) folded before Flop (didn't bet)
Seat 6: bdixon_5 (small blind) folded before Flop



PokerStars Hand #166667953373:  Hold'em No Limit ($0.05/$0.10 USD) - 2017/02/23 16:10:34 ET
Table 'Lacroute' 6-max Seat #5 is the button
Seat 1: Orlangoor ($10.25 in chips) 
Seat 2: Andy Wolf ($10.54 in chips) 
Seat 3: KOS3573 ($4 in chips) 
Seat 4: st4tion ($17.39 in chips) 
Seat 5: steepfell ($10.04 in chips) 
Seat 6: IAntikI ($11.57 in chips) 
IAntikI: posts small blind $0.05
Orlangoor: posts big blind $0.10
KOS3573: posts big blind $0.10
*** HOLE CARDS ***
Andy Wolf: folds 
KOS3573: raises $0.10 to $0.20
st4tion: folds 
steepfell: raises $0.60 to $0.80
IAntikI: folds 
Orlangoor: folds 
KOS3573: calls $0.60
*** FLOP *** [3d 9d 6c]
KOS3573: checks 
steepfell: bets $1.20
KOS3573: calls $1.20
*** TURN *** [3d 9d 6c] [9h]
KOS3573: bets $2 and is all-in
steepfell: calls $2
*** RIVER *** [3d 9d 6c 9h] [6h]
*** SHOW DOWN ***
KOS3573: shows [Qd Ac] (two pair, Nines and Sixes)
steepfell: shows [Jd Js] (two pair, Jacks and Nines)
steepfell collected $7.78 from pot
*** SUMMARY ***
Total pot $8.15 | Rake $0.37 
Board [3d 9d 6c 9h 6h]
Seat 1: Orlangoor (big blind) folded before Flop
Seat 2: Andy Wolf folded before Flop (didn't bet)
Seat 3: KOS3573 showed [Qd Ac] and lost with two pair, Nines and Sixes
Seat 4: st4tion folded before Flop (didn't bet)
Seat 5: steepfell (button) showed [Jd Js] and won ($7.78) with two pair, Jacks and Nines
Seat 6: IAntikI (small blind) folded before Flop



PokerStars Hand #166667953406:  Hold'em No Limit ($0.05/$0.10 USD) - 2017/02/23 16:10:34 ET
Table 'Lehigh' 6-max Seat #5 is the button
Seat 1: pokekrk ($10.05 in chips) 
Seat 3: Cluckh ($10 in chips) 
Seat 5: Slavoaca693 ($7.85 in chips) 
pokekrk: posts small blind $0.05
Sbozzz: is sitting out 
Cluckh: posts big blind $0.10
manashov: sits out 
*** HOLE CARDS ***
Slavoaca693: folds 
pokekrk: raises $0.15 to $0.25
Cluckh: raises $0.55 to $0.80
pokekrk: folds 
Uncalled bet ($0.55) returned to Cluckh
Sbozzz leaves the table
Cluckh collected $0.50 from pot
*** SUMMARY ***
Total pot $0.50 | Rake $0 
Seat 1: pokekrk (small blind) folded before Flop
Seat 3: Cluckh (big blind) collected ($0.50)
Seat 5: Slavoaca693 (button) folded before Flop (didn't bet)



PokerStars Hand #166667953446:  Hold'em No Limit ($0.05/$0.10 USD) - 2017/02/23 16:10:34 ET
Table 'Postrema' 6-max Seat #6 is the button
Seat 1: CHRO8 ($11.15 in chips) 
Seat 2: pancernik21 ($13.59 in chips) 
Seat 3: edcc19 ($5.10 in chips) 
Seat 4: ChuikaPridi ($12.83 in chips) 
Seat 5: Comeback3392 ($11.87 in chips) 
Seat 6: Scanner17 ($10 in chips) 
CHRO8: posts small blind $0.05
pancernik21: posts big blind $0.10
*** HOLE CARDS ***
edcc19: folds 
ChuikaPridi: raises $0.20 to $0.30
Comeback3392: folds 
Scanner17: calls $0.30
CHRO8: raises $1 to $1.30
pancernik21: folds 
ChuikaPridi: calls $1
Scanner17: calls $1
*** FLOP *** [4h 3d 7c]
CHRO8: checks 
ChuikaPridi: bets $1.70
Scanner17: folds 
CHRO8: calls $1.70
*** TURN *** [4h 3d 7c] [7h]
CHRO8: checks 
ChuikaPridi: checks 
*** RIVER *** [4h 3d 7c 7h] [3s]
CHRO8: checks 
ChuikaPridi: checks 
*** SHOW DOWN ***
CHRO8: shows [Ac Ad] (two pair, Aces and Sevens)
ChuikaPridi: mucks hand 
CHRO8 collected $7.07 from pot
*** SUMMARY ***
Total pot $7.40 | Rake $0.33 
Board [4h 3d 7c 7h 3s]
Seat 1: CHRO8 (small blind) showed [Ac Ad] and won ($7.07) with two pair, Aces and Sevens
Seat 2: pancernik21 (big blind) folded before Flop
Seat 3: edcc19 folded before Flop (didn't bet)
Seat 4: ChuikaPridi mucked
Seat 5: Comeback3392 folded before Flop (didn't bet)
Seat 6: Scanner17 (button) folded on the Flop



PokerStars Hand #166667953911:  Hold'em No Limit ($0.05/$0.10 USD) - 2017/02/23 16:10:35 ET
Table 'Reginhild' 6-max Seat #1 is the button
Seat 1: iamkakaroto ($11.10 in chips) 
Seat 2: Kow6oy ($10 in chips) 
Seat 3: ARCHITECT83 ($8.03 in chips) 
Seat 4: Raymondo21 ($24.48 in chips) 
Seat 5: XCarlos610 ($28.87 in chips) 
Seat 6: eniksenik ($10 in chips) 
Kow6oy: posts small blind $0.05
ARCHITECT83: posts big blind $0.10
*** HOLE CARDS ***
Raymondo21: folds 
XCarlos610: folds 
eniksenik: folds 
iamkakaroto: raises $0.15 to $0.25
Kow6oy: raises $0.75 to $1
ARCHITECT83: folds 
iamkakaroto: folds 
Uncalled bet ($0.75) returned to Kow6oy
Kow6oy collected $0.60 from pot
*** SUMMARY ***
Total pot $0.60 | Rake $0 
Seat 1: iamkakaroto (button) folded before Flop
Seat 2: Kow6oy (small blind) collected ($0.60)
Seat 3: ARCHITECT83 (big blind) folded before Flop
Seat 4: Raymondo21 folded before Flop (didn't bet)
Seat 5: XCarlos610 folded before Flop (didn't bet)
Seat 6: eniksenik folded before Flop (didn't bet)



PokerStars Hand #166667953919:  Hold'em No Limit ($0.05/$0.10 USD) - 2017/02/23 16:10:35 ET
Table 'Rosalia' 6-max Seat #4 is the button
Seat 1: Hyd SK ($10 in chips) 
Seat 2: Bandyaev ($10.09 in chips) 
Seat 3: Andy Wolf ($11.13 in chips) 
Seat 4: THIMUCHIN ($10 in chips) 
Seat 5: miron762 ($21.21 in chips) 
Seat 6: facewald ($18.14 in chips) 
miron762: posts small blind $0.05
facewald: posts big blind $0.10
*** HOLE CARDS ***
Hyd SK: raises $0.25 to $0.35
Bandyaev: folds 
Andy Wolf: folds 
THIMUCHIN: folds 
miron762: calls $0.30
facewald: calls $0.25
*** FLOP *** [Kc 6h 6s]
miron762: checks 
facewald: checks 
Hyd SK: checks 
*** TURN *** [Kc 6h 6s] [4s]
miron762: bets $0.20
facewald: raises $0.55 to $0.75
Hyd SK: folds 
miron762: calls $0.55
*** RIVER *** [Kc 6h 6s 4s] [7c]
miron762: checks 
facewald: checks 
*** SHOW DOWN ***
miron762: shows [4h 5c] (two pair, Sixes and Fours)
facewald: shows [7s 8s] (two pair, Sevens and Sixes)
facewald collected $2.44 from pot
*** SUMMARY ***
Total pot $2.55 | Rake $0.11 
Board [Kc 6h 6s 4s 7c]
Seat 1: Hyd SK folded on the Turn
Seat 2: Bandyaev folded before Flop (didn't bet)
Seat 3: Andy Wolf folded before Flop (didn't bet)
Seat 4: THIMUCHIN (button) folded before Flop (didn't bet)
Seat 5: miron762 (small blind) showed [4h 5c] and lost with two pair, Sixes and Fours
Seat 6: facewald (big blind) showed [7s 8s] and won ($2.44) with two pair, Sevens and Sixes



PokerStars Hand #166667953996:  Hold'em No Limit ($0.05/$0.10 USD) - 2017/02/23 16:10:35 ET
Table 'Ebella II' 6-max Seat #4 is the button
Seat 1: gaHy_HaXeP ($10 in chips) 
Seat 2: Therodorus ($10 in chips) 
Seat 3: Torften2 ($17.66 in chips) 
Seat 4: ValdemorS ($11.55 in chips) 
Seat 5: Bird et al ($10 in chips) 
Seat 6: Joker51_wtf! ($11.39 in chips) 
Bird et al: posts small blind $0.05
Joker51_wtf!: posts big blind $0.10
*** HOLE CARDS ***
gaHy_HaXeP: folds 
Therodorus: raises $0.20 to $0.30
Torften2: folds 
ValdemorS: folds 
Bird et al: folds 
Joker51_wtf!: raises $0.90 to $1.20
Therodorus: folds 
Uncalled bet ($0.90) returned to Joker51_wtf!
Joker51_wtf! collected $0.65 from pot
*** SUMMARY ***
Total pot $0.65 | Rake $0 
Seat 1: gaHy_HaXeP folded before Flop (didn't bet)
Seat 2: Therodorus folded before Flop
Seat 3: Torften2 folded before Flop (didn't bet)
Seat 4: ValdemorS (button) folded before Flop (didn't bet)
Seat 5: Bird et al (small blind) folded before Flop
Seat 6: Joker51_wtf! (big blind) collected ($0.65)



PokerStars Hand #166667954130:  Hold'em No Limit ($0.05/$0.10 USD) - 2017/02/23 16:10:35 ET
Table 'Luanda' 6-max Seat #4 is the button
Seat 1: AM-L-SL ($2.81 in chips) 
Seat 2: Xander188 ($10.15 in chips) 
Seat 4: aapokerkot ($10.08 in chips) 
Seat 5: st4tion ($12.40 in chips) 
st4tion: posts small blind $0.05
KA3AXCTAHEU,: is sitting out 
AM-L-SL: posts big blind $0.10
KA3AXCTAHEU, leaves the table
pokekrk: sits out 
*** HOLE CARDS ***
Xander188: folds 
aapokerkot: folds 
st4tion: folds 
Uncalled bet ($0.05) returned to AM-L-SL
AM-L-SL collected $0.10 from pot
*** SUMMARY ***
Total pot $0.10 | Rake $0 
Seat 1: AM-L-SL (big blind) collected ($0.10)
Seat 2: Xander188 folded before Flop (didn't bet)
Seat 4: aapokerkot (button) folded before Flop (didn't bet)
Seat 5: st4tion (small blind) folded before Flop



PokerStars Hand #166667954359:  Hold'em No Limit ($0.05/$0.10 USD) - 2017/02/23 16:10:35 ET
Table 'Krethon' 6-max Seat #1 is the button
Seat 1: boxer821 ($10.62 in chips) 
Seat 4: chimera252 ($14.84 in chips) 
Seat 5: popypaleta ($10 in chips) 
Seat 6: fabadam ($18.83 in chips) 
chimera252: posts small blind $0.05
popypaleta: posts big blind $0.10
*** HOLE CARDS ***
fabadam: folds 
boxer821: raises $0.12 to $0.22
chimera252: folds 
popypaleta: raises $0.49 to $0.71
boxer821: folds 
Uncalled bet ($0.49) returned to popypaleta
popypaleta collected $0.49 from pot
*** SUMMARY ***
Total pot $0.49 | Rake $0 
Seat 1: boxer821 (button) folded before Flop
Seat 4: chimera252 (small blind) folded before Flop
Seat 5: popypaleta (big blind) collected ($0.49)
Seat 6: fabadam folded before Flop (didn't bet)



PokerStars Hand #166667954801:  Hold'em No Limit ($0.05/$0.10 USD) - 2017/02/23 16:10:36 ET
Table 'Wingolfia II' 6-max Seat #2 is the button
Seat 1: BahiaMinhaP ($10 in chips) 
Seat 2: NvR.m1nD ($10 in chips) 
Seat 3: truck1234 ($10.62 in chips) 
Seat 4: zlobslob ($17.87 in chips) 
Seat 5: tr41n3r12 ($12.09 in chips) 
Seat 6: Tom Zhangxue ($9.60 in chips) 
truck1234: posts small blind $0.05
zlobslob: posts big blind $0.10
*** HOLE CARDS ***
tr41n3r12: folds 
Tom Zhangxue: raises $0.20 to $0.30
BahiaMinhaP: folds 
NvR.m1nD: folds 
truck1234: folds 
zlobslob: folds 
Uncalled bet ($0.20) returned to Tom Zhangxue
Tom Zhangxue collected $0.25 from pot
*** SUMMARY ***
Total pot $0.25 | Rake $0 
Seat 1: BahiaMinhaP folded before Flop (didn't bet)
Seat 2: NvR.m1nD (button) folded before Flop (didn't bet)
Seat 3: truck1234 (small blind) folded before Flop
Seat 4: zlobslob (big blind) folded before Flop
Seat 5: tr41n3r12 folded before Flop (didn't bet)
Seat 6: Tom Zhangxue collected ($0.25)



PokerStars Hand #166667954803:  Hold'em No Limit ($0.05/$0.10 USD) - 2017/02/23 16:10:36 ET
Table 'Gaika' 6-max Seat #2 is the button
Seat 1: oddshoff ($16.71 in chips) 
Seat 2: NvR.m1nD ($22.26 in chips) 
Seat 4: fortieth ($10.32 in chips) 
fortieth: posts small blind $0.05
fedorka rus: is sitting out 
dr.goofy: is sitting out 
oddshoff: posts big blind $0.10
*** HOLE CARDS ***
NvR.m1nD: folds 
fortieth: folds 
Uncalled bet ($0.05) returned to oddshoff
oddshoff collected $0.10 from pot
*** SUMMARY ***
Total pot $0.10 | Rake $0 
Seat 1: oddshoff (big blind) collected ($0.10)
Seat 2: NvR.m1nD (button) folded before Flop (didn't bet)
Seat 4: fortieth (small blind) folded before Flop



PokerStars Hand #166667955204:  Hold'em No Limit ($0.05/$0.10 USD) - 2017/02/23 16:10:36 ET
Table 'Marbachia II' 6-max Seat #1 is the button
Seat 1: crooso ($9.60 in chips) 
Seat 2: Yabidooo ($10.27 in chips) 
Seat 3: MisterX413 ($10.39 in chips) 
Seat 4: marianoboni ($10.15 in chips) 
Seat 6: arti192837 ($10 in chips) 
Yabidooo: posts small blind $0.05
MisterX413: posts big blind $0.10
osmea: sits out 
*** HOLE CARDS ***
marianoboni: raises $0.24 to $0.34
arti192837: folds 
crooso: folds 
Yabidooo: calls $0.29
MisterX413: folds 
*** FLOP *** [5c 9c 4d]
Yabidooo: bets $0.40
marianoboni: raises $0.80 to $1.20
Yabidooo: folds 
Uncalled bet ($0.80) returned to marianoboni
marianoboni collected $1.51 from pot
*** SUMMARY ***
Total pot $1.58 | Rake $0.07 
Board [5c 9c 4d]
Seat 1: crooso (button) folded before Flop (didn't bet)
Seat 2: Yabidooo (small blind) folded on the Flop
Seat 3: MisterX413 (big blind) folded before Flop
Seat 4: marianoboni collected ($1.51)
Seat 6: arti192837 folded before Flop (didn't bet)



PokerStars Hand #166667955389:  Hold'em No Limit ($0.05/$0.10 USD) - 2017/02/23 16:10:36 ET
Table 'Brambilla II' 6-max Seat #6 is the button
Seat 1: Rodik002 ($12.32 in chips) 
Seat 5: FRAID358 ($10 in chips) 
Seat 6: boxer821 ($10 in chips) 
Rodik002: posts small blind $0.05
FRAID358: posts big blind $0.10
*** HOLE CARDS ***
Andrei ProFF joins the table at seat #2 
Andrei ProFF leaves the table
boxer821: folds 
Rodik002: folds 
Uncalled bet ($0.05) returned to FRAID358
FRAID358 collected $0.10 from pot
*** SUMMARY ***
Total pot $0.10 | Rake $0 
Seat 1: Rodik002 (small blind) folded before Flop
Seat 5: FRAID358 (big blind) collected ($0.10)
Seat 6: boxer821 (button) folded before Flop (didn't bet)



PokerStars Hand #166667955471:  Hold'em No Limit ($0.05/$0.10 USD) - 2017/02/23 16:10:36 ET
Table 'Virginia II' 6-max Seat #3 is the button
Seat 1: Iarlei ($11.41 in chips) 
Seat 3: garigura ($15.68 in chips) 
Seat 4: onkelottoHH ($10.63 in chips) 
Seat 6: NvR.m1nD ($10.30 in chips) 
onkelottoHH: posts small blind $0.05
dr.goofy: is sitting out 
NvR.m1nD: posts big blind $0.10
*** HOLE CARDS ***
Iarlei: raises $0.20 to $0.30
dr.goofy leaves the table
garigura: raises $0.60 to $0.90
onkelottoHH: folds 
yodzik joins the table at seat #5 
NvR.m1nD: folds 
Iarlei: folds 
Uncalled bet ($0.60) returned to garigura
garigura collected $0.75 from pot
*** SUMMARY ***
Total pot $0.75 | Rake $0 
Seat 1: Iarlei folded before Flop
Seat 3: garigura (button) collected ($0.75)
Seat 4: onkelottoHH (small blind) folded before Flop
Seat 6: NvR.m1nD (big blind) folded before Flop



PokerStars Hand #166667955512:  Hold'em No Limit ($0.05/$0.10 USD) - 2017/02/23 16:10:36 ET
Table 'Cyane' 6-max Seat #6 is the button
Seat 1: KA3AXCTAHEU, ($10.20 in chips) 
Seat 2: sashi18 ($7.86 in chips) 
Seat 3: Mamm0nism ($10 in chips) 
Seat 4: truck1234 ($32.53 in chips) 
Seat 5: RoJ1 ($10.22 in chips) 
Seat 6: 8th wonders ($11.46 in chips) 
KA3AXCTAHEU,: posts small blind $0.05
sashi18: posts big blind $0.10
*** HOLE CARDS ***
Mamm0nism: folds 
truck1234: folds 
RoJ1: folds 
8th wonders: raises $0.20 to $0.30
KA3AXCTAHEU,: calls $0.25
sashi18: calls $0.20
*** FLOP *** [2c 2s Tc]
KA3AXCTAHEU,: bets $0.10
sashi18: calls $0.10
8th wonders: calls $0.10
*** TURN *** [2c 2s Tc] [5h]
KA3AXCTAHEU,: bets $0.15
sashi18: folds 
8th wonders: calls $0.15
*** RIVER *** [2c 2s Tc 5h] [Jh]
KA3AXCTAHEU,: checks 
8th wonders: checks 
*** SHOW DOWN ***
KA3AXCTAHEU,: shows [8c 8s] (two pair, Eights and Deuces)
8th wonders: mucks hand 
KA3AXCTAHEU, collected $1.43 from pot
*** SUMMARY ***
Total pot $1.50 | Rake $0.07 
Board [2c 2s Tc 5h Jh]
Seat 1: KA3AXCTAHEU, (small blind) showed [8c 8s] and won ($1.43) with two pair, Eights and Deuces
Seat 2: sashi18 (big blind) folded on the Turn
Seat 3: Mamm0nism folded before Flop (didn't bet)
Seat 4: truck1234 folded before Flop (didn't bet)
Seat 5: RoJ1 folded before Flop (didn't bet)
Seat 6: 8th wonders (button) mucked



PokerStars Hand #166667955619:  Hold'em No Limit ($0.05/$0.10 USD) - 2017/02/23 16:10:36 ET
Table 'Giclas' 6-max Seat #3 is the button
Seat 2: Crafty23@PS ($10 in chips) 
Seat 3: fidas1972 ($6.48 in chips) 
Seat 4: Eddys Edge ($13.84 in chips) 
Seat 5: dedea1989 ($34.63 in chips) 
Seat 6: eniksenik ($14.73 in chips) 
Eddys Edge: posts small blind $0.05
dedea1989: posts big blind $0.10
*** HOLE CARDS ***
eniksenik: folds 
Crafty23@PS: raises $0.20 to $0.30
fidas1972: calls $0.30
Eddys Edge: folds 
dedea1989: calls $0.20
*** FLOP *** [Jd 3c Kd]
dedea1989: checks 
Crafty23@PS: checks 
fidas1972: bets $0.46
dedea1989: calls $0.46
Crafty23@PS: folds 
*** TURN *** [Jd 3c Kd] [Ah]
dedea1989: checks 
fidas1972: checks 
*** RIVER *** [Jd 3c Kd Ah] [6c]
dedea1989: bets $1.80
fidas1972: calls $1.80
*** SHOW DOWN ***
dedea1989: shows [Jh 6s] (two pair, Jacks and Sixes)
fidas1972: mucks hand 
dedea1989 collected $5.22 from pot
*** SUMMARY ***
Total pot $5.47 | Rake $0.25 
Board [Jd 3c Kd Ah 6c]
Seat 2: Crafty23@PS folded on the Flop
Seat 3: fidas1972 (button) mucked
Seat 4: Eddys Edge (small blind) folded before Flop
Seat 5: dedea1989 (big blind) showed [Jh 6s] and won ($5.22) with two pair, Jacks and Sixes
Seat 6: eniksenik folded before Flop (didn't bet)



PokerStars Hand #166667955857:  Hold'em No Limit ($0.05/$0.10 USD) - 2017/02/23 16:10:37 ET
Table 'Tyche III' 6-max Seat #1 is the button
Seat 1: milt65 ($10.05 in chips) 
Seat 2: arti192837 ($12.43 in chips) 
Seat 3: FRAID358 ($10 in chips) 
Seat 4: Kazacha ($10.63 in chips) 
Seat 5: chimera252 ($14.36 in chips) 
Seat 6: Ice_Isayev ($10 in chips) 
arti192837: posts small blind $0.05
FRAID358: posts big blind $0.10
*** HOLE CARDS ***
Kazacha: folds 
chimera252: raises $0.20 to $0.30
Ice_Isayev: folds 
milt65: folds 
arti192837: calls $0.25
FRAID358: folds 
*** FLOP *** [2h Kd 6c]
arti192837: checks 
chimera252: bets $0.33
arti192837: folds 
Uncalled bet ($0.33) returned to chimera252
chimera252 collected $0.67 from pot
*** SUMMARY ***
Total pot $0.70 | Rake $0.03 
Board [2h Kd 6c]
Seat 1: milt65 (button) folded before Flop (didn't bet)
Seat 2: arti192837 (small blind) folded on the Flop
Seat 3: FRAID358 (big blind) folded before Flop
Seat 4: Kazacha folded before Flop (didn't bet)
Seat 5: chimera252 collected ($0.67)
Seat 6: Ice_Isayev folded before Flop (didn't bet)



PokerStars Hand #166667956629:  Hold'em No Limit ($0.05/$0.10 USD) - 2017/02/23 16:10:38 ET
Table 'Wesselink II' 6-max Seat #2 is the button
Seat 2: KRZuff ($10.27 in chips) 
Seat 3: Wargolandros ($8.32 in chips) 
Seat 4: BahiaMinhaP ($10 in chips) 
Seat 6: bambolejro ($17.92 in chips) 
Wargolandros: posts small blind $0.05
BahiaMinhaP: posts big blind $0.10
xdjango07x: sits out 
*** HOLE CARDS ***
bambolejro: folds 
KRZuff: folds 
Wargolandros: folds 
Uncalled bet ($0.05) returned to BahiaMinhaP
BahiaMinhaP collected $0.10 from pot
*** SUMMARY ***
Total pot $0.10 | Rake $0 
Seat 2: KRZuff (button) folded before Flop (didn't bet)
Seat 3: Wargolandros (small blind) folded before Flop
Seat 4: BahiaMinhaP (big blind) collected ($0.10)
Seat 6: bambolejro folded before Flop (didn't bet)



PokerStars Hand #166667956815:  Hold'em No Limit ($0.05/$0.10 USD) - 2017/02/23 16:10:38 ET
Table 'Clavel' 6-max Seat #1 is the button
Seat 1: KRZuff ($14.82 in chips) 
Seat 2: Namhkal ($10.30 in chips) 
Seat 4: Dcaro31 ($11.68 in chips) 
Seat 5: Vrinni ($11.33 in chips) 
Seat 6: Gra_anD77 ($3.17 in chips) 
Namhkal: posts small blind $0.05
Dcaro31: posts big blind $0.10
*** HOLE CARDS ***
Vrinni: folds 
Gra_anD77: folds 
KRZuff: raises $0.15 to $0.25
Namhkal: folds 
Dcaro31: folds 
Uncalled bet ($0.15) returned to KRZuff
KRZuff collected $0.25 from pot
*** SUMMARY ***
Total pot $0.25 | Rake $0 
Seat 1: KRZuff (button) collected ($0.25)
Seat 2: Namhkal (small blind) folded before Flop
Seat 4: Dcaro31 (big blind) folded before Flop
Seat 5: Vrinni folded before Flop (didn't bet)
Seat 6: Gra_anD77 folded before Flop (didn't bet)



PokerStars Hand #166667957101:  Hold'em No Limit ($0.05/$0.10 USD) - 2017/02/23 16:10:38 ET
Table 'Emma II' 6-max Seat #2 is the button
Seat 1: LarryTheStar ($10.10 in chips) 
Seat 2: T9MS ($11.49 in chips) 
Seat 3: oddshoff ($10.12 in chips) 
Seat 4: Jucatorul823 ($6.66 in chips) 
Seat 5: Scanner17 ($10.51 in chips) 
Seat 6: CHRO8 ($14.37 in chips) 
oddshoff: posts small blind $0.05
Jucatorul823: posts big blind $0.10
*** HOLE CARDS ***
Scanner17: raises $0.20 to $0.30
CHRO8: folds 
LarryTheStar: folds 
T9MS: folds 
oddshoff: folds 
Jucatorul823: calls $0.20
*** FLOP *** [Ah As 3s]
Jucatorul823: checks 
Scanner17: bets $0.40
Jucatorul823: folds 
Uncalled bet ($0.40) returned to Scanner17
Scanner17 collected $0.62 from pot
*** SUMMARY ***
Total pot $0.65 | Rake $0.03 
Board [Ah As 3s]
Seat 1: LarryTheStar folded before Flop (didn't bet)
Seat 2: T9MS (button) folded before Flop (didn't bet)
Seat 3: oddshoff (small blind) folded before Flop
Seat 4: Jucatorul823 (big blind) folded on the Flop
Seat 5: Scanner17 collected ($0.62)
Seat 6: CHRO8 folded before Flop (didn't bet)



PokerStars Hand #166667957105:  Hold'em No Limit ($0.05/$0.10 USD) - 2017/02/23 16:10:38 ET
Table 'Arkab' 6-max Seat #3 is the button
Seat 1: iamkakaroto ($10.15 in chips) 
Seat 2: aktion4ik ($12.24 in chips) 
Seat 3: sexy_seagull ($10.36 in chips) 
Seat 4: dincimus ($9.90 in chips) 
Seat 5: OrionYusupov ($9.43 in chips) 
Seat 6: MihaGr ($11.20 in chips) 
dincimus: posts small blind $0.05
OrionYusupov: posts big blind $0.10
*** HOLE CARDS ***
MihaGr: folds 
iamkakaroto: folds 
aktion4ik: folds 
sexy_seagull: folds 
dincimus: raises $0.10 to $0.20
OrionYusupov: calls $0.10
*** FLOP *** [Jd Ks 7h]
dincimus: bets $0.19
OrionYusupov: folds 
Uncalled bet ($0.19) returned to dincimus
dincimus collected $0.38 from pot
*** SUMMARY ***
Total pot $0.40 | Rake $0.02 
Board [Jd Ks 7h]
Seat 1: iamkakaroto folded before Flop (didn't bet)
Seat 2: aktion4ik folded before Flop (didn't bet)
Seat 3: sexy_seagull (button) folded before Flop (didn't bet)
Seat 4: dincimus (small blind) collected ($0.38)
Seat 5: OrionYusupov (big blind) folded on the Flop
Seat 6: MihaGr folded before Flop (didn't bet)



PokerStars Hand #166667957886:  Hold'em No Limit ($0.05/$0.10 USD) - 2017/02/23 16:10:39 ET
Table 'Tirela' 6-max Seat #3 is the button
Seat 1: Smitty03300 ($10 in chips) 
Seat 2: Andrei ProFF ($16.99 in chips) 
Seat 3: aim444 ($16.26 in chips) 
Seat 4: ArcticBearDK ($10 in chips) 
Seat 5: KRZuff ($15.43 in chips) 
Seat 6: coolisses111 ($9.80 in chips) 
ArcticBearDK: posts small blind $0.05
KRZuff: posts big blind $0.10
*** HOLE CARDS ***
coolisses111: folds 
Smitty03300: folds 
Andrei ProFF: raises $0.20 to $0.30
aim444: folds 
ArcticBearDK: folds 
KRZuff: folds 
Uncalled bet ($0.20) returned to Andrei ProFF
Andrei ProFF collected $0.25 from pot
*** SUMMARY ***
Total pot $0.25 | Rake $0 
Seat 1: Smitty03300 folded before Flop (didn't bet)
Seat 2: Andrei ProFF collected ($0.25)
Seat 3: aim444 (button) folded before Flop (didn't bet)
Seat 4: ArcticBearDK (small blind) folded before Flop
Seat 5: KRZuff (big blind) folded before Flop
Seat 6: coolisses111 folded before Flop (didn't bet)



PokerStars Hand #166667958192:  Hold'em No Limit ($0.05/$0.10 USD) - 2017/02/23 16:10:39 ET
Table 'Nymphe II' 6-max Seat #1 is the button
Seat 1: jacktayra ($1.49 in chips) 
Seat 2: Newqbrown ($12.16 in chips) 
Seat 3: THIMUCHIN ($15.45 in chips) 
Seat 4: coolisses111 ($17.15 in chips) 
Seat 6: Xander188 ($10 in chips) 
Newqbrown: posts small blind $0.05
THIMUCHIN: posts big blind $0.10
AC Evergreen: sits out 
*** HOLE CARDS ***
coolisses111: folds 
Xander188: folds 
jacktayra: folds 
Newqbrown: folds 
Uncalled bet ($0.05) returned to THIMUCHIN
THIMUCHIN collected $0.10 from pot
*** SUMMARY ***
Total pot $0.10 | Rake $0 
Seat 1: jacktayra (button) folded before Flop (didn't bet)
Seat 2: Newqbrown (small blind) folded before Flop
Seat 3: THIMUCHIN (big blind) collected ($0.10)
Seat 4: coolisses111 folded before Flop (didn't bet)
Seat 6: Xander188 folded before Flop (didn't bet)



PokerStars Hand #166667958209:  Hold'em No Limit ($0.05/$0.10 USD) - 2017/02/23 16:10:39 ET
Table 'Landi II' 6-max Seat #1 is the button
Seat 1: dersiemer ($13.63 in chips) 
Seat 2: Aescul@pius ($10 in chips) 
Seat 3: x3ultimate ($10 in chips) 
Seat 4: alesi13 ($5.74 in chips) 
Seat 5: Bird et al ($10.25 in chips) 
Seat 6: arti192837 ($10 in chips) 
Aescul@pius: posts small blind $0.05
x3ultimate: posts big blind $0.10
*** HOLE CARDS ***
alesi13: folds 
Bird et al: folds 
arti192837: raises $0.20 to $0.30
dersiemer: calls $0.30
Aescul@pius: folds 
x3ultimate: raises $1 to $1.30
arti192837: calls $1
dersiemer: folds 
*** FLOP *** [2d 6c Th]
x3ultimate: bets $1.50
arti192837: calls $1.50
*** TURN *** [2d 6c Th] [3d]
x3ultimate: checks 
arti192837: bets $3
x3ultimate: folds 
Uncalled bet ($3) returned to arti192837
arti192837 collected $5.68 from pot
*** SUMMARY ***
Total pot $5.95 | Rake $0.27 
Board [2d 6c Th 3d]
Seat 1: dersiemer (button) folded before Flop
Seat 2: Aescul@pius (small blind) folded before Flop
Seat 3: x3ultimate (big blind) folded on the Turn
Seat 4: alesi13 folded before Flop (didn't bet)
Seat 5: Bird et al folded before Flop (didn't bet)
Seat 6: arti192837 collected ($5.68)



PokerStars Hand #166667958754:  Hold'em No Limit ($0.05/$0.10 USD) - 2017/02/23 16:10:40 ET
Table 'Aludra II' 6-max Seat #2 is the button
Seat 1: voledy ($10.15 in chips) 
Seat 2: JahSoldier69 ($13.93 in chips) 
Seat 3: mbkongstad ($9.75 in chips) 
Seat 4: MihaGr ($10 in chips) 
Seat 5: kingartur222 ($16.17 in chips) 
Seat 6: call me haaa ($14.84 in chips) 
mbkongstad: posts small blind $0.05
MihaGr: posts big blind $0.10
*** HOLE CARDS ***
kingartur222: folds 
call me haaa: raises $0.25 to $0.35
voledy: folds 
JahSoldier69: folds 
mbkongstad: folds 
MihaGr: folds 
Uncalled bet ($0.25) returned to call me haaa
call me haaa collected $0.25 from pot
*** SUMMARY ***
Total pot $0.25 | Rake $0 
Seat 1: voledy folded before Flop (didn't bet)
Seat 2: JahSoldier69 (button) folded before Flop (didn't bet)
Seat 3: mbkongstad (small blind) folded before Flop
Seat 4: MihaGr (big blind) folded before Flop
Seat 5: kingartur222 folded before Flop (didn't bet)
Seat 6: call me haaa collected ($0.25)



PokerStars Hand #166667958944:  Hold'em No Limit ($0.05/$0.10 USD) - 2017/02/23 16:10:40 ET
Table 'California II' 6-max Seat #2 is the button
Seat 2: homelessdan ($10 in chips) 
Seat 3: Bird et al ($10 in chips) 
Seat 4: pokekrk ($13.97 in chips) 
Seat 5: Nikolai77798 ($4.91 in chips) 
Seat 6: chiko4040 ($8.03 in chips) 
Bird et al: posts small blind $0.05
pokekrk: posts big blind $0.10
*** HOLE CARDS ***
Nikolai77798: raises $0.20 to $0.30
chiko4040: folds 
homelessdan: folds 
Bird et al: folds 
pokekrk: folds 
Uncalled bet ($0.20) returned to Nikolai77798
Nikolai77798 collected $0.25 from pot
*** SUMMARY ***
Total pot $0.25 | Rake $0 
Seat 2: homelessdan (button) folded before Flop (didn't bet)
Seat 3: Bird et al (small blind) folded before Flop
Seat 4: pokekrk (big blind) folded before Flop
Seat 5: Nikolai77798 collected ($0.25)
Seat 6: chiko4040 folded before Flop (didn't bet)



PokerStars Hand #166667959107:  Hold'em No Limit ($0.05/$0.10 USD) - 2017/02/23 16:10:40 ET
Table 'Amalia' 6-max Seat #2 is the button
Seat 1: voledy ($10.04 in chips) 
Seat 2: DamDatsAnAce ($10.95 in chips) 
Seat 3: Kow6oy ($10 in chips) 
Seat 4: Rodik002 ($16.51 in chips) 
Seat 5: coolisses111 ($13.45 in chips) 
Kow6oy: posts small blind $0.05
Rodik002: posts big blind $0.10
*** HOLE CARDS ***
coolisses111: raises $0.30 to $0.40
voledy: folds 
DamDatsAnAce: raises $0.95 to $1.35
Kow6oy: folds 
Rodik002: folds 
coolisses111: raises $1.45 to $2.80
DamDatsAnAce: raises $8.15 to $10.95 and is all-in
coolisses111: calls $8.15
*** FIRST FLOP *** [4c 9h 8s]
*** FIRST TURN *** [4c 9h 8s] [Qc]
*** FIRST RIVER *** [4c 9h 8s Qc] [Js]
*** SECOND FLOP *** [9c Ad Qh]
*** SECOND TURN *** [9c Ad Qh] [6c]
*** SECOND RIVER *** [9c Ad Qh 6c] [8d]
*** FIRST SHOW DOWN ***
coolisses111: shows [Kh Kc] (a pair of Kings)
DamDatsAnAce: shows [Ks Ac] (high card Ace)
coolisses111 collected $10.53 from pot
*** SECOND SHOW DOWN ***
coolisses111: shows [Kh Kc] (a pair of Kings)
DamDatsAnAce: shows [Ks Ac] (a pair of Aces)
DamDatsAnAce collected $10.53 from pot
*** SUMMARY ***
Total pot $22.05 | Rake $0.99 
Hand was run twice
FIRST Board [4c 9h 8s Qc Js]
SECOND Board [9c Ad Qh 6c 8d]
Seat 1: voledy folded before Flop (didn't bet)
Seat 2: DamDatsAnAce (button) showed [Ks Ac] and lost with high card Ace, and won ($10.53) with a pair of Aces
Seat 3: Kow6oy (small blind) folded before Flop
Seat 4: Rodik002 (big blind) folded before Flop
Seat 5: coolisses111 showed [Kh Kc] and won ($10.53) with a pair of Kings, and lost with a pair of Kings



PokerStars Hand #166667959188:  Hold'em No Limit ($0.05/$0.10 USD) - 2017/02/23 16:10:41 ET
Table 'Cassini' 6-max Seat #3 is the button
Seat 1: Pokeaster ($10.53 in chips) 
Seat 2: mhonielsen ($12.26 in chips) 
Seat 3: J1234T ($10.91 in chips) 
Seat 4: fortieth ($13.67 in chips) 
Seat 5: DrVzad ($10 in chips) 
Seat 6: MihaGr ($10 in chips) 
fortieth: posts small blind $0.05
DrVzad: posts big blind $0.10
*** HOLE CARDS ***
MihaGr: folds 
Pokeaster: folds 
mhonielsen: folds 
J1234T: folds 
fortieth: raises $0.20 to $0.30
DrVzad: folds 
Uncalled bet ($0.20) returned to fortieth
fortieth collected $0.20 from pot
*** SUMMARY ***
Total pot $0.20 | Rake $0 
Seat 1: Pokeaster folded before Flop (didn't bet)
Seat 2: mhonielsen folded before Flop (didn't bet)
Seat 3: J1234T (button) folded before Flop (didn't bet)
Seat 4: fortieth (small blind) collected ($0.20)
Seat 5: DrVzad (big blind) folded before Flop
Seat 6: MihaGr folded before Flop (didn't bet)



PokerStars Hand #166667959366:  Hold'em No Limit ($0.05/$0.10 USD) - 2017/02/23 16:10:41 ET
Table 'Kunigunde II' 6-max Seat #3 is the button
Seat 1: facewald ($9.88 in chips) 
Seat 2: DrVzad ($10.15 in chips) 
Seat 3: pancernik21 ($16.99 in chips) 
Seat 5: mdelfin0 ($12.63 in chips) 
Seat 6: Zooplack ($10.15 in chips) 
mdelfin0: posts small blind $0.05
Zooplack: posts big blind $0.10
*** HOLE CARDS ***
facewald: folds 
DrVzad: raises $0.20 to $0.30
pancernik21: calls $0.30
mdelfin0: folds 
Zooplack: folds 
*** FLOP *** [Kd Tc 8s]
DrVzad: bets $0.40
pancernik21: folds 
Uncalled bet ($0.40) returned to DrVzad
DrVzad collected $0.72 from pot
*** SUMMARY ***
Total pot $0.75 | Rake $0.03 
Board [Kd Tc 8s]
Seat 1: facewald folded before Flop (didn't bet)
Seat 2: DrVzad collected ($0.72)
Seat 3: pancernik21 (button) folded on the Flop
Seat 5: mdelfin0 (small blind) folded before Flop
Seat 6: Zooplack (big blind) folded before Flop



PokerStars Hand #166667959417:  Hold'em No Limit ($0.05/$0.10 USD) - 2017/02/23 16:10:41 ET
Table 'Vesta II' 6-max Seat #5 is the button
Seat 1: Yabidooo ($17.57 in chips) 
Seat 2: Dimka4 ($10 in chips) 
Seat 3: Pokeaster ($12.56 in chips) 
Seat 4: Dcaro31 ($10 in chips) 
Seat 5: ChuikaPridi ($10 in chips) 
Seat 6: XaXaTyH4uK ($11.41 in chips) 
XaXaTyH4uK: posts small blind $0.05
Yabidooo: posts big blind $0.10
*** HOLE CARDS ***
Dimka4: raises $0.20 to $0.30
Pokeaster: calls $0.30
Dcaro31: folds 
ChuikaPridi: folds 
XaXaTyH4uK: folds 
Yabidooo: folds 
*** FLOP *** [9c 8h Ks]
Dimka4: bets $0.37
Pokeaster: calls $0.37
*** TURN *** [9c 8h Ks] [2h]
Dimka4: checks 
Pokeaster: checks 
*** RIVER *** [9c 8h Ks 2h] [8d]
Dimka4: checks 
Pokeaster: checks 
*** SHOW DOWN ***
Dimka4: shows [Qc Jc] (a pair of Eights)
Pokeaster: shows [Td 9d] (two pair, Nines and Eights)
Pokeaster collected $1.42 from pot
*** SUMMARY ***
Total pot $1.49 | Rake $0.07 
Board [9c 8h Ks 2h 8d]
Seat 1: Yabidooo (big blind) folded before Flop
Seat 2: Dimka4 showed [Qc Jc] and lost with a pair of Eights
Seat 3: Pokeaster showed [Td 9d] and won ($1.42) with two pair, Nines and Eights
Seat 4: Dcaro31 folded before Flop (didn't bet)
Seat 5: ChuikaPridi (button) folded before Flop (didn't bet)
Seat 6: XaXaTyH4uK (small blind) folded before Flop



PokerStars Hand #166667959442:  Hold'em No Limit ($0.05/$0.10 USD) - 2017/02/23 16:10:41 ET
Table 'Phereclos II' 6-max Seat #6 is the button
Seat 1: Vladu1986 ($10 in chips) 
Seat 2: Kazacha ($15.63 in chips) 
Seat 5: crazydevill ($12.09 in chips) 
Seat 6: mhonielsen ($16.49 in chips) 
Vladu1986: posts small blind $0.05
Kazacha: posts big blind $0.10
overbet666: sits out 
*** HOLE CARDS ***
crazydevill: raises $0.20 to $0.30
mhonielsen: folds 
Vladu1986: folds 
Kazacha: folds 
Uncalled bet ($0.20) returned to crazydevill
crazydevill collected $0.25 from pot
*** SUMMARY ***
Total pot $0.25 | Rake $0 
Seat 1: Vladu1986 (small blind) folded before Flop
Seat 2: Kazacha (big blind) folded before Flop
Seat 5: crazydevill collected ($0.25)
Seat 6: mhonielsen (button) folded before Flop (didn't bet)



PokerStars Hand #166667959553:  Hold'em No Limit ($0.05/$0.10 USD) - 2017/02/23 16:10:41 ET
Table 'Mesarthim' 6-max Seat #1 is the button
Seat 1: Mancuso2010 ($16.27 in chips) 
Seat 2: MühliJr ($13.18 in chips) 
Seat 3: Damage514 ($9.34 in chips) 
Seat 4: Strelok1974 ($10 in chips) 
Seat 5: Iarlei ($10.30 in chips) 
Seat 6: bdixon_5 ($8.31 in chips) 
MühliJr: posts small blind $0.05
Damage514: posts big blind $0.10
*** HOLE CARDS ***
Strelok1974: folds 
Iarlei: folds 
bdixon_5: folds 
Mancuso2010: raises $0.20 to $0.30
MühliJr: calls $0.25
Damage514: folds 
*** FLOP *** [Ts 9d 6s]
MühliJr: checks 
Mancuso2010: bets $0.40
MühliJr: calls $0.40
*** TURN *** [Ts 9d 6s] [2c]
MühliJr: checks 
Mancuso2010: checks 
*** RIVER *** [Ts 9d 6s 2c] [6d]
MühliJr: checks 
Mancuso2010: checks 
*** SHOW DOWN ***
MühliJr: shows [9h As] (two pair, Nines and Sixes)
Mancuso2010: mucks hand 
MühliJr collected $1.43 from pot
*** SUMMARY ***
Total pot $1.50 | Rake $0.07 
Board [Ts 9d 6s 2c 6d]
Seat 1: Mancuso2010 (button) mucked
Seat 2: MühliJr (small blind) showed [9h As] and won ($1.43) with two pair, Nines and Sixes
Seat 3: Damage514 (big blind) folded before Flop
Seat 4: Strelok1974 folded before Flop (didn't bet)
Seat 5: Iarlei folded before Flop (didn't bet)
Seat 6: bdixon_5 folded before Flop (didn't bet)



PokerStars Hand #166667959632:  Hold'em No Limit ($0.05/$0.10 USD) - 2017/02/23 16:10:41 ET
Table 'Sheragul III' 6-max Seat #5 is the button
Seat 2: Bird et al ($10.36 in chips) 
Seat 3: FRAID358 ($10 in chips) 
Seat 5: RGhearted ($10 in chips) 
Seat 6: XaXaTyH4uK ($10.30 in chips) 
XaXaTyH4uK: posts small blind $0.05
Bird et al: posts big blind $0.10
*** HOLE CARDS ***
FRAID358: folds 
RGhearted: folds 
XaXaTyH4uK: raises $0.20 to $0.30
CallByValue joins the table at seat #1 
Bird et al: folds 
Uncalled bet ($0.20) returned to XaXaTyH4uK
XaXaTyH4uK collected $0.20 from pot
*** SUMMARY ***
Total pot $0.20 | Rake $0 
Seat 2: Bird et al (big blind) folded before Flop
Seat 3: FRAID358 folded before Flop (didn't bet)
Seat 5: RGhearted (button) folded before Flop (didn't bet)
Seat 6: XaXaTyH4uK (small blind) collected ($0.20)



PokerStars Hand #166667959771:  Hold'em No Limit ($0.05/$0.10 USD) - 2017/02/23 16:10:41 ET
Table 'Duhr II' 6-max Seat #4 is the button
Seat 2: Feverhead ($38.04 in chips) 
Seat 3: Smitty03300 ($10 in chips) 
Seat 4: CHRO8 ($9.85 in chips) 
Seat 5: Dimka4 ($10 in chips) 
Seat 6: townerz1991 ($11.28 in chips) 
Dimka4: posts small blind $0.05
townerz1991: posts big blind $0.10
*** HOLE CARDS ***
Feverhead: folds 
Smitty03300: folds 
CHRO8: folds 
Dimka4: folds 
Uncalled bet ($0.05) returned to townerz1991
townerz1991 collected $0.10 from pot
*** SUMMARY ***
Total pot $0.10 | Rake $0 
Seat 2: Feverhead folded before Flop (didn't bet)
Seat 3: Smitty03300 folded before Flop (didn't bet)
Seat 4: CHRO8 (button) folded before Flop (didn't bet)
Seat 5: Dimka4 (small blind) folded before Flop
Seat 6: townerz1991 (big blind) collected ($0.10)



PokerStars Hand #166667959964:  Hold'em No Limit ($0.05/$0.10 USD) - 2017/02/23 16:10:41 ET
Table 'Pallas II' 6-max Seat #6 is the button
Seat 1: mdelfin0 ($16.54 in chips) 
Seat 3: popypaleta ($10.45 in chips) 
Seat 4: MisterX413 ($10 in chips) 
Seat 6: Smitty03300 ($10 in chips) 
mdelfin0: posts small blind $0.05
popypaleta: posts big blind $0.10
*** HOLE CARDS ***
MisterX413: folds 
Smitty03300: raises $0.10 to $0.20
mdelfin0: folds 
popypaleta: folds 
Uncalled bet ($0.10) returned to Smitty03300
Smitty03300 collected $0.25 from pot
*** SUMMARY ***
Total pot $0.25 | Rake $0 
Seat 1: mdelfin0 (small blind) folded before Flop
Seat 3: popypaleta (big blind) folded before Flop
Seat 4: MisterX413 folded before Flop (didn't bet)
Seat 6: Smitty03300 (button) collected ($0.25)



PokerStars Hand #166667960050:  Hold'em No Limit ($0.05/$0.10 USD) - 2017/02/23 16:10:41 ET
Table 'Selinur' 6-max Seat #3 is the button
Seat 1: KA3AXCTAHEU, ($10 in chips) 
Seat 2: hoedje72 ($7.68 in chips) 
Seat 3: bambolejro ($11.07 in chips) 
Seat 4: ThuyeTD11 ($3.70 in chips) 
Seat 5: DrVzad ($10 in chips) 
Seat 6: homelessdan ($18.20 in chips) 
ThuyeTD11: posts small blind $0.05
DrVzad: posts big blind $0.10
*** HOLE CARDS ***
homelessdan: raises $0.20 to $0.30
KA3AXCTAHEU,: folds 
hoedje72: folds 
bambolejro: calls $0.30
ThuyeTD11: folds 
DrVzad: folds 
*** FLOP *** [Kc 4c Jc]
homelessdan: checks 
bambolejro: checks 
*** TURN *** [Kc 4c Jc] [Ah]
homelessdan: checks 
bambolejro: bets $0.49
homelessdan: calls $0.49
*** RIVER *** [Kc 4c Jc Ah] [7c]
homelessdan: checks 
bambolejro: checks 
*** SHOW DOWN ***
homelessdan: shows [Kh Qd] (a pair of Kings)
bambolejro: shows [Qs As] (a pair of Aces)
bambolejro collected $1.65 from pot
*** SUMMARY ***
Total pot $1.73 | Rake $0.08 
Board [Kc 4c Jc Ah 7c]
Seat 1: KA3AXCTAHEU, folded before Flop (didn't bet)
Seat 2: hoedje72 folded before Flop (didn't bet)
Seat 3: bambolejro (button) showed [Qs As] and won ($1.65) with a pair of Aces
Seat 4: ThuyeTD11 (small blind) folded before Flop
Seat 5: DrVzad (big blind) folded before Flop
Seat 6: homelessdan showed [Kh Qd] and lost with a pair of Kings



PokerStars Hand #166667960105:  Hold'em No Limit ($0.05/$0.10 USD) - 2017/02/23 16:10:41 ET
Table 'Nemo III' 6-max Seat #3 is the button
Seat 1: Kow6oy ($10.10 in chips) 
Seat 2: Bandyaev ($10.81 in chips) 
Seat 3: Dimka4 ($10 in chips) 
Seat 4: vtalian ($11.03 in chips) 
Seat 5: Joker51_wtf! ($11.73 in chips) 
Seat 6: maxiv608 ($10 in chips) 
vtalian: posts small blind $0.05
Joker51_wtf!: posts big blind $0.10
*** HOLE CARDS ***
maxiv608: folds 
Kow6oy: folds 
Bandyaev: folds 
Dimka4: folds 
vtalian: folds 
Uncalled bet ($0.05) returned to Joker51_wtf!
Joker51_wtf! collected $0.10 from pot
*** SUMMARY ***
Total pot $0.10 | Rake $0 
Seat 1: Kow6oy folded before Flop (didn't bet)
Seat 2: Bandyaev folded before Flop (didn't bet)
Seat 3: Dimka4 (button) folded before Flop (didn't bet)
Seat 4: vtalian (small blind) folded before Flop
Seat 5: Joker51_wtf! (big blind) collected ($0.10)
Seat 6: maxiv608 folded before Flop (didn't bet)



PokerStars Hand #166667960141:  Hold'em No Limit ($0.05/$0.10 USD) - 2017/02/23 16:10:41 ET
Table 'Hirons' 6-max Seat #6 is the button
Seat 1: RoJ1 ($12.24 in chips) 
Seat 2: coolisses111 ($10 in chips) 
Seat 3: czeczen7 ($14.11 in chips) 
Seat 4: Smitty03300 ($11.20 in chips) 
Seat 5: Pekaml ($10 in chips) 
Seat 6: garigura ($13.48 in chips) 
RoJ1: posts small blind $0.05
coolisses111: posts big blind $0.10
*** HOLE CARDS ***
czeczen7: calls $0.10
Smitty03300: raises $0.35 to $0.45
Pekaml: folds 
garigura: folds 
RoJ1: folds 
coolisses111: folds 
czeczen7: calls $0.35
*** FLOP *** [Qh Ts 4c]
czeczen7: checks 
Smitty03300: bets $0.55
czeczen7: folds 
Uncalled bet ($0.55) returned to Smitty03300
Smitty03300 collected $1 from pot
*** SUMMARY ***
Total pot $1.05 | Rake $0.05 
Board [Qh Ts 4c]
Seat 1: RoJ1 (small blind) folded before Flop
Seat 2: coolisses111 (big blind) folded before Flop
Seat 3: czeczen7 folded on the Flop
Seat 4: Smitty03300 collected ($1)
Seat 5: Pekaml folded before Flop (didn't bet)
Seat 6: garigura (button) folded before Flop (didn't bet)



PokerStars Hand #166667960343:  Hold'em No Limit ($0.05/$0.10 USD) - 2017/02/23 16:10:42 ET
Table 'Caprera III' 6-max Seat #6 is the button
Seat 1: Vrinni ($18.74 in chips) 
Seat 6: GESPERIA ($15.01 in chips) 
GESPERIA: posts small blind $0.05
Vrinni: posts big blind $0.10
*** HOLE CARDS ***
GESPERIA: raises $0.20 to $0.30
Vrinni: folds 
Uncalled bet ($0.20) returned to GESPERIA
GESPERIA collected $0.20 from pot
*** SUMMARY ***
Total pot $0.20 | Rake $0 
Seat 1: Vrinni (big blind) folded before Flop
Seat 6: GESPERIA (button) (small blind) collected ($0.20)



PokerStars Hand #166667960563:  Hold'em No Limit ($0.05/$0.10 USD) - 2017/02/23 16:10:42 ET
Table 'Sinon II' 6-max Seat #5 is the button
Seat 1: Aescul@pius ($10 in chips) 
Seat 2: ÄissesHai ($28.77 in chips) 
Seat 3: crazydevill ($10 in chips) 
Seat 4: Bandyaev ($14.68 in chips) 
Seat 5: ab260414 ($10.91 in chips) 
Seat 6: hartmut2012 ($5.92 in chips) 
hartmut2012: posts small blind $0.05
Aescul@pius: posts big blind $0.10
*** HOLE CARDS ***
ÄissesHai: calls $0.10
crazydevill: folds 
Bandyaev: folds 
ab260414: raises $0.30 to $0.40
hartmut2012: calls $0.35
Aescul@pius: folds 
ÄissesHai: calls $0.30
*** FLOP *** [Jc Qd 9c]
hartmut2012: checks 
ÄissesHai: bets $0.30
ab260414: calls $0.30
hartmut2012: calls $0.30
*** TURN *** [Jc Qd 9c] [2h]
hartmut2012: checks 
ÄissesHai: bets $0.30
ab260414: folds 
hartmut2012: calls $0.30
*** RIVER *** [Jc Qd 9c 2h] [7s]
hartmut2012: bets $2.70
ÄissesHai: folds 
Uncalled bet ($2.70) returned to hartmut2012
hartmut2012 collected $2.67 from pot
*** SUMMARY ***
Total pot $2.80 | Rake $0.13 
Board [Jc Qd 9c 2h 7s]
Seat 1: Aescul@pius (big blind) folded before Flop
Seat 2: ÄissesHai folded on the River
Seat 3: crazydevill folded before Flop (didn't bet)
Seat 4: Bandyaev folded before Flop (didn't bet)
Seat 5: ab260414 (button) folded on the Turn
Seat 6: hartmut2012 (small blind) collected ($2.67)



PokerStars Hand #166667960768:  Hold'em No Limit ($0.05/$0.10 USD) - 2017/02/23 16:10:42 ET
Table 'Huberta II' 6-max Seat #6 is the button
Seat 1: tr41n3r12 ($10 in chips) 
Seat 2: Ice_Isayev ($10 in chips) 
Seat 3: patrick19111 ($12.71 in chips) 
Seat 4: VAD21 ($11.96 in chips) 
Seat 5: Feverhead ($27.55 in chips) 
Seat 6: yodzik ($5.68 in chips) 
tr41n3r12: posts small blind $0.05
Ice_Isayev: posts big blind $0.10
*** HOLE CARDS ***
patrick19111: folds 
VAD21: folds 
Feverhead: folds 
yodzik: raises $0.20 to $0.30
tr41n3r12: folds 
Ice_Isayev: folds 
Uncalled bet ($0.20) returned to yodzik
yodzik collected $0.25 from pot
*** SUMMARY ***
Total pot $0.25 | Rake $0 
Seat 1: tr41n3r12 (small blind) folded before Flop
Seat 2: Ice_Isayev (big blind) folded before Flop
Seat 3: patrick19111 folded before Flop (didn't bet)
Seat 4: VAD21 folded before Flop (didn't bet)
Seat 5: Feverhead folded before Flop (didn't bet)
Seat 6: yodzik (button) collected ($0.25)



PokerStars Hand #166667960769:  Hold'em No Limit ($0.05/$0.10 USD) - 2017/02/23 16:10:42 ET
Table 'Themisto II' 6-max Seat #3 is the button
Seat 1: ChuikaPridi ($10.25 in chips) 
Seat 2: CA225 ($11.81 in chips) 
Seat 3: eniksenik ($16.06 in chips) 
Seat 4: DrVzad ($9.90 in chips) 
Seat 5: ex3Lero86 ($10.94 in chips) 
Seat 6: noobigrok ($2.47 in chips) 
DrVzad: posts small blind $0.05
ex3Lero86: posts big blind $0.10
*** HOLE CARDS ***
noobigrok: raises $0.20 to $0.30
ChuikaPridi: folds 
CA225: folds 
eniksenik: calls $0.30
DrVzad: folds 
ex3Lero86: calls $0.20
*** FLOP *** [4s 9h 5c]
ex3Lero86: checks 
noobigrok: bets $0.91
eniksenik: calls $0.91
ex3Lero86: folds 
*** TURN *** [4s 9h 5c] [8c]
noobigrok: bets $1.26 and is all-in
eniksenik: calls $1.26
*** RIVER *** [4s 9h 5c 8c] [2h]
*** SHOW DOWN ***
noobigrok: shows [9c Ah] (a pair of Nines)
eniksenik: shows [8h 8s] (three of a kind, Eights)
eniksenik collected $5.05 from pot
*** SUMMARY ***
Total pot $5.29 | Rake $0.24 
Board [4s 9h 5c 8c 2h]
Seat 1: ChuikaPridi folded before Flop (didn't bet)
Seat 2: CA225 folded before Flop (didn't bet)
Seat 3: eniksenik (button) showed [8h 8s] and won ($5.05) with three of a kind, Eights
Seat 4: DrVzad (small blind) folded before Flop
Seat 5: ex3Lero86 (big blind) folded on the Flop
Seat 6: noobigrok showed [9c Ah] and lost with a pair of Nines



PokerStars Hand #166667960815:  Hold'em No Limit ($0.05/$0.10 USD) - 2017/02/23 16:10:42 ET
Table 'Tristan III' 6-max Seat #2 is the button
Seat 1: CHRO8 ($19.04 in chips) 
Seat 2: Hyd SK ($14.48 in chips) 
Seat 4: Feverhead ($11.23 in chips) 
Seat 5: RoJ1 ($10 in chips) 
Seat 6: fredrik10528 ($9.65 in chips) 
Feverhead: posts small blind $0.05
RoJ1: posts big blind $0.10
*** HOLE CARDS ***
fredrik10528: folds 
CHRO8: folds 
Hyd SK: raises $0.15 to $0.25
Feverhead: folds 
RoJ1: calls $0.15
*** FLOP *** [Qc Td 3h]
RoJ1: checks 
Hyd SK: bets $0.35
RoJ1: calls $0.35
*** TURN *** [Qc Td 3h] [4h]
RoJ1: checks 
Hyd SK: bets $0.79
RoJ1: folds 
Uncalled bet ($0.79) returned to Hyd SK
Hyd SK collected $1.19 from pot
*** SUMMARY ***
Total pot $1.25 | Rake $0.06 
Board [Qc Td 3h 4h]
Seat 1: CHRO8 folded before Flop (didn't bet)
Seat 2: Hyd SK (button) collected ($1.19)
Seat 4: Feverhead (small blind) folded before Flop
Seat 5: RoJ1 (big blind) folded on the Turn
Seat 6: fredrik10528 folded before Flop (didn't bet)



PokerStars Hand #166667960949:  Hold'em No Limit ($0.05/$0.10 USD) - 2017/02/23 16:10:42 ET
Table 'Caupolican II' 6-max Seat #4 is the button
Seat 1: Strelok1974 ($10 in chips) 
Seat 2: MBen10 ($25.62 in chips) 
Seat 4: GESPERIA ($21.27 in chips) 
Seat 5: ArcticBearDK ($15.35 in chips) 
Seat 6: pancernik21 ($10 in chips) 
ArcticBearDK: posts small blind $0.05
pancernik21: posts big blind $0.10
*** HOLE CARDS ***
Strelok1974: folds 
MBen10: raises $0.15 to $0.25
GESPERIA: calls $0.25
ArcticBearDK: folds 
pancernik21: folds 
*** FLOP *** [4s 6h 5s]
MBen10: bets $0.40
GESPERIA: calls $0.40
*** TURN *** [4s 6h 5s] [7c]
MBen10: checks 
GESPERIA: checks 
*** RIVER *** [4s 6h 5s 7c] [Qd]
MBen10: checks 
GESPERIA: bets $1.60
MBen10: folds 
Uncalled bet ($1.60) returned to GESPERIA
GESPERIA collected $1.38 from pot
*** SUMMARY ***
Cruger: !!???????!!??!!??
Total pot $1.45 | Rake $0.07 
Board [4s 6h 5s 7c Qd]
Seat 1: Strelok1974 folded before Flop (didn't bet)
Seat 2: MBen10 folded on the River
Seat 4: GESPERIA (button) collected ($1.38)
Seat 5: ArcticBearDK (small blind) folded before Flop
Seat 6: pancernik21 (big blind) folded before Flop



PokerStars Hand #166667961021:  Hold'em No Limit ($0.05/$0.10 USD) - 2017/02/23 16:10:42 ET
Table 'Ruvuma' 6-max Seat #1 is the button
Seat 1: FRAID358 ($24.29 in chips) 
Seat 3: Spud014 ($10.28 in chips) 
Seat 5: sexy_seagull ($10 in chips) 
Spud014: posts small blind $0.05
DamDatsAnAce: is sitting out 
DamDatsAnAce leaves the table
sexy_seagull: posts big blind $0.10
osmea: sits out 
*** HOLE CARDS ***
FRAID358: folds 
Spud014: folds 
Uncalled bet ($0.05) returned to sexy_seagull
sexy_seagull collected $0.10 from pot
*** SUMMARY ***
Total pot $0.10 | Rake $0 
Seat 1: FRAID358 (button) folded before Flop (didn't bet)
Seat 3: Spud014 (small blind) folded before Flop
Seat 5: sexy_seagull (big blind) collected ($0.10)



PokerStars Hand #166667961048:  Hold'em No Limit ($0.05/$0.10 USD) - 2017/02/23 16:10:42 ET
Table 'Jacchia' 6-max Seat #6 is the button
Seat 1: viklundm ($32.28 in chips) 
Seat 3: maxiv608 ($10 in chips) 
Seat 4: paterthomas ($9.51 in chips) 
Seat 5: arti192837 ($11.24 in chips) 
Seat 6: RoJ1 ($12.84 in chips) 
viklundm: posts small blind $0.05
VAD21: is sitting out 
maxiv608: posts big blind $0.10
*** HOLE CARDS ***
paterthomas: folds 
arti192837: folds 
RoJ1: raises $0.12 to $0.22
viklundm: folds 
maxiv608: folds 
Uncalled bet ($0.12) returned to RoJ1
RoJ1 collected $0.25 from pot
*** SUMMARY ***
Total pot $0.25 | Rake $0 
Seat 1: viklundm (small blind) folded before Flop
Seat 3: maxiv608 (big blind) folded before Flop
Seat 4: paterthomas folded before Flop (didn't bet)
Seat 5: arti192837 folded before Flop (didn't bet)
Seat 6: RoJ1 (button) collected ($0.25)



PokerStars Hand #166667961157:  Hold'em No Limit ($0.05/$0.10 USD) - 2017/02/23 16:10:43 ET
Table 'Crommelin II' 6-max Seat #5 is the button
Seat 1: THIMUCHIN ($10 in chips) 
Seat 2: Bird et al ($10 in chips) 
Seat 3: Strelok1974 ($22.88 in chips) 
Seat 4: Pequeño Clau ($12.82 in chips) 
Seat 5: Action_Gibi ($19.15 in chips) 
THIMUCHIN: posts small blind $0.05
Bird et al: posts big blind $0.10
*** HOLE CARDS ***
Strelok1974: folds 
Pequeño Clau: folds 
Action_Gibi: folds 
THIMUCHIN: raises $0.15 to $0.25
Bird et al: raises $0.75 to $1
THIMUCHIN: raises $1.65 to $2.65
Bird et al: raises $7.35 to $10 and is all-in
THIMUCHIN: calls $7.35 and is all-in
*** FLOP *** [9s Ah 6s]
*** TURN *** [9s Ah 6s] [Ac]
*** RIVER *** [9s Ah 6s Ac] [Js]
*** SHOW DOWN ***
THIMUCHIN: shows [Ad As] (four of a kind, Aces)
Bird et al: shows [Qh Jc] (two pair, Aces and Jacks)
THIMUCHIN collected $19.10 from pot
*** SUMMARY ***
Total pot $20 | Rake $0.90 
Board [9s Ah 6s Ac Js]
Seat 1: THIMUCHIN (small blind) showed [Ad As] and won ($19.10) with four of a kind, Aces
Seat 2: Bird et al (big blind) showed [Qh Jc] and lost with two pair, Aces and Jacks
Seat 3: Strelok1974 folded before Flop (didn't bet)
Seat 4: Pequeño Clau folded before Flop (didn't bet)
Seat 5: Action_Gibi (button) folded before Flop (didn't bet)



PokerStars Hand #166667961167:  Hold'em No Limit ($0.05/$0.10 USD) - 2017/02/23 16:10:43 ET
Table 'Aisakos II' 6-max Seat #4 is the button
Seat 1: Crafty23@PS ($10.35 in chips) 
Seat 2: svaika24 ($17.02 in chips) 
Seat 3: iamkakaroto ($10.82 in chips) 
Seat 4: T9MS ($10.30 in chips) 
Seat 5: KokoulinV ($11.65 in chips) 
Seat 6: LarryTheStar ($10.03 in chips) 
KokoulinV: posts small blind $0.05
LarryTheStar: posts big blind $0.10
*** HOLE CARDS ***
Crafty23@PS: raises $0.30 to $0.40
svaika24: folds 
iamkakaroto: folds 
T9MS: folds 
KokoulinV: folds 
LarryTheStar: folds 
Uncalled bet ($0.30) returned to Crafty23@PS
Crafty23@PS collected $0.25 from pot
*** SUMMARY ***
Total pot $0.25 | Rake $0 
Seat 1: Crafty23@PS collected ($0.25)
Seat 2: svaika24 folded before Flop (didn't bet)
Seat 3: iamkakaroto folded before Flop (didn't bet)
Seat 4: T9MS (button) folded before Flop (didn't bet)
Seat 5: KokoulinV (small blind) folded before Flop
Seat 6: LarryTheStar (big blind) folded before Flop



PokerStars Hand #166667961397:  Hold'em No Limit ($0.05/$0.10 USD) - 2017/02/23 16:10:43 ET
Table 'Ophelia' 6-max Seat #5 is the button
Seat 1: ralfi37 ($11.14 in chips) 
Seat 2: popypaleta ($16.63 in chips) 
Seat 3: mvp0013 ($10.80 in chips) 
Seat 4: Cluckh ($11.99 in chips) 
Seat 5: truck1234 ($13.21 in chips) 
Seat 6: Yabidooo ($11.03 in chips) 
Yabidooo: posts small blind $0.05
ralfi37: posts big blind $0.10
*** HOLE CARDS ***
popypaleta: folds 
mvp0013: folds 
Cluckh: folds 
truck1234: folds 
Yabidooo: calls $0.05
ralfi37: checks 
*** FLOP *** [Ac As 8c]
Yabidooo: bets $0.10
ralfi37: calls $0.10
*** TURN *** [Ac As 8c] [9h]
Yabidooo: bets $0.20
ralfi37: calls $0.20
*** RIVER *** [Ac As 8c 9h] [Jd]
Yabidooo: checks 
ralfi37: checks 
*** SHOW DOWN ***
Yabidooo: shows [Kh 8s] (two pair, Aces and Eights)
ralfi37: shows [Ah 2h] (three of a kind, Aces)
ralfi37 collected $0.76 from pot
*** SUMMARY ***
Total pot $0.80 | Rake $0.04 
Board [Ac As 8c 9h Jd]
Seat 1: ralfi37 (big blind) showed [Ah 2h] and won ($0.76) with three of a kind, Aces
Seat 2: popypaleta folded before Flop (didn't bet)
Seat 3: mvp0013 folded before Flop (didn't bet)
Seat 4: Cluckh folded before Flop (didn't bet)
Seat 5: truck1234 (button) folded before Flop (didn't bet)
Seat 6: Yabidooo (small blind) showed [Kh 8s] and lost with two pair, Aces and Eights



PokerStars Hand #166667961773:  Hold'em No Limit ($0.05/$0.10 USD) - 2017/02/23 16:10:43 ET
Table 'Antielus II' 6-max Seat #2 is the button
Seat 1: Dcaro31 ($18.49 in chips) 
Seat 2: Orlangoor ($10 in chips) 
Seat 3: mcyi3at2 ($9.07 in chips) 
Seat 4: XwinX25 ($10 in chips) 
Seat 5: Hyd SK ($14.87 in chips) 
Seat 6: GiveTwoMe ($11.98 in chips) 
mcyi3at2: posts small blind $0.05
XwinX25: posts big blind $0.10
*** HOLE CARDS ***
Hyd SK: folds 
GiveTwoMe: raises $0.20 to $0.30
Dcaro31: calls $0.30
Orlangoor: calls $0.30
mcyi3at2: folds 
XwinX25: folds 
*** FLOP *** [Kc 4h 3s]
GiveTwoMe: bets $0.60
Dcaro31: folds 
Orlangoor: folds 
Uncalled bet ($0.60) returned to GiveTwoMe
GiveTwoMe collected $1 from pot
*** SUMMARY ***
Total pot $1.05 | Rake $0.05 
Board [Kc 4h 3s]
Seat 1: Dcaro31 folded on the Flop
Seat 2: Orlangoor (button) folded on the Flop
Seat 3: mcyi3at2 (small blind) folded before Flop
Seat 4: XwinX25 (big blind) folded before Flop
Seat 5: Hyd SK folded before Flop (didn't bet)
Seat 6: GiveTwoMe collected ($1)



PokerStars Hand #166667961857:  Hold'em No Limit ($0.05/$0.10 USD) - 2017/02/23 16:10:43 ET
Table 'Pulcova II' 6-max Seat #6 is the button
Seat 1: sexy_seagull ($11.43 in chips) 
Seat 2: Kazacha ($10.40 in chips) 
Seat 3: Lao Tsy ($14.22 in chips) 
Seat 4: Jalida3 ($10 in chips) 
Seat 5: mdelfin0 ($10 in chips) 
Seat 6: Ice_Isayev ($10 in chips) 
sexy_seagull: posts small blind $0.05
Kazacha: posts big blind $0.10
Jalida3: posts big blind $0.10
*** HOLE CARDS ***
Lao Tsy: folds 
Jalida3: checks 
mdelfin0: raises $0.30 to $0.40
Ice_Isayev: calls $0.40
sexy_seagull: folds 
Kazacha: folds 
Jalida3: folds 
*** FLOP *** [5h 3c Js]
mdelfin0: checks 
Ice_Isayev: checks 
*** TURN *** [5h 3c Js] [3h]
mdelfin0: bets $0.47
Ice_Isayev: folds 
Uncalled bet ($0.47) returned to mdelfin0
mdelfin0 collected $1 from pot
*** SUMMARY ***
Total pot $1.05 | Rake $0.05 
Board [5h 3c Js 3h]
Seat 1: sexy_seagull (small blind) folded before Flop
Seat 2: Kazacha (big blind) folded before Flop
Seat 3: Lao Tsy folded before Flop (didn't bet)
Seat 4: Jalida3 folded before Flop
Seat 5: mdelfin0 collected ($1)
Seat 6: Ice_Isayev (button) folded on the Turn



PokerStars Hand #166667961858:  Hold'em No Limit ($0.05/$0.10 USD) - 2017/02/23 16:10:43 ET
Table 'Peiroos' 6-max Seat #3 is the button
Seat 1: ksandr_hom ($10 in chips) 
Seat 2: Nr847 ($10.80 in chips) 
Seat 3: atlx0711 ($25.09 in chips) 
Seat 4: Peter0087 ($8.57 in chips) 
Seat 5: sergio-cb164 ($8 in chips) 
Seat 6: DevonMiles88 ($11.61 in chips) 
Peter0087: posts small blind $0.05
sergio-cb164: posts big blind $0.10
*** HOLE CARDS ***
DevonMiles88: calls $0.10
ksandr_hom: folds 
Nr847: folds 
atlx0711: raises $0.20 to $0.30
Peter0087: raises $1.20 to $1.50
sergio-cb164: folds 
DevonMiles88: calls $1.40
atlx0711: folds 
*** FLOP *** [2s 5d Jc]
Peter0087: bets $7.07 and is all-in
DevonMiles88: folds 
Uncalled bet ($7.07) returned to Peter0087
Peter0087 collected $3.25 from pot
*** SUMMARY ***
Total pot $3.40 | Rake $0.15 
Board [2s 5d Jc]
Seat 1: ksandr_hom folded before Flop (didn't bet)
Seat 2: Nr847 folded before Flop (didn't bet)
Seat 3: atlx0711 (button) folded before Flop
Seat 4: Peter0087 (small blind) collected ($3.25)
Seat 5: sergio-cb164 (big blind) folded before Flop
Seat 6: DevonMiles88 folded on the Flop



PokerStars Hand #166667961884:  Hold'em No Limit ($0.05/$0.10 USD) - 2017/02/23 16:10:43 ET
Table 'Gaika' 6-max Seat #1 is the button
Seat 1: oddshoff ($16.76 in chips) 
Seat 4: fortieth ($10.27 in chips) 
oddshoff: posts small blind $0.05
NvR.m1nD: is sitting out 
fortieth: posts big blind $0.10
*** HOLE CARDS ***
dr.goofy leaves the table
NvR.m1nD leaves the table
oddshoff: raises $0.10 to $0.20
fortieth: calls $0.10
*** FLOP *** [Jd Tc 7c]
fortieth: checks 
oddshoff: checks 
*** TURN *** [Jd Tc 7c] [8s]
fortieth: bets $0.27
oddshoff: folds 
Uncalled bet ($0.27) returned to fortieth
fortieth collected $0.38 from pot
*** SUMMARY ***
Total pot $0.40 | Rake $0.02 
Board [Jd Tc 7c 8s]
Seat 1: oddshoff (button) (small blind) folded on the Turn
Seat 4: fortieth (big blind) collected ($0.38)



PokerStars Hand #166667961943:  Hold'em No Limit ($0.05/$0.10 USD) - 2017/02/23 16:10:43 ET
Table 'Markab II' 6-max Seat #6 is the button
Seat 2: truck1234 ($10.87 in chips) 
Seat 3: sexy_seagull ($10.15 in chips) 
Seat 4: Crafty23@PS ($11.44 in chips) 
Seat 5: Rodik002 ($19.77 in chips) 
Seat 6: Comeback3392 ($10 in chips) 
Danijnho will be allowed to play after the button
truck1234: posts small blind $0.05
sexy_seagull: posts big blind $0.10
*** HOLE CARDS ***
Crafty23@PS: folds 
Rodik002: raises $0.15 to $0.25
Comeback3392: folds 
truck1234: calls $0.20
sexy_seagull: raises $0.95 to $1.20
Rodik002: folds 
truck1234: calls $0.95
*** FLOP *** [3c Jd Ac]
truck1234: checks 
sexy_seagull: bets $1.20
truck1234: folds 
Uncalled bet ($1.20) returned to sexy_seagull
sexy_seagull collected $2.53 from pot
*** SUMMARY ***
Total pot $2.65 | Rake $0.12 
Board [3c Jd Ac]
Seat 2: truck1234 (small blind) folded on the Flop
Seat 3: sexy_seagull (big blind) collected ($2.53)
Seat 4: Crafty23@PS folded before Flop (didn't bet)
Seat 5: Rodik002 folded before Flop
Seat 6: Comeback3392 (button) folded before Flop (didn't bet)



PokerStars Hand #166667961949:  Hold'em No Limit ($0.05/$0.10 USD) - 2017/02/23 16:10:43 ET
Table 'Halawe II' 6-max Seat #5 is the button
Seat 1: DIGOR100 ($6.16 in chips) 
Seat 3: cherep61987 ($10.39 in chips) 
Seat 4: voledy ($12 in chips) 
Seat 5: takis nik ($12.88 in chips) 
Seat 6: Rodik002 ($21.35 in chips) 
Rodik002: posts small blind $0.05
DIGOR100: posts big blind $0.10
*** HOLE CARDS ***
cherep61987: folds 
voledy: folds 
takis nik: raises $0.10 to $0.20
Rodik002: folds 
DIGOR100: raises $0.45 to $0.65
takis nik: folds 
Uncalled bet ($0.45) returned to DIGOR100
DIGOR100 collected $0.45 from pot
*** SUMMARY ***
Total pot $0.45 | Rake $0 
Seat 1: DIGOR100 (big blind) collected ($0.45)
Seat 3: cherep61987 folded before Flop (didn't bet)
Seat 4: voledy folded before Flop (didn't bet)
Seat 5: takis nik (button) folded before Flop
Seat 6: Rodik002 (small blind) folded before Flop



PokerStars Hand #166667961989:  Hold'em No Limit ($0.05/$0.10 USD) - 2017/02/23 16:10:43 ET
Table 'Eurykleia' 6-max Seat #3 is the button
Seat 1: Giyorod ($10.15 in chips) 
Seat 2: x3ultimate ($10.74 in chips) 
Seat 3: boxer821 ($20.26 in chips) 
Seat 4: 6ePeMeHHa9 ($18.85 in chips) 
Seat 5: fishhook5 ($10 in chips) 
Seat 6: afca128 ($4.72 in chips) 
6ePeMeHHa9: posts small blind $0.05
fishhook5: posts big blind $0.10
*** HOLE CARDS ***
afca128: calls $0.10
Giyorod: raises $0.35 to $0.45
x3ultimate: folds 
boxer821: folds 
6ePeMeHHa9: folds 
fishhook5: folds 
afca128: folds 
Uncalled bet ($0.35) returned to Giyorod
Giyorod collected $0.35 from pot
*** SUMMARY ***
Total pot $0.35 | Rake $0 
Seat 1: Giyorod collected ($0.35)
Seat 2: x3ultimate folded before Flop (didn't bet)
Seat 3: boxer821 (button) folded before Flop (didn't bet)
Seat 4: 6ePeMeHHa9 (small blind) folded before Flop
Seat 5: fishhook5 (big blind) folded before Flop
Seat 6: afca128 folded before Flop



PokerStars Hand #166667962029:  Hold'em No Limit ($0.05/$0.10 USD) - 2017/02/23 16:10:43 ET
Table 'Rostia' 6-max Seat #4 is the button
Seat 1: paxit71 ($8 in chips) 
Seat 2: GrzesiuWilu ($10 in chips) 
Seat 3: iThreeBarrel ($10 in chips) 
Seat 4: Hyd SK ($12.03 in chips) 
Seat 5: silsilviu ($7.57 in chips) 
Seat 6: Giyorod ($16.53 in chips) 
silsilviu: posts small blind $0.05
Giyorod: posts big blind $0.10
GrzesiuWilu: posts big blind $0.10
*** HOLE CARDS ***
paxit71: calls $0.10
GrzesiuWilu: checks 
iThreeBarrel: folds 
Hyd SK: folds 
silsilviu: folds 
Giyorod: checks 
*** FLOP *** [3h Jc Qs]
Giyorod: checks 
paxit71: checks 
GrzesiuWilu: checks 
*** TURN *** [3h Jc Qs] [7d]
Giyorod: bets $0.21
paxit71: folds 
GrzesiuWilu: calls $0.21
*** RIVER *** [3h Jc Qs 7d] [2s]
Giyorod: bets $0.41
GrzesiuWilu: raises $0.41 to $0.82
Giyorod: calls $0.41
*** SHOW DOWN ***
GrzesiuWilu: shows [Qc 4h] (a pair of Queens)
Giyorod: shows [Qd 6d] (a pair of Queens - Jack+Seven+Six kicker)
Giyorod collected $2.30 from pot
*** SUMMARY ***
Total pot $2.41 | Rake $0.11 
Board [3h Jc Qs 7d 2s]
Seat 1: paxit71 folded on the Turn
Seat 2: GrzesiuWilu showed [Qc 4h] and lost with a pair of Queens
Seat 3: iThreeBarrel folded before Flop (didn't bet)
Seat 4: Hyd SK (button) folded before Flop (didn't bet)
Seat 5: silsilviu (small blind) folded before Flop
Seat 6: Giyorod (big blind) showed [Qd 6d] and won ($2.30) with a pair of Queens



PokerStars Hand #166667962091:  Hold'em No Limit ($0.05/$0.10 USD) - 2017/02/23 16:10:44 ET
Table 'Tomita II' 6-max Seat #1 is the button
Seat 1: HARDCORE66RU ($22.63 in chips) 
Seat 2: mhonielsen ($10.20 in chips) 
Seat 4: Hyd SK ($11.76 in chips) 
Seat 5: ex3Lero86 ($10 in chips) 
Seat 6: saniasmir ($10 in chips) 
mhonielsen: posts small blind $0.05
D3NyA: is sitting out 
Hyd SK: posts big blind $0.10
*** HOLE CARDS ***
D3NyA leaves the table
Kow6oy joins the table at seat #3 
ex3Lero86: folds 
saniasmir has timed out
saniasmir: folds 
HARDCORE66RU: raises $0.15 to $0.25
mhonielsen: folds 
Hyd SK: folds 
Uncalled bet ($0.15) returned to HARDCORE66RU
HARDCORE66RU collected $0.25 from pot
*** SUMMARY ***
Total pot $0.25 | Rake $0 
Seat 1: HARDCORE66RU (button) collected ($0.25)
Seat 2: mhonielsen (small blind) folded before Flop
Seat 4: Hyd SK (big blind) folded before Flop
Seat 5: ex3Lero86 folded before Flop (didn't bet)
Seat 6: saniasmir folded before Flop (didn't bet)



PokerStars Hand #166667962468:  Hold'em No Limit ($0.05/$0.10 USD) - 2017/02/23 16:10:44 ET
Table 'Alnasl' 6-max Seat #5 is the button
Seat 2: saddur ($9.09 in chips) 
Seat 4: oddshoff ($10.50 in chips) 
Seat 5: 6ePeMeHHa9 ($10 in chips) 
Seat 6: Zooplack ($13.48 in chips) 
Zooplack: posts small blind $0.05
KA3AXCTAHEU,: is sitting out 
saddur: posts big blind $0.10
*** HOLE CARDS ***
KA3AXCTAHEU, leaves the table
RoJ1 joins the table at seat #1 
oddshoff: folds 
6ePeMeHHa9: folds 
Zooplack: raises $0.15 to $0.25
saddur: folds 
Uncalled bet ($0.15) returned to Zooplack
Zooplack collected $0.20 from pot
*** SUMMARY ***
Total pot $0.20 | Rake $0 
Seat 2: saddur (big blind) folded before Flop
Seat 4: oddshoff folded before Flop (didn't bet)
Seat 5: 6ePeMeHHa9 (button) folded before Flop (didn't bet)
Seat 6: Zooplack (small blind) collected ($0.20)



PokerStars Hand #166667962786:  Hold'em No Limit ($0.05/$0.10 USD) - 2017/02/23 16:10:44 ET
Table 'Camilla II' 6-max Seat #5 is the button
Seat 1: paxit71 ($8.22 in chips) 
Seat 2: Giyorod ($13.01 in chips) 
Seat 3: Andy Wolf ($12.84 in chips) 
Seat 4: chimera252 ($12.41 in chips) 
Seat 5: LarryTheStar ($11.09 in chips) 
DeleonBR will be allowed to play after the button
paxit71: posts small blind $0.05
Giyorod: posts big blind $0.10
*** HOLE CARDS ***
Andy Wolf: folds 
chimera252: raises $0.20 to $0.30
LarryTheStar: folds 
paxit71: folds 
Giyorod: folds 
Uncalled bet ($0.20) returned to chimera252
chimera252 collected $0.25 from pot
*** SUMMARY ***
Total pot $0.25 | Rake $0 
Seat 1: paxit71 (small blind) folded before Flop
Seat 2: Giyorod (big blind) folded before Flop
Seat 3: Andy Wolf folded before Flop (didn't bet)
Seat 4: chimera252 collected ($0.25)
Seat 5: LarryTheStar (button) folded before Flop (didn't bet)



PokerStars Hand #166667962915:  Hold'em No Limit ($0.05/$0.10 USD) - 2017/02/23 16:10:44 ET
Table 'Alzirr II' 6-max Seat #2 is the button
Seat 2: popypaleta ($10.60 in chips) 
Seat 3: devon_red ($7.25 in chips) 
Seat 4: Scanner17 ($18.09 in chips) 
Seat 5: yodzik ($5.73 in chips) 
Seat 6: AM-L-SL ($4.33 in chips) 
devon_red: posts small blind $0.05
Scanner17: posts big blind $0.10
Kow6oy: sits out 
*** HOLE CARDS ***
yodzik: folds 
AM-L-SL: folds 
popypaleta: raises $0.20 to $0.30
devon_red: folds 
Scanner17: folds 
Uncalled bet ($0.20) returned to popypaleta
popypaleta collected $0.25 from pot
*** SUMMARY ***
Total pot $0.25 | Rake $0 
Seat 2: popypaleta (button) collected ($0.25)
Seat 3: devon_red (small blind) folded before Flop
Seat 4: Scanner17 (big blind) folded before Flop
Seat 5: yodzik folded before Flop (didn't bet)
Seat 6: AM-L-SL folded before Flop (didn't bet)



PokerStars Hand #166667963178:  Hold'em No Limit ($0.05/$0.10 USD) - 2017/02/23 16:10:45 ET
Table 'Wilkens II' 6-max Seat #6 is the button
Seat 1: Islamiq-GuRL ($10.24 in chips) 
Seat 2: manashov ($10.75 in chips) 
Seat 3: Namhkal ($11.68 in chips) 
Seat 4: myevc ($10 in chips) 
Seat 5: patrick19111 ($13.57 in chips) 
Seat 6: XaXaTyH4uK ($14.01 in chips) 
Islamiq-GuRL: posts small blind $0.05
manashov: posts big blind $0.10
*** HOLE CARDS ***
Namhkal: folds 
myevc: folds 
patrick19111: folds 
XaXaTyH4uK: folds 
Islamiq-GuRL: folds 
Uncalled bet ($0.05) returned to manashov
manashov collected $0.10 from pot
*** SUMMARY ***
Total pot $0.10 | Rake $0 
Seat 1: Islamiq-GuRL (small blind) folded before Flop
Seat 2: manashov (big blind) collected ($0.10)
Seat 3: Namhkal folded before Flop (didn't bet)
Seat 4: myevc folded before Flop (didn't bet)
Seat 5: patrick19111 folded before Flop (didn't bet)
Seat 6: XaXaTyH4uK (button) folded before Flop (didn't bet)



PokerStars Hand #166667963475:  Hold'em No Limit ($0.05/$0.10 USD) - 2017/02/23 16:10:45 ET
Table 'Marghanna II' 6-max Seat #6 is the button
Seat 1: Goroshkos88 ($10 in chips) 
Seat 2: Namhkal ($14.61 in chips) 
Seat 4: D3NyA ($12.29 in chips) 
Seat 5: ofl21189 ($3.57 in chips) 
Seat 6: VAD21 ($13.13 in chips) 
Goroshkos88: posts small blind $0.05
Namhkal: posts big blind $0.10
Andrei ProFF: sits out 
*** HOLE CARDS ***
D3NyA: folds 
ofl21189: raises $3.47 to $3.57 and is all-in
VAD21: folds 
Goroshkos88: folds 
Namhkal: folds 
Uncalled bet ($3.47) returned to ofl21189
ofl21189 collected $0.25 from pot
*** SUMMARY ***
Total pot $0.25 | Rake $0 
Seat 1: Goroshkos88 (small blind) folded before Flop
Seat 2: Namhkal (big blind) folded before Flop
Seat 4: D3NyA folded before Flop (didn't bet)
Seat 5: ofl21189 collected ($0.25)
Seat 6: VAD21 (button) folded before Flop (didn't bet)



PokerStars Hand #166667963546:  Hold'em No Limit ($0.05/$0.10 USD) - 2017/02/23 16:10:45 ET
Table 'Carina' 6-max Seat #6 is the button
Seat 1: Kupi007 ($10.05 in chips) 
Seat 2: XwinX25 ($10 in chips) 
Seat 3: LarryTheStar ($12.59 in chips) 
Seat 4: steepfell ($10.56 in chips) 
Seat 5: IAntikI ($10.23 in chips) 
Seat 6: alexweezer ($7.43 in chips) 
Kupi007: posts small blind $0.05
XwinX25: posts big blind $0.10
*** HOLE CARDS ***
LarryTheStar: folds 
steepfell: folds 
IAntikI: folds 
alexweezer: folds 
Kupi007: raises $0.20 to $0.30
XwinX25: calls $0.20
*** FLOP *** [7c Qd 4c]
Kupi007: checks 
XwinX25: bets $0.40
Kupi007: folds 
Uncalled bet ($0.40) returned to XwinX25
XwinX25 collected $0.57 from pot
*** SUMMARY ***
Total pot $0.60 | Rake $0.03 
Board [7c Qd 4c]
Seat 1: Kupi007 (small blind) folded on the Flop
Seat 2: XwinX25 (big blind) collected ($0.57)
Seat 3: LarryTheStar folded before Flop (didn't bet)
Seat 4: steepfell folded before Flop (didn't bet)
Seat 5: IAntikI folded before Flop (didn't bet)
Seat 6: alexweezer (button) folded before Flop (didn't bet)



PokerStars Hand #166667963886:  Hold'em No Limit ($0.05/$0.10 USD) - 2017/02/23 16:10:45 ET
Table 'Euryalos II' 6-max Seat #3 is the button
Seat 2: silsilviu ($16.92 in chips) 
Seat 3: Hyd SK ($10.35 in chips) 
Seat 4: popypaleta ($11.83 in chips) 
Seat 6: MihaGr ($10.15 in chips) 
popypaleta: posts small blind $0.05
MihaGr: posts big blind $0.10
voledy: sits out 
*** HOLE CARDS ***
RoJ1 leaves the table
WinninBikini joins the table at seat #5 
silsilviu: raises $0.20 to $0.30
WinninBikini leaves the table
Hyd SK: folds 
popypaleta: folds 
MihaGr: calls $0.20
*** FLOP *** [As 6d 7s]
MihaGr: checks 
voledy leaves the table
silsilviu: checks 
*** TURN *** [As 6d 7s] [2s]
MihaGr: checks 
silsilviu: checks 
*** RIVER *** [As 6d 7s 2s] [4c]
MihaGr: checks 
silsilviu: checks 
*** SHOW DOWN ***
MihaGr: shows [Qc Jd] (high card Ace)
silsilviu: shows [Kc 9c] (high card Ace - King kicker)
silsilviu collected $0.62 from pot
*** SUMMARY ***
Total pot $0.65 | Rake $0.03 
Board [As 6d 7s 2s 4c]
Seat 2: silsilviu showed [Kc 9c] and won ($0.62) with high card Ace
Seat 3: Hyd SK (button) folded before Flop (didn't bet)
Seat 4: popypaleta (small blind) folded before Flop
Seat 6: MihaGr (big blind) showed [Qc Jd] and lost with high card Ace



PokerStars Hand #166667964277:  Hold'em No Limit ($0.05/$0.10 USD) - 2017/02/23 16:10:46 ET
Table 'Hunnia' 6-max Seat #3 is the button
Seat 1: univibe68 ($21.33 in chips) 
Seat 2: mhonielsen ($11.09 in chips) 
Seat 3: 6ePeMeHHa9 ($10.41 in chips) 
Seat 4: Jalida3 ($11.78 in chips) 
Seat 5: Smarkon ($14.74 in chips) 
Seat 6: ChuikaPridi ($11.29 in chips) 
Jalida3: posts small blind $0.05
Smarkon: posts big blind $0.10
*** HOLE CARDS ***
ChuikaPridi: folds 
univibe68: raises $0.20 to $0.30
mhonielsen: folds 
6ePeMeHHa9: folds 
Jalida3: folds 
Smarkon: calls $0.20
*** FLOP *** [7c 5s Ad]
Smarkon: bets $0.30
univibe68: raises $0.85 to $1.15
Smarkon: folds 
Uncalled bet ($0.85) returned to univibe68
univibe68 collected $1.19 from pot
*** SUMMARY ***
Total pot $1.25 | Rake $0.06 
Board [7c 5s Ad]
Seat 1: univibe68 collected ($1.19)
Seat 2: mhonielsen folded before Flop (didn't bet)
Seat 3: 6ePeMeHHa9 (button) folded before Flop (didn't bet)
Seat 4: Jalida3 (small blind) folded before Flop
Seat 5: Smarkon (big blind) folded on the Flop
Seat 6: ChuikaPridi folded before Flop (didn't bet)



PokerStars Hand #166667964473:  Hold'em No Limit ($0.05/$0.10 USD) - 2017/02/23 16:10:46 ET
Table 'Risha II' 6-max Seat #3 is the button
Seat 1: marianoboni ($10 in chips) 
Seat 3: steepfell ($10 in chips) 
Seat 4: Comeback3392 ($19.58 in chips) 
Seat 5: m.c-alkatraz ($9.90 in chips) 
Seat 6: univibe68 ($11.16 in chips) 
Comeback3392: posts small blind $0.05
m.c-alkatraz: posts big blind $0.10
*** HOLE CARDS ***
univibe68: raises $0.20 to $0.30
marianoboni: folds 
steepfell: folds 
Comeback3392: folds 
m.c-alkatraz: folds 
Uncalled bet ($0.20) returned to univibe68
univibe68 collected $0.25 from pot
*** SUMMARY ***
Total pot $0.25 | Rake $0 
Seat 1: marianoboni folded before Flop (didn't bet)
Seat 3: steepfell (button) folded before Flop (didn't bet)
Seat 4: Comeback3392 (small blind) folded before Flop
Seat 5: m.c-alkatraz (big blind) folded before Flop
Seat 6: univibe68 collected ($0.25)



PokerStars Hand #166667964577:  Hold'em No Limit ($0.05/$0.10 USD) - 2017/02/23 16:10:46 ET
Table 'Brambilla II' 6-max Seat #1 is the button
Seat 1: Rodik002 ($12.27 in chips) 
Seat 5: FRAID358 ($10.05 in chips) 
Seat 6: boxer821 ($10 in chips) 
FRAID358: posts small blind $0.05
boxer821: posts big blind $0.10
*** HOLE CARDS ***
Rodik002: raises $0.10 to $0.20
overbet666 joins the table at seat #2 
FRAID358: calls $0.15
boxer821: folds 
*** FLOP *** [Th 8h As]
FRAID358: checks 
Rodik002: bets $0.34
FRAID358: folds 
Uncalled bet ($0.34) returned to Rodik002
Rodik002 collected $0.48 from pot
*** SUMMARY ***
Total pot $0.50 | Rake $0.02 
Board [Th 8h As]
Seat 1: Rodik002 (button) collected ($0.48)
Seat 5: FRAID358 (small blind) folded on the Flop
Seat 6: boxer821 (big blind) folded before Flop



PokerStars Hand #166667964629:  Hold'em No Limit ($0.05/$0.10 USD) - 2017/02/23 16:10:46 ET
Table 'Hajek III' 6-max Seat #6 is the button
Seat 1: MBen10 ($12.06 in chips) 
Seat 2: fortieth ($9.76 in chips) 
Seat 3: fedorka rus ($10.18 in chips) 
Seat 4: NvR.m1nD ($13.52 in chips) 
Seat 5: Chrips ($10 in chips) 
Seat 6: fabadam ($22.80 in chips) 
MBen10: posts small blind $0.05
fortieth: posts big blind $0.10
Chrips: posts big blind $0.10
*** HOLE CARDS ***
fedorka rus: folds 
NvR.m1nD: folds 
Chrips: raises $0.10 to $0.20
fabadam: folds 
MBen10: folds 
fortieth: folds 
Uncalled bet ($0.10) returned to Chrips
Chrips collected $0.25 from pot
*** SUMMARY ***
Total pot $0.25 | Rake $0 
Seat 1: MBen10 (small blind) folded before Flop
Seat 2: fortieth (big blind) folded before Flop
Seat 3: fedorka rus folded before Flop (didn't bet)
Seat 4: NvR.m1nD folded before Flop (didn't bet)
Seat 5: Chrips collected ($0.25)
Seat 6: fabadam (button) folded before Flop (didn't bet)



PokerStars Hand #166667965243:  Hold'em No Limit ($0.05/$0.10 USD) - 2017/02/23 16:10:47 ET
Table 'Manto II' 6-max Seat #2 is the button
Seat 1: ex3Lero86 ($10 in chips) 
Seat 2: voledy ($10.42 in chips) 
Seat 3: Komap511 ($10 in chips) 
Seat 5: ArcticBearDK ($34.38 in chips) 
Seat 6: pancernik21 ($14.33 in chips) 
Komap511: posts small blind $0.05
dr.goofy: is sitting out 
ArcticBearDK: posts big blind $0.10
*** HOLE CARDS ***
pancernik21: folds 
ex3Lero86: folds 
dr.goofy leaves the table
voledy: folds 
Komap511: folds 
Uncalled bet ($0.05) returned to ArcticBearDK
ArcticBearDK collected $0.10 from pot
*** SUMMARY ***
Total pot $0.10 | Rake $0 
Seat 1: ex3Lero86 folded before Flop (didn't bet)
Seat 2: voledy (button) folded before Flop (didn't bet)
Seat 3: Komap511 (small blind) folded before Flop
Seat 5: ArcticBearDK (big blind) collected ($0.10)
Seat 6: pancernik21 folded before Flop (didn't bet)



PokerStars Hand #166667965822:  Hold'em No Limit ($0.05/$0.10 USD) - 2017/02/23 16:10:48 ET
Table 'Pyrrhus III' 6-max Seat #6 is the button
Seat 2: univibe68 ($26.45 in chips) 
Seat 3: coolisses111 ($9.85 in chips) 
Seat 4: ex3Lero86 ($14.02 in chips) 
Seat 5: eniksenik ($10 in chips) 
Seat 6: MLPlayer16 ($22.23 in chips) 
univibe68: posts small blind $0.05
coolisses111: posts big blind $0.10
univibe68: posts the ante $0.02
coolisses111: posts the ante $0.02
ex3Lero86: posts the ante $0.02
eniksenik: posts the ante $0.02
MLPlayer16: posts the ante $0.02
*** HOLE CARDS ***
ex3Lero86: raises $0.17 to $0.27
eniksenik: calls $0.27
MLPlayer16: folds 
univibe68: folds 
coolisses111: folds 
*** FLOP *** [6s 8d 4c]
ex3Lero86: checks 
eniksenik: bets $0.41
ex3Lero86: folds 
Uncalled bet ($0.41) returned to eniksenik
eniksenik collected $0.75 from pot
*** SUMMARY ***
Total pot $0.79 | Rake $0.04 
Board [6s 8d 4c]
Seat 2: univibe68 (small blind) folded before Flop
Seat 3: coolisses111 (big blind) folded before Flop
Seat 4: ex3Lero86 folded on the Flop
Seat 5: eniksenik collected ($0.75)
Seat 6: MLPlayer16 (button) folded before Flop (didn't bet)



PokerStars Hand #166667965843:  Hold'em No Limit ($0.05/$0.10 USD) - 2017/02/23 16:10:48 ET
Table 'Wil' 6-max Seat #2 is the button
Seat 1: jwhelan94 ($24.17 in chips) 
Seat 2: Vrinni ($21.95 in chips) 
Seat 3: Namhkal ($10 in chips) 
Seat 4: x3ultimate ($10 in chips) 
Seat 5: Feverhead ($14.78 in chips) 
Seat 6: Comeback3392 ($13.63 in chips) 
Namhkal: posts small blind $0.05
x3ultimate: posts big blind $0.10
*** HOLE CARDS ***
Feverhead: raises $0.20 to $0.30
Comeback3392: calls $0.30
jwhelan94: calls $0.30
Vrinni: folds 
Namhkal: folds 
x3ultimate: folds 
*** FLOP *** [8c 6h Qh]
Feverhead: checks 
Comeback3392: checks 
jwhelan94: checks 
*** TURN *** [8c 6h Qh] [7d]
Feverhead: checks 
Comeback3392: checks 
jwhelan94: bets $0.50
Feverhead: folds 
Comeback3392: calls $0.50
*** RIVER *** [8c 6h Qh 7d] [3c]
Comeback3392: checks 
jwhelan94: bets $3.50
Comeback3392: folds 
Uncalled bet ($3.50) returned to jwhelan94
jwhelan94 collected $1.96 from pot
*** SUMMARY ***
Total pot $2.05 | Rake $0.09 
Board [8c 6h Qh 7d 3c]
Seat 1: jwhelan94 collected ($1.96)
Seat 2: Vrinni (button) folded before Flop (didn't bet)
Seat 3: Namhkal (small blind) folded before Flop
Seat 4: x3ultimate (big blind) folded before Flop
Seat 5: Feverhead folded on the Turn
Seat 6: Comeback3392 folded on the River



PokerStars Hand #166667965892:  Hold'em No Limit ($0.05/$0.10 USD) - 2017/02/23 16:10:48 ET
Table 'Armenia' 6-max Seat #6 is the button
Seat 1: tr41n3r12 ($11.42 in chips) 
Seat 2: Yabidooo ($10.83 in chips) 
Seat 3: Crimsonr ($5.74 in chips) 
Seat 4: mbkongstad ($8.60 in chips) 
Seat 5: DrVzad ($9.85 in chips) 
Seat 6: mega spasser ($8.03 in chips) 
tr41n3r12: posts small blind $0.05
Yabidooo: posts big blind $0.10
*** HOLE CARDS ***
Crimsonr: folds 
mbkongstad: folds 
DrVzad: folds 
mega spasser: folds 
tr41n3r12: folds 
Uncalled bet ($0.05) returned to Yabidooo
Yabidooo collected $0.10 from pot
*** SUMMARY ***
Total pot $0.10 | Rake $0 
Seat 1: tr41n3r12 (small blind) folded before Flop
Seat 2: Yabidooo (big blind) collected ($0.10)
Seat 3: Crimsonr folded before Flop (didn't bet)
Seat 4: mbkongstad folded before Flop (didn't bet)
Seat 5: DrVzad folded before Flop (didn't bet)
Seat 6: mega spasser (button) folded before Flop (didn't bet)



PokerStars Hand #166667966009:  Hold'em No Limit ($0.05/$0.10 USD) - 2017/02/23 16:10:48 ET
Table 'Epimetheus' 6-max Seat #2 is the button
Seat 1: 6ePeMeHHa9 ($10.29 in chips) 
Seat 2: patrick19111 ($15.76 in chips) 
Seat 3: dineldidi ($9.74 in chips) 
Seat 4: Namhkal ($10 in chips) 
Seat 5: afca128 ($24.18 in chips) 
Seat 6: voledy ($10.35 in chips) 
dineldidi: posts small blind $0.05
Namhkal: posts big blind $0.10
*** HOLE CARDS ***
afca128: folds 
voledy: folds 
6ePeMeHHa9: folds 
patrick19111: raises $0.15 to $0.25
dineldidi: folds 
Namhkal: folds 
Uncalled bet ($0.15) returned to patrick19111
patrick19111 collected $0.25 from pot
*** SUMMARY ***
Total pot $0.25 | Rake $0 
Seat 1: 6ePeMeHHa9 folded before Flop (didn't bet)
Seat 2: patrick19111 (button) collected ($0.25)
Seat 3: dineldidi (small blind) folded before Flop
Seat 4: Namhkal (big blind) folded before Flop
Seat 5: afca128 folded before Flop (didn't bet)
Seat 6: voledy folded before Flop (didn't bet)



PokerStars Hand #166667966181:  Hold'em No Limit ($0.05/$0.10 USD) - 2017/02/23 16:10:48 ET
Table 'Walpurga' 6-max Seat #1 is the button
Seat 1: chimera252 ($11.92 in chips) 
Seat 2: paxit71 ($5 in chips) 
Seat 3: Lucky HoBBiT ($10 in chips) 
Seat 4: oddshoff ($12.89 in chips) 
paxit71: posts small blind $0.05
Lucky HoBBiT: posts big blind $0.10
Fremara: sits out 
*** HOLE CARDS ***
oddshoff: folds 
chimera252: raises $0.15 to $0.25
paxit71: folds 
Lucky HoBBiT: calls $0.15
*** FLOP *** [7h 4s Qh]
Lucky HoBBiT: checks 
chimera252: bets $0.28
Lucky HoBBiT: folds 
Uncalled bet ($0.28) returned to chimera252
chimera252 collected $0.53 from pot
*** SUMMARY ***
Total pot $0.55 | Rake $0.02 
Board [7h 4s Qh]
Seat 1: chimera252 (button) collected ($0.53)
Seat 2: paxit71 (small blind) folded before Flop
Seat 3: Lucky HoBBiT (big blind) folded on the Flop
Seat 4: oddshoff folded before Flop (didn't bet)



PokerStars Hand #166667966357:  Hold'em No Limit ($0.05/$0.10 USD) - 2017/02/23 16:10:48 ET
Table 'Mizar II' 6-max Seat #2 is the button
Seat 1: Cole Jaq ($7.43 in chips) 
Seat 2: rusu_rapid ($10 in chips) 
Seat 3: Therodorus ($10.49 in chips) 
Seat 4: DEraser ($8 in chips) 
Therodorus: posts small blind $0.05
DEraser: posts big blind $0.10
AC Evergreen: sits out 
Pekaml: sits out 
*** HOLE CARDS ***
Cole Jaq: calls $0.10
rusu_rapid: folds 
Therodorus: calls $0.05
DEraser: checks 
*** FLOP *** [3d Ah 5h]
Therodorus: bets $0.20
DEraser: calls $0.20
Cole Jaq: folds 
*** TURN *** [3d Ah 5h] [7d]
Therodorus: bets $0.49
DEraser: calls $0.49
*** RIVER *** [3d Ah 5h 7d] [Th]
Therodorus: checks 
DEraser: bets $0.90
Therodorus: folds 
Uncalled bet ($0.90) returned to DEraser
DEraser collected $1.60 from pot
*** SUMMARY ***
Total pot $1.68 | Rake $0.08 
Board [3d Ah 5h 7d Th]
Seat 1: Cole Jaq folded on the Flop
Seat 2: rusu_rapid (button) folded before Flop (didn't bet)
Seat 3: Therodorus (small blind) folded on the River
Seat 4: DEraser (big blind) collected ($1.60)



PokerStars Hand #166667966363:  Hold'em No Limit ($0.05/$0.10 USD) - 2017/02/23 16:10:48 ET
Table 'Juliet II' 6-max Seat #4 is the button
Seat 1: alexpolevaja ($11.29 in chips) 
Seat 2: KA3AXCTAHEU, ($15.53 in chips) 
Seat 3: patrick19111 ($11.27 in chips) 
Seat 4: x3ultimate ($11.46 in chips) 
Seat 5: Dcaro31 ($19.96 in chips) 
Seat 6: BookWorm78 ($30.48 in chips) 
Dcaro31: posts small blind $0.05
BookWorm78: posts big blind $0.10
*** HOLE CARDS ***
alexpolevaja: calls $0.10
KA3AXCTAHEU,: folds 
patrick19111: raises $0.30 to $0.40
x3ultimate: folds 
Dcaro31: folds 
BookWorm78: folds 
alexpolevaja: calls $0.30
*** FLOP *** [Kd Qh 7d]
alexpolevaja: checks 
patrick19111: checks 
*** TURN *** [Kd Qh 7d] [8s]
alexpolevaja: bets $0.10
patrick19111: calls $0.10
*** RIVER *** [Kd Qh 7d 8s] [7h]
alexpolevaja: bets $0.10
patrick19111: raises $0.10 to $0.20
alexpolevaja: calls $0.10
*** SHOW DOWN ***
patrick19111: shows [Qc Jc] (two pair, Queens and Sevens)
alexpolevaja: mucks hand 
patrick19111 collected $1.48 from pot
*** SUMMARY ***
Total pot $1.55 | Rake $0.07 
Board [Kd Qh 7d 8s 7h]
Seat 1: alexpolevaja mucked
Seat 2: KA3AXCTAHEU, folded before Flop (didn't bet)
Seat 3: patrick19111 showed [Qc Jc] and won ($1.48) with two pair, Queens and Sevens
Seat 4: x3ultimate (button) folded before Flop (didn't bet)
Seat 5: Dcaro31 (small blind) folded before Flop
Seat 6: BookWorm78 (big blind) folded before Flop



PokerStars Hand #166667966392:  Hold'em No Limit ($0.05/$0.10 USD) - 2017/02/23 16:10:48 ET
Table 'Lederle' 6-max Seat #5 is the button
Seat 1: Sterjek ($10 in chips) 
Seat 2: truck1234 ($15.54 in chips) 
Seat 3: Kazacha ($11.11 in chips) 
Seat 4: Pokeaster ($13.66 in chips) 
Seat 5: 8th wonders ($13.53 in chips) 
Seat 6: pokekrk ($10.27 in chips) 
pokekrk: posts small blind $0.05
Sterjek: posts big blind $0.10
*** HOLE CARDS ***
truck1234: folds 
Kazacha: folds 
Pokeaster: folds 
8th wonders: folds 
pokekrk: raises $0.15 to $0.25
Sterjek: folds 
Uncalled bet ($0.15) returned to pokekrk
pokekrk collected $0.20 from pot
*** SUMMARY ***
Total pot $0.20 | Rake $0 
Seat 1: Sterjek (big blind) folded before Flop
Seat 2: truck1234 folded before Flop (didn't bet)
Seat 3: Kazacha folded before Flop (didn't bet)
Seat 4: Pokeaster folded before Flop (didn't bet)
Seat 5: 8th wonders (button) folded before Flop (didn't bet)
Seat 6: pokekrk (small blind) collected ($0.20)



PokerStars Hand #166667966680:  Hold'em No Limit ($0.05/$0.10 USD) - 2017/02/23 16:10:49 ET
Table 'Pompeja III' 6-max Seat #3 is the button
Seat 1: Iarlei ($11.68 in chips) 
Seat 2: steepfell ($10.42 in chips) 
Seat 3: Yspenyanin ($12.61 in chips) 
Seat 5: Spud014 ($12.50 in chips) 
Seat 6: mega spasser ($4.50 in chips) 
Spud014: posts small blind $0.05
mega spasser: posts big blind $0.10
*** HOLE CARDS ***
Iarlei: folds 
steepfell: folds 
Yspenyanin: folds 
Spud014: raises $0.10 to $0.20
mega spasser: raises $0.40 to $0.60
Spud014: folds 
Uncalled bet ($0.40) returned to mega spasser
mega spasser collected $0.40 from pot
*** SUMMARY ***
Total pot $0.40 | Rake $0 
Seat 1: Iarlei folded before Flop (didn't bet)
Seat 2: steepfell folded before Flop (didn't bet)
Seat 3: Yspenyanin (button) folded before Flop (didn't bet)
Seat 5: Spud014 (small blind) folded before Flop
Seat 6: mega spasser (big blind) collected ($0.40)



PokerStars Hand #166667966710:  Hold'em No Limit ($0.05/$0.10 USD) - 2017/02/23 16:10:49 ET
Table 'Iduberga II' 6-max Seat #2 is the button
Seat 1: mhonielsen ($10.71 in chips) 
Seat 2: popypaleta ($12.80 in chips) 
Seat 3: scorpionfish ($11.33 in chips) 
Seat 4: Peter0087 ($11.12 in chips) 
Seat 5: Pokeaster ($10.88 in chips) 
Seat 6: tblocos ($10.79 in chips) 
scorpionfish: posts small blind $0.05
Peter0087: posts big blind $0.10
*** HOLE CARDS ***
Pokeaster: raises $0.20 to $0.30
tblocos: calls $0.30
mhonielsen: folds 
popypaleta: folds 
scorpionfish: folds 
Peter0087: folds 
*** FLOP *** [7h 3h Ac]
Pokeaster: checks 
tblocos: checks 
*** TURN *** [7h 3h Ac] [6c]
Pokeaster: checks 
tblocos: checks 
*** RIVER *** [7h 3h Ac 6c] [6s]
Pokeaster: bets $0.48
tblocos: folds 
Uncalled bet ($0.48) returned to Pokeaster
Pokeaster collected $0.72 from pot
Pokeaster: doesn't show hand 
*** SUMMARY ***
Total pot $0.75 | Rake $0.03 
Board [7h 3h Ac 6c 6s]
Seat 1: mhonielsen folded before Flop (didn't bet)
Seat 2: popypaleta (button) folded before Flop (didn't bet)
Seat 3: scorpionfish (small blind) folded before Flop
Seat 4: Peter0087 (big blind) folded before Flop
Seat 5: Pokeaster collected ($0.72)
Seat 6: tblocos folded on the River



PokerStars Hand #166667966791:  Hold'em No Limit ($0.05/$0.10 USD) - 2017/02/23 16:10:49 ET
Table 'Serpens' 6-max Seat #4 is the button
Seat 1: Namhkal ($10.28 in chips) 
Seat 2: KA3AXCTAHEU, ($19.48 in chips) 
Seat 3: homelessdan ($30.25 in chips) 
Seat 4: DIENY772 ($9.45 in chips) 
Seat 5: JahSoldier69 ($10 in chips) 
Seat 6: XaXaTyH4uK ($10 in chips) 
JahSoldier69: posts small blind $0.05
XaXaTyH4uK: posts big blind $0.10
*** HOLE CARDS ***
Namhkal: folds 
KA3AXCTAHEU,: raises $0.20 to $0.30
homelessdan: folds 
DIENY772: calls $0.30
JahSoldier69: folds 
XaXaTyH4uK: folds 
*** FLOP *** [5d 9s Th]
KA3AXCTAHEU,: checks 
DIENY772: bets $0.72
KA3AXCTAHEU,: folds 
Uncalled bet ($0.72) returned to DIENY772
DIENY772 collected $0.72 from pot
*** SUMMARY ***
Total pot $0.75 | Rake $0.03 
Board [5d 9s Th]
Seat 1: Namhkal folded before Flop (didn't bet)
Seat 2: KA3AXCTAHEU, folded on the Flop
Seat 3: homelessdan folded before Flop (didn't bet)
Seat 4: DIENY772 (button) collected ($0.72)
Seat 5: JahSoldier69 (small blind) folded before Flop
Seat 6: XaXaTyH4uK (big blind) folded before Flop



PokerStars Hand #166667966949:  Hold'em No Limit ($0.05/$0.10 USD) - 2017/02/23 16:10:49 ET
Table 'Ruvuma' 6-max Seat #3 is the button
Seat 1: FRAID358 ($24.29 in chips) 
Seat 3: Spud014 ($10.23 in chips) 
Seat 5: sexy_seagull ($10.05 in chips) 
Seat 6: osmea ($10 in chips) 
sexy_seagull: posts small blind $0.05
osmea: posts big blind $0.10
Yspenyanin: sits out 
*** HOLE CARDS ***
FRAID358: folds 
Spud014: raises $0.10 to $0.20
sexy_seagull: raises $0.60 to $0.80
osmea: folds 
Spud014: folds 
Uncalled bet ($0.60) returned to sexy_seagull
sexy_seagull collected $0.50 from pot
*** SUMMARY ***
Total pot $0.50 | Rake $0 
Seat 1: FRAID358 folded before Flop (didn't bet)
Seat 3: Spud014 (button) folded before Flop
Seat 5: sexy_seagull (small blind) collected ($0.50)
Seat 6: osmea (big blind) folded before Flop



PokerStars Hand #166667966981:  Hold'em No Limit ($0.05/$0.10 USD) - 2017/02/23 16:10:49 ET
Table 'Nauheima II' 6-max Seat #6 is the button
Seat 1: HARDCORE66RU ($17.94 in chips) 
Seat 2: Peter0087 ($10.27 in chips) 
Seat 3: KokoulinV ($13.60 in chips) 
Seat 5: bambolejro ($10 in chips) 
Seat 6: bonyo71 ($5.04 in chips) 
HARDCORE66RU: posts small blind $0.05
Peter0087: posts big blind $0.10
martijn091: sits out 
*** HOLE CARDS ***
KokoulinV: folds 
bambolejro: folds 
bonyo71: folds 
HARDCORE66RU: folds 
Uncalled bet ($0.05) returned to Peter0087
Peter0087 collected $0.10 from pot
*** SUMMARY ***
Total pot $0.10 | Rake $0 
Seat 1: HARDCORE66RU (small blind) folded before Flop
Seat 2: Peter0087 (big blind) collected ($0.10)
Seat 3: KokoulinV folded before Flop (didn't bet)
Seat 5: bambolejro folded before Flop (didn't bet)
Seat 6: bonyo71 (button) folded before Flop (didn't bet)



PokerStars Hand #166667966983:  Hold'em No Limit ($0.05/$0.10 USD) - 2017/02/23 16:10:49 ET
Table 'Grietje' 6-max Seat #5 is the button
Seat 1: dragonste89 ($10 in chips) 
Seat 2: Feverhead ($10 in chips) 
Seat 3: GitoValdivia ($8.03 in chips) 
Seat 4: MihaGr ($10.56 in chips) 
Seat 5: iThreeBarrel ($10 in chips) 
Seat 6: Prometheu$8 ($28.50 in chips) 
Prometheu$8: posts small blind $0.05
dragonste89: posts big blind $0.10
*** HOLE CARDS ***
Feverhead: folds 
GitoValdivia: folds 
MihaGr: folds 
iThreeBarrel: folds 
Prometheu$8: raises $0.20 to $0.30
dragonste89: calls $0.20
*** FLOP *** [4c 8c Kh]
Prometheu$8: bets $0.57
dragonste89: calls $0.57
*** TURN *** [4c 8c Kh] [5h]
Prometheu$8: bets $1.66
dragonste89: calls $1.66
*** RIVER *** [4c 8c Kh 5h] [Ah]
Prometheu$8: bets $25.97 and is all-in
dragonste89: calls $7.47 and is all-in
Uncalled bet ($18.50) returned to Prometheu$8
*** SHOW DOWN ***
Prometheu$8: shows [8d Ac] (two pair, Aces and Eights)
dragonste89: shows [7d Kd] (a pair of Kings)
Prometheu$8 collected $19.10 from pot
*** SUMMARY ***
Total pot $20 | Rake $0.90 
Board [4c 8c Kh 5h Ah]
Seat 1: dragonste89 (big blind) showed [7d Kd] and lost with a pair of Kings
Seat 2: Feverhead folded before Flop (didn't bet)
Seat 3: GitoValdivia folded before Flop (didn't bet)
Seat 4: MihaGr folded before Flop (didn't bet)
Seat 5: iThreeBarrel (button) folded before Flop (didn't bet)
Seat 6: Prometheu$8 (small blind) showed [8d Ac] and won ($19.10) with two pair, Aces and Eights



PokerStars Hand #166667967005:  Hold'em No Limit ($0.05/$0.10 USD) - 2017/02/23 16:10:49 ET
Table 'Nymphe II' 6-max Seat #2 is the button
Seat 1: jacktayra ($1.49 in chips) 
Seat 2: Newqbrown ($12.11 in chips) 
Seat 3: THIMUCHIN ($15.50 in chips) 
Seat 4: coolisses111 ($17.15 in chips) 
Seat 6: Xander188 ($10 in chips) 
THIMUCHIN: posts small blind $0.05
coolisses111: posts big blind $0.10
AC Evergreen: sits out 
*** HOLE CARDS ***
Xander188: folds 
jacktayra: calls $0.10
Newqbrown: folds 
THIMUCHIN: folds 
coolisses111: checks 
*** FLOP *** [Ah 7d Th]
coolisses111: checks 
jacktayra: checks 
*** TURN *** [Ah 7d Th] [Kc]
coolisses111: checks 
jacktayra: checks 
*** RIVER *** [Ah 7d Th Kc] [5d]
coolisses111: checks 
jacktayra: checks 
*** SHOW DOWN ***
coolisses111: shows [6h 2d] (high card Ace)
jacktayra: shows [Jc 4c] (high card Ace - King+Jack kicker)
jacktayra collected $0.24 from pot
*** SUMMARY ***
Total pot $0.25 | Rake $0.01 
Board [Ah 7d Th Kc 5d]
Seat 1: jacktayra showed [Jc 4c] and won ($0.24) with high card Ace
Seat 2: Newqbrown (button) folded before Flop (didn't bet)
Seat 3: THIMUCHIN (small blind) folded before Flop
Seat 4: coolisses111 (big blind) showed [6h 2d] and lost with high card Ace
Seat 6: Xander188 folded before Flop (didn't bet)



PokerStars Hand #166667967106:  Hold'em No Limit ($0.05/$0.10 USD) - 2017/02/23 16:10:49 ET
Table 'Heka II' 6-max Seat #5 is the button
Seat 1: Mamm0nism ($15.36 in chips) 
Seat 2: oddshoff ($10.92 in chips) 
Seat 4: theNot0r1ous ($10.13 in chips) 
Seat 5: ArcticBearDK ($12.63 in chips) 
Seat 6: MonteCris92 ($11.32 in chips) 
MonteCris92: posts small blind $0.05
Mamm0nism: posts big blind $0.10
voledy: sits out 
*** HOLE CARDS ***
oddshoff: folds 
theNot0r1ous: raises $0.20 to $0.30
ArcticBearDK: folds 
MonteCris92: folds 
Mamm0nism: folds 
Uncalled bet ($0.20) returned to theNot0r1ous
theNot0r1ous collected $0.25 from pot
*** SUMMARY ***
Total pot $0.25 | Rake $0 
Seat 1: Mamm0nism (big blind) folded before Flop
Seat 2: oddshoff folded before Flop (didn't bet)
Seat 4: theNot0r1ous collected ($0.25)
Seat 5: ArcticBearDK (button) folded before Flop (didn't bet)
Seat 6: MonteCris92 (small blind) folded before Flop



PokerStars Hand #166667967147:  Hold'em No Limit ($0.05/$0.10 USD) - 2017/02/23 16:10:49 ET
Table 'Martha' 6-max Seat #5 is the button
Seat 1: Peter0087 ($9.99 in chips) 
Seat 2: pauli95 ($10.81 in chips) 
Seat 3: Hyd SK ($12.37 in chips) 
Seat 4: dittoro ($10 in chips) 
Seat 5: MihaGr ($10 in chips) 
Seat 6: 8th wonders ($10.66 in chips) 
8th wonders: posts small blind $0.05
Peter0087: posts big blind $0.10
*** HOLE CARDS ***
pauli95: folds 
Hyd SK: folds 
dittoro: folds 
MihaGr: folds 
8th wonders: folds 
Uncalled bet ($0.05) returned to Peter0087
Peter0087 collected $0.10 from pot
*** SUMMARY ***
Total pot $0.10 | Rake $0 
Seat 1: Peter0087 (big blind) collected ($0.10)
Seat 2: pauli95 folded before Flop (didn't bet)
Seat 3: Hyd SK folded before Flop (didn't bet)
Seat 4: dittoro folded before Flop (didn't bet)
Seat 5: MihaGr (button) folded before Flop (didn't bet)
Seat 6: 8th wonders (small blind) folded before Flop



PokerStars Hand #166667967148:  Hold'em No Limit ($0.05/$0.10 USD) - 2017/02/23 16:10:49 ET
Table 'Kochera' 6-max Seat #6 is the button
Seat 1: chimera252 ($11.57 in chips) 
Seat 2: bartabs2 ($7.69 in chips) 
Seat 3: KA3AXCTAHEU, ($13.06 in chips) 
Seat 4: dany_de_vit ($9.40 in chips) 
Seat 5: univibe68 ($12.20 in chips) 
Seat 6: oddshoff ($9.48 in chips) 
chimera252: posts small blind $0.05
bartabs2: posts big blind $0.10
*** HOLE CARDS ***
KA3AXCTAHEU,: raises $0.20 to $0.30
dany_de_vit: folds 
univibe68: folds 
oddshoff: folds 
chimera252: folds 
bartabs2: folds 
Uncalled bet ($0.20) returned to KA3AXCTAHEU,
KA3AXCTAHEU, collected $0.25 from pot
*** SUMMARY ***
Total pot $0.25 | Rake $0 
Seat 1: chimera252 (small blind) folded before Flop
Seat 2: bartabs2 (big blind) folded before Flop
Seat 3: KA3AXCTAHEU, collected ($0.25)
Seat 4: dany_de_vit folded before Flop (didn't bet)
Seat 5: univibe68 folded before Flop (didn't bet)
Seat 6: oddshoff (button) folded before Flop (didn't bet)



PokerStars Hand #166667967200:  Hold'em No Limit ($0.05/$0.10 USD) - 2017/02/23 16:10:49 ET
Table 'Azelfafage' 6-max Seat #1 is the button
Seat 1: Sbozzz ($15.46 in chips) 
Seat 2: tr41n3r12 ($11.60 in chips) 
Seat 3: todor1711 ($14.39 in chips) 
Seat 4: fedorka rus ($15.81 in chips) 
Seat 5: 8th wonders ($12.40 in chips) 
Seat 6: KA3AXCTAHEU, ($10 in chips) 
tr41n3r12: posts small blind $0.05
todor1711: posts big blind $0.10
*** HOLE CARDS ***
fedorka rus: folds 
8th wonders: folds 
KA3AXCTAHEU,: folds 
Sbozzz: folds 
tr41n3r12: folds 
Uncalled bet ($0.05) returned to todor1711
todor1711 collected $0.10 from pot
*** SUMMARY ***
Total pot $0.10 | Rake $0 
Seat 1: Sbozzz (button) folded before Flop (didn't bet)
Seat 2: tr41n3r12 (small blind) folded before Flop
Seat 3: todor1711 (big blind) collected ($0.10)
Seat 4: fedorka rus folded before Flop (didn't bet)
Seat 5: 8th wonders folded before Flop (didn't bet)
Seat 6: KA3AXCTAHEU, folded before Flop (didn't bet)



PokerStars Hand #166667967243:  Hold'em No Limit ($0.05/$0.10 USD) - 2017/02/23 16:10:49 ET
Table 'Seinajoki' 6-max Seat #4 is the button
Seat 2: niukak ($10.05 in chips) 
Seat 3: Therodorus ($10.15 in chips) 
Seat 4: rusu_rapid ($10 in chips) 
niukak: posts small blind $0.05
Therodorus: posts big blind $0.10
*** HOLE CARDS ***
rusu_rapid: folds 
niukak: raises $0.20 to $0.30
Therodorus: folds 
Uncalled bet ($0.20) returned to niukak
niukak collected $0.20 from pot
*** SUMMARY ***
Total pot $0.20 | Rake $0 
Seat 2: niukak (small blind) collected ($0.20)
Seat 3: Therodorus (big blind) folded before Flop
Seat 4: rusu_rapid (button) folded before Flop (didn't bet)



PokerStars Hand #166667967305:  Hold'em No Limit ($0.05/$0.10 USD) - 2017/02/23 16:10:49 ET
Table 'Nephthys II' 6-max Seat #3 is the button
Seat 1: DamDatsAnAce ($10 in chips) 
Seat 2: Ju$tD0it ($8.34 in chips) 
Seat 3: Newqbrown ($19.51 in chips) 
Seat 4: MihaGr ($10.05 in chips) 
Seat 5: kingartur222 ($8.61 in chips) 
Seat 6: CHRO8 ($19.76 in chips) 
MihaGr: posts small blind $0.05
kingartur222: posts big blind $0.10
*** HOLE CARDS ***
CHRO8: folds 
DamDatsAnAce: raises $0.25 to $0.35
Ju$tD0it: folds 
Newqbrown: folds 
Ju$tD0it is disconnected 
MihaGr: folds 
kingartur222: folds 
Uncalled bet ($0.25) returned to DamDatsAnAce
DamDatsAnAce collected $0.25 from pot
*** SUMMARY ***
Total pot $0.25 | Rake $0 
Seat 1: DamDatsAnAce collected ($0.25)
Seat 2: Ju$tD0it folded before Flop (didn't bet)
Seat 3: Newqbrown (button) folded before Flop (didn't bet)
Seat 4: MihaGr (small blind) folded before Flop
Seat 5: kingartur222 (big blind) folded before Flop
Seat 6: CHRO8 folded before Flop (didn't bet)



PokerStars Hand #166667967354:  Hold'em No Limit ($0.05/$0.10 USD) - 2017/02/23 16:10:49 ET
Table 'Senta II' 6-max Seat #1 is the button
Seat 1: Goovr ($10 in chips) 
Seat 2: NvR.m1nD ($13.80 in chips) 
Seat 3: Aescul@pius ($21.88 in chips) 
Seat 4: fedorka rus ($19.18 in chips) 
Seat 5: Algarah ($5.38 in chips) 
Seat 6: T9MS ($11.17 in chips) 
NvR.m1nD: posts small blind $0.05
Aescul@pius: posts big blind $0.10
*** HOLE CARDS ***
fedorka rus has timed out
fedorka rus: folds 
Algarah: folds 
T9MS: folds 
Goovr: folds 
NvR.m1nD: folds 
Uncalled bet ($0.05) returned to Aescul@pius
Aescul@pius collected $0.10 from pot
*** SUMMARY ***
Total pot $0.10 | Rake $0 
Seat 1: Goovr (button) folded before Flop (didn't bet)
Seat 2: NvR.m1nD (small blind) folded before Flop
Seat 3: Aescul@pius (big blind) collected ($0.10)
Seat 4: fedorka rus folded before Flop (didn't bet)
Seat 5: Algarah folded before Flop (didn't bet)
Seat 6: T9MS folded before Flop (didn't bet)



PokerStars Hand #166667967674:  Hold'em No Limit ($0.05/$0.10 USD) - 2017/02/23 16:10:50 ET
Table 'Esperanto II' 6-max Seat #6 is the button
Seat 1: kurasd ($9.50 in chips) 
Seat 2: MihaGr ($10.30 in chips) 
Seat 3: Namhkal ($11.05 in chips) 
Seat 4: Andrei ProFF ($10 in chips) 
Seat 5: FRAID358 ($12.33 in chips) 
Seat 6: ArcticBearDK ($13.50 in chips) 
kurasd: posts small blind $0.05
MihaGr: posts big blind $0.10
*** HOLE CARDS ***
Namhkal: folds 
Andrei ProFF: folds 
FRAID358: folds 
ArcticBearDK: folds 
kurasd: calls $0.05
MihaGr: checks 
*** FLOP *** [2d Kh 9s]
kurasd: checks 
MihaGr: bets $0.15
kurasd: folds 
Uncalled bet ($0.15) returned to MihaGr
MihaGr collected $0.19 from pot
*** SUMMARY ***
Total pot $0.20 | Rake $0.01 
Board [2d Kh 9s]
Seat 1: kurasd (small blind) folded on the Flop
Seat 2: MihaGr (big blind) collected ($0.19)
Seat 3: Namhkal folded before Flop (didn't bet)
Seat 4: Andrei ProFF folded before Flop (didn't bet)
Seat 5: FRAID358 folded before Flop (didn't bet)
Seat 6: ArcticBearDK (button) folded before Flop (didn't bet)



PokerStars Hand #166667967965:  Hold'em No Limit ($0.05/$0.10 USD) - 2017/02/23 16:10:50 ET
Table 'Wesselink II' 6-max Seat #3 is the button
Seat 2: KRZuff ($10.27 in chips) 
Seat 3: Wargolandros ($8.27 in chips) 
Seat 4: BahiaMinhaP ($10.05 in chips) 
Seat 5: xdjango07x ($18.75 in chips) 
Seat 6: bambolejro ($17.92 in chips) 
BahiaMinhaP: posts small blind $0.05
xdjango07x: posts big blind $0.10
*** HOLE CARDS ***
RoJ1 leaves the table
D3NyA joins the table at seat #1 
bambolejro: folds 
KRZuff: folds 
Wargolandros: folds 
BahiaMinhaP: raises $0.20 to $0.30
xdjango07x: raises $0.60 to $0.90
BahiaMinhaP: folds 
Uncalled bet ($0.60) returned to xdjango07x
xdjango07x collected $0.60 from pot
*** SUMMARY ***
Total pot $0.60 | Rake $0 
Seat 2: KRZuff folded before Flop (didn't bet)
Seat 3: Wargolandros (button) folded before Flop (didn't bet)
Seat 4: BahiaMinhaP (small blind) folded before Flop
Seat 5: xdjango07x (big blind) collected ($0.60)
Seat 6: bambolejro folded before Flop (didn't bet)



PokerStars Hand #166667968370:  Hold'em No Limit ($0.05/$0.10 USD) - 2017/02/23 16:10:50 ET
Table 'Arpola' 6-max Seat #5 is the button
Seat 1: dincimus ($11.12 in chips) 
Seat 2: patrick19111 ($10.25 in chips) 
Seat 4: Orlangoor ($18.60 in chips) 
Seat 5: truck1234 ($12.02 in chips) 
Seat 6: DasoII ($4.50 in chips) 
DasoII: posts small blind $0.05
dincimus: posts big blind $0.10
*** HOLE CARDS ***
patrick19111: folds 
Orlangoor: folds 
truck1234: raises $0.20 to $0.30
DasoII: folds 
dincimus: folds 
Uncalled bet ($0.20) returned to truck1234
truck1234 collected $0.25 from pot
*** SUMMARY ***
Total pot $0.25 | Rake $0 
Seat 1: dincimus (big blind) folded before Flop
Seat 2: patrick19111 folded before Flop (didn't bet)
Seat 4: Orlangoor folded before Flop (didn't bet)
Seat 5: truck1234 (button) collected ($0.25)
Seat 6: DasoII (small blind) folded before Flop



PokerStars Hand #166667968735:  Hold'em No Limit ($0.05/$0.10 USD) - 2017/02/23 16:10:51 ET
Table 'Goto II' 6-max Seat #4 is the button
Seat 1: FRAID358 ($12.01 in chips) 
Seat 2: 6ePeMeHHa9 ($12.61 in chips) 
Seat 3: Goroshkos88 ($10.53 in chips) 
Seat 4: KRZuff ($13.61 in chips) 
Seat 5: RoJ1 ($14.40 in chips) 
Seat 6: ermananb93 ($11.01 in chips) 
RoJ1: posts small blind $0.05
ermananb93: posts big blind $0.10
*** HOLE CARDS ***
FRAID358: folds 
6ePeMeHHa9: folds 
Goroshkos88: folds 
KRZuff: folds 
RoJ1: folds 
Uncalled bet ($0.05) returned to ermananb93
ermananb93 collected $0.10 from pot
*** SUMMARY ***
Total pot $0.10 | Rake $0 
Seat 1: FRAID358 folded before Flop (didn't bet)
Seat 2: 6ePeMeHHa9 folded before Flop (didn't bet)
Seat 3: Goroshkos88 folded before Flop (didn't bet)
Seat 4: KRZuff (button) folded before Flop (didn't bet)
Seat 5: RoJ1 (small blind) folded before Flop
Seat 6: ermananb93 (big blind) collected ($0.10)



PokerStars Hand #166667968941:  Hold'em No Limit ($0.05/$0.10 USD) - 2017/02/23 16:10:51 ET
Table 'Clavel' 6-max Seat #2 is the button
Seat 1: KRZuff ($14.97 in chips) 
Seat 2: Namhkal ($10.25 in chips) 
Seat 4: Dcaro31 ($11.58 in chips) 
Seat 5: Vrinni ($11.33 in chips) 
Seat 6: Gra_anD77 ($3.17 in chips) 
Dcaro31: posts small blind $0.05
Vrinni: posts big blind $0.10
*** HOLE CARDS ***
Gra_anD77: folds 
KRZuff: raises $0.20 to $0.30
Namhkal: folds 
Dcaro31: folds 
Vrinni: folds 
Uncalled bet ($0.20) returned to KRZuff
KRZuff collected $0.25 from pot
*** SUMMARY ***
Total pot $0.25 | Rake $0 
Seat 1: KRZuff collected ($0.25)
Seat 2: Namhkal (button) folded before Flop (didn't bet)
Seat 4: Dcaro31 (small blind) folded before Flop
Seat 5: Vrinni (big blind) folded before Flop
Seat 6: Gra_anD77 folded before Flop (didn't bet)



PokerStars Hand #166667969334:  Hold'em No Limit ($0.05/$0.10 USD) - 2017/02/23 16:10:51 ET
Table 'Nuki' 6-max Seat #3 is the button
Seat 1: bdixon_5 ($8.43 in chips) 
Seat 2: ArcticBearDK ($19.33 in chips) 
Seat 3: Chodemuncher ($10 in chips) 
Seat 4: GESPERIA ($28.33 in chips) 
Seat 5: fabadam ($10.43 in chips) 
Seat 6: Zooplack ($25.62 in chips) 
GESPERIA: posts small blind $0.05
fabadam: posts big blind $0.10
*** HOLE CARDS ***
Zooplack: raises $0.20 to $0.30
bdixon_5: folds 
ArcticBearDK: folds 
Chodemuncher: calls $0.30
GESPERIA: folds 
fabadam: folds 
*** FLOP *** [Ts 7h 5d]
Zooplack: bets $0.43
Chodemuncher: folds 
Uncalled bet ($0.43) returned to Zooplack
Zooplack collected $0.72 from pot
*** SUMMARY ***
Total pot $0.75 | Rake $0.03 
Board [Ts 7h 5d]
Seat 1: bdixon_5 folded before Flop (didn't bet)
Seat 2: ArcticBearDK folded before Flop (didn't bet)
Seat 3: Chodemuncher (button) folded on the Flop
Seat 4: GESPERIA (small blind) folded before Flop
Seat 5: fabadam (big blind) folded before Flop
Seat 6: Zooplack collected ($0.72)



PokerStars Hand #166667969384:  Hold'em No Limit ($0.05/$0.10 USD) - 2017/02/23 16:10:52 ET
Table 'Tirela' 6-max Seat #4 is the button
Seat 1: Smitty03300 ($10 in chips) 
Seat 2: Andrei ProFF ($17.14 in chips) 
Seat 3: aim444 ($16.26 in chips) 
Seat 4: ArcticBearDK ($10 in chips) 
Seat 5: KRZuff ($15.33 in chips) 
Seat 6: coolisses111 ($9.80 in chips) 
KRZuff: posts small blind $0.05
coolisses111: posts big blind $0.10
*** HOLE CARDS ***
Smitty03300: folds 
Andrei ProFF: folds 
aim444: folds 
ArcticBearDK: raises $0.17 to $0.27
KRZuff: folds 
coolisses111: folds 
Uncalled bet ($0.17) returned to ArcticBearDK
ArcticBearDK collected $0.25 from pot
*** SUMMARY ***
Total pot $0.25 | Rake $0 
Seat 1: Smitty03300 folded before Flop (didn't bet)
Seat 2: Andrei ProFF folded before Flop (didn't bet)
Seat 3: aim444 folded before Flop (didn't bet)
Seat 4: ArcticBearDK (button) collected ($0.25)
Seat 5: KRZuff (small blind) folded before Flop
Seat 6: coolisses111 (big blind) folded before Flop



PokerStars Hand #166667969512:  Hold'em No Limit ($0.05/$0.10 USD) - 2017/02/23 16:10:52 ET
Table 'California II' 6-max Seat #3 is the button
Seat 2: homelessdan ($10 in chips) 
Seat 3: Bird et al ($10 in chips) 
Seat 4: pokekrk ($13.87 in chips) 
Seat 5: Nikolai77798 ($5.06 in chips) 
Seat 6: chiko4040 ($8.03 in chips) 
pokekrk: posts small blind $0.05
Nikolai77798: posts big blind $0.10
*** HOLE CARDS ***
chiko4040: folds 
homelessdan: raises $0.20 to $0.30
Bird et al: folds 
pokekrk: calls $0.25
Nikolai77798: folds 
*** FLOP *** [3h 4c 2h]
pokekrk: checks 
homelessdan: bets $0.50
pokekrk: calls $0.50
*** TURN *** [3h 4c 2h] [9d]
pokekrk: checks 
homelessdan: bets $1.10
pokekrk: calls $1.10
*** RIVER *** [3h 4c 2h 9d] [Jh]
pokekrk: checks 
homelessdan: checks 
*** SHOW DOWN ***
pokekrk: shows [8s 8h] (a pair of Eights)
homelessdan: shows [9c 9h] (three of a kind, Nines)
homelessdan collected $3.72 from pot
*** SUMMARY ***
Total pot $3.90 | Rake $0.18 
Board [3h 4c 2h 9d Jh]
Seat 2: homelessdan showed [9c 9h] and won ($3.72) with three of a kind, Nines
Seat 3: Bird et al (button) folded before Flop (didn't bet)
Seat 4: pokekrk (small blind) showed [8s 8h] and lost with a pair of Eights
Seat 5: Nikolai77798 (big blind) folded before Flop
Seat 6: chiko4040 folded before Flop (didn't bet)



PokerStars Hand #166667969928:  Hold'em No Limit ($0.05/$0.10 USD) - 2017/02/23 16:10:52 ET
Table 'Pandora III' 6-max Seat #2 is the button
Seat 1: Pokeaster ($11.24 in chips) 
Seat 2: garigura ($11.39 in chips) 
Seat 3: Chodemuncher ($10 in chips) 
Seat 4: mhonielsen ($10.15 in chips) 
Seat 5: MühliJr ($10.57 in chips) 
Seat 6: yodzik ($5.32 in chips) 
Chodemuncher: posts small blind $0.05
mhonielsen: posts big blind $0.10
*** HOLE CARDS ***
MühliJr: folds 
yodzik: folds 
Pokeaster: folds 
garigura: folds 
Chodemuncher: folds 
Uncalled bet ($0.05) returned to mhonielsen
mhonielsen collected $0.10 from pot
*** SUMMARY ***
Total pot $0.10 | Rake $0 
Seat 1: Pokeaster folded before Flop (didn't bet)
Seat 2: garigura (button) folded before Flop (didn't bet)
Seat 3: Chodemuncher (small blind) folded before Flop
Seat 4: mhonielsen (big blind) collected ($0.10)
Seat 5: MühliJr folded before Flop (didn't bet)
Seat 6: yodzik folded before Flop (didn't bet)



PokerStars Hand #166667969977:  Hold'em No Limit ($0.05/$0.10 USD) - 2017/02/23 16:10:52 ET
Table 'Bootes' 6-max Seat #4 is the button
Seat 1: Namhkal ($11.40 in chips) 
Seat 2: Bird et al ($17.46 in chips) 
Seat 3: KA3AXCTAHEU, ($20.61 in chips) 
Seat 4: totonove ($7.02 in chips) 
Seat 5: Pekaml ($15.32 in chips) 
Seat 6: cherep61987 ($10.07 in chips) 
Pekaml: posts small blind $0.05
cherep61987: posts big blind $0.10
*** HOLE CARDS ***
Namhkal: folds 
Bird et al: raises $0.21 to $0.31
KA3AXCTAHEU,: folds 
totonove: folds 
Pekaml: folds 
cherep61987: folds 
Uncalled bet ($0.21) returned to Bird et al
Bird et al collected $0.25 from pot
*** SUMMARY ***
Total pot $0.25 | Rake $0 
Seat 1: Namhkal folded before Flop (didn't bet)
Seat 2: Bird et al collected ($0.25)
Seat 3: KA3AXCTAHEU, folded before Flop (didn't bet)
Seat 4: totonove (button) folded before Flop (didn't bet)
Seat 5: Pekaml (small blind) folded before Flop
Seat 6: cherep61987 (big blind) folded before Flop



PokerStars Hand #166667970007:  Hold'em No Limit ($0.05/$0.10 USD) - 2017/02/23 16:10:52 ET
Table 'Sheragul III' 6-max Seat #6 is the button
Seat 2: Bird et al ($10.26 in chips) 
Seat 5: RGhearted ($10 in chips) 
Seat 6: XaXaTyH4uK ($10.40 in chips) 
CallByValue will be allowed to play after the button
Bird et al: posts small blind $0.05
FRAID358: is sitting out 
RGhearted: posts big blind $0.10
*** HOLE CARDS ***
XaXaTyH4uK: folds 
Bird et al: folds 
Uncalled bet ($0.05) returned to RGhearted
RGhearted collected $0.10 from pot
*** SUMMARY ***
Total pot $0.10 | Rake $0 
Seat 2: Bird et al (small blind) folded before Flop
Seat 5: RGhearted (big blind) collected ($0.10)
Seat 6: XaXaTyH4uK (button) folded before Flop (didn't bet)



PokerStars Hand #166667971430:  Hold'em No Limit ($0.05/$0.10 USD) - 2017/02/23 16:10:54 ET
Table 'Bengt' 6-max Seat #3 is the button
Seat 2: ChefRocco ($20.47 in chips) 
Seat 3: nantes15 ($13.14 in chips) 
Seat 4: 8th wonders ($10.05 in chips) 
Seat 5: RoJ1 ($10.16 in chips) 
Seat 6: Goroshkos88 ($11.06 in chips) 
8th wonders: posts small blind $0.05
RoJ1: posts big blind $0.10
*** HOLE CARDS ***
Goroshkos88: raises $0.20 to $0.30
ChefRocco: folds 
nantes15: folds 
8th wonders: folds 
RoJ1: calls $0.20
*** FLOP *** [Qc As Th]
RoJ1: checks 
Goroshkos88: bets $0.36
RoJ1: calls $0.36
*** TURN *** [Qc As Th] [5s]
RoJ1: checks 
Goroshkos88: checks 
*** RIVER *** [Qc As Th 5s] [Qd]
RoJ1: bets $0.95
Goroshkos88: calls $0.95
*** SHOW DOWN ***
RoJ1: shows [Qs Ks] (three of a kind, Queens)
Goroshkos88: mucks hand 
RoJ1 collected $3.12 from pot
*** SUMMARY ***
Total pot $3.27 | Rake $0.15 
Board [Qc As Th 5s Qd]
Seat 2: ChefRocco folded before Flop (didn't bet)
Seat 3: nantes15 (button) folded before Flop (didn't bet)
Seat 4: 8th wonders (small blind) folded before Flop
Seat 5: RoJ1 (big blind) showed [Qs Ks] and won ($3.12) with three of a kind, Queens
Seat 6: Goroshkos88 mucked



PokerStars Hand #166667971527:  Hold'em No Limit ($0.05/$0.10 USD) - 2017/02/23 16:10:54 ET
Table 'Torrence II' 6-max Seat #6 is the button
Seat 1: Starbooks ($6.51 in chips) 
Seat 2: scorpionfish ($15.82 in chips) 
Seat 3: coolisses111 ($9.89 in chips) 
Seat 4: Zooplack ($10 in chips) 
Seat 5: Kow6oy ($12.03 in chips) 
Seat 6: mhonielsen ($10.92 in chips) 
Starbooks: posts small blind $0.05
scorpionfish: posts big blind $0.10
*** HOLE CARDS ***
coolisses111: folds 
Zooplack: folds 
Kow6oy: folds 
mhonielsen: raises $0.10 to $0.20
Starbooks: folds 
scorpionfish: calls $0.10
*** FLOP *** [2s Th Kh]
scorpionfish: checks 
mhonielsen: bets $0.34
scorpionfish: raises $0.54 to $0.88
mhonielsen: calls $0.54
*** TURN *** [2s Th Kh] [5d]
scorpionfish: bets $1.30
mhonielsen: calls $1.30
*** RIVER *** [2s Th Kh 5d] [Qd]
scorpionfish: checks 
mhonielsen: checks 
*** SHOW DOWN ***
scorpionfish: shows [Jd Kc] (a pair of Kings)
mhonielsen: mucks hand 
scorpionfish collected $4.59 from pot
*** SUMMARY ***
Total pot $4.81 | Rake $0.22 
Board [2s Th Kh 5d Qd]
Seat 1: Starbooks (small blind) folded before Flop
Seat 2: scorpionfish (big blind) showed [Jd Kc] and won ($4.59) with a pair of Kings
Seat 3: coolisses111 folded before Flop (didn't bet)
Seat 4: Zooplack folded before Flop (didn't bet)
Seat 5: Kow6oy folded before Flop (didn't bet)
Seat 6: mhonielsen (button) mucked



PokerStars Hand #166667971604:  Hold'em No Limit ($0.05/$0.10 USD) - 2017/02/23 16:10:54 ET
Table 'Wingolfia II' 6-max Seat #3 is the button
Seat 1: BahiaMinhaP ($10 in chips) 
Seat 2: NvR.m1nD ($10 in chips) 
Seat 3: truck1234 ($10.57 in chips) 
Seat 4: zlobslob ($17.77 in chips) 
Seat 5: tr41n3r12 ($12.09 in chips) 
Seat 6: Tom Zhangxue ($9.75 in chips) 
zlobslob: posts small blind $0.05
tr41n3r12: posts big blind $0.10
*** HOLE CARDS ***
Tom Zhangxue: folds 
BahiaMinhaP: folds 
NvR.m1nD: folds 
truck1234: folds 
zlobslob: folds 
Uncalled bet ($0.05) returned to tr41n3r12
tr41n3r12 collected $0.10 from pot
*** SUMMARY ***
Total pot $0.10 | Rake $0 
Seat 1: BahiaMinhaP folded before Flop (didn't bet)
Seat 2: NvR.m1nD folded before Flop (didn't bet)
Seat 3: truck1234 (button) folded before Flop (didn't bet)
Seat 4: zlobslob (small blind) folded before Flop
Seat 5: tr41n3r12 (big blind) collected ($0.10)
Seat 6: Tom Zhangxue folded before Flop (didn't bet)



PokerStars Hand #166667972346:  Hold'em No Limit ($0.05/$0.10 USD) - 2017/02/23 16:10:55 ET
Table 'Glarona' 6-max Seat #6 is the button
Seat 1: LarryTheStar ($10.05 in chips) 
Seat 2: BookWorm78 ($10.25 in chips) 
Seat 4: CrippledGod ($7.04 in chips) 
Seat 6: marianoboni ($10 in chips) 
LarryTheStar: posts small blind $0.05
BookWorm78: posts big blind $0.10
*** HOLE CARDS ***
CrippledGod: folds 
marianoboni: folds 
LarryTheStar: folds 
Uncalled bet ($0.05) returned to BookWorm78
gaHy_HaXeP joins the table at seat #3 
BookWorm78 collected $0.10 from pot
*** SUMMARY ***
Total pot $0.10 | Rake $0 
Seat 1: LarryTheStar (small blind) folded before Flop
Seat 2: BookWorm78 (big blind) collected ($0.10)
Seat 4: CrippledGod folded before Flop (didn't bet)
Seat 6: marianoboni (button) folded before Flop (didn't bet)



PokerStars Hand #166667972602:  Hold'em No Limit ($0.05/$0.10 USD) - 2017/02/23 16:10:55 ET
Table 'Gyldenia II' 6-max Seat #3 is the button
Seat 1: KokoulinV ($11.44 in chips) 
Seat 2: Kow6oy ($10 in chips) 
Seat 3: mhonielsen ($10.10 in chips) 
Seat 5: CHRO8 ($15.89 in chips) 
Seat 6: 8th wonders ($11.33 in chips) 
univibe68 will be allowed to play after the button
CHRO8: posts small blind $0.05
8th wonders: posts big blind $0.10
*** HOLE CARDS ***
KokoulinV: folds 
Kow6oy: folds 
mhonielsen: raises $0.10 to $0.20
CHRO8: folds 
8th wonders: folds 
Uncalled bet ($0.10) returned to mhonielsen
mhonielsen collected $0.25 from pot
*** SUMMARY ***
Total pot $0.25 | Rake $0 
Seat 1: KokoulinV folded before Flop (didn't bet)
Seat 2: Kow6oy folded before Flop (didn't bet)
Seat 3: mhonielsen (button) collected ($0.25)
Seat 5: CHRO8 (small blind) folded before Flop
Seat 6: 8th wonders (big blind) folded before Flop



PokerStars Hand #166667972672:  Hold'em No Limit ($0.05/$0.10 USD) - 2017/02/23 16:10:55 ET
Table 'Ebella II' 6-max Seat #5 is the button
Seat 1: gaHy_HaXeP ($10 in chips) 
Seat 2: Therodorus ($10 in chips) 
Seat 3: Torften2 ($17.66 in chips) 
Seat 4: ValdemorS ($11.55 in chips) 
Seat 5: Bird et al ($10 in chips) 
Seat 6: Joker51_wtf! ($11.74 in chips) 
Joker51_wtf!: posts small blind $0.05
gaHy_HaXeP: posts big blind $0.10
*** HOLE CARDS ***
Therodorus: folds 
Torften2: folds 
ValdemorS: raises $0.20 to $0.30
Bird et al: folds 
Joker51_wtf!: folds 
gaHy_HaXeP: folds 
Uncalled bet ($0.20) returned to ValdemorS
ValdemorS collected $0.25 from pot
*** SUMMARY ***
Total pot $0.25 | Rake $0 
Seat 1: gaHy_HaXeP (big blind) folded before Flop
Seat 2: Therodorus folded before Flop (didn't bet)
Seat 3: Torften2 folded before Flop (didn't bet)
Seat 4: ValdemorS collected ($0.25)
Seat 5: Bird et al (button) folded before Flop (didn't bet)
Seat 6: Joker51_wtf! (small blind) folded before Flop



PokerStars Hand #166667972813:  Hold'em No Limit ($0.05/$0.10 USD) - 2017/02/23 16:10:55 ET
Table 'Phereclos II' 6-max Seat #1 is the button
Seat 1: Vladu1986 ($10 in chips) 
Seat 2: Kazacha ($15.53 in chips) 
Seat 3: overbet666 ($10 in chips) 
Seat 5: crazydevill ($12.24 in chips) 
Seat 6: mhonielsen ($16.49 in chips) 
Kazacha: posts small blind $0.05
overbet666: posts big blind $0.10
*** HOLE CARDS ***
crazydevill: folds 
mhonielsen: folds 
Vladu1986: raises $0.10 to $0.20
Kazacha: folds 
overbet666: folds 
Uncalled bet ($0.10) returned to Vladu1986
Vladu1986 collected $0.25 from pot
*** SUMMARY ***
Total pot $0.25 | Rake $0 
Seat 1: Vladu1986 (button) collected ($0.25)
Seat 2: Kazacha (small blind) folded before Flop
Seat 3: overbet666 (big blind) folded before Flop
Seat 5: crazydevill folded before Flop (didn't bet)
Seat 6: mhonielsen folded before Flop (didn't bet)



PokerStars Hand #166667973231:  Hold'em No Limit ($0.05/$0.10 USD) - 2017/02/23 16:10:56 ET
Table 'Hamal II' 6-max Seat #3 is the button
Seat 1: saxoalto2011 ($6.74 in chips) 
Seat 2: pancernik21 ($21.40 in chips) 
Seat 3: Cluckh ($10.84 in chips) 
Seat 4: ArcticBearDK ($10 in chips) 
Seat 5: eniksenik ($10.89 in chips) 
Seat 6: LarryTheStar ($11.34 in chips) 
ArcticBearDK: posts small blind $0.05
eniksenik: posts big blind $0.10
*** HOLE CARDS ***
LarryTheStar: folds 
saxoalto2011: raises $0.20 to $0.30
pancernik21: folds 
Cluckh: calls $0.30
ArcticBearDK: folds 
eniksenik: folds 
*** FLOP *** [2s Jh Qh]
saxoalto2011: checks 
Cluckh: checks 
*** TURN *** [2s Jh Qh] [7h]
saxoalto2011: checks 
Cluckh: bets $0.30
saxoalto2011: calls $0.30
*** RIVER *** [2s Jh Qh 7h] [4s]
saxoalto2011: checks 
Cluckh: bets $0.80
saxoalto2011: folds 
Uncalled bet ($0.80) returned to Cluckh
Cluckh collected $1.29 from pot
*** SUMMARY ***
Total pot $1.35 | Rake $0.06 
Board [2s Jh Qh 7h 4s]
Seat 1: saxoalto2011 folded on the River
Seat 2: pancernik21 folded before Flop (didn't bet)
Seat 3: Cluckh (button) collected ($1.29)
Seat 4: ArcticBearDK (small blind) folded before Flop
Seat 5: eniksenik (big blind) folded before Flop
Seat 6: LarryTheStar folded before Flop (didn't bet)



PokerStars Hand #166667973232:  Hold'em No Limit ($0.05/$0.10 USD) - 2017/02/23 16:10:56 ET
Table 'Unitas II' 6-max Seat #5 is the button
Seat 1: Peter0087 ($10.36 in chips) 
Seat 2: steepfell ($10.10 in chips) 
Seat 3: BahiaMinhaP ($10.40 in chips) 
Seat 4: truck1234 ($10.54 in chips) 
Seat 5: chimera252 ($24.18 in chips) 
Seat 6: paxit71 ($9.48 in chips) 
paxit71: posts small blind $0.05
Peter0087: posts big blind $0.10
*** HOLE CARDS ***
steepfell: folds 
BahiaMinhaP: folds 
truck1234: folds 
chimera252: raises $0.15 to $0.25
paxit71: calls $0.20
Peter0087: raises $1.05 to $1.30
chimera252: folds 
paxit71: folds 
Uncalled bet ($1.05) returned to Peter0087
Peter0087 collected $0.75 from pot
*** SUMMARY ***
Total pot $0.75 | Rake $0 
Seat 1: Peter0087 (big blind) collected ($0.75)
Seat 2: steepfell folded before Flop (didn't bet)
Seat 3: BahiaMinhaP folded before Flop (didn't bet)
Seat 4: truck1234 folded before Flop (didn't bet)
Seat 5: chimera252 (button) folded before Flop
Seat 6: paxit71 (small blind) folded before Flop



PokerStars Hand #166667973459:  Hold'em No Limit ($0.05/$0.10 USD) - 2017/02/23 16:10:56 ET
Table 'Lorbach' 6-max Seat #6 is the button
Seat 1: LarryTheStar ($18.09 in chips) 
Seat 2: fabadam ($11.68 in chips) 
Seat 3: ArcticBearDK ($10 in chips) 
Seat 4: kpumukAA ($4 in chips) 
Seat 6: Worlz ($15.85 in chips) 
LarryTheStar: posts small blind $0.05
fabadam: posts big blind $0.10
kpumukAA: posts big blind $0.10
*** HOLE CARDS ***
brotherluck leaves the table
ArcticBearDK: folds 
overbet666 joins the table at seat #5 
kpumukAA: checks 
Worlz: folds 
LarryTheStar: raises $0.30 to $0.40
fabadam: folds 
kpumukAA: calls $0.30
*** FLOP *** [Ks 3c Qc]
LarryTheStar: bets $0.60
kpumukAA: calls $0.60
*** TURN *** [Ks 3c Qc] [2c]
LarryTheStar: checks 
kpumukAA: bets $1.30
LarryTheStar: folds 
Uncalled bet ($1.30) returned to kpumukAA
kpumukAA collected $2.01 from pot
*** SUMMARY ***
Total pot $2.10 | Rake $0.09 
Board [Ks 3c Qc 2c]
Seat 1: LarryTheStar (small blind) folded on the Turn
Seat 2: fabadam (big blind) folded before Flop
Seat 3: ArcticBearDK folded before Flop (didn't bet)
Seat 4: kpumukAA collected ($2.01)
Seat 6: Worlz (button) folded before Flop (didn't bet)



PokerStars Hand #166667974013:  Hold'em No Limit ($0.05/$0.10 USD) - 2017/02/23 16:10:57 ET
Table 'Nemo III' 6-max Seat #4 is the button
Seat 1: Kow6oy ($10.10 in chips) 
Seat 2: Bandyaev ($10.81 in chips) 
Seat 3: Dimka4 ($10 in chips) 
Seat 4: vtalian ($10.98 in chips) 
Seat 5: Joker51_wtf! ($11.78 in chips) 
Seat 6: maxiv608 ($10 in chips) 
Joker51_wtf!: posts small blind $0.05
maxiv608: posts big blind $0.10
*** HOLE CARDS ***
Kow6oy: folds 
Bandyaev: raises $0.20 to $0.30
Dimka4: folds 
vtalian: folds 
Joker51_wtf!: folds 
maxiv608: calls $0.20
*** FLOP *** [5d 2s 4h]
maxiv608: checks 
Bandyaev: bets $0.47
maxiv608: folds 
Uncalled bet ($0.47) returned to Bandyaev
Bandyaev collected $0.62 from pot
*** SUMMARY ***
Total pot $0.65 | Rake $0.03 
Board [5d 2s 4h]
Seat 1: Kow6oy folded before Flop (didn't bet)
Seat 2: Bandyaev collected ($0.62)
Seat 3: Dimka4 folded before Flop (didn't bet)
Seat 4: vtalian (button) folded before Flop (didn't bet)
Seat 5: Joker51_wtf! (small blind) folded before Flop
Seat 6: maxiv608 (big blind) folded on the Flop



PokerStars Hand #166667974014:  Hold'em No Limit ($0.05/$0.10 USD) - 2017/02/23 16:10:57 ET
Table 'Kanda' 6-max Seat #3 is the button
Seat 1: Andy Wolf ($11.72 in chips) 
Seat 2: Pelotín ($5.12 in chips) 
Seat 3: XaXaTyH4uK ($10.96 in chips) 
Seat 4: Orlangoor ($10 in chips) 
Seat 5: Dimka4 ($10.43 in chips) 
Seat 6: oddshoff ($8.91 in chips) 
Orlangoor: posts small blind $0.05
Dimka4: posts big blind $0.10
*** HOLE CARDS ***
oddshoff: folds 
Andy Wolf: raises $0.20 to $0.30
Pelotín: folds 
XaXaTyH4uK: folds 
Orlangoor: folds 
Dimka4: calls $0.20
*** FLOP *** [4c 2s 5c]
Dimka4: checks 
Andy Wolf: checks 
*** TURN *** [4c 2s 5c] [6h]
Dimka4: checks 
Andy Wolf: checks 
*** RIVER *** [4c 2s 5c 6h] [3c]
Dimka4: checks 
Andy Wolf: checks 
*** SHOW DOWN ***
Dimka4: shows [Qc Kh] (a straight, Deuce to Six)
Andy Wolf: shows [Js Ts] (a straight, Deuce to Six)
Dimka4 collected $0.31 from pot
Andy Wolf collected $0.31 from pot
*** SUMMARY ***
Total pot $0.65 | Rake $0.03 
Board [4c 2s 5c 6h 3c]
Seat 1: Andy Wolf showed [Js Ts] and won ($0.31) with a straight, Deuce to Six
Seat 2: Pelotín folded before Flop (didn't bet)
Seat 3: XaXaTyH4uK (button) folded before Flop (didn't bet)
Seat 4: Orlangoor (small blind) folded before Flop
Seat 5: Dimka4 (big blind) showed [Qc Kh] and won ($0.31) with a straight, Deuce to Six
Seat 6: oddshoff folded before Flop (didn't bet)



PokerStars Hand #166667974022:  Hold'em No Limit ($0.05/$0.10 USD) - 2017/02/23 16:10:57 ET
Table 'Wilkens II' 6-max Seat #1 is the button
Seat 1: Islamiq-GuRL ($10.19 in chips) 
Seat 2: manashov ($10.80 in chips) 
Seat 3: Namhkal ($11.68 in chips) 
Seat 4: myevc ($10 in chips) 
Seat 5: patrick19111 ($13.57 in chips) 
Seat 6: XaXaTyH4uK ($14.01 in chips) 
manashov: posts small blind $0.05
Namhkal: posts big blind $0.10
*** HOLE CARDS ***
myevc: folds 
patrick19111: folds 
XaXaTyH4uK: folds 
Islamiq-GuRL: folds 
manashov: raises $0.20 to $0.30
Namhkal: folds 
Uncalled bet ($0.20) returned to manashov
manashov collected $0.20 from pot
*** SUMMARY ***
Total pot $0.20 | Rake $0 
Seat 1: Islamiq-GuRL (button) folded before Flop (didn't bet)
Seat 2: manashov (small blind) collected ($0.20)
Seat 3: Namhkal (big blind) folded before Flop
Seat 4: myevc folded before Flop (didn't bet)
Seat 5: patrick19111 folded before Flop (didn't bet)
Seat 6: XaXaTyH4uK folded before Flop (didn't bet)



PokerStars Hand #166667974176:  Hold'em No Limit ($0.05/$0.10 USD) - 2017/02/23 16:10:57 ET
Table 'Girtab' 6-max Seat #2 is the button
Seat 2: MühliJr ($10 in chips) 
Seat 3: kingartur222 ($9.95 in chips) 
Seat 4: Hyd SK ($10.98 in chips) 
Seat 5: sexy_seagull ($11.20 in chips) 
Seat 6: iluzja12 ($10.95 in chips) 
kingartur222: posts small blind $0.05
Hyd SK: posts big blind $0.10
*** HOLE CARDS ***
sexy_seagull: raises $0.20 to $0.30
iluzja12: folds 
MühliJr: folds 
kingartur222: folds 
Hyd SK: folds 
Uncalled bet ($0.20) returned to sexy_seagull
sexy_seagull collected $0.25 from pot
*** SUMMARY ***
Total pot $0.25 | Rake $0 
Seat 2: MühliJr (button) folded before Flop (didn't bet)
Seat 3: kingartur222 (small blind) folded before Flop
Seat 4: Hyd SK (big blind) folded before Flop
Seat 5: sexy_seagull collected ($0.25)
Seat 6: iluzja12 folded before Flop (didn't bet)



PokerStars Hand #166667974206:  Hold'em No Limit ($0.05/$0.10 USD) - 2017/02/23 16:10:57 ET
Table 'Lehigh' 6-max Seat #1 is the button
Seat 1: pokekrk ($10 in chips) 
Seat 3: Cluckh ($10.25 in chips) 
Seat 4: manashov ($10 in chips) 
Seat 5: Slavoaca693 ($7.85 in chips) 
Cluckh: posts small blind $0.05
manashov: posts big blind $0.10
*** HOLE CARDS ***
Slavoaca693: folds 
pokekrk: folds 
Cluckh: folds 
Uncalled bet ($0.05) returned to manashov
manashov collected $0.10 from pot
*** SUMMARY ***
Total pot $0.10 | Rake $0 
Seat 1: pokekrk (button) folded before Flop (didn't bet)
Seat 3: Cluckh (small blind) folded before Flop
Seat 4: manashov (big blind) collected ($0.10)
Seat 5: Slavoaca693 folded before Flop (didn't bet)



PokerStars Hand #166667974319:  Hold'em No Limit ($0.05/$0.10 USD) - 2017/02/23 16:10:57 ET
Table 'Stroobantia' 6-max Seat #1 is the button
Seat 1: mam9zyc ($10.37 in chips) 
Seat 2: XwinX25 ($10 in chips) 
Seat 3: Namhkal ($11.05 in chips) 
Seat 4: Yspenyanin ($10.45 in chips) 
Seat 5: boxer821 ($10.84 in chips) 
Seat 6: KokoulinV ($15.52 in chips) 
XwinX25: posts small blind $0.05
Namhkal: posts big blind $0.10
*** HOLE CARDS ***
Yspenyanin: raises $0.15 to $0.25
boxer821: folds 
KokoulinV: folds 
mam9zyc: folds 
XwinX25: folds 
Namhkal: folds 
Uncalled bet ($0.15) returned to Yspenyanin
Yspenyanin collected $0.25 from pot
*** SUMMARY ***
Total pot $0.25 | Rake $0 
Seat 1: mam9zyc (button) folded before Flop (didn't bet)
Seat 2: XwinX25 (small blind) folded before Flop
Seat 3: Namhkal (big blind) folded before Flop
Seat 4: Yspenyanin collected ($0.25)
Seat 5: boxer821 folded before Flop (didn't bet)
Seat 6: KokoulinV folded before Flop (didn't bet)



PokerStars Hand #166667974359:  Hold'em No Limit ($0.05/$0.10 USD) - 2017/02/23 16:10:57 ET
Table 'Atalante' 6-max Seat #2 is the button
Seat 1: OceanBlue100 ($5.14 in chips) 
Seat 2: CiisCi ($19.25 in chips) 
Seat 3: Kow6oy ($10 in chips) 
Seat 4: Dcaro31 ($24.17 in chips) 
Seat 5: eniksenik ($10.93 in chips) 
Seat 6: FlopsterGB ($31.06 in chips) 
Kow6oy: posts small blind $0.05
Dcaro31: posts big blind $0.10
*** HOLE CARDS ***
eniksenik: folds 
FlopsterGB: folds 
OceanBlue100: calls $0.10
CiisCi: raises $0.20 to $0.30
Kow6oy: calls $0.25
Dcaro31: calls $0.20
OceanBlue100: calls $0.20
*** FLOP *** [5h 3s 2h]
Kow6oy: checks 
Dcaro31: checks 
OceanBlue100: bets $4.84 and is all-in
CiisCi: folds 
Kow6oy: raises $4.84 to $9.68
Dcaro31: folds 
Uncalled bet ($4.84) returned to Kow6oy
*** TURN *** [5h 3s 2h] [Ah]
*** RIVER *** [5h 3s 2h Ah] [Js]
*** SHOW DOWN ***
Kow6oy: shows [9c 9s] (a pair of Nines)
OceanBlue100: shows [8h 8c] (a pair of Eights)
Kow6oy collected $10.39 from pot
*** SUMMARY ***
Total pot $10.88 | Rake $0.49 
Board [5h 3s 2h Ah Js]
Seat 1: OceanBlue100 showed [8h 8c] and lost with a pair of Eights
Seat 2: CiisCi (button) folded on the Flop
Seat 3: Kow6oy (small blind) showed [9c 9s] and won ($10.39) with a pair of Nines
Seat 4: Dcaro31 (big blind) folded on the Flop
Seat 5: eniksenik folded before Flop (didn't bet)
Seat 6: FlopsterGB folded before Flop (didn't bet)



PokerStars Hand #166667974419:  Hold'em No Limit ($0.05/$0.10 USD) - 2017/02/23 16:10:57 ET
Table 'Caupolican' 6-max Seat #2 is the button
Seat 1: kingartur222 ($12.42 in chips) 
Seat 2: garigura ($18.60 in chips) 
Seat 3: ducksheep82 ($5.48 in chips) 
Seat 4: mhonielsen ($14.37 in chips) 
Seat 5: Kazacha ($12.55 in chips) 
Seat 6: crazydevill ($10 in chips) 
ducksheep82: posts small blind $0.05
mhonielsen: posts big blind $0.10
*** HOLE CARDS ***
Kazacha: folds 
crazydevill: folds 
kingartur222: folds 
garigura: folds 
ducksheep82: calls $0.05
mhonielsen: checks 
*** FLOP *** [Qc Jd 5c]
ducksheep82: checks 
mhonielsen: bets $0.12
ducksheep82: folds 
Uncalled bet ($0.12) returned to mhonielsen
mhonielsen collected $0.19 from pot
*** SUMMARY ***
Total pot $0.20 | Rake $0.01 
Board [Qc Jd 5c]
Seat 1: kingartur222 folded before Flop (didn't bet)
Seat 2: garigura (button) folded before Flop (didn't bet)
Seat 3: ducksheep82 (small blind) folded on the Flop
Seat 4: mhonielsen (big blind) collected ($0.19)
Seat 5: Kazacha folded before Flop (didn't bet)
Seat 6: crazydevill folded before Flop (didn't bet)



PokerStars Hand #166667974654:  Hold'em No Limit ($0.05/$0.10 USD) - 2017/02/23 16:10:57 ET
Table 'Armenia' 6-max Seat #1 is the button
Seat 1: tr41n3r12 ($11.37 in chips) 
Seat 2: Yabidooo ($10.88 in chips) 
Seat 3: Crimsonr ($5.74 in chips) 
Seat 4: mbkongstad ($8.60 in chips) 
Seat 5: DrVzad ($9.85 in chips) 
Seat 6: mega spasser ($8.03 in chips) 
Yabidooo: posts small blind $0.05
Crimsonr: posts big blind $0.10
*** HOLE CARDS ***
mbkongstad: folds 
DrVzad: folds 
mega spasser: folds 
tr41n3r12: raises $0.15 to $0.25
Yabidooo: folds 
Crimsonr: folds 
Uncalled bet ($0.15) returned to tr41n3r12
tr41n3r12 collected $0.25 from pot
*** SUMMARY ***
Total pot $0.25 | Rake $0 
Seat 1: tr41n3r12 (button) collected ($0.25)
Seat 2: Yabidooo (small blind) folded before Flop
Seat 3: Crimsonr (big blind) folded before Flop
Seat 4: mbkongstad folded before Flop (didn't bet)
Seat 5: DrVzad folded before Flop (didn't bet)
Seat 6: mega spasser folded before Flop (didn't bet)



PokerStars Hand #166667974716:  Hold'em No Limit ($0.05/$0.10 USD) - 2017/02/23 16:10:57 ET
Table 'Persephone' 6-max Seat #2 is the button
Seat 1: dragonste89 ($14.45 in chips) 
Seat 2: AM-L-SL ($5.50 in chips) 
Seat 3: Mooneye19 ($10.59 in chips) 
Seat 4: 2G28 ($11.36 in chips) 
Seat 5: ab260414 ($10.56 in chips) 
Seat 6: popypaleta ($12.78 in chips) 
Mooneye19: posts small blind $0.05
2G28: posts big blind $0.10
*** HOLE CARDS ***
ab260414: raises $0.20 to $0.30
popypaleta: folds 
dragonste89: calls $0.30
AM-L-SL: calls $0.30
Mooneye19: folds 
2G28: folds 
*** FLOP *** [2d Ac Js]
ab260414: checks 
dragonste89: bets $0.50
AM-L-SL: calls $0.50
ab260414: folds 
*** TURN *** [2d Ac Js] [2c]
dragonste89: bets $0.98
AM-L-SL: calls $0.98
*** RIVER *** [2d Ac Js 2c] [8h]
dragonste89: checks 
AM-L-SL: checks 
*** SHOW DOWN ***
dragonste89: shows [Qc Qd] (two pair, Queens and Deuces)
AM-L-SL: shows [5d Ad] (two pair, Aces and Deuces)
AM-L-SL collected $3.83 from pot
*** SUMMARY ***
Total pot $4.01 | Rake $0.18 
Board [2d Ac Js 2c 8h]
Seat 1: dragonste89 showed [Qc Qd] and lost with two pair, Queens and Deuces
Seat 2: AM-L-SL (button) showed [5d Ad] and won ($3.83) with two pair, Aces and Deuces
Seat 3: Mooneye19 (small blind) folded before Flop
Seat 4: 2G28 (big blind) folded before Flop
Seat 5: ab260414 folded on the Flop
Seat 6: popypaleta folded before Flop (didn't bet)



PokerStars Hand #166667974889:  Hold'em No Limit ($0.05/$0.10 USD) - 2017/02/23 16:10:58 ET
Table 'Luanda' 6-max Seat #5 is the button
Seat 1: AM-L-SL ($2.86 in chips) 
Seat 2: Xander188 ($10.15 in chips) 
Seat 4: aapokerkot ($10.08 in chips) 
Seat 5: st4tion ($12.35 in chips) 
AM-L-SL: posts small blind $0.05
Xander188: posts big blind $0.10
pokekrk: sits out 
*** HOLE CARDS ***
aapokerkot: folds 
st4tion: folds 
AM-L-SL: folds 
Uncalled bet ($0.05) returned to Xander188
Xander188 collected $0.10 from pot
*** SUMMARY ***
Total pot $0.10 | Rake $0 
Seat 1: AM-L-SL (small blind) folded before Flop
Seat 2: Xander188 (big blind) collected ($0.10)
Seat 4: aapokerkot folded before Flop (didn't bet)
Seat 5: st4tion (button) folded before Flop (didn't bet)



PokerStars Hand #166667974964:  Hold'em No Limit ($0.05/$0.10 USD) - 2017/02/23 16:10:58 ET
Table 'Nerthus II' 6-max Seat #6 is the button
Seat 1: mdelfin0 ($12.54 in chips) 
Seat 2: Hovhannes990 ($9.27 in chips) 
Seat 3: Mamm0nism ($18.71 in chips) 
Seat 4: myevc ($16.53 in chips) 
Seat 5: Hyd SK ($10.47 in chips) 
Seat 6: Lucky HoBBiT ($10 in chips) 
mdelfin0: posts small blind $0.05
Hovhannes990: posts big blind $0.10
*** HOLE CARDS ***
Mamm0nism: folds 
myevc: folds 
Hyd SK: raises $0.25 to $0.35
Lucky HoBBiT: folds 
mdelfin0: folds 
Hovhannes990: folds 
Uncalled bet ($0.25) returned to Hyd SK
Hyd SK collected $0.25 from pot
*** SUMMARY ***
Total pot $0.25 | Rake $0 
Seat 1: mdelfin0 (small blind) folded before Flop
Seat 2: Hovhannes990 (big blind) folded before Flop
Seat 3: Mamm0nism folded before Flop (didn't bet)
Seat 4: myevc folded before Flop (didn't bet)
Seat 5: Hyd SK collected ($0.25)
Seat 6: Lucky HoBBiT (button) folded before Flop (didn't bet)



PokerStars Hand #166667975180:  Hold'em No Limit ($0.05/$0.10 USD) - 2017/02/23 16:10:58 ET
Table 'Crocus' 6-max Seat #2 is the button
Seat 1: truck1234 ($25.66 in chips) 
Seat 2: garigura ($10.99 in chips) 
Seat 3: Yspenyanin ($10 in chips) 
Seat 4: patrick19111 ($12.76 in chips) 
Seat 6: Rodik002 ($10.24 in chips) 
Yspenyanin: posts small blind $0.05
patrick19111: posts big blind $0.10
FilK74: sits out 
*** HOLE CARDS ***
Rodik002: folds 
truck1234: raises $0.20 to $0.30
garigura: folds 
Yspenyanin: folds 
patrick19111: folds 
Uncalled bet ($0.20) returned to truck1234
truck1234 collected $0.25 from pot
*** SUMMARY ***
Total pot $0.25 | Rake $0 
Seat 1: truck1234 collected ($0.25)
Seat 2: garigura (button) folded before Flop (didn't bet)
Seat 3: Yspenyanin (small blind) folded before Flop
Seat 4: patrick19111 (big blind) folded before Flop
Seat 6: Rodik002 folded before Flop (didn't bet)



PokerStars Hand #166667975360:  Hold'em No Limit ($0.05/$0.10 USD) - 2017/02/23 16:10:58 ET
Table 'Deflotte' 6-max Seat #1 is the button
Seat 1: Zooplack ($17.20 in chips) 
Seat 2: MonteCris92 ($10.05 in chips) 
Seat 3: Yspenyanin ($10 in chips) 
Seat 4: 8th wonders ($10.37 in chips) 
Seat 5: Pokeaster ($11.62 in chips) 
Seat 6: Iarlei ($10.30 in chips) 
MonteCris92: posts small blind $0.05
Yspenyanin: posts big blind $0.10
*** HOLE CARDS ***
8th wonders: folds 
Pokeaster: folds 
Iarlei: folds 
Zooplack: raises $0.15 to $0.25
MonteCris92: folds 
Yspenyanin: folds 
Uncalled bet ($0.15) returned to Zooplack
Zooplack collected $0.25 from pot
Zooplack: doesn't show hand 
*** SUMMARY ***
Total pot $0.25 | Rake $0 
Seat 1: Zooplack (button) collected ($0.25)
Seat 2: MonteCris92 (small blind) folded before Flop
Seat 3: Yspenyanin (big blind) folded before Flop
Seat 4: 8th wonders folded before Flop (didn't bet)
Seat 5: Pokeaster folded before Flop (didn't bet)
Seat 6: Iarlei folded before Flop (didn't bet)



PokerStars Hand #166667975476:  Hold'em No Limit ($0.05/$0.10 USD) - 2017/02/23 16:10:58 ET
Table 'Pallas II' 6-max Seat #1 is the button
Seat 1: mdelfin0 ($16.49 in chips) 
Seat 3: popypaleta ($10.35 in chips) 
Seat 4: MisterX413 ($10 in chips) 
popypaleta: posts small blind $0.05
MisterX413: posts big blind $0.10
*** HOLE CARDS ***
mdelfin0: raises $0.12 to $0.22
popypaleta: folds 
MisterX413: folds 
Uncalled bet ($0.12) returned to mdelfin0
mdelfin0 collected $0.25 from pot
*** SUMMARY ***
Total pot $0.25 | Rake $0 
Seat 1: mdelfin0 (button) collected ($0.25)
Seat 3: popypaleta (small blind) folded before Flop
Seat 4: MisterX413 (big blind) folded before Flop



PokerStars Hand #166667975545:  Hold'em No Limit ($0.05/$0.10 USD) - 2017/02/23 16:10:58 ET
Table 'Anhui II' 6-max Seat #6 is the button
Seat 1: kingartur222 ($17.64 in chips) 
Seat 2: kikus334 ($11.36 in chips) 
Seat 3: lochniak556 ($21.22 in chips) 
Seat 4: dragonste89 ($10 in chips) 
Seat 5: Bandyaev ($12.70 in chips) 
Seat 6: .BaRReL.1122 ($3.75 in chips) 
kingartur222: posts small blind $0.05
kikus334: posts big blind $0.10
*** HOLE CARDS ***
lochniak556: folds 
dragonste89: folds 
Bandyaev: folds 
.BaRReL.1122: folds 
kingartur222: raises $0.19 to $0.29
kikus334: calls $0.19
*** FLOP *** [Ac As 5d]
kingartur222: bets $0.41
kikus334: folds 
Uncalled bet ($0.41) returned to kingartur222
kingartur222 collected $0.55 from pot
*** SUMMARY ***
Total pot $0.58 | Rake $0.03 
Board [Ac As 5d]
Seat 1: kingartur222 (small blind) collected ($0.55)
Seat 2: kikus334 (big blind) folded on the Flop
Seat 3: lochniak556 folded before Flop (didn't bet)
Seat 4: dragonste89 folded before Flop (didn't bet)
Seat 5: Bandyaev folded before Flop (didn't bet)
Seat 6: .BaRReL.1122 (button) folded before Flop (didn't bet)



PokerStars Hand #166667975643:  Hold'em No Limit ($0.05/$0.10 USD) - 2017/02/23 16:10:58 ET
Table 'Kobresia II' 6-max Seat #2 is the button
Seat 1: RoJ1 ($15.34 in chips) 
Seat 2: Dcaro31 ($13.37 in chips) 
Seat 3: ocmarigo81 ($3.80 in chips) 
Seat 4: Vanne11 ($10.37 in chips) 
ocmarigo81: posts small blind $0.05
Vanne11: posts big blind $0.10
XaXaTyH4uK: sits out 
*** HOLE CARDS ***
RoJ1: folds 
Dcaro31: raises $0.20 to $0.30
ocmarigo81: folds 
Vanne11: folds 
Uncalled bet ($0.20) returned to Dcaro31
Dcaro31 collected $0.25 from pot
*** SUMMARY ***
Total pot $0.25 | Rake $0 
Seat 1: RoJ1 folded before Flop (didn't bet)
Seat 2: Dcaro31 (button) collected ($0.25)
Seat 3: ocmarigo81 (small blind) folded before Flop
Seat 4: Vanne11 (big blind) folded before Flop



PokerStars Hand #166667975651:  Hold'em No Limit ($0.05/$0.10 USD) - 2017/02/23 16:10:58 ET
Table 'Aegle' 6-max Seat #1 is the button
Seat 1: phatts76 ($3.45 in chips) 
Seat 2: yodzik ($5.32 in chips) 
Seat 4: ab260414 ($12.92 in chips) 
Seat 5: KokoulinV ($11.49 in chips) 
Seat 6: CHRO8 ($20.41 in chips) 
yodzik: posts small blind $0.05
ab260414: posts big blind $0.10
*** HOLE CARDS ***
KokoulinV: folds 
CHRO8: raises $0.20 to $0.30
phatts76: calls $0.30
yodzik: folds 
ab260414: folds 
*** FLOP *** [5c 3c 4d]
Bandyaev joins the table at seat #3 
Bandyaev leaves the table
KRZuff joins the table at seat #3 
KRZuff leaves the table
CHRO8: bets $0.36
phatts76: calls $0.36
*** TURN *** [5c 3c 4d] [3d]
CHRO8: checks 
phatts76: bets $0.80
CHRO8: calls $0.80
*** RIVER *** [5c 3c 4d 3d] [Kh]
CHRO8: checks 
phatts76: bets $1.50
CHRO8: calls $1.50
*** SHOW DOWN ***
phatts76: shows [2s Ts] (a pair of Threes)
CHRO8: shows [Qd As] (a pair of Threes - Ace kicker)
CHRO8 collected $5.80 from pot
*** SUMMARY ***
Total pot $6.07 | Rake $0.27 
Board [5c 3c 4d 3d Kh]
Seat 1: phatts76 (button) showed [2s Ts] and lost with a pair of Threes
Seat 2: yodzik (small blind) folded before Flop
Seat 4: ab260414 (big blind) folded before Flop
Seat 5: KokoulinV folded before Flop (didn't bet)
Seat 6: CHRO8 showed [Qd As] and won ($5.80) with a pair of Threes



PokerStars Hand #166667975716:  Hold'em No Limit ($0.05/$0.10 USD) - 2017/02/23 16:10:58 ET
Table 'Alzirr II' 6-max Seat #3 is the button
Seat 2: popypaleta ($10.75 in chips) 
Seat 3: devon_red ($7.20 in chips) 
Seat 4: Scanner17 ($17.99 in chips) 
Seat 5: yodzik ($5.73 in chips) 
Seat 6: AM-L-SL ($4.33 in chips) 
Scanner17: posts small blind $0.05
yodzik: posts big blind $0.10
Kow6oy: sits out 
*** HOLE CARDS ***
AM-L-SL: folds 
popypaleta: folds 
devon_red: folds 
Scanner17: raises $0.20 to $0.30
yodzik: folds 
Uncalled bet ($0.20) returned to Scanner17
Scanner17 collected $0.20 from pot
*** SUMMARY ***
Total pot $0.20 | Rake $0 
Seat 2: popypaleta folded before Flop (didn't bet)
Seat 3: devon_red (button) folded before Flop (didn't bet)
Seat 4: Scanner17 (small blind) collected ($0.20)
Seat 5: yodzik (big blind) folded before Flop
Seat 6: AM-L-SL folded before Flop (didn't bet)



PokerStars Hand #166667975853:  Hold'em No Limit ($0.05/$0.10 USD) - 2017/02/23 16:10:59 ET
Table 'Laetitia II' 6-max Seat #5 is the button
Seat 1: Cluckh ($10.83 in chips) 
Seat 2: manashov ($11.17 in chips) 
Seat 3: 6ePeMeHHa9 ($10 in chips) 
Seat 4: Feverhead ($17.43 in chips) 
Seat 5: D3NyA ($16.71 in chips) 
Seat 6: Dima91360 ($4.40 in chips) 
Dima91360: posts small blind $0.05
Cluckh: posts big blind $0.10
*** HOLE CARDS ***
manashov: folds 
6ePeMeHHa9: folds 
Feverhead: folds 
D3NyA: folds 
Dima91360: calls $0.05
Cluckh: checks 
*** FLOP *** [4h 4d Jd]
Dima91360: checks 
Cluckh: checks 
*** TURN *** [4h 4d Jd] [4c]
Dima91360: checks 
Cluckh: bets $0.10
Dima91360: folds 
Uncalled bet ($0.10) returned to Cluckh
Cluckh collected $0.19 from pot
*** SUMMARY ***
Total pot $0.20 | Rake $0.01 
Board [4h 4d Jd 4c]
Seat 1: Cluckh (big blind) collected ($0.19)
Seat 2: manashov folded before Flop (didn't bet)
Seat 3: 6ePeMeHHa9 folded before Flop (didn't bet)
Seat 4: Feverhead folded before Flop (didn't bet)
Seat 5: D3NyA (button) folded before Flop (didn't bet)
Seat 6: Dima91360 (small blind) folded on the Turn



PokerStars Hand #166667975936:  Hold'em No Limit ($0.05/$0.10 USD) - 2017/02/23 16:10:59 ET
Table 'Sheragul III' 6-max Seat #2 is the button
Seat 2: Bird et al ($10.21 in chips) 
Seat 5: RGhearted ($10.05 in chips) 
Seat 6: XaXaTyH4uK ($10.40 in chips) 
RGhearted: posts small blind $0.05
XaXaTyH4uK: posts big blind $0.10
FRAID358 leaves the table
CallByValue: sits out 
*** HOLE CARDS ***
Bird et al: folds 
RGhearted: raises $0.15 to $0.25
XaXaTyH4uK: folds 
Uncalled bet ($0.15) returned to RGhearted
RGhearted collected $0.20 from pot
*** SUMMARY ***
Total pot $0.20 | Rake $0 
Seat 2: Bird et al (button) folded before Flop (didn't bet)
Seat 5: RGhearted (small blind) collected ($0.20)
Seat 6: XaXaTyH4uK (big blind) folded before Flop



PokerStars Hand #166667975937:  Hold'em No Limit ($0.05/$0.10 USD) - 2017/02/23 16:10:59 ET
Table 'Hercynia III' 6-max Seat #6 is the button
Seat 1: Bird et al ($14.98 in chips) 
Seat 2: Action_Gibi ($4.73 in chips) 
Seat 3: Dcaro31 ($20.02 in chips) 
Seat 5: THIMUCHIN ($15.30 in chips) 
Seat 6: bdixon_5 ($13.47 in chips) 
Bird et al: posts small blind $0.05
Action_Gibi: posts big blind $0.10
*** HOLE CARDS ***
Dcaro31: folds 
THIMUCHIN: raises $0.15 to $0.25
bdixon_5: folds 
Bird et al: folds 
Action_Gibi: calls $0.15
*** FLOP *** [3c 7s 7h]
Action_Gibi: bets $0.27
THIMUCHIN: folds 
Uncalled bet ($0.27) returned to Action_Gibi
Action_Gibi collected $0.53 from pot
*** SUMMARY ***
Total pot $0.55 | Rake $0.02 
Board [3c 7s 7h]
Seat 1: Bird et al (small blind) folded before Flop
Seat 2: Action_Gibi (big blind) collected ($0.53)
Seat 3: Dcaro31 folded before Flop (didn't bet)
Seat 5: THIMUCHIN folded on the Flop
Seat 6: bdixon_5 (button) folded before Flop (didn't bet)



PokerStars Hand #166667976301:  Hold'em No Limit ($0.05/$0.10 USD) - 2017/02/23 16:10:59 ET
Table 'Pandora III' 6-max Seat #3 is the button
Seat 1: Pokeaster ($11.24 in chips) 
Seat 2: garigura ($11.39 in chips) 
Seat 3: Chodemuncher ($10 in chips) 
Seat 4: mhonielsen ($10.20 in chips) 
Seat 5: MühliJr ($10.57 in chips) 
Seat 6: yodzik ($5.32 in chips) 
mhonielsen: posts small blind $0.05
MühliJr: posts big blind $0.10
*** HOLE CARDS ***
yodzik: folds 
Pokeaster: folds 
garigura: raises $0.15 to $0.25
Chodemuncher: folds 
mhonielsen: folds 
MühliJr: folds 
Uncalled bet ($0.15) returned to garigura
garigura collected $0.25 from pot
*** SUMMARY ***
Total pot $0.25 | Rake $0 
Seat 1: Pokeaster folded before Flop (didn't bet)
Seat 2: garigura collected ($0.25)
Seat 3: Chodemuncher (button) folded before Flop (didn't bet)
Seat 4: mhonielsen (small blind) folded before Flop
Seat 5: MühliJr (big blind) folded before Flop
Seat 6: yodzik folded before Flop (didn't bet)



PokerStars Hand #166667976552:  Hold'em No Limit ($0.05/$0.10 USD) - 2017/02/23 16:10:59 ET
Table 'Manto II' 6-max Seat #3 is the button
Seat 1: ex3Lero86 ($10 in chips) 
Seat 2: voledy ($10.42 in chips) 
Seat 3: Komap511 ($9.95 in chips) 
Seat 5: ArcticBearDK ($34.43 in chips) 
Seat 6: pancernik21 ($14.33 in chips) 
ArcticBearDK: posts small blind $0.05
pancernik21: posts big blind $0.10
*** HOLE CARDS ***
AIONCMA1988 joins the table at seat #4 
ex3Lero86: folds 
voledy: folds 
Komap511: raises $0.20 to $0.30
ArcticBearDK: folds 
pancernik21: folds 
Uncalled bet ($0.20) returned to Komap511
Komap511 collected $0.25 from pot
*** SUMMARY ***
Total pot $0.25 | Rake $0 
Seat 1: ex3Lero86 folded before Flop (didn't bet)
Seat 2: voledy folded before Flop (didn't bet)
Seat 3: Komap511 (button) collected ($0.25)
Seat 5: ArcticBearDK (small blind) folded before Flop
Seat 6: pancernik21 (big blind) folded before Flop



PokerStars Hand #166667976579:  Hold'em No Limit ($0.05/$0.10 USD) - 2017/02/23 16:10:59 ET
Table 'Kraz II' 6-max Seat #3 is the button
Seat 1: bdixon_5 ($9.10 in chips) 
Seat 2: shellyld ($10 in chips) 
Seat 3: Eddys Edge ($10 in chips) 
Seat 4: DrVzad ($9.90 in chips) 
Seat 5: Joker51_wtf! ($10 in chips) 
Seat 6: tr41n3r12 ($11.58 in chips) 
DrVzad: posts small blind $0.05
Joker51_wtf!: posts big blind $0.10
*** HOLE CARDS ***
tr41n3r12: folds 
bdixon_5: raises $0.20 to $0.30
shellyld: folds 
Eddys Edge: folds 
DrVzad: folds 
Joker51_wtf!: folds 
Uncalled bet ($0.20) returned to bdixon_5
bdixon_5 collected $0.25 from pot
*** SUMMARY ***
Total pot $0.25 | Rake $0 
Seat 1: bdixon_5 collected ($0.25)
Seat 2: shellyld folded before Flop (didn't bet)
Seat 3: Eddys Edge (button) folded before Flop (didn't bet)
Seat 4: DrVzad (small blind) folded before Flop
Seat 5: Joker51_wtf! (big blind) folded before Flop
Seat 6: tr41n3r12 folded before Flop (didn't bet)



PokerStars Hand #166667976679:  Hold'em No Limit ($0.05/$0.10 USD) - 2017/02/23 16:10:59 ET
Table 'Syringa II' 6-max Seat #1 is the button
Seat 1: GiveTwoMe ($15.02 in chips) 
Seat 2: Cluckh ($10 in chips) 
Seat 3: gaHy_HaXeP ($10.28 in chips) 
Seat 4: MBen10 ($13.93 in chips) 
Seat 5: Mishapok196 ($5.70 in chips) 
Seat 6: WinninBikini ($10.97 in chips) 
Cluckh: posts small blind $0.05
gaHy_HaXeP: posts big blind $0.10
*** HOLE CARDS ***
MBen10: raises $0.18 to $0.28
Mishapok196: calls $0.28
WinninBikini: folds 
GiveTwoMe: raises $0.79 to $1.07
Cluckh: folds 
gaHy_HaXeP: folds 
MBen10: folds 
Mishapok196: calls $0.79
*** FLOP *** [5c Jh 5d]
Mishapok196: checks 
GiveTwoMe: bets $1.47
Mishapok196: folds 
Uncalled bet ($1.47) returned to GiveTwoMe
GiveTwoMe collected $2.45 from pot
*** SUMMARY ***
Total pot $2.57 | Rake $0.12 
Board [5c Jh 5d]
Seat 1: GiveTwoMe (button) collected ($2.45)
Seat 2: Cluckh (small blind) folded before Flop
Seat 3: gaHy_HaXeP (big blind) folded before Flop
Seat 4: MBen10 folded before Flop
Seat 5: Mishapok196 folded on the Flop
Seat 6: WinninBikini folded before Flop (didn't bet)



PokerStars Hand #166667976842:  Hold'em No Limit ($0.05/$0.10 USD) - 2017/02/23 16:11:00 ET
Table 'Risha II' 6-max Seat #4 is the button
Seat 1: marianoboni ($10 in chips) 
Seat 3: steepfell ($10 in chips) 
Seat 4: Comeback3392 ($19.53 in chips) 
Seat 5: m.c-alkatraz ($9.80 in chips) 
Seat 6: univibe68 ($11.31 in chips) 
m.c-alkatraz: posts small blind $0.05
univibe68: posts big blind $0.10
*** HOLE CARDS ***
AIONCMA1988 joins the table at seat #2 
marianoboni: raises $0.24 to $0.34
steepfell: folds 
Comeback3392: folds 
m.c-alkatraz: folds 
univibe68: calls $0.24
*** FLOP *** [Qs Ah Jd]
univibe68: checks 
marianoboni: checks 
*** TURN *** [Qs Ah Jd] [Qh]
univibe68: checks 
marianoboni: checks 
*** RIVER *** [Qs Ah Jd Qh] [9d]
univibe68: bets $0.77
marianoboni: folds 
Uncalled bet ($0.77) returned to univibe68
univibe68 collected $0.70 from pot
*** SUMMARY ***
Total pot $0.73 | Rake $0.03 
Board [Qs Ah Jd Qh 9d]
Seat 1: marianoboni folded on the River
Seat 3: steepfell folded before Flop (didn't bet)
Seat 4: Comeback3392 (button) folded before Flop (didn't bet)
Seat 5: m.c-alkatraz (small blind) folded before Flop
Seat 6: univibe68 (big blind) collected ($0.70)



PokerStars Hand #166667977184:  Hold'em No Limit ($0.05/$0.10 USD) - 2017/02/23 16:11:00 ET
Table 'Alnasl II' 6-max Seat #3 is the button
Seat 1: dragonste89 ($13.90 in chips) 
Seat 2: Therodorus ($10 in chips) 
Seat 3: ICBM-RS26 ($15.99 in chips) 
Seat 4: Eddys Edge ($10 in chips) 
Seat 5: mdelfin0 ($12.61 in chips) 
Seat 6: Bommer78 ($5.85 in chips) 
Eddys Edge: posts small blind $0.05
mdelfin0: posts big blind $0.10
*** HOLE CARDS ***
Bommer78: folds 
Bommer78 leaves the table
dragonste89: folds 
Therodorus: folds 
ICBM-RS26: folds 
Eddys Edge: folds 
Uncalled bet ($0.05) returned to mdelfin0
mdelfin0 collected $0.10 from pot
*** SUMMARY ***
Total pot $0.10 | Rake $0 
Seat 1: dragonste89 folded before Flop (didn't bet)
Seat 2: Therodorus folded before Flop (didn't bet)
Seat 3: ICBM-RS26 (button) folded before Flop (didn't bet)
Seat 4: Eddys Edge (small blind) folded before Flop
Seat 5: mdelfin0 (big blind) collected ($0.10)
Seat 6: Bommer78 folded before Flop (didn't bet)



PokerStars Hand #166667977230:  Hold'em No Limit ($0.05/$0.10 USD) - 2017/02/23 16:11:00 ET
Table 'Aludra II' 6-max Seat #3 is the button
Seat 1: voledy ($10.15 in chips) 
Seat 2: JahSoldier69 ($13.93 in chips) 
Seat 3: mbkongstad ($9.70 in chips) 
Seat 4: MihaGr ($10 in chips) 
Seat 5: kingartur222 ($16.17 in chips) 
Seat 6: call me haaa ($14.99 in chips) 
MihaGr: posts small blind $0.05
kingartur222: posts big blind $0.10
*** HOLE CARDS ***
call me haaa: folds 
voledy: folds 
JahSoldier69: folds 
mbkongstad: raises $0.10 to $0.20
MihaGr: folds 
kingartur222: folds 
Uncalled bet ($0.10) returned to mbkongstad
mbkongstad collected $0.25 from pot
*** SUMMARY ***
Total pot $0.25 | Rake $0 
Seat 1: voledy folded before Flop (didn't bet)
Seat 2: JahSoldier69 folded before Flop (didn't bet)
Seat 3: mbkongstad (button) collected ($0.25)
Seat 4: MihaGr (small blind) folded before Flop
Seat 5: kingartur222 (big blind) folded before Flop
Seat 6: call me haaa folded before Flop (didn't bet)



PokerStars Hand #166667977531:  Hold'em No Limit ($0.05/$0.10 USD) - 2017/02/23 16:11:00 ET
Table 'Antinous' 6-max Seat #4 is the button
Seat 1: Andrei ProFF ($16.55 in chips) 
Seat 2: Nr847 ($13.45 in chips) 
Seat 3: dittoro ($10 in chips) 
Seat 4: Pekaml ($14.67 in chips) 
Seat 5: Covetsoles ($4.64 in chips) 
Seat 6: coolisses111 ($9.25 in chips) 
Covetsoles: posts small blind $0.05
coolisses111: posts big blind $0.10
*** HOLE CARDS ***
Andrei ProFF: folds 
Nr847: folds 
dittoro: folds 
Pekaml: raises $0.10 to $0.20
Covetsoles: calls $0.15
coolisses111: folds 
*** FLOP *** [4h 4c Jc]
Covetsoles: bets $0.10
Pekaml: raises $0.34 to $0.44
Covetsoles: raises $0.34 to $0.78
Pekaml: folds 
Uncalled bet ($0.34) returned to Covetsoles
Covetsoles collected $1.32 from pot
*** SUMMARY ***
Total pot $1.38 | Rake $0.06 
Board [4h 4c Jc]
Seat 1: Andrei ProFF folded before Flop (didn't bet)
Seat 2: Nr847 folded before Flop (didn't bet)
Seat 3: dittoro folded before Flop (didn't bet)
Seat 4: Pekaml (button) folded on the Flop
Seat 5: Covetsoles (small blind) collected ($1.32)
Seat 6: coolisses111 (big blind) folded before Flop



PokerStars Hand #166667977611:  Hold'em No Limit ($0.05/$0.10 USD) - 2017/02/23 16:11:01 ET
Table 'Sham' 6-max Seat #2 is the button
Seat 1: pancernik21 ($10 in chips) 
Seat 2: ex3Lero86 ($10 in chips) 
Seat 3: weez3r ($15.25 in chips) 
Seat 5: T9MS ($10 in chips) 
Seat 6: bdixon_5 ($19.50 in chips) 
weez3r: posts small blind $0.05
VAD21: is sitting out 
T9MS: posts big blind $0.10
*** HOLE CARDS ***
VAD21 leaves the table
bdixon_5: folds 
pancernik21: raises $0.20 to $0.30
ex3Lero86: folds 
weez3r: folds 
T9MS: folds 
Uncalled bet ($0.20) returned to pancernik21
pancernik21 collected $0.25 from pot
*** SUMMARY ***
Total pot $0.25 | Rake $0 
Seat 1: pancernik21 collected ($0.25)
Seat 2: ex3Lero86 (button) folded before Flop (didn't bet)
Seat 3: weez3r (small blind) folded before Flop
Seat 5: T9MS (big blind) folded before Flop
Seat 6: bdixon_5 folded before Flop (didn't bet)



PokerStars Hand #166667977876:  Hold'em No Limit ($0.05/$0.10 USD) - 2017/02/23 16:11:01 ET
Table 'Vaisala' 6-max Seat #4 is the button
Seat 2: XaXaTyH4uK ($10.34 in chips) 
Seat 4: sexy_seagull ($11.16 in chips) 
Seat 5: univibe68 ($10 in chips) 
Seat 6: fábiu ($7.90 in chips) 
univibe68: posts small blind $0.05
fábiu: posts big blind $0.10
ksandr_hom: sits out 
Elinaattor: sits out 
*** HOLE CARDS ***
XaXaTyH4uK: folds 
sexy_seagull: folds 
univibe68: raises $0.20 to $0.30
fábiu: calls $0.20
*** FLOP *** [6c 7s Js]
univibe68: bets $0.40
fábiu: folds 
Uncalled bet ($0.40) returned to univibe68
univibe68 collected $0.57 from pot
*** SUMMARY ***
Total pot $0.60 | Rake $0.03 
Board [6c 7s Js]
Seat 2: XaXaTyH4uK folded before Flop (didn't bet)
Seat 4: sexy_seagull (button) folded before Flop (didn't bet)
Seat 5: univibe68 (small blind) collected ($0.57)
Seat 6: fábiu (big blind) folded on the Flop



PokerStars Hand #166667978067:  Hold'em No Limit ($0.05/$0.10 USD) - 2017/02/23 16:11:01 ET
Table 'Duhr II' 6-max Seat #5 is the button
Seat 1: Lucky HoBBiT ($10.88 in chips) 
Seat 2: Feverhead ($38.04 in chips) 
Seat 3: Smitty03300 ($10 in chips) 
Seat 4: CHRO8 ($9.85 in chips) 
Seat 5: Dimka4 ($10 in chips) 
Seat 6: townerz1991 ($11.33 in chips) 
townerz1991: posts small blind $0.05
Lucky HoBBiT: posts big blind $0.10
*** HOLE CARDS ***
Feverhead: folds 
Smitty03300: folds 
CHRO8: folds 
Dimka4: folds 
townerz1991: folds 
Uncalled bet ($0.05) returned to Lucky HoBBiT
Lucky HoBBiT collected $0.10 from pot
*** SUMMARY ***
Total pot $0.10 | Rake $0 
Seat 1: Lucky HoBBiT (big blind) collected ($0.10)
Seat 2: Feverhead folded before Flop (didn't bet)
Seat 3: Smitty03300 folded before Flop (didn't bet)
Seat 4: CHRO8 folded before Flop (didn't bet)
Seat 5: Dimka4 (button) folded before Flop (didn't bet)
Seat 6: townerz1991 (small blind) folded before Flop



PokerStars Hand #166667978227:  Hold'em No Limit ($0.05/$0.10 USD) - 2017/02/23 16:11:01 ET
Table 'Virginia II' 6-max Seat #4 is the button
Seat 2: Yspenyanin ($10 in chips) 
Seat 3: garigura ($16.13 in chips) 
Seat 4: onkelottoHH ($10.58 in chips) 
Seat 6: NvR.m1nD ($10.20 in chips) 
yodzik will be allowed to play after the button
NvR.m1nD: posts small blind $0.05
Iarlei: is sitting out 
Yspenyanin: posts big blind $0.10
*** HOLE CARDS ***
garigura: folds 
onkelottoHH: folds 
NvR.m1nD: raises $0.15 to $0.25
Yspenyanin: folds 
Uncalled bet ($0.15) returned to NvR.m1nD
NvR.m1nD collected $0.20 from pot
*** SUMMARY ***
Total pot $0.20 | Rake $0 
Seat 2: Yspenyanin (big blind) folded before Flop
Seat 3: garigura folded before Flop (didn't bet)
Seat 4: onkelottoHH (button) folded before Flop (didn't bet)
Seat 6: NvR.m1nD (small blind) collected ($0.20)



PokerStars Hand #166667978341:  Hold'em No Limit ($0.05/$0.10 USD) - 2017/02/23 16:11:01 ET
Table 'Seinajoki' 6-max Seat #2 is the button
Seat 2: niukak ($10.15 in chips) 
Seat 3: Therodorus ($10.05 in chips) 
Seat 4: rusu_rapid ($10 in chips) 
Therodorus: posts small blind $0.05
rusu_rapid: posts big blind $0.10
*** HOLE CARDS ***
niukak: folds 
Therodorus: folds 
Uncalled bet ($0.05) returned to rusu_rapid
rusu_rapid collected $0.10 from pot
*** SUMMARY ***
Total pot $0.10 | Rake $0 
Seat 2: niukak (button) folded before Flop (didn't bet)
Seat 3: Therodorus (small blind) folded before Flop
Seat 4: rusu_rapid (big blind) collected ($0.10)



PokerStars Hand #166667978486:  Hold'em No Limit ($0.05/$0.10 USD) - 2017/02/23 16:11:01 ET
Table 'Veniakaverin' 6-max Seat #5 is the button
Seat 1: pivanki11 ($13.76 in chips) 
Seat 3: Hyd SK ($28.23 in chips) 
Seat 5: Tox1cel ($7.23 in chips) 
Seat 6: bdixon_5 ($9.20 in chips) 
bdixon_5: posts small blind $0.05
pivanki11: posts big blind $0.10
RoJ1: sits out 
FRAID358: sits out 
*** HOLE CARDS ***
Hyd SK: folds 
Tox1cel: raises $0.10 to $0.20
bdixon_5: folds 
pivanki11: folds 
Uncalled bet ($0.10) returned to Tox1cel
Tox1cel collected $0.25 from pot
*** SUMMARY ***
Total pot $0.25 | Rake $0 
Seat 1: pivanki11 (big blind) folded before Flop
Seat 3: Hyd SK folded before Flop (didn't bet)
Seat 5: Tox1cel (button) collected ($0.25)
Seat 6: bdixon_5 (small blind) folded before Flop



PokerStars Hand #166667978559:  Hold'em No Limit ($0.05/$0.10 USD) - 2017/02/23 16:11:02 ET
Table 'Fechtig III' 6-max Seat #3 is the button
Seat 1: Scanner17 ($12.04 in chips) 
Seat 2: GV82 ($19.24 in chips) 
Seat 3: eniksenik ($10 in chips) 
Seat 4: Kow6oy ($19.15 in chips) 
Seat 5: ksandr_hom ($10.10 in chips) 
Seat 6: Glatzemandse ($5.87 in chips) 
Kow6oy: posts small blind $0.05
ksandr_hom: posts big blind $0.10
*** HOLE CARDS ***
Glatzemandse: calls $0.10
Scanner17: raises $0.20 to $0.30
GV82: folds 
eniksenik: folds 
Kow6oy: folds 
ksandr_hom: folds 
Glatzemandse: raises $0.20 to $0.50
Scanner17: calls $0.20
*** FLOP *** [Tc Jc 9h]
Glatzemandse: bets $0.10
Scanner17: calls $0.10
*** TURN *** [Tc Jc 9h] [Ks]
Glatzemandse: bets $0.10
Scanner17: raises $1.10 to $1.20
Glatzemandse: raises $1.10 to $2.30
Scanner17: calls $1.10
*** RIVER *** [Tc Jc 9h Ks] [2c]
Glatzemandse: bets $2.97 and is all-in
Scanner17: folds 
Uncalled bet ($2.97) returned to Glatzemandse
Glatzemandse collected $5.68 from pot
*** SUMMARY ***
Total pot $5.95 | Rake $0.27 
Board [Tc Jc 9h Ks 2c]
Seat 1: Scanner17 folded on the River
Seat 2: GV82 folded before Flop (didn't bet)
Seat 3: eniksenik (button) folded before Flop (didn't bet)
Seat 4: Kow6oy (small blind) folded before Flop
Seat 5: ksandr_hom (big blind) folded before Flop
Seat 6: Glatzemandse collected ($5.68)



PokerStars Hand #166667979334:  Hold'em No Limit ($0.05/$0.10 USD) - 2017/02/23 16:11:02 ET
Table 'Tyndareus II' 6-max Seat #6 is the button
Seat 1: Makc1705 ($4.29 in chips) 
Seat 2: fishhook5 ($12.23 in chips) 
Seat 4: gaHy_HaXeP ($10.36 in chips) 
Seat 5: vtalian ($7.78 in chips) 
Seat 6: sexy_seagull ($10.15 in chips) 
Makc1705: posts small blind $0.05
fishhook5: posts big blind $0.10
Chodemuncher: sits out 
*** HOLE CARDS ***
gaHy_HaXeP: folds 
vtalian: folds 
sexy_seagull: raises $0.15 to $0.25
Makc1705: calls $0.20
fishhook5: folds 
*** FLOP *** [2h 5c Qs]
Makc1705: checks 
sexy_seagull: checks 
*** TURN *** [2h 5c Qs] [9h]
Makc1705: bets $0.10
sexy_seagull: calls $0.10
*** RIVER *** [2h 5c Qs 9h] [Tc]
Makc1705: bets $0.30
sexy_seagull: folds 
Uncalled bet ($0.30) returned to Makc1705
Makc1705 collected $0.76 from pot
*** SUMMARY ***
Total pot $0.80 | Rake $0.04 
Board [2h 5c Qs 9h Tc]
Seat 1: Makc1705 (small blind) collected ($0.76)
Seat 2: fishhook5 (big blind) folded before Flop
Seat 4: gaHy_HaXeP folded before Flop (didn't bet)
Seat 5: vtalian folded before Flop (didn't bet)
Seat 6: sexy_seagull (button) folded on the River



PokerStars Hand #166667979457:  Hold'em No Limit ($0.05/$0.10 USD) - 2017/02/23 16:11:03 ET
Table 'Garlena III' 6-max Seat #1 is the button
Seat 1: dittoro ($11.39 in chips) 
Seat 2: YY778 ($10.52 in chips) 
Seat 3: IAntikI ($10 in chips) 
Seat 4: mbkongstad ($9.70 in chips) 
Seat 5: steepfell ($10 in chips) 
Seat 6: iluzja12 ($9.50 in chips) 
YY778: posts small blind $0.05
IAntikI: posts big blind $0.10
*** HOLE CARDS ***
mbkongstad: folds 
steepfell: folds 
iluzja12: folds 
dittoro: folds 
YY778: raises $0.10 to $0.20
IAntikI: folds 
Uncalled bet ($0.10) returned to YY778
YY778 collected $0.20 from pot
*** SUMMARY ***
Total pot $0.20 | Rake $0 
Seat 1: dittoro (button) folded before Flop (didn't bet)
Seat 2: YY778 (small blind) collected ($0.20)
Seat 3: IAntikI (big blind) folded before Flop
Seat 4: mbkongstad folded before Flop (didn't bet)
Seat 5: steepfell folded before Flop (didn't bet)
Seat 6: iluzja12 folded before Flop (didn't bet)



PokerStars Hand #166667979684:  Hold'em No Limit ($0.05/$0.10 USD) - 2017/02/23 16:11:03 ET
Table 'Cuyo' 6-max Seat #5 is the button
Seat 1: Bandyaev ($11.54 in chips) 
Seat 2: Therodorus ($10.47 in chips) 
Seat 3: Hergie88 ($9.32 in chips) 
Seat 4: bambolejro ($10 in chips) 
Seat 5: DrVzad ($9.85 in chips) 
Seat 6: iluzja12 ($9.70 in chips) 
iluzja12: posts small blind $0.05
Bandyaev: posts big blind $0.10
*** HOLE CARDS ***
Therodorus: folds 
Hergie88: folds 
bambolejro: folds 
DrVzad: folds 
iluzja12: folds 
Uncalled bet ($0.05) returned to Bandyaev
Bandyaev collected $0.10 from pot
*** SUMMARY ***
Total pot $0.10 | Rake $0 
Seat 1: Bandyaev (big blind) collected ($0.10)
Seat 2: Therodorus folded before Flop (didn't bet)
Seat 3: Hergie88 folded before Flop (didn't bet)
Seat 4: bambolejro folded before Flop (didn't bet)
Seat 5: DrVzad (button) folded before Flop (didn't bet)
Seat 6: iluzja12 (small blind) folded before Flop



PokerStars Hand #166667980166:  Hold'em No Limit ($0.05/$0.10 USD) - 2017/02/23 16:11:03 ET
Table 'Aisakos II' 6-max Seat #5 is the button
Seat 1: Crafty23@PS ($10.50 in chips) 
Seat 2: svaika24 ($17.02 in chips) 
Seat 3: iamkakaroto ($10.82 in chips) 
Seat 4: T9MS ($10.30 in chips) 
Seat 5: KokoulinV ($11.60 in chips) 
Seat 6: LarryTheStar ($10 in chips) 
LarryTheStar: posts small blind $0.05
Crafty23@PS: posts big blind $0.10
*** HOLE CARDS ***
svaika24: folds 
iamkakaroto: folds 
T9MS: raises $0.20 to $0.30
KokoulinV: folds 
LarryTheStar: calls $0.25
Crafty23@PS: folds 
*** FLOP *** [9h 2d 3d]
LarryTheStar: checks 
T9MS: checks 
*** TURN *** [9h 2d 3d] [Ad]
LarryTheStar: bets $0.50
T9MS: calls $0.50
*** RIVER *** [9h 2d 3d Ad] [Kc]
LarryTheStar: bets $1.30
T9MS: calls $1.30
*** SHOW DOWN ***
LarryTheStar: shows [Jd Qd] (a flush, Ace high)
T9MS: mucks hand 
LarryTheStar collected $4.11 from pot
*** SUMMARY ***
Total pot $4.30 | Rake $0.19 
Board [9h 2d 3d Ad Kc]
Seat 1: Crafty23@PS (big blind) folded before Flop
Seat 2: svaika24 folded before Flop (didn't bet)
Seat 3: iamkakaroto folded before Flop (didn't bet)
Seat 4: T9MS mucked
Seat 5: KokoulinV (button) folded before Flop (didn't bet)
Seat 6: LarryTheStar (small blind) showed [Jd Qd] and won ($4.11) with a flush, Ace high



PokerStars Hand #166667980675:  Hold'em No Limit ($0.05/$0.10 USD) - 2017/02/23 16:11:04 ET
Table 'Nikko II' 6-max Seat #4 is the button
Seat 1: bdixon_5 ($9.62 in chips) 
Seat 2: popypaleta ($10.15 in chips) 
Seat 3: Hyd SK ($10.78 in chips) 
Seat 4: Peter0087 ($9.61 in chips) 
Seat 5: Aescul@pius ($13.19 in chips) 
Aescul@pius: posts small blind $0.05
JahSoldier69: is sitting out 
bdixon_5: posts big blind $0.10
*** HOLE CARDS ***
JahSoldier69 leaves the table
popypaleta: raises $0.20 to $0.30
MihaGr joins the table at seat #6 
Hyd SK: folds 
Peter0087: folds 
Aescul@pius: folds 
bdixon_5: folds 
Uncalled bet ($0.20) returned to popypaleta
popypaleta collected $0.25 from pot
*** SUMMARY ***
Total pot $0.25 | Rake $0 
Seat 1: bdixon_5 (big blind) folded before Flop
Seat 2: popypaleta collected ($0.25)
Seat 3: Hyd SK folded before Flop (didn't bet)
Seat 4: Peter0087 (button) folded before Flop (didn't bet)
Seat 5: Aescul@pius (small blind) folded before Flop



PokerStars Hand #166667980837:  Hold'em No Limit ($0.05/$0.10 USD) - 2017/02/23 16:11:04 ET
Table 'Syringa' 6-max Seat #6 is the button
Seat 1: bdixon_5 ($9.48 in chips) 
Seat 2: Goroshkos88 ($11.08 in chips) 
Seat 3: Yspenyanin ($13.37 in chips) 
Seat 5: Andrei ProFF ($15.06 in chips) 
Seat 6: ibara000 ($14.05 in chips) 
bdixon_5: posts small blind $0.05
Goroshkos88: posts big blind $0.10
voledy: sits out 
*** HOLE CARDS ***
Yspenyanin: folds 
Andrei ProFF: folds 
ibara000: raises $0.16 to $0.26
bdixon_5: folds 
Goroshkos88: raises $0.74 to $1
ibara000: folds 
Uncalled bet ($0.74) returned to Goroshkos88
Goroshkos88 collected $0.57 from pot
*** SUMMARY ***
Total pot $0.57 | Rake $0 
Seat 1: bdixon_5 (small blind) folded before Flop
Seat 2: Goroshkos88 (big blind) collected ($0.57)
Seat 3: Yspenyanin folded before Flop (didn't bet)
Seat 5: Andrei ProFF folded before Flop (didn't bet)
Seat 6: ibara000 (button) folded before Flop



PokerStars Hand #166667981044:  Hold'em No Limit ($0.05/$0.10 USD) - 2017/02/23 16:11:04 ET
Table 'Ushakaron II' 6-max Seat #5 is the button
Seat 1: Kow6oy ($10 in chips) 
Seat 2: Iarlei ($12.44 in chips) 
Seat 3: Rodik002 ($11.22 in chips) 
Seat 4: avintage176 ($30.43 in chips) 
Seat 5: 1limewax1 ($15.28 in chips) 
Seat 6: eniksenik ($10.55 in chips) 
eniksenik: posts small blind $0.05
Kow6oy: posts big blind $0.10
*** HOLE CARDS ***
Iarlei: folds 
Rodik002: folds 
avintage176: folds 
1limewax1: folds 
eniksenik: raises $0.20 to $0.30
Kow6oy: folds 
Uncalled bet ($0.20) returned to eniksenik
eniksenik collected $0.20 from pot
*** SUMMARY ***
Total pot $0.20 | Rake $0 
Seat 1: Kow6oy (big blind) folded before Flop
Seat 2: Iarlei folded before Flop (didn't bet)
Seat 3: Rodik002 folded before Flop (didn't bet)
Seat 4: avintage176 folded before Flop (didn't bet)
Seat 5: 1limewax1 (button) folded before Flop (didn't bet)
Seat 6: eniksenik (small blind) collected ($0.20)



PokerStars Hand #166667981280:  Hold'em No Limit ($0.05/$0.10 USD) - 2017/02/23 16:11:05 ET
Table 'Orthos III' 6-max Seat #5 is the button
Seat 1: sexy_seagull ($11.12 in chips) 
Seat 2: Xander188 ($19.31 in chips) 
Seat 3: koka4cs ($4.90 in chips) 
Seat 4: FlopsterGB ($17.85 in chips) 
Seat 5: Bird et al ($18.16 in chips) 
Seat 6: RoJ1 ($10.24 in chips) 
RoJ1: posts small blind $0.05
sexy_seagull: posts big blind $0.10
*** HOLE CARDS ***
Xander188: folds 
koka4cs: folds 
FlopsterGB: folds 
Bird et al: folds 
RoJ1: folds 
Uncalled bet ($0.05) returned to sexy_seagull
sexy_seagull collected $0.10 from pot
*** SUMMARY ***
Total pot $0.10 | Rake $0 
Seat 1: sexy_seagull (big blind) collected ($0.10)
Seat 2: Xander188 folded before Flop (didn't bet)
Seat 3: koka4cs folded before Flop (didn't bet)
Seat 4: FlopsterGB folded before Flop (didn't bet)
Seat 5: Bird et al (button) folded before Flop (didn't bet)
Seat 6: RoJ1 (small blind) folded before Flop



PokerStars Hand #166667981466:  Hold'em No Limit ($0.05/$0.10 USD) - 2017/02/23 16:11:05 ET
Table 'Jacchia' 6-max Seat #1 is the button
Seat 1: viklundm ($32.23 in chips) 
Seat 3: maxiv608 ($10 in chips) 
Seat 4: paterthomas ($9.51 in chips) 
Seat 5: arti192837 ($11.24 in chips) 
Seat 6: RoJ1 ($12.99 in chips) 
maxiv608: posts small blind $0.05
VAD21 leaves the table
paterthomas: posts big blind $0.10
*** HOLE CARDS ***
arti192837: folds 
RoJ1: folds 
eniksenik joins the table at seat #2 
viklundm: calls $0.10
maxiv608: folds 
paterthomas: checks 
*** FLOP *** [6c 6s 9s]
paterthomas: checks 
viklundm: bets $0.20
paterthomas: folds 
Uncalled bet ($0.20) returned to viklundm
eniksenik leaves the table
viklundm collected $0.24 from pot
*** SUMMARY ***
Total pot $0.25 | Rake $0.01 
Board [6c 6s 9s]
Seat 1: viklundm (button) collected ($0.24)
Seat 3: maxiv608 (small blind) folded before Flop
Seat 4: paterthomas (big blind) folded on the Flop
Seat 5: arti192837 folded before Flop (didn't bet)
Seat 6: RoJ1 folded before Flop (didn't bet)



PokerStars Hand #166667981496:  Hold'em No Limit ($0.05/$0.10 USD) - 2017/02/23 16:11:05 ET
Table 'Lagrula' 6-max Seat #6 is the button
Seat 1: Ice_Isayev ($10 in chips) 
Seat 2: KRZuff ($10.15 in chips) 
Seat 3: micke667 ($14.25 in chips) 
Seat 4: Calimero2408 ($12.38 in chips) 
Seat 5: Iarlei ($12.07 in chips) 
Seat 6: Spud014 ($10 in chips) 
Ice_Isayev: posts small blind $0.05
KRZuff: posts big blind $0.10
*** HOLE CARDS ***
micke667: calls $0.10
Calimero2408: calls $0.10
Iarlei: calls $0.10
Spud014: calls $0.10
Ice_Isayev: folds 
KRZuff: checks 
*** FLOP *** [Qs 5s Jh]
KRZuff: checks 
micke667: bets $0.10
Calimero2408: calls $0.10
Iarlei: folds 
Spud014: raises $0.41 to $0.51
KRZuff: folds 
micke667: calls $0.41
Calimero2408: calls $0.41
*** TURN *** [Qs 5s Jh] [2s]
micke667: bets $1
Calimero2408: folds 
Spud014: folds 
Uncalled bet ($1) returned to micke667
micke667 collected $1.99 from pot
*** SUMMARY ***
Total pot $2.08 | Rake $0.09 
Board [Qs 5s Jh 2s]
Seat 1: Ice_Isayev (small blind) folded before Flop
Seat 2: KRZuff (big blind) folded on the Flop
Seat 3: micke667 collected ($1.99)
Seat 4: Calimero2408 folded on the Turn
Seat 5: Iarlei folded on the Flop
Seat 6: Spud014 (button) folded on the Turn



PokerStars Hand #166667981583:  Hold'em No Limit ($0.05/$0.10 USD) - 2017/02/23 16:11:05 ET
Table 'Alnasl' 6-max Seat #6 is the button
Seat 2: saddur ($8.99 in chips) 
Seat 3: KRZuff ($10 in chips) 
Seat 4: oddshoff ($10.50 in chips) 
Seat 5: 6ePeMeHHa9 ($10 in chips) 
Seat 6: Zooplack ($13.58 in chips) 
RoJ1 will be allowed to play after the button
saddur: posts small blind $0.05
KRZuff: posts big blind $0.10
*** HOLE CARDS ***
oddshoff: folds 
6ePeMeHHa9: folds 
Zooplack: folds 
saddur: folds 
Uncalled bet ($0.05) returned to KRZuff
KRZuff collected $0.10 from pot
*** SUMMARY ***
Total pot $0.10 | Rake $0 
Seat 2: saddur (small blind) folded before Flop
Seat 3: KRZuff (big blind) collected ($0.10)
Seat 4: oddshoff folded before Flop (didn't bet)
Seat 5: 6ePeMeHHa9 folded before Flop (didn't bet)
Seat 6: Zooplack (button) folded before Flop (didn't bet)



PokerStars Hand #166667981759:  Hold'em No Limit ($0.05/$0.10 USD) - 2017/02/23 16:11:05 ET
Table 'Kunigunde II' 6-max Seat #5 is the button
Seat 1: facewald ($9.88 in chips) 
Seat 2: DrVzad ($10.57 in chips) 
Seat 3: pancernik21 ($16.69 in chips) 
Seat 5: mdelfin0 ($12.58 in chips) 
Seat 6: Zooplack ($10.05 in chips) 
Zooplack: posts small blind $0.05
facewald: posts big blind $0.10
*** HOLE CARDS ***
DrVzad: folds 
pancernik21: raises $0.20 to $0.30
mdelfin0: calls $0.30
Zooplack: folds 
facewald: calls $0.20
*** FLOP *** [Jd 2h 2c]
facewald: checks 
pancernik21: bets $0.31
JahSoldier69 joins the table at seat #4 
mdelfin0: calls $0.31
JahSoldier69 leaves the table
facewald: calls $0.31
*** TURN *** [Jd 2h 2c] [Qd]
facewald: checks 
pancernik21: bets $1.35
mdelfin0: folds 
facewald: folds 
Uncalled bet ($1.35) returned to pancernik21
pancernik21 collected $1.80 from pot
*** SUMMARY ***
Total pot $1.88 | Rake $0.08 
Board [Jd 2h 2c Qd]
Seat 1: facewald (big blind) folded on the Turn
Seat 2: DrVzad folded before Flop (didn't bet)
Seat 3: pancernik21 collected ($1.80)
Seat 5: mdelfin0 (button) folded on the Turn
Seat 6: Zooplack (small blind) folded before Flop



PokerStars Hand #166667982090:  Hold'em No Limit ($0.05/$0.10 USD) - 2017/02/23 16:11:05 ET
Table 'Luanda' 6-max Seat #1 is the button
Seat 1: AM-L-SL ($2.81 in chips) 
Seat 2: Xander188 ($10.20 in chips) 
Seat 3: pokekrk ($10 in chips) 
Seat 4: aapokerkot ($10.08 in chips) 
Seat 5: st4tion ($12.35 in chips) 
Xander188: posts small blind $0.05
pokekrk: posts big blind $0.10
*** HOLE CARDS ***
aapokerkot: folds 
st4tion: folds 
AM-L-SL: folds 
Xander188: folds 
Uncalled bet ($0.05) returned to pokekrk
pokekrk collected $0.10 from pot
*** SUMMARY ***
Total pot $0.10 | Rake $0 
Seat 1: AM-L-SL (button) folded before Flop (didn't bet)
Seat 2: Xander188 (small blind) folded before Flop
Seat 3: pokekrk (big blind) collected ($0.10)
Seat 4: aapokerkot folded before Flop (didn't bet)
Seat 5: st4tion folded before Flop (didn't bet)



PokerStars Hand #166667982191:  Hold'em No Limit ($0.05/$0.10 USD) - 2017/02/23 16:11:06 ET
Table 'Cassini' 6-max Seat #4 is the button
Seat 1: Pokeaster ($10.53 in chips) 
Seat 2: mhonielsen ($12.26 in chips) 
Seat 3: J1234T ($10.91 in chips) 
Seat 4: fortieth ($13.77 in chips) 
Seat 5: DrVzad ($9.90 in chips) 
Seat 6: MihaGr ($10 in chips) 
DrVzad: posts small blind $0.05
MihaGr: posts big blind $0.10
*** HOLE CARDS ***
Pokeaster: folds 
mhonielsen: folds 
J1234T: raises $0.20 to $0.30
fortieth: folds 
DrVzad: folds 
MihaGr: calls $0.20
*** FLOP *** [Qh 5c 8h]
MihaGr: checks 
J1234T: bets $0.38
MihaGr: folds 
Uncalled bet ($0.38) returned to J1234T
J1234T collected $0.62 from pot
*** SUMMARY ***
Total pot $0.65 | Rake $0.03 
Board [Qh 5c 8h]
Seat 1: Pokeaster folded before Flop (didn't bet)
Seat 2: mhonielsen folded before Flop (didn't bet)
Seat 3: J1234T collected ($0.62)
Seat 4: fortieth (button) folded before Flop (didn't bet)
Seat 5: DrVzad (small blind) folded before Flop
Seat 6: MihaGr (big blind) folded on the Flop



PokerStars Hand #166667982193:  Hold'em No Limit ($0.05/$0.10 USD) - 2017/02/23 16:11:06 ET
Table 'Heka II' 6-max Seat #6 is the button
Seat 1: Mamm0nism ($15.26 in chips) 
Seat 2: oddshoff ($10.92 in chips) 
Seat 4: theNot0r1ous ($10.28 in chips) 
Seat 5: ArcticBearDK ($12.63 in chips) 
Seat 6: MonteCris92 ($11.27 in chips) 
Mamm0nism: posts small blind $0.05
oddshoff: posts big blind $0.10
voledy: sits out 
*** HOLE CARDS ***
theNot0r1ous: folds 
ArcticBearDK: folds 
MonteCris92: folds 
Mamm0nism: raises $0.20 to $0.30
oddshoff: folds 
Uncalled bet ($0.20) returned to Mamm0nism
Mamm0nism collected $0.20 from pot
*** SUMMARY ***
Total pot $0.20 | Rake $0 
Seat 1: Mamm0nism (small blind) collected ($0.20)
Seat 2: oddshoff (big blind) folded before Flop
Seat 4: theNot0r1ous folded before Flop (didn't bet)
Seat 5: ArcticBearDK folded before Flop (didn't bet)
Seat 6: MonteCris92 (button) folded before Flop (didn't bet)



PokerStars Hand #166667983038:  Hold'em No Limit ($0.05/$0.10 USD) - 2017/02/23 16:11:07 ET
Table 'Siebohme II' 6-max Seat #4 is the button
Seat 1: homelessdan ($17.67 in chips) 
Seat 2: townerz1991 ($12.97 in chips) 
Seat 3: D3NyA ($10.04 in chips) 
Seat 4: POT_TRADER ($11.99 in chips) 
Seat 5: NvR.m1nD ($11.24 in chips) 
Seat 6: Fozzy690 ($10.83 in chips) 
NvR.m1nD: posts small blind $0.05
Fozzy690: posts big blind $0.10
*** HOLE CARDS ***
homelessdan: folds 
townerz1991: folds 
D3NyA: raises $0.15 to $0.25
POT_TRADER: folds 
NvR.m1nD: folds 
Fozzy690: folds 
Uncalled bet ($0.15) returned to D3NyA
D3NyA collected $0.25 from pot
*** SUMMARY ***
Total pot $0.25 | Rake $0 
Seat 1: homelessdan folded before Flop (didn't bet)
Seat 2: townerz1991 folded before Flop (didn't bet)
Seat 3: D3NyA collected ($0.25)
Seat 4: POT_TRADER (button) folded before Flop (didn't bet)
Seat 5: NvR.m1nD (small blind) folded before Flop
Seat 6: Fozzy690 (big blind) folded before Flop



PokerStars Hand #166667983138:  Hold'em No Limit ($0.05/$0.10 USD) - 2017/02/23 16:11:07 ET
Table 'Ruvuma' 6-max Seat #5 is the button
Seat 2: Yspenyanin ($10 in chips) 
Seat 3: Spud014 ($10.03 in chips) 
Seat 5: sexy_seagull ($10.35 in chips) 
Seat 6: osmea ($9.90 in chips) 
osmea: posts small blind $0.05
FRAID358: is sitting out 
Yspenyanin: posts big blind $0.10
*** HOLE CARDS ***
FRAID358 leaves the table
Spud014: raises $0.15 to $0.25
thegunman88 joins the table at seat #4 
sexy_seagull: folds 
osmea: raises $0.85 to $1.10
Yspenyanin: folds 
Spud014: folds 
Uncalled bet ($0.85) returned to osmea
osmea collected $0.60 from pot
*** SUMMARY ***
Total pot $0.60 | Rake $0 
Seat 2: Yspenyanin (big blind) folded before Flop
Seat 3: Spud014 folded before Flop
Seat 5: sexy_seagull (button) folded before Flop (didn't bet)
Seat 6: osmea (small blind) collected ($0.60)



PokerStars Hand #166667983382:  Hold'em No Limit ($0.05/$0.10 USD) - 2017/02/23 16:11:07 ET
Table 'Kobresia II' 6-max Seat #3 is the button
Seat 1: RoJ1 ($15.34 in chips) 
Seat 2: Dcaro31 ($13.52 in chips) 
Seat 3: ocmarigo81 ($3.75 in chips) 
Seat 4: Vanne11 ($10.27 in chips) 
Seat 5: XaXaTyH4uK ($10 in chips) 
Vanne11: posts small blind $0.05
XaXaTyH4uK: posts big blind $0.10
*** HOLE CARDS ***
RoJ1: folds 
Dcaro31: folds 
ocmarigo81: folds 
Vanne11: calls $0.05
XaXaTyH4uK: raises $0.30 to $0.40
Vanne11: folds 
Uncalled bet ($0.30) returned to XaXaTyH4uK
XaXaTyH4uK collected $0.20 from pot
*** SUMMARY ***
Total pot $0.20 | Rake $0 
Seat 1: RoJ1 folded before Flop (didn't bet)
Seat 2: Dcaro31 folded before Flop (didn't bet)
Seat 3: ocmarigo81 (button) folded before Flop (didn't bet)
Seat 4: Vanne11 (small blind) folded before Flop
Seat 5: XaXaTyH4uK (big blind) collected ($0.20)



PokerStars Hand #166667983505:  Hold'em No Limit ($0.05/$0.10 USD) - 2017/02/23 16:11:07 ET
Table 'Lehigh' 6-max Seat #3 is the button
Seat 1: pokekrk ($10 in chips) 
Seat 3: Cluckh ($10.20 in chips) 
Seat 4: manashov ($10.05 in chips) 
Seat 5: Slavoaca693 ($7.85 in chips) 
manashov: posts small blind $0.05
Slavoaca693: posts big blind $0.10
RoJ1: sits out 
*** HOLE CARDS ***
pokekrk: raises $0.15 to $0.25
Cluckh: folds 
manashov: folds 
Slavoaca693: calls $0.15
*** FLOP *** [6s 6h 2s]
Slavoaca693: checks 
pokekrk: bets $0.29
Slavoaca693: folds 
Uncalled bet ($0.29) returned to pokekrk
pokekrk collected $0.53 from pot
*** SUMMARY ***
Total pot $0.55 | Rake $0.02 
Board [6s 6h 2s]
Seat 1: pokekrk collected ($0.53)
Seat 3: Cluckh (button) folded before Flop (didn't bet)
Seat 4: manashov (small blind) folded before Flop
Seat 5: Slavoaca693 (big blind) folded on the Flop



PokerStars Hand #166667983581:  Hold'em No Limit ($0.05/$0.10 USD) - 2017/02/23 16:11:07 ET
Table 'Tyndareus III' 6-max Seat #1 is the button
Seat 1: MBen10 ($18.81 in chips) 
Seat 2: MihaGr ($10 in chips) 
Seat 3: XaXaTyH4uK ($10 in chips) 
Seat 4: tequila_joop ($11.82 in chips) 
Seat 5: yodzik ($5 in chips) 
Seat 6: Hb-309 ($9.41 in chips) 
MihaGr: posts small blind $0.05
XaXaTyH4uK: posts big blind $0.10
*** HOLE CARDS ***
tequila_joop: folds 
yodzik: folds 
Hb-309: folds 
MBen10: folds 
MihaGr: folds 
Uncalled bet ($0.05) returned to XaXaTyH4uK
XaXaTyH4uK collected $0.10 from pot
*** SUMMARY ***
Total pot $0.10 | Rake $0 
Seat 1: MBen10 (button) folded before Flop (didn't bet)
Seat 2: MihaGr (small blind) folded before Flop
Seat 3: XaXaTyH4uK (big blind) collected ($0.10)
Seat 4: tequila_joop folded before Flop (didn't bet)
Seat 5: yodzik folded before Flop (didn't bet)
Seat 6: Hb-309 folded before Flop (didn't bet)



PokerStars Hand #166667983681:  Hold'em No Limit ($0.05/$0.10 USD) - 2017/02/23 16:11:07 ET
Table 'Cyane' 6-max Seat #1 is the button
Seat 1: KA3AXCTAHEU, ($11.08 in chips) 
Seat 2: sashi18 ($7.46 in chips) 
Seat 3: Mamm0nism ($10 in chips) 
Seat 4: truck1234 ($32.53 in chips) 
Seat 5: RoJ1 ($10.22 in chips) 
Seat 6: 8th wonders ($10.91 in chips) 
sashi18: posts small blind $0.05
Mamm0nism: posts big blind $0.10
*** HOLE CARDS ***
truck1234: folds 
RoJ1: raises $0.12 to $0.22
8th wonders: raises $0.68 to $0.90
KA3AXCTAHEU,: folds 
sashi18: calls $0.85
Mamm0nism: folds 
RoJ1: calls $0.68
*** FLOP *** [Js 8s 8c]
sashi18: checks 
RoJ1: checks 
8th wonders: bets $2
sashi18: raises $2 to $4
RoJ1: folds 
8th wonders: raises $3 to $7
sashi18: calls $2.56 and is all-in
Uncalled bet ($0.44) returned to 8th wonders
*** TURN *** [Js 8s 8c] [3h]
*** RIVER *** [Js 8s 8c 3h] [8d]
*** SHOW DOWN ***
sashi18: shows [9c Ah] (three of a kind, Eights)
8th wonders: shows [Ac As] (a full house, Eights full of Aces)
8th wonders collected $15.20 from pot
*** SUMMARY ***
Total pot $15.92 | Rake $0.72 
Board [Js 8s 8c 3h 8d]
Seat 1: KA3AXCTAHEU, (button) folded before Flop (didn't bet)
Seat 2: sashi18 (small blind) showed [9c Ah] and lost with three of a kind, Eights
Seat 3: Mamm0nism (big blind) folded before Flop
Seat 4: truck1234 folded before Flop (didn't bet)
Seat 5: RoJ1 folded on the Flop
Seat 6: 8th wonders showed [Ac As] and won ($15.20) with a full house, Eights full of Aces



PokerStars Hand #166667983800:  Hold'em No Limit ($0.05/$0.10 USD) - 2017/02/23 16:11:07 ET
Table 'Lederle' 6-max Seat #6 is the button
Seat 1: Sterjek ($9.90 in chips) 
Seat 2: truck1234 ($15.54 in chips) 
Seat 3: Kazacha ($11.11 in chips) 
Seat 4: Pokeaster ($13.66 in chips) 
Seat 5: 8th wonders ($13.53 in chips) 
Seat 6: pokekrk ($10.37 in chips) 
Sterjek: posts small blind $0.05
truck1234: posts big blind $0.10
*** HOLE CARDS ***
Kazacha: folds 
Pokeaster: folds 
8th wonders: raises $0.20 to $0.30
pokekrk: folds 
Sterjek: calls $0.25
truck1234: folds 
*** FLOP *** [Ad Qs Td]
Sterjek: checks 
8th wonders: bets $0.50
Sterjek: calls $0.50
*** TURN *** [Ad Qs Td] [Qh]
Sterjek: checks 
8th wonders: bets $1.22
Sterjek: folds 
Uncalled bet ($1.22) returned to 8th wonders
8th wonders collected $1.62 from pot
*** SUMMARY ***
Total pot $1.70 | Rake $0.08 
Board [Ad Qs Td Qh]
Seat 1: Sterjek (small blind) folded on the Turn
Seat 2: truck1234 (big blind) folded before Flop
Seat 3: Kazacha folded before Flop (didn't bet)
Seat 4: Pokeaster folded before Flop (didn't bet)
Seat 5: 8th wonders collected ($1.62)
Seat 6: pokekrk (button) folded before Flop (didn't bet)



PokerStars Hand #166667984225:  Hold'em No Limit ($0.05/$0.10 USD) - 2017/02/23 16:11:08 ET
Table 'Tyche III' 6-max Seat #2 is the button
Seat 1: milt65 ($10.05 in chips) 
Seat 2: arti192837 ($12.13 in chips) 
Seat 3: FRAID358 ($9.90 in chips) 
Seat 4: Kazacha ($10.63 in chips) 
Seat 5: chimera252 ($14.73 in chips) 
Seat 6: Ice_Isayev ($10 in chips) 
FRAID358: posts small blind $0.05
Kazacha: posts big blind $0.10
*** HOLE CARDS ***
chimera252: folds 
Ice_Isayev: folds 
milt65: folds 
arti192837: folds 
FRAID358: raises $0.15 to $0.25
Kazacha: folds 
Uncalled bet ($0.15) returned to FRAID358
FRAID358 collected $0.20 from pot
*** SUMMARY ***
Total pot $0.20 | Rake $0 
Seat 1: milt65 folded before Flop (didn't bet)
Seat 2: arti192837 (button) folded before Flop (didn't bet)
Seat 3: FRAID358 (small blind) collected ($0.20)
Seat 4: Kazacha (big blind) folded before Flop
Seat 5: chimera252 folded before Flop (didn't bet)
Seat 6: Ice_Isayev folded before Flop (didn't bet)



PokerStars Hand #166667984247:  Hold'em No Limit ($0.05/$0.10 USD) - 2017/02/23 16:11:08 ET
Table 'Thia' 6-max Seat #3 is the button
Seat 1: Eddys Edge ($10.15 in chips) 
Seat 2: sugrob86 ($20.22 in chips) 
Seat 3: northug18 ($9.22 in chips) 
Seat 4: Bandyaev ($10 in chips) 
Seat 5: ab260414 ($10 in chips) 
Seat 6: ex3Lero86 ($15.65 in chips) 
Bandyaev: posts small blind $0.05
ab260414: posts big blind $0.10
*** HOLE CARDS ***
ex3Lero86: raises $0.20 to $0.30
Eddys Edge: folds 
sugrob86: calls $0.30
northug18: calls $0.30
Bandyaev: folds 
ab260414: calls $0.20
*** FLOP *** [Js 4d Ah]
ab260414: checks 
ex3Lero86: bets $0.47
sugrob86: calls $0.47
northug18: folds 
ab260414: folds 
*** TURN *** [Js 4d Ah] [Tc]
ex3Lero86: bets $1.30
sugrob86: raises $4 to $5.30
ex3Lero86: folds 
Uncalled bet ($4) returned to sugrob86
sugrob86 collected $4.57 from pot
*** SUMMARY ***
Total pot $4.79 | Rake $0.22 
Board [Js 4d Ah Tc]
Seat 1: Eddys Edge folded before Flop (didn't bet)
Seat 2: sugrob86 collected ($4.57)
Seat 3: northug18 (button) folded on the Flop
Seat 4: Bandyaev (small blind) folded before Flop
Seat 5: ab260414 (big blind) folded on the Flop
Seat 6: ex3Lero86 folded on the Turn



PokerStars Hand #166667984384:  Hold'em No Limit ($0.05/$0.10 USD) - 2017/02/23 16:11:08 ET
Table 'Wingolfia II' 6-max Seat #4 is the button
Seat 1: BahiaMinhaP ($10 in chips) 
Seat 2: NvR.m1nD ($10 in chips) 
Seat 3: truck1234 ($10.57 in chips) 
Seat 4: zlobslob ($17.72 in chips) 
Seat 5: tr41n3r12 ($12.14 in chips) 
Seat 6: Tom Zhangxue ($9.75 in chips) 
tr41n3r12: posts small blind $0.05
Tom Zhangxue: posts big blind $0.10
*** HOLE CARDS ***
BahiaMinhaP: folds 
NvR.m1nD: folds 
truck1234: folds 
zlobslob: raises $0.10 to $0.20
tr41n3r12: raises $0.60 to $0.80
Tom Zhangxue: folds 
zlobslob: folds 
Uncalled bet ($0.60) returned to tr41n3r12
tr41n3r12 collected $0.50 from pot
*** SUMMARY ***
Total pot $0.50 | Rake $0 
Seat 1: BahiaMinhaP folded before Flop (didn't bet)
Seat 2: NvR.m1nD folded before Flop (didn't bet)
Seat 3: truck1234 folded before Flop (didn't bet)
Seat 4: zlobslob (button) folded before Flop
Seat 5: tr41n3r12 (small blind) collected ($0.50)
Seat 6: Tom Zhangxue (big blind) folded before Flop



PokerStars Hand #166667984386:  Hold'em No Limit ($0.05/$0.10 USD) - 2017/02/23 16:11:08 ET
Table 'Geisha' 6-max Seat #6 is the button
Seat 1: facewald ($35.13 in chips) 
Seat 2: MisterX413 ($10 in chips) 
Seat 3: Eddys Edge ($10 in chips) 
Seat 4: marianoboni ($10 in chips) 
Seat 6: Namhkal ($20.68 in chips) 
facewald: posts small blind $0.05
MisterX413: posts big blind $0.10
crooso: sits out 
*** HOLE CARDS ***
Eddys Edge: folds 
marianoboni: raises $0.24 to $0.34
Namhkal: folds 
facewald: folds 
MisterX413: folds 
Uncalled bet ($0.24) returned to marianoboni
marianoboni collected $0.25 from pot
*** SUMMARY ***
Total pot $0.25 | Rake $0 
Seat 1: facewald (small blind) folded before Flop
Seat 2: MisterX413 (big blind) folded before Flop
Seat 3: Eddys Edge folded before Flop (didn't bet)
Seat 4: marianoboni collected ($0.25)
Seat 6: Namhkal (button) folded before Flop (didn't bet)



PokerStars Hand #166667984789:  Hold'em No Limit ($0.05/$0.10 USD) - 2017/02/23 16:11:08 ET
Table 'Joella' 6-max Seat #4 is the button
Seat 1: Dcaro31 ($12.78 in chips) 
Seat 2: Kaelyns_Bark ($9.01 in chips) 
Seat 3: Joker51_wtf! ($12.52 in chips) 
Seat 4: KRZuff ($10 in chips) 
Seat 5: Anestakis777 ($1.14 in chips) 
Anestakis777: posts small blind $0.05
Dcaro31: posts big blind $0.10
*** HOLE CARDS ***
Kaelyns_Bark: folds 
Joker51_wtf!: raises $0.12 to $0.22
KRZuff: folds 
Anestakis777: calls $0.17
Dcaro31: folds 
*** FLOP *** [4c 7d Th]
Anestakis777: checks 
WinninBikini joins the table at seat #6 
Joker51_wtf!: bets $0.30
Anestakis777: folds 
Uncalled bet ($0.30) returned to Joker51_wtf!
Joker51_wtf! collected $0.52 from pot
*** SUMMARY ***
Total pot $0.54 | Rake $0.02 
Board [4c 7d Th]
Seat 1: Dcaro31 (big blind) folded before Flop
Seat 2: Kaelyns_Bark folded before Flop (didn't bet)
Seat 3: Joker51_wtf! collected ($0.52)
Seat 4: KRZuff (button) folded before Flop (didn't bet)
Seat 5: Anestakis777 (small blind) folded on the Flop



PokerStars Hand #166667985071:  Hold'em No Limit ($0.05/$0.10 USD) - 2017/02/23 16:11:09 ET
Table 'Peiroos III' 6-max Seat #6 is the button
Seat 1: tequila_joop ($9.72 in chips) 
Seat 2: Goovr ($17.54 in chips) 
Seat 3: nabatov.m ($4.62 in chips) 
Seat 4: pivanki11 ($12.49 in chips) 
Seat 5: ChuikaPridi ($10.68 in chips) 
Seat 6: CHRO8 ($10.45 in chips) 
tequila_joop: posts small blind $0.05
Goovr: posts big blind $0.10
tequila_joop: posts the ante $0.02
Goovr: posts the ante $0.02
nabatov.m: posts the ante $0.02
pivanki11: posts the ante $0.02
ChuikaPridi: posts the ante $0.02
CHRO8: posts the ante $0.02
*** HOLE CARDS ***
nabatov.m: raises $0.10 to $0.20
pivanki11: folds 
ChuikaPridi: folds 
CHRO8: folds 
tequila_joop: folds 
Goovr: calls $0.10
*** FLOP *** [Kh 3h Ts]
Goovr: checks 
nabatov.m: bets $0.27
Goovr: folds 
Uncalled bet ($0.27) returned to nabatov.m
nabatov.m collected $0.54 from pot
*** SUMMARY ***
Total pot $0.57 | Rake $0.03 
Board [Kh 3h Ts]
Seat 1: tequila_joop (small blind) folded before Flop
Seat 2: Goovr (big blind) folded on the Flop
Seat 3: nabatov.m collected ($0.54)
Seat 4: pivanki11 folded before Flop (didn't bet)
Seat 5: ChuikaPridi folded before Flop (didn't bet)
Seat 6: CHRO8 (button) folded before Flop (didn't bet)



PokerStars Hand #166667985182:  Hold'em No Limit ($0.05/$0.10 USD) - 2017/02/23 16:11:09 ET
Table 'Gyldenia II' 6-max Seat #5 is the button
Seat 1: KokoulinV ($11.44 in chips) 
Seat 2: Kow6oy ($10 in chips) 
Seat 3: mhonielsen ($10.25 in chips) 
Seat 5: CHRO8 ($15.84 in chips) 
Seat 6: 8th wonders ($11.23 in chips) 
8th wonders: posts small blind $0.05
KokoulinV: posts big blind $0.10
univibe68: sits out 
*** HOLE CARDS ***
Kow6oy: folds 
mhonielsen: folds 
CHRO8: folds 
8th wonders: raises $0.20 to $0.30
KokoulinV: folds 
Uncalled bet ($0.20) returned to 8th wonders
8th wonders collected $0.20 from pot
*** SUMMARY ***
Total pot $0.20 | Rake $0 
Seat 1: KokoulinV (big blind) folded before Flop
Seat 2: Kow6oy folded before Flop (didn't bet)
Seat 3: mhonielsen folded before Flop (didn't bet)
Seat 5: CHRO8 (button) folded before Flop (didn't bet)
Seat 6: 8th wonders (small blind) collected ($0.20)



PokerStars Hand #166667985305:  Hold'em No Limit ($0.05/$0.10 USD) - 2017/02/23 16:11:09 ET
Table 'Gaika II' 6-max Seat #1 is the button
Seat 1: Ice_Isayev ($10.10 in chips) 
Seat 2: steepfell ($11.91 in chips) 
Seat 3: iDecMate ($18.73 in chips) 
Seat 4: Hyd SK ($10.43 in chips) 
Seat 5: KokoulinV ($12.71 in chips) 
Seat 6: bartabs2 ($8.72 in chips) 
steepfell: posts small blind $0.05
iDecMate: posts big blind $0.10
*** HOLE CARDS ***
Hyd SK: raises $0.25 to $0.35
KokoulinV: folds 
bartabs2: folds 
Ice_Isayev: folds 
steepfell: folds 
iDecMate: folds 
Uncalled bet ($0.25) returned to Hyd SK
Hyd SK collected $0.25 from pot
*** SUMMARY ***
Total pot $0.25 | Rake $0 
Seat 1: Ice_Isayev (button) folded before Flop (didn't bet)
Seat 2: steepfell (small blind) folded before Flop
Seat 3: iDecMate (big blind) folded before Flop
Seat 4: Hyd SK collected ($0.25)
Seat 5: KokoulinV folded before Flop (didn't bet)
Seat 6: bartabs2 folded before Flop (didn't bet)



PokerStars Hand #166667985874:  Hold'em No Limit ($0.05/$0.10 USD) - 2017/02/23 16:11:10 ET
Table 'Arpola' 6-max Seat #6 is the button
Seat 1: dincimus ($11.02 in chips) 
Seat 2: patrick19111 ($10.25 in chips) 
Seat 4: Orlangoor ($18.60 in chips) 
Seat 5: truck1234 ($12.17 in chips) 
Seat 6: DasoII ($4.45 in chips) 
dincimus: posts small blind $0.05
patrick19111: posts big blind $0.10
*** HOLE CARDS ***
Orlangoor: raises $0.15 to $0.25
truck1234: folds 
DasoII: folds 
dincimus: folds 
patrick19111: calls $0.15
*** FLOP *** [9c 7d 9h]
patrick19111: checks 
Orlangoor: checks 
*** TURN *** [9c 7d 9h] [5s]
patrick19111: checks 
Orlangoor: checks 
*** RIVER *** [9c 7d 9h 5s] [8c]
patrick19111: checks 
Orlangoor: checks 
*** SHOW DOWN ***
patrick19111: shows [As Kc] (a pair of Nines)
Orlangoor: shows [2d 2c] (two pair, Nines and Deuces)
Orlangoor collected $0.53 from pot
*** SUMMARY ***
Total pot $0.55 | Rake $0.02 
Board [9c 7d 9h 5s 8c]
Seat 1: dincimus (small blind) folded before Flop
Seat 2: patrick19111 (big blind) showed [As Kc] and lost with a pair of Nines
Seat 4: Orlangoor showed [2d 2c] and won ($0.53) with two pair, Nines and Deuces
Seat 5: truck1234 folded before Flop (didn't bet)
Seat 6: DasoII (button) folded before Flop (didn't bet)



PokerStars Hand #166667985952:  Hold'em No Limit ($0.05/$0.10 USD) - 2017/02/23 16:11:10 ET
Table 'Tirela' 6-max Seat #5 is the button
Seat 1: Smitty03300 ($10 in chips) 
Seat 2: Andrei ProFF ($17.14 in chips) 
Seat 3: aim444 ($16.26 in chips) 
Seat 4: ArcticBearDK ($10.15 in chips) 
Seat 5: KRZuff ($15.28 in chips) 
Seat 6: coolisses111 ($9.70 in chips) 
coolisses111: posts small blind $0.05
Smitty03300: posts big blind $0.10
*** HOLE CARDS ***
Andrei ProFF: folds 
aim444: calls $0.10
ArcticBearDK: folds 
KRZuff: raises $0.40 to $0.50
coolisses111: folds 
Smitty03300: folds 
aim444: calls $0.40
*** FLOP *** [4d 4c 7c]
aim444: checks 
KRZuff: bets $0.70
aim444: calls $0.70
*** TURN *** [4d 4c 7c] [Kh]
aim444: checks 
KRZuff: bets $1.35
aim444: folds 
Uncalled bet ($1.35) returned to KRZuff
KRZuff collected $2.44 from pot
*** SUMMARY ***
Total pot $2.55 | Rake $0.11 
Board [4d 4c 7c Kh]
Seat 1: Smitty03300 (big blind) folded before Flop
Seat 2: Andrei ProFF folded before Flop (didn't bet)
Seat 3: aim444 folded on the Turn
Seat 4: ArcticBearDK folded before Flop (didn't bet)
Seat 5: KRZuff (button) collected ($2.44)
Seat 6: coolisses111 (small blind) folded before Flop



PokerStars Hand #166667986006:  Hold'em No Limit ($0.05/$0.10 USD) - 2017/02/23 16:11:10 ET
Table 'Wilkens II' 6-max Seat #2 is the button
Seat 1: Islamiq-GuRL ($10.19 in chips) 
Seat 2: manashov ($10.90 in chips) 
Seat 3: Namhkal ($11.58 in chips) 
Seat 4: myevc ($10 in chips) 
Seat 5: patrick19111 ($13.57 in chips) 
Seat 6: XaXaTyH4uK ($14.01 in chips) 
Namhkal: posts small blind $0.05
myevc: posts big blind $0.10
*** HOLE CARDS ***
patrick19111: raises $0.20 to $0.30
XaXaTyH4uK: folds 
Islamiq-GuRL: folds 
manashov: folds 
Namhkal: folds 
myevc: raises $0.80 to $1.10
patrick19111: folds 
Uncalled bet ($0.80) returned to myevc
myevc collected $0.65 from pot
*** SUMMARY ***
Total pot $0.65 | Rake $0 
Seat 1: Islamiq-GuRL folded before Flop (didn't bet)
Seat 2: manashov (button) folded before Flop (didn't bet)
Seat 3: Namhkal (small blind) folded before Flop
Seat 4: myevc (big blind) collected ($0.65)
Seat 5: patrick19111 folded before Flop
Seat 6: XaXaTyH4uK folded before Flop (didn't bet)



PokerStars Hand #166667986339:  Hold'em No Limit ($0.05/$0.10 USD) - 2017/02/23 16:11:10 ET
Table 'Clavel' 6-max Seat #4 is the button
Seat 1: KRZuff ($15.12 in chips) 
Seat 2: Namhkal ($10.25 in chips) 
Seat 4: Dcaro31 ($11.53 in chips) 
Seat 5: Vrinni ($11.23 in chips) 
Seat 6: Gra_anD77 ($3.17 in chips) 
Vrinni: posts small blind $0.05
Gra_anD77: posts big blind $0.10
*** HOLE CARDS ***
KRZuff: folds 
Namhkal: folds 
Dcaro31: folds 
Vrinni: raises $0.20 to $0.30
Gra_anD77: calls $0.20
*** FLOP *** [3c 8s 2h]
Vrinni: bets $0.29
Gra_anD77: calls $0.29
*** TURN *** [3c 8s 2h] [7s]
Vrinni: bets $0.57
Gra_anD77: raises $0.57 to $1.14
Vrinni: folds 
Uncalled bet ($0.57) returned to Gra_anD77
Gra_anD77 collected $2.22 from pot
*** SUMMARY ***
Total pot $2.32 | Rake $0.10 
Board [3c 8s 2h 7s]
Seat 1: KRZuff folded before Flop (didn't bet)
Seat 2: Namhkal folded before Flop (didn't bet)
Seat 4: Dcaro31 (button) folded before Flop (didn't bet)
Seat 5: Vrinni (small blind) folded on the Turn
Seat 6: Gra_anD77 (big blind) collected ($2.22)



PokerStars Hand #166667986806:  Hold'em No Limit ($0.05/$0.10 USD) - 2017/02/23 16:11:11 ET
Table 'Hyakutake' 6-max Seat #6 is the button
Seat 1: Asilvagoat ($12.22 in chips) 
Seat 2: boxer821 ($13.12 in chips) 
Seat 3: lenboysprite ($4.35 in chips) 
Seat 4: eniksenik ($14.05 in chips) 
Seat 5: RoJ1 ($10.22 in chips) 
Seat 6: maxiv608 ($13.27 in chips) 
Asilvagoat: posts small blind $0.05
boxer821: posts big blind $0.10
*** HOLE CARDS ***
lenboysprite: folds 
eniksenik: folds 
RoJ1: folds 
maxiv608: raises $0.10 to $0.20
Asilvagoat: folds 
boxer821: folds 
Uncalled bet ($0.10) returned to maxiv608
maxiv608 collected $0.25 from pot
*** SUMMARY ***
Total pot $0.25 | Rake $0 
Seat 1: Asilvagoat (small blind) folded before Flop
Seat 2: boxer821 (big blind) folded before Flop
Seat 3: lenboysprite folded before Flop (didn't bet)
Seat 4: eniksenik folded before Flop (didn't bet)
Seat 5: RoJ1 folded before Flop (didn't bet)
Seat 6: maxiv608 (button) collected ($0.25)



PokerStars Hand #166667986892:  Hold'em No Limit ($0.05/$0.10 USD) - 2017/02/23 16:11:11 ET
Table 'Xanthippe II' 6-max Seat #6 is the button
Seat 1: noonhill ($8.32 in chips) 
Seat 2: Bird et al ($10.77 in chips) 
Seat 3: Dcaro31 ($14.51 in chips) 
Seat 5: XaXaTyH4uK ($10 in chips) 
Seat 6: Orlangoor ($12.27 in chips) 
noonhill: posts small blind $0.05
Bird et al: posts big blind $0.10
*** HOLE CARDS ***
Dcaro31: raises $0.20 to $0.30
XaXaTyH4uK: folds 
Orlangoor: folds 
noonhill: folds 
Bird et al: folds 
Uncalled bet ($0.20) returned to Dcaro31
Dcaro31 collected $0.25 from pot
*** SUMMARY ***
Total pot $0.25 | Rake $0 
Seat 1: noonhill (small blind) folded before Flop
Seat 2: Bird et al (big blind) folded before Flop
Seat 3: Dcaro31 collected ($0.25)
Seat 5: XaXaTyH4uK folded before Flop (didn't bet)
Seat 6: Orlangoor (button) folded before Flop (didn't bet)



PokerStars Hand #166667986894:  Hold'em No Limit ($0.05/$0.10 USD) - 2017/02/23 16:11:11 ET
Table 'Lobelia II' 6-max Seat #2 is the button
Seat 1: facewald ($21.52 in chips) 
Seat 2: Dcaro31 ($22.51 in chips) 
Seat 3: oddshoff ($14.98 in chips) 
Seat 4: arti192837 ($13.42 in chips) 
Seat 5: Feverhead ($18.65 in chips) 
Seat 6: NvR.m1nD ($10.09 in chips) 
oddshoff: posts small blind $0.05
arti192837: posts big blind $0.10
*** HOLE CARDS ***
Feverhead: folds 
NvR.m1nD: raises $0.15 to $0.25
facewald: folds 
Dcaro31: folds 
oddshoff: raises $0.65 to $0.90
arti192837: folds 
NvR.m1nD: folds 
Uncalled bet ($0.65) returned to oddshoff
oddshoff collected $0.60 from pot
*** SUMMARY ***
Total pot $0.60 | Rake $0 
Seat 1: facewald folded before Flop (didn't bet)
Seat 2: Dcaro31 (button) folded before Flop (didn't bet)
Seat 3: oddshoff (small blind) collected ($0.60)
Seat 4: arti192837 (big blind) folded before Flop
Seat 5: Feverhead folded before Flop (didn't bet)
Seat 6: NvR.m1nD folded before Flop



PokerStars Hand #166667987678:  Hold'em No Limit ($0.05/$0.10 USD) - 2017/02/23 16:11:12 ET
Table 'Marghanna II' 6-max Seat #1 is the button
Seat 1: Goroshkos88 ($10 in chips) 
Seat 2: Namhkal ($14.51 in chips) 
Seat 3: Andrei ProFF ($10 in chips) 
Seat 4: D3NyA ($12.29 in chips) 
Seat 5: ofl21189 ($3.72 in chips) 
Seat 6: VAD21 ($13.13 in chips) 
Namhkal: posts small blind $0.05
Andrei ProFF: posts big blind $0.10
*** HOLE CARDS ***
D3NyA: folds 
ofl21189: folds 
VAD21: folds 
Goroshkos88: raises $0.15 to $0.25
Namhkal: folds 
Andrei ProFF: folds 
Uncalled bet ($0.15) returned to Goroshkos88
Goroshkos88 collected $0.25 from pot
*** SUMMARY ***
Total pot $0.25 | Rake $0 
Seat 1: Goroshkos88 (button) collected ($0.25)
Seat 2: Namhkal (small blind) folded before Flop
Seat 3: Andrei ProFF (big blind) folded before Flop
Seat 4: D3NyA folded before Flop (didn't bet)
Seat 5: ofl21189 folded before Flop (didn't bet)
Seat 6: VAD21 folded before Flop (didn't bet)



PokerStars Hand #166667987899:  Hold'em No Limit ($0.05/$0.10 USD) - 2017/02/23 16:11:12 ET
Table 'Seinajoki' 6-max Seat #3 is the button
Seat 2: niukak ($10.15 in chips) 
Seat 3: Therodorus ($10 in chips) 
Seat 4: rusu_rapid ($10.05 in chips) 
rusu_rapid: posts small blind $0.05
niukak: posts big blind $0.10
*** HOLE CARDS ***
Therodorus: raises $0.15 to $0.25
rusu_rapid: folds 
niukak: folds 
Uncalled bet ($0.15) returned to Therodorus
Therodorus collected $0.25 from pot
*** SUMMARY ***
Total pot $0.25 | Rake $0 
Seat 2: niukak (big blind) folded before Flop
Seat 3: Therodorus (button) collected ($0.25)
Seat 4: rusu_rapid (small blind) folded before Flop



PokerStars Hand #166667987962:  Hold'em No Limit ($0.05/$0.10 USD) - 2017/02/23 16:11:12 ET
Table 'Martha' 6-max Seat #6 is the button
Seat 1: Peter0087 ($10.04 in chips) 
Seat 2: pauli95 ($10.81 in chips) 
Seat 3: Hyd SK ($12.37 in chips) 
Seat 4: dittoro ($10 in chips) 
Seat 5: MihaGr ($10 in chips) 
Seat 6: 8th wonders ($10.61 in chips) 
Peter0087: posts small blind $0.05
pauli95: posts big blind $0.10
*** HOLE CARDS ***
Hyd SK: folds 
dittoro: folds 
MihaGr: folds 
8th wonders: folds 
Peter0087: raises $0.10 to $0.20
pauli95: calls $0.10
*** FLOP *** [8s Kh 5d]
Peter0087: bets $0.30
pauli95: folds 
Uncalled bet ($0.30) returned to Peter0087
Peter0087 collected $0.38 from pot
Peter0087: doesn't show hand 
*** SUMMARY ***
Total pot $0.40 | Rake $0.02 
Board [8s Kh 5d]
Seat 1: Peter0087 (small blind) collected ($0.38)
Seat 2: pauli95 (big blind) folded on the Flop
Seat 3: Hyd SK folded before Flop (didn't bet)
Seat 4: dittoro folded before Flop (didn't bet)
Seat 5: MihaGr folded before Flop (didn't bet)
Seat 6: 8th wonders (button) folded before Flop (didn't bet)



PokerStars Hand #166667988118:  Hold'em No Limit ($0.05/$0.10 USD) - 2017/02/23 16:11:12 ET
Table 'Sheragul III' 6-max Seat #5 is the button
Seat 1: CallByValue ($10 in chips) 
Seat 2: Bird et al ($10.21 in chips) 
Seat 5: RGhearted ($10.15 in chips) 
Seat 6: XaXaTyH4uK ($10.30 in chips) 
XaXaTyH4uK: posts small blind $0.05
CallByValue: posts big blind $0.10
maxiv608: sits out 
*** HOLE CARDS ***
Bird et al: raises $0.21 to $0.31
Mesmer416 joins the table at seat #3 
RGhearted: calls $0.31
XaXaTyH4uK: folds 
CallByValue: folds 
*** FLOP *** [Ks 2h 3s]
Bird et al: bets $0.44
RGhearted: folds 
Uncalled bet ($0.44) returned to Bird et al
Bird et al collected $0.74 from pot
*** SUMMARY ***
Total pot $0.77 | Rake $0.03 
Board [Ks 2h 3s]
Seat 1: CallByValue (big blind) folded before Flop
Seat 2: Bird et al collected ($0.74)
Seat 5: RGhearted (button) folded on the Flop
Seat 6: XaXaTyH4uK (small blind) folded before Flop



PokerStars Hand #166667988239:  Hold'em No Limit ($0.05/$0.10 USD) - 2017/02/23 16:11:12 ET
Table 'Virginia II' 6-max Seat #6 is the button
Seat 2: Yspenyanin ($10 in chips) 
Seat 3: garigura ($16.13 in chips) 
Seat 4: onkelottoHH ($10.58 in chips) 
Seat 6: NvR.m1nD ($10.30 in chips) 
Yspenyanin: posts small blind $0.05
garigura: posts big blind $0.10
yodzik: sits out 
*** HOLE CARDS ***
onkelottoHH: raises $0.20 to $0.30
NvR.m1nD: folds 
Yspenyanin: folds 
garigura: folds 
Uncalled bet ($0.20) returned to onkelottoHH
onkelottoHH collected $0.25 from pot
*** SUMMARY ***
Total pot $0.25 | Rake $0 
Seat 2: Yspenyanin (small blind) folded before Flop
Seat 3: garigura (big blind) folded before Flop
Seat 4: onkelottoHH collected ($0.25)
Seat 6: NvR.m1nD (button) folded before Flop (didn't bet)



PokerStars Hand #166667988365:  Hold'em No Limit ($0.05/$0.10 USD) - 2017/02/23 16:11:12 ET
Table 'Pallas II' 6-max Seat #3 is the button
Seat 1: mdelfin0 ($16.64 in chips) 
Seat 3: popypaleta ($10.30 in chips) 
Seat 4: MisterX413 ($10 in chips) 
MisterX413: posts small blind $0.05
mdelfin0: posts big blind $0.10
*** HOLE CARDS ***
popypaleta: folds 
Smitty03300 leaves the table
MisterX413: folds 
Uncalled bet ($0.05) returned to mdelfin0
mdelfin0 collected $0.10 from pot
*** SUMMARY ***
Total pot $0.10 | Rake $0 
Seat 1: mdelfin0 (big blind) collected ($0.10)
Seat 3: popypaleta (button) folded before Flop (didn't bet)
Seat 4: MisterX413 (small blind) folded before Flop



PokerStars Hand #166667988530:  Hold'em No Limit ($0.05/$0.10 USD) - 2017/02/23 16:11:13 ET
Table 'Goto II' 6-max Seat #5 is the button
Seat 1: FRAID358 ($12.01 in chips) 
Seat 2: 6ePeMeHHa9 ($12.61 in chips) 
Seat 3: Goroshkos88 ($10.53 in chips) 
Seat 4: KRZuff ($13.61 in chips) 
Seat 5: RoJ1 ($14.35 in chips) 
Seat 6: ermananb93 ($11.06 in chips) 
ermananb93: posts small blind $0.05
FRAID358: posts big blind $0.10
*** HOLE CARDS ***
6ePeMeHHa9: raises $0.19 to $0.29
Goroshkos88: folds 
KRZuff: folds 
RoJ1: folds 
ermananb93: folds 
FRAID358: calls $0.19
*** FLOP *** [Kc Jh Td]
FRAID358: checks 
6ePeMeHHa9: checks 
*** TURN *** [Kc Jh Td] [5s]
FRAID358: checks 
6ePeMeHHa9: bets $0.60
FRAID358: folds 
Uncalled bet ($0.60) returned to 6ePeMeHHa9
6ePeMeHHa9 collected $0.60 from pot
*** SUMMARY ***
Total pot $0.63 | Rake $0.03 
Board [Kc Jh Td 5s]
Seat 1: FRAID358 (big blind) folded on the Turn
Seat 2: 6ePeMeHHa9 collected ($0.60)
Seat 3: Goroshkos88 folded before Flop (didn't bet)
Seat 4: KRZuff folded before Flop (didn't bet)
Seat 5: RoJ1 (button) folded before Flop (didn't bet)
Seat 6: ermananb93 (small blind) folded before Flop



PokerStars Hand #166667988782:  Hold'em No Limit ($0.05/$0.10 USD) - 2017/02/23 16:11:13 ET
Table 'Gaika' 6-max Seat #4 is the button
Seat 1: oddshoff ($16.56 in chips) 
Seat 4: fortieth ($10.45 in chips) 
fortieth: posts small blind $0.05
oddshoff: posts big blind $0.10
*** HOLE CARDS ***
fortieth: raises $0.25 to $0.35
oddshoff: folds 
Uncalled bet ($0.25) returned to fortieth
fortieth collected $0.20 from pot
*** SUMMARY ***
Total pot $0.20 | Rake $0 
Seat 1: oddshoff (big blind) folded before Flop
Seat 4: fortieth (button) (small blind) collected ($0.20)



PokerStars Hand #166667989248:  Hold'em No Limit ($0.05/$0.10 USD) - 2017/02/23 16:11:13 ET
Table 'Eudora' 6-max Seat #6 is the button
Seat 1: archer2511 ($12.30 in chips) 
Seat 2: popypaleta ($10 in chips) 
Seat 3: Ice_Isayev ($10.15 in chips) 
Seat 4: yodzik ($5 in chips) 
Seat 5: chimera252 ($11.53 in chips) 
Seat 6: HARDCORE66RU ($10 in chips) 
archer2511: posts small blind $0.05
popypaleta: posts big blind $0.10
*** HOLE CARDS ***
Ice_Isayev: folds 
yodzik: folds 
chimera252: folds 
HARDCORE66RU: raises $0.15 to $0.25
archer2511: calls $0.20
popypaleta: folds 
*** FLOP *** [2h 6d 8s]
archer2511: bets $0.40
HARDCORE66RU: calls $0.40
*** TURN *** [2h 6d 8s] [9c]
archer2511: bets $1
HARDCORE66RU: raises $1.67 to $2.67
archer2511: folds 
Uncalled bet ($1.67) returned to HARDCORE66RU
HARDCORE66RU collected $3.25 from pot
*** SUMMARY ***
Total pot $3.40 | Rake $0.15 
Board [2h 6d 8s 9c]
Seat 1: archer2511 (small blind) folded on the Turn
Seat 2: popypaleta (big blind) folded before Flop
Seat 3: Ice_Isayev folded before Flop (didn't bet)
Seat 4: yodzik folded before Flop (didn't bet)
Seat 5: chimera252 folded before Flop (didn't bet)
Seat 6: HARDCORE66RU (button) collected ($3.25)



PokerStars Hand #166667989551:  Hold'em No Limit ($0.05/$0.10 USD) - 2017/02/23 16:11:14 ET
Table 'Lacroute' 6-max Seat #6 is the button
Seat 1: Orlangoor ($10.15 in chips) 
Seat 2: Andy Wolf ($10.54 in chips) 
Seat 4: st4tion ($17.39 in chips) 
Seat 5: steepfell ($13.82 in chips) 
Seat 6: IAntikI ($11.52 in chips) 
Orlangoor: posts small blind $0.05
Andy Wolf: posts big blind $0.10
*** HOLE CARDS ***
st4tion: folds 
steepfell: folds 
IAntikI: folds 
Orlangoor: raises $0.15 to $0.25
Andy Wolf: calls $0.15
*** FLOP *** [Jd Ts 8c]
Orlangoor: checks 
Andy Wolf: bets $0.30
Orlangoor: calls $0.30
*** TURN *** [Jd Ts 8c] [Js]
Orlangoor: checks 
Andy Wolf: checks 
*** RIVER *** [Jd Ts 8c Js] [5s]
Orlangoor: checks 
Andy Wolf: checks 
*** SHOW DOWN ***
Orlangoor: shows [Kc As] (a pair of Jacks)
Andy Wolf: mucks hand 
Orlangoor collected $1.05 from pot
*** SUMMARY ***
Total pot $1.10 | Rake $0.05 
Board [Jd Ts 8c Js 5s]
Seat 1: Orlangoor (small blind) showed [Kc As] and won ($1.05) with a pair of Jacks
Seat 2: Andy Wolf (big blind) mucked
Seat 4: st4tion folded before Flop (didn't bet)
Seat 5: steepfell folded before Flop (didn't bet)
Seat 6: IAntikI (button) folded before Flop (didn't bet)



PokerStars Hand #166667989556:  Hold'em No Limit ($0.05/$0.10 USD) - 2017/02/23 16:11:14 ET
Table 'Pompeja III' 6-max Seat #5 is the button
Seat 2: steepfell ($10.42 in chips) 
Seat 3: Yspenyanin ($12.61 in chips) 
Seat 5: Spud014 ($12.30 in chips) 
Seat 6: mega spasser ($4.70 in chips) 
mega spasser: posts small blind $0.05
Iarlei: is sitting out 
steepfell: posts big blind $0.10
*** HOLE CARDS ***
BgdAlex117 joins the table at seat #4 
Yspenyanin: folds 
Spud014: folds 
mega spasser: folds 
Uncalled bet ($0.05) returned to steepfell
steepfell collected $0.10 from pot
*** SUMMARY ***
Total pot $0.10 | Rake $0 
Seat 2: steepfell (big blind) collected ($0.10)
Seat 3: Yspenyanin folded before Flop (didn't bet)
Seat 5: Spud014 (button) folded before Flop (didn't bet)
Seat 6: mega spasser (small blind) folded before Flop



PokerStars Hand #166667990240:  Hold'em No Limit ($0.05/$0.10 USD) - 2017/02/23 16:11:14 ET
Table 'Thoas' 6-max Seat #4 is the button
Seat 1: Pekaml ($11.14 in chips) 
Seat 2: themacer24 ($8.69 in chips) 
Seat 3: iamkakaroto ($10 in chips) 
Seat 4: Morris_Chair ($21.70 in chips) 
Seat 5: Kow6oy ($10 in chips) 
Seat 6: takis nik ($10 in chips) 
Kow6oy: posts small blind $0.05
takis nik: posts big blind $0.10
*** HOLE CARDS ***
Pekaml: folds 
themacer24: folds 
iamkakaroto: raises $0.20 to $0.30
Morris_Chair: folds 
Kow6oy: folds 
takis nik: folds 
Uncalled bet ($0.20) returned to iamkakaroto
iamkakaroto collected $0.25 from pot
*** SUMMARY ***
Total pot $0.25 | Rake $0 
Seat 1: Pekaml folded before Flop (didn't bet)
Seat 2: themacer24 folded before Flop (didn't bet)
Seat 3: iamkakaroto collected ($0.25)
Seat 4: Morris_Chair (button) folded before Flop (didn't bet)
Seat 5: Kow6oy (small blind) folded before Flop
Seat 6: takis nik (big blind) folded before Flop



PokerStars Hand #166667990257:  Hold'em No Limit ($0.05/$0.10 USD) - 2017/02/23 16:11:14 ET
Table 'Eurydome II' 6-max Seat #5 is the button
Seat 1: rusu_rapid ($11.83 in chips) 
Seat 3: gaHy_HaXeP ($12.09 in chips) 
Seat 4: Smitty03300 ($10 in chips) 
Seat 5: kush-killa87 ($8.64 in chips) 
Seat 6: Jucatorul823 ($6.49 in chips) 
Jucatorul823: posts small blind $0.05
rusu_rapid: posts big blind $0.10
Elinaattor: sits out 
*** HOLE CARDS ***
gaHy_HaXeP: folds 
Smitty03300: raises $0.15 to $0.25
kush-killa87: raises $0.65 to $0.90
Jucatorul823: folds 
rusu_rapid: folds 
Smitty03300: calls $0.65
*** FLOP *** [Kc 8s 2c]
Smitty03300: checks 
kush-killa87: bets $0.90
Smitty03300: folds 
Uncalled bet ($0.90) returned to kush-killa87
kush-killa87 collected $1.86 from pot
*** SUMMARY ***
Total pot $1.95 | Rake $0.09 
Board [Kc 8s 2c]
Seat 1: rusu_rapid (big blind) folded before Flop
Seat 3: gaHy_HaXeP folded before Flop (didn't bet)
Seat 4: Smitty03300 folded on the Flop
Seat 5: kush-killa87 (button) collected ($1.86)
Seat 6: Jucatorul823 (small blind) folded before Flop



PokerStars Hand #166667990417:  Hold'em No Limit ($0.05/$0.10 USD) - 2017/02/23 16:11:15 ET
Table 'Camilla II' 6-max Seat #1 is the button
Seat 1: paxit71 ($8.17 in chips) 
Seat 2: Giyorod ($12.91 in chips) 
Seat 3: Andy Wolf ($12.84 in chips) 
Seat 4: chimera252 ($12.56 in chips) 
Seat 5: LarryTheStar ($11.09 in chips) 
Seat 6: DeleonBR ($4.70 in chips) 
Giyorod: posts small blind $0.05
Andy Wolf: posts big blind $0.10
DeleonBR: posts big blind $0.10
*** HOLE CARDS ***
chimera252: folds 
LarryTheStar: folds 
DeleonBR: raises $0.10 to $0.20
paxit71: folds 
Giyorod: folds 
Andy Wolf: calls $0.10
*** FLOP *** [9d 5c Kd]
Andy Wolf: checks 
DeleonBR: bets $0.43
Andy Wolf: folds 
Uncalled bet ($0.43) returned to DeleonBR
DeleonBR collected $0.43 from pot
*** SUMMARY ***
Total pot $0.45 | Rake $0.02 
Board [9d 5c Kd]
Seat 1: paxit71 (button) folded before Flop (didn't bet)
Seat 2: Giyorod (small blind) folded before Flop
Seat 3: Andy Wolf (big blind) folded on the Flop
Seat 4: chimera252 folded before Flop (didn't bet)
Seat 5: LarryTheStar folded before Flop (didn't bet)
Seat 6: DeleonBR collected ($0.43)



PokerStars Hand #166667990762:  Hold'em No Limit ($0.05/$0.10 USD) - 2017/02/23 16:11:15 ET
Table 'Jokaste II' 6-max Seat #6 is the button
Seat 1: Hyd SK ($13.25 in chips) 
Seat 2: T9MS ($14.14 in chips) 
Seat 3: crazydevill ($11.65 in chips) 
Seat 4: FRAID358 ($15.21 in chips) 
Seat 5: Vrinni ($10 in chips) 
Seat 6: Adailton07 ($12.07 in chips) 
Hyd SK: posts small blind $0.05
T9MS: posts big blind $0.10
*** HOLE CARDS ***
crazydevill: folds 
FRAID358: folds 
Vrinni: folds 
Adailton07: folds 
Adailton07 leaves the table
WinninBikini joins the table at seat #6 
Hyd SK: raises $0.25 to $0.35
WinninBikini leaves the table
T9MS: folds 
Uncalled bet ($0.25) returned to Hyd SK
Hyd SK collected $0.20 from pot
*** SUMMARY ***
Total pot $0.20 | Rake $0 
Seat 1: Hyd SK (small blind) collected ($0.20)
Seat 2: T9MS (big blind) folded before Flop
Seat 3: crazydevill folded before Flop (didn't bet)
Seat 4: FRAID358 folded before Flop (didn't bet)
Seat 5: Vrinni folded before Flop (didn't bet)
Seat 6: Adailton07 (button) folded before Flop (didn't bet)



PokerStars Hand #166667990841:  Hold'em No Limit ($0.05/$0.10 USD) - 2017/02/23 16:11:15 ET
Table 'Antielus II' 6-max Seat #3 is the button
Seat 1: Dcaro31 ($18.19 in chips) 
Seat 2: Orlangoor ($10 in chips) 
Seat 3: mcyi3at2 ($9.02 in chips) 
Seat 4: XwinX25 ($10 in chips) 
Seat 5: Hyd SK ($14.87 in chips) 
Seat 6: GiveTwoMe ($12.68 in chips) 
XwinX25: posts small blind $0.05
Hyd SK: posts big blind $0.10
*** HOLE CARDS ***
GiveTwoMe: raises $0.20 to $0.30
Dcaro31: folds 
Orlangoor: folds 
mcyi3at2: raises $0.50 to $0.80
XwinX25: folds 
Hyd SK: folds 
GiveTwoMe: calls $0.50
*** FLOP *** [3d 8c 6h]
GiveTwoMe: checks 
mcyi3at2: bets $1.20
GiveTwoMe: calls $1.20
*** TURN *** [3d 8c 6h] [Ac]
GiveTwoMe: checks 
mcyi3at2: bets $2.40
GiveTwoMe: calls $2.40
*** RIVER *** [3d 8c 6h Ac] [3h]
GiveTwoMe: checks 
mcyi3at2: checks 
*** SHOW DOWN ***
GiveTwoMe: shows [7h Ah] (two pair, Aces and Threes)
mcyi3at2: mucks hand 
GiveTwoMe collected $8.55 from pot
*** SUMMARY ***
Total pot $8.95 | Rake $0.40 
Board [3d 8c 6h Ac 3h]
Seat 1: Dcaro31 folded before Flop (didn't bet)
Seat 2: Orlangoor folded before Flop (didn't bet)
Seat 3: mcyi3at2 (button) mucked
Seat 4: XwinX25 (small blind) folded before Flop
Seat 5: Hyd SK (big blind) folded before Flop
Seat 6: GiveTwoMe showed [7h Ah] and won ($8.55) with two pair, Aces and Threes



PokerStars Hand #166667990948:  Hold'em No Limit ($0.05/$0.10 USD) - 2017/02/23 16:11:15 ET
Table 'Rotraut' 6-max Seat #3 is the button
Seat 1: Hypermetal ($13.51 in chips) 
Seat 2: Newqbrown ($10.45 in chips) 
Seat 3: FlackoD ($7.66 in chips) 
Seat 5: Bird et al ($12.13 in chips) 
Seat 6: KokoulinV ($16.42 in chips) 
Bird et al: posts small blind $0.05
KokoulinV: posts big blind $0.10
*** HOLE CARDS ***
Hypermetal: folds 
Newqbrown: folds 
FlackoD: folds 
Bird et al: folds 
Uncalled bet ($0.05) returned to KokoulinV
KokoulinV collected $0.10 from pot
*** SUMMARY ***
Total pot $0.10 | Rake $0 
Seat 1: Hypermetal folded before Flop (didn't bet)
Seat 2: Newqbrown folded before Flop (didn't bet)
Seat 3: FlackoD (button) folded before Flop (didn't bet)
Seat 5: Bird et al (small blind) folded before Flop
Seat 6: KokoulinV (big blind) collected ($0.10)



PokerStars Hand #166667991381:  Hold'em No Limit ($0.05/$0.10 USD) - 2017/02/23 16:11:16 ET
Table 'Armenia' 6-max Seat #2 is the button
Seat 1: tr41n3r12 ($11.52 in chips) 
Seat 2: Yabidooo ($10.83 in chips) 
Seat 3: Crimsonr ($5.64 in chips) 
Seat 4: mbkongstad ($10 in chips) 
Seat 5: DrVzad ($9.85 in chips) 
Seat 6: mega spasser ($8.03 in chips) 
Crimsonr: posts small blind $0.05
mbkongstad: posts big blind $0.10
*** HOLE CARDS ***
DrVzad: folds 
mega spasser: folds 
tr41n3r12: raises $0.20 to $0.30
Yabidooo: folds 
Crimsonr: folds 
mbkongstad: folds 
Uncalled bet ($0.20) returned to tr41n3r12
tr41n3r12 collected $0.25 from pot
*** SUMMARY ***
Total pot $0.25 | Rake $0 
Seat 1: tr41n3r12 collected ($0.25)
Seat 2: Yabidooo (button) folded before Flop (didn't bet)
Seat 3: Crimsonr (small blind) folded before Flop
Seat 4: mbkongstad (big blind) folded before Flop
Seat 5: DrVzad folded before Flop (didn't bet)
Seat 6: mega spasser folded before Flop (didn't bet)



PokerStars Hand #166667991512:  Hold'em No Limit ($0.05/$0.10 USD) - 2017/02/23 16:11:16 ET
Table 'Azelfafage' 6-max Seat #2 is the button
Seat 1: Sbozzz ($15.46 in chips) 
Seat 2: tr41n3r12 ($11.55 in chips) 
Seat 3: todor1711 ($14.44 in chips) 
Seat 5: 8th wonders ($12.40 in chips) 
Seat 6: KA3AXCTAHEU, ($10 in chips) 
todor1711: posts small blind $0.05
fedorka rus said, "smoke"
fedorka rus: is sitting out 
8th wonders: posts big blind $0.10
*** HOLE CARDS ***
KA3AXCTAHEU,: folds 
Sbozzz: raises $0.20 to $0.30
tr41n3r12: folds 
todor1711: folds 
8th wonders: folds 
Uncalled bet ($0.20) returned to Sbozzz
Sbozzz collected $0.25 from pot
*** SUMMARY ***
Total pot $0.25 | Rake $0 
Seat 1: Sbozzz collected ($0.25)
Seat 2: tr41n3r12 (button) folded before Flop (didn't bet)
Seat 3: todor1711 (small blind) folded before Flop
Seat 5: 8th wonders (big blind) folded before Flop
Seat 6: KA3AXCTAHEU, folded before Flop (didn't bet)



PokerStars Hand #166667991523:  Hold'em No Limit ($0.05/$0.10 USD) - 2017/02/23 16:11:16 ET
Table 'Wabash' 6-max Seat #5 is the button
Seat 1: pivanki11 ($9.76 in chips) 
Seat 2: ex3Lero86 ($32.63 in chips) 
Seat 3: tauronex ($10 in chips) 
Seat 4: Nr847 ($10.92 in chips) 
Seat 5: popypaleta ($13.74 in chips) 
Seat 6: weez3r ($11.12 in chips) 
weez3r: posts small blind $0.05
pivanki11: posts big blind $0.10
*** HOLE CARDS ***
ex3Lero86: folds 
tauronex: folds 
Nr847: folds 
popypaleta: folds 
weez3r: raises $0.20 to $0.30
pivanki11: folds 
Uncalled bet ($0.20) returned to weez3r
weez3r collected $0.20 from pot
*** SUMMARY ***
Total pot $0.20 | Rake $0 
Seat 1: pivanki11 (big blind) folded before Flop
Seat 2: ex3Lero86 folded before Flop (didn't bet)
Seat 3: tauronex folded before Flop (didn't bet)
Seat 4: Nr847 folded before Flop (didn't bet)
Seat 5: popypaleta (button) folded before Flop (didn't bet)
Seat 6: weez3r (small blind) collected ($0.20)



PokerStars Hand #166667991619:  Hold'em No Limit ($0.05/$0.10 USD) - 2017/02/23 16:11:16 ET
Table 'Lesath III' 6-max Seat #4 is the button
Seat 1: Gogeta26 ($7 in chips) 
Seat 2: WinninBikini ($10.17 in chips) 
Seat 3: Giyorod ($10.51 in chips) 
Seat 4: Eddys Edge ($10.36 in chips) 
Seat 5: eniksenik ($15.75 in chips) 
Seat 6: patrick19111 ($10.21 in chips) 
eniksenik: posts small blind $0.05
patrick19111: posts big blind $0.10
*** HOLE CARDS ***
Gogeta26: calls $0.10
WinninBikini: folds 
Giyorod: folds 
Eddys Edge: raises $0.30 to $0.40
eniksenik: folds 
patrick19111: folds 
Gogeta26: calls $0.30
*** FLOP *** [Jd 9h 6s]
Gogeta26: checks 
Eddys Edge: bets $0.61
Gogeta26: folds 
Uncalled bet ($0.61) returned to Eddys Edge
Eddys Edge collected $0.91 from pot
*** SUMMARY ***
Total pot $0.95 | Rake $0.04 
Board [Jd 9h 6s]
Seat 1: Gogeta26 folded on the Flop
Seat 2: WinninBikini folded before Flop (didn't bet)
Seat 3: Giyorod folded before Flop (didn't bet)
Seat 4: Eddys Edge (button) collected ($0.91)
Seat 5: eniksenik (small blind) folded before Flop
Seat 6: patrick19111 (big blind) folded before Flop



PokerStars Hand #166667991711:  Hold'em No Limit ($0.05/$0.10 USD) - 2017/02/23 16:11:16 ET
Table 'Reginhild' 6-max Seat #2 is the button
Seat 1: iamkakaroto ($10.85 in chips) 
Seat 2: Kow6oy ($10.35 in chips) 
Seat 3: ARCHITECT83 ($7.93 in chips) 
Seat 4: Raymondo21 ($24.48 in chips) 
Seat 5: XCarlos610 ($28.87 in chips) 
Seat 6: eniksenik ($10 in chips) 
ARCHITECT83: posts small blind $0.05
Raymondo21: posts big blind $0.10
*** HOLE CARDS ***
XCarlos610: folds 
eniksenik: folds 
iamkakaroto: folds 
Kow6oy: raises $0.10 to $0.20
ARCHITECT83: raises $0.10 to $0.30
Raymondo21: folds 
Kow6oy: calls $0.10
*** FLOP *** [As 5d 3c]
ARCHITECT83: bets $0.40
Kow6oy: folds 
Uncalled bet ($0.40) returned to ARCHITECT83
ARCHITECT83 collected $0.67 from pot
*** SUMMARY ***
Total pot $0.70 | Rake $0.03 
Board [As 5d 3c]
Seat 1: iamkakaroto folded before Flop (didn't bet)
Seat 2: Kow6oy (button) folded on the Flop
Seat 3: ARCHITECT83 (small blind) collected ($0.67)
Seat 4: Raymondo21 (big blind) folded before Flop
Seat 5: XCarlos610 folded before Flop (didn't bet)
Seat 6: eniksenik folded before Flop (didn't bet)



PokerStars Hand #166667992074:  Hold'em No Limit ($0.05/$0.10 USD) - 2017/02/23 16:11:16 ET
Table 'Veniakaverin' 6-max Seat #6 is the button
Seat 1: pivanki11 ($13.66 in chips) 
Seat 2: RoJ1 ($10 in chips) 
Seat 3: Hyd SK ($28.23 in chips) 
Seat 5: Tox1cel ($7.38 in chips) 
Seat 6: bdixon_5 ($9.15 in chips) 
pivanki11: posts small blind $0.05
RoJ1: posts big blind $0.10
FRAID358: sits out 
*** HOLE CARDS ***
Hyd SK: folds 
Tox1cel: raises $0.10 to $0.20
bdixon_5: folds 
pivanki11: calls $0.15
RoJ1: calls $0.10
*** FLOP *** [7h 2d 8h]
pivanki11: bets $0.60
RoJ1: folds 
Tox1cel: calls $0.60
*** TURN *** [7h 2d 8h] [9d]
pivanki11: checks 
Tox1cel: checks 
*** RIVER *** [7h 2d 8h 9d] [Td]
pivanki11: checks 
Tox1cel: bets $0.40
pivanki11: folds 
Uncalled bet ($0.40) returned to Tox1cel
Tox1cel collected $1.72 from pot
*** SUMMARY ***
Total pot $1.80 | Rake $0.08 
Board [7h 2d 8h 9d Td]
Seat 1: pivanki11 (small blind) folded on the River
Seat 2: RoJ1 (big blind) folded on the Flop
Seat 3: Hyd SK folded before Flop (didn't bet)
Seat 5: Tox1cel collected ($1.72)
Seat 6: bdixon_5 (button) folded before Flop (didn't bet)



PokerStars Hand #166667992080:  Hold'em No Limit ($0.05/$0.10 USD) - 2017/02/23 16:11:16 ET
Table 'Girtab' 6-max Seat #3 is the button
Seat 2: MühliJr ($10 in chips) 
Seat 3: kingartur222 ($9.90 in chips) 
Seat 4: Hyd SK ($10.88 in chips) 
Seat 5: sexy_seagull ($11.35 in chips) 
Seat 6: iluzja12 ($10.95 in chips) 
Hyd SK: posts small blind $0.05
sexy_seagull: posts big blind $0.10
*** HOLE CARDS ***
AIONCMA1988 joins the table at seat #1 
iluzja12: raises $0.10 to $0.20
MühliJr: folds 
kingartur222: folds 
Hyd SK: folds 
sexy_seagull: folds 
Uncalled bet ($0.10) returned to iluzja12
iluzja12 collected $0.25 from pot
*** SUMMARY ***
Total pot $0.25 | Rake $0 
Seat 2: MühliJr folded before Flop (didn't bet)
Seat 3: kingartur222 (button) folded before Flop (didn't bet)
Seat 4: Hyd SK (small blind) folded before Flop
Seat 5: sexy_seagull (big blind) folded before Flop
Seat 6: iluzja12 collected ($0.25)



PokerStars Hand #166667992107:  Hold'em No Limit ($0.05/$0.10 USD) - 2017/02/23 16:11:16 ET
Table 'Serpens' 6-max Seat #5 is the button
Seat 1: Namhkal ($10.28 in chips) 
Seat 2: KA3AXCTAHEU, ($19.18 in chips) 
Seat 3: homelessdan ($30.25 in chips) 
Seat 4: DIENY772 ($9.87 in chips) 
Seat 5: JahSoldier69 ($10 in chips) 
Seat 6: XaXaTyH4uK ($10 in chips) 
XaXaTyH4uK: posts small blind $0.05
Namhkal: posts big blind $0.10
*** HOLE CARDS ***
KA3AXCTAHEU,: folds 
homelessdan: folds 
DIENY772: calls $0.10
JahSoldier69: folds 
XaXaTyH4uK: folds 
Namhkal: checks 
*** FLOP *** [4s 2h Kd]
Namhkal: checks 
DIENY772: bets $1.07
Namhkal: folds 
Uncalled bet ($1.07) returned to DIENY772
DIENY772 collected $0.24 from pot
*** SUMMARY ***
Total pot $0.25 | Rake $0.01 
Board [4s 2h Kd]
Seat 1: Namhkal (big blind) folded on the Flop
Seat 2: KA3AXCTAHEU, folded before Flop (didn't bet)
Seat 3: homelessdan folded before Flop (didn't bet)
Seat 4: DIENY772 collected ($0.24)
Seat 5: JahSoldier69 (button) folded before Flop (didn't bet)
Seat 6: XaXaTyH4uK (small blind) folded before Flop



PokerStars Hand #166667992184:  Hold'em No Limit ($0.05/$0.10 USD) - 2017/02/23 16:11:17 ET
Table 'Marbachia II' 6-max Seat #2 is the button
Seat 1: crooso ($9.60 in chips) 
Seat 2: Yabidooo ($10 in chips) 
Seat 3: MisterX413 ($10.29 in chips) 
Seat 4: marianoboni ($10.92 in chips) 
Seat 6: arti192837 ($10 in chips) 
MisterX413: posts small blind $0.05
marianoboni: posts big blind $0.10
osmea: sits out 
*** HOLE CARDS ***
arti192837: folds 
crooso: folds 
Yabidooo: folds 
MisterX413: folds 
Uncalled bet ($0.05) returned to marianoboni
marianoboni collected $0.10 from pot
*** SUMMARY ***
Total pot $0.10 | Rake $0 
Seat 1: crooso folded before Flop (didn't bet)
Seat 2: Yabidooo (button) folded before Flop (didn't bet)
Seat 3: MisterX413 (small blind) folded before Flop
Seat 4: marianoboni (big blind) collected ($0.10)
Seat 6: arti192837 folded before Flop (didn't bet)



PokerStars Hand #166667992185:  Hold'em No Limit ($0.05/$0.10 USD) - 2017/02/23 16:11:17 ET
Table 'Lampetia III' 6-max Seat #6 is the button
Seat 3: Kow6oy ($10 in chips) 
Seat 4: IAntikI ($10.60 in chips) 
Seat 5: robson1235 ($20.30 in chips) 
Seat 6: bdixon_5 ($9.05 in chips) 
AIONCMA1988 will be allowed to play after the button
Kow6oy: posts small blind $0.05
IAntikI: posts big blind $0.10
*** HOLE CARDS ***
robson1235: folds 
bdixon_5: folds 
JahSoldier69 joins the table at seat #1 
JahSoldier69 leaves the table
Kow6oy: raises $0.20 to $0.30
IAntikI: folds 
Uncalled bet ($0.20) returned to Kow6oy
Kow6oy collected $0.20 from pot
*** SUMMARY ***
Total pot $0.20 | Rake $0 
Seat 3: Kow6oy (small blind) collected ($0.20)
Seat 4: IAntikI (big blind) folded before Flop
Seat 5: robson1235 folded before Flop (didn't bet)
Seat 6: bdixon_5 (button) folded before Flop (didn't bet)



PokerStars Hand #166667992186:  Hold'em No Limit ($0.05/$0.10 USD) - 2017/02/23 16:11:17 ET
Table 'Peiroos' 6-max Seat #4 is the button
Seat 1: ksandr_hom ($10 in chips) 
Seat 2: Nr847 ($10.80 in chips) 
Seat 3: atlx0711 ($24.79 in chips) 
Seat 4: Peter0087 ($10.32 in chips) 
Seat 5: sergio-cb164 ($7.90 in chips) 
Seat 6: DevonMiles88 ($10.11 in chips) 
sergio-cb164: posts small blind $0.05
DevonMiles88: posts big blind $0.10
*** HOLE CARDS ***
ksandr_hom: raises $0.20 to $0.30
Nr847: folds 
atlx0711: calls $0.30
Peter0087: folds 
sergio-cb164: calls $0.25
DevonMiles88: calls $0.20
*** FLOP *** [8d 2s Qh]
sergio-cb164: checks 
DevonMiles88: checks 
ksandr_hom: checks 
atlx0711: checks 
*** TURN *** [8d 2s Qh] [Jh]
sergio-cb164: bets $1
DevonMiles88: folds 
ksandr_hom: folds 
atlx0711: calls $1
*** RIVER *** [8d 2s Qh Jh] [Td]
sergio-cb164: checks 
atlx0711: checks 
*** SHOW DOWN ***
sergio-cb164: shows [Qs Js] (two pair, Queens and Jacks)
atlx0711: mucks hand 
sergio-cb164 collected $3.06 from pot
*** SUMMARY ***
Total pot $3.20 | Rake $0.14 
Board [8d 2s Qh Jh Td]
Seat 1: ksandr_hom folded on the Turn
Seat 2: Nr847 folded before Flop (didn't bet)
Seat 3: atlx0711 mucked
Seat 4: Peter0087 (button) folded before Flop (didn't bet)
Seat 5: sergio-cb164 (small blind) showed [Qs Js] and won ($3.06) with two pair, Queens and Jacks
Seat 6: DevonMiles88 (big blind) folded on the Turn



PokerStars Hand #166667992660:  Hold'em No Limit ($0.05/$0.10 USD) - 2017/02/23 16:11:17 ET
Table 'Duhr II' 6-max Seat #6 is the button
Seat 1: Lucky HoBBiT ($10.93 in chips) 
Seat 2: Feverhead ($38.04 in chips) 
Seat 3: Smitty03300 ($10 in chips) 
Seat 4: CHRO8 ($9.85 in chips) 
Seat 5: Dimka4 ($10 in chips) 
Seat 6: townerz1991 ($11.28 in chips) 
Lucky HoBBiT: posts small blind $0.05
Feverhead: posts big blind $0.10
*** HOLE CARDS ***
Smitty03300: folds 
CHRO8: folds 
Dimka4: folds 
townerz1991: folds 
Lucky HoBBiT: raises $0.15 to $0.25
Feverhead: folds 
Uncalled bet ($0.15) returned to Lucky HoBBiT
Lucky HoBBiT collected $0.20 from pot
*** SUMMARY ***
Total pot $0.20 | Rake $0 
Seat 1: Lucky HoBBiT (small blind) collected ($0.20)
Seat 2: Feverhead (big blind) folded before Flop
Seat 3: Smitty03300 folded before Flop (didn't bet)
Seat 4: CHRO8 folded before Flop (didn't bet)
Seat 5: Dimka4 folded before Flop (didn't bet)
Seat 6: townerz1991 (button) folded before Flop (didn't bet)



PokerStars Hand #166667992663:  Hold'em No Limit ($0.05/$0.10 USD) - 2017/02/23 16:11:17 ET
Table 'Crocus' 6-max Seat #3 is the button
Seat 1: truck1234 ($25.81 in chips) 
Seat 2: garigura ($10.99 in chips) 
Seat 3: Yspenyanin ($10 in chips) 
Seat 4: patrick19111 ($12.66 in chips) 
Seat 5: FilK74 ($8 in chips) 
Seat 6: Rodik002 ($10.24 in chips) 
patrick19111: posts small blind $0.05
FilK74: posts big blind $0.10
*** HOLE CARDS ***
Rodik002: folds 
truck1234: folds 
garigura: folds 
Yspenyanin: raises $0.15 to $0.25
patrick19111: calls $0.20
FilK74: calls $0.15
*** FLOP *** [Kh 4d 3h]
patrick19111: checks 
FilK74: checks 
Yspenyanin: checks 
*** TURN *** [Kh 4d 3h] [5c]
patrick19111: checks 
FilK74: checks 
Yspenyanin: checks 
*** RIVER *** [Kh 4d 3h 5c] [9d]
patrick19111: checks 
FilK74: checks 
Yspenyanin: bets $0.36
patrick19111: folds 
FilK74: folds 
Uncalled bet ($0.36) returned to Yspenyanin
Yspenyanin collected $0.72 from pot
*** SUMMARY ***
Total pot $0.75 | Rake $0.03 
Board [Kh 4d 3h 5c 9d]
Seat 1: truck1234 folded before Flop (didn't bet)
Seat 2: garigura folded before Flop (didn't bet)
Seat 3: Yspenyanin (button) collected ($0.72)
Seat 4: patrick19111 (small blind) folded on the River
Seat 5: FilK74 (big blind) folded on the River
Seat 6: Rodik002 folded before Flop (didn't bet)



PokerStars Hand #166667992763:  Hold'em No Limit ($0.05/$0.10 USD) - 2017/02/23 16:11:17 ET
Table 'Apollonia' 6-max Seat #3 is the button
Seat 1: ex3Lero86 ($10 in chips) 
Seat 2: ibara000 ($17.85 in chips) 
Seat 3: steepfell ($10.38 in chips) 
Seat 4: Goroshkos88 ($17.91 in chips) 
Seat 5: bambolejro ($10 in chips) 
Seat 6: iluzja12 ($10.37 in chips) 
Goroshkos88: posts small blind $0.05
bambolejro: posts big blind $0.10
*** HOLE CARDS ***
iluzja12: folds 
ex3Lero86: folds 
ibara000: folds 
steepfell: raises $0.15 to $0.25
Goroshkos88: folds 
bambolejro: folds 
Uncalled bet ($0.15) returned to steepfell
steepfell collected $0.25 from pot
*** SUMMARY ***
Total pot $0.25 | Rake $0 
Seat 1: ex3Lero86 folded before Flop (didn't bet)
Seat 2: ibara000 folded before Flop (didn't bet)
Seat 3: steepfell (button) collected ($0.25)
Seat 4: Goroshkos88 (small blind) folded before Flop
Seat 5: bambolejro (big blind) folded before Flop
Seat 6: iluzja12 folded before Flop (didn't bet)



PokerStars Hand #166667992999:  Hold'em No Limit ($0.05/$0.10 USD) - 2017/02/23 16:11:17 ET
Table 'Nata II' 6-max Seat #2 is the button
Seat 1: luisantrs ($4.14 in chips) 
Seat 2: CHRO8 ($18.29 in chips) 
Seat 3: 8th wonders ($10 in chips) 
Seat 4: Comeback3392 ($14.97 in chips) 
Seat 5: RoJ1 ($11.28 in chips) 
8th wonders: posts small blind $0.05
Comeback3392: posts big blind $0.10
RGhearted: sits out 
*** HOLE CARDS ***
RoJ1: folds 
luisantrs: raises $0.10 to $0.20
CHRO8: folds 
8th wonders: calls $0.15
Comeback3392: folds 
*** FLOP *** [Ts 4h 4c]
8th wonders: checks 
luisantrs: checks 
*** TURN *** [Ts 4h 4c] [2s]
8th wonders: bets $0.70
luisantrs: folds 
Uncalled bet ($0.70) returned to 8th wonders
8th wonders collected $0.48 from pot
*** SUMMARY ***
Total pot $0.50 | Rake $0.02 
Board [Ts 4h 4c 2s]
Seat 1: luisantrs folded on the Turn
Seat 2: CHRO8 (button) folded before Flop (didn't bet)
Seat 3: 8th wonders (small blind) collected ($0.48)
Seat 4: Comeback3392 (big blind) folded before Flop
Seat 5: RoJ1 folded before Flop (didn't bet)



PokerStars Hand #166667993167:  Hold'em No Limit ($0.05/$0.10 USD) - 2017/02/23 16:11:18 ET
Table 'Epimetheus' 6-max Seat #3 is the button
Seat 1: 6ePeMeHHa9 ($10.29 in chips) 
Seat 2: patrick19111 ($15.91 in chips) 
Seat 3: dineldidi ($9.69 in chips) 
Seat 4: Namhkal ($10 in chips) 
Seat 5: afca128 ($24.18 in chips) 
Seat 6: voledy ($10.35 in chips) 
Namhkal: posts small blind $0.05
afca128: posts big blind $0.10
*** HOLE CARDS ***
voledy: folds 
6ePeMeHHa9: folds 
patrick19111: folds 
dineldidi: folds 
Namhkal: raises $0.15 to $0.25
afca128: raises $0.55 to $0.80
Namhkal: raises $1.10 to $1.90
afca128: calls $1.10
*** FLOP *** [6h Js 7d]
Namhkal: bets $1.70
afca128: calls $1.70
*** TURN *** [6h Js 7d] [5d]
Namhkal: checks 
afca128: bets $3.44
Namhkal: folds 
Uncalled bet ($3.44) returned to afca128
afca128 collected $6.88 from pot
*** SUMMARY ***
Total pot $7.20 | Rake $0.32 
Board [6h Js 7d 5d]
Seat 1: 6ePeMeHHa9 folded before Flop (didn't bet)
Seat 2: patrick19111 folded before Flop (didn't bet)
Seat 3: dineldidi (button) folded before Flop (didn't bet)
Seat 4: Namhkal (small blind) folded on the Turn
Seat 5: afca128 (big blind) collected ($6.88)
Seat 6: voledy folded before Flop (didn't bet)



PokerStars Hand #166667993209:  Hold'em No Limit ($0.05/$0.10 USD) - 2017/02/23 16:11:18 ET
Table 'Siebohme' 6-max Seat #2 is the button
Seat 1: kusa4ki ($11.53 in chips) 
Seat 2: el toro 1507 ($0.87 in chips) 
Seat 3: ex3Lero86 ($19.88 in chips) 
Seat 4: Kow6oy ($10 in chips) 
Seat 5: Kazacha ($10 in chips) 
Seat 6: townerz1991 ($10.28 in chips) 
ex3Lero86: posts small blind $0.05
Kow6oy: posts big blind $0.10
*** HOLE CARDS ***
Kazacha: raises $0.14 to $0.24
townerz1991: folds 
kusa4ki: folds 
el toro 1507: folds 
el toro 1507 leaves the table
ex3Lero86: folds 
nantes15 joins the table at seat #2 
Kow6oy: folds 
Uncalled bet ($0.14) returned to Kazacha
Kazacha collected $0.25 from pot
*** SUMMARY ***
Total pot $0.25 | Rake $0 
Seat 1: kusa4ki folded before Flop (didn't bet)
Seat 2: el toro 1507 (button) folded before Flop (didn't bet)
Seat 3: ex3Lero86 (small blind) folded before Flop
Seat 4: Kow6oy (big blind) folded before Flop
Seat 5: Kazacha collected ($0.25)
Seat 6: townerz1991 folded before Flop (didn't bet)



PokerStars Hand #166667993438:  Hold'em No Limit ($0.05/$0.10 USD) - 2017/02/23 16:11:18 ET
Table 'Krethon' 6-max Seat #4 is the button
Seat 1: boxer821 ($10.40 in chips) 
Seat 4: chimera252 ($14.79 in chips) 
Seat 5: popypaleta ($10.27 in chips) 
Seat 6: fabadam ($18.83 in chips) 
popypaleta: posts small blind $0.05
fabadam: posts big blind $0.10
*** HOLE CARDS ***
boxer821: folds 
chimera252: raises $0.15 to $0.25
popypaleta: raises $0.60 to $0.85
fabadam: folds 
chimera252: folds 
Uncalled bet ($0.60) returned to popypaleta
popypaleta collected $0.60 from pot
*** SUMMARY ***
Total pot $0.60 | Rake $0 
Seat 1: boxer821 folded before Flop (didn't bet)
Seat 4: chimera252 (button) folded before Flop
Seat 5: popypaleta (small blind) collected ($0.60)
Seat 6: fabadam (big blind) folded before Flop



PokerStars Hand #166667993487:  Hold'em No Limit ($0.05/$0.10 USD) - 2017/02/23 16:11:18 ET
Table 'Atropos' 6-max Seat #5 is the button
Seat 1: ScorpionF39 ($2.19 in chips) 
Seat 2: yodzik ($5.15 in chips) 
Seat 3: NvR.m1nD ($10.28 in chips) 
Seat 4: iDecMate ($11.33 in chips) 
Seat 5: KokoulinV ($11.64 in chips) 
ScorpionF39: posts small blind $0.05
yodzik: posts big blind $0.10
*** HOLE CARDS ***
NvR.m1nD: folds 
iDecMate: folds 
KokoulinV: folds 
ScorpionF39: raises $0.40 to $0.50
yodzik: folds 
Uncalled bet ($0.40) returned to ScorpionF39
ScorpionF39 collected $0.20 from pot
*** SUMMARY ***
Total pot $0.20 | Rake $0 
Seat 1: ScorpionF39 (small blind) collected ($0.20)
Seat 2: yodzik (big blind) folded before Flop
Seat 3: NvR.m1nD folded before Flop (didn't bet)
Seat 4: iDecMate folded before Flop (didn't bet)
Seat 5: KokoulinV (button) folded before Flop (didn't bet)



PokerStars Hand #166667993559:  Hold'em No Limit ($0.05/$0.10 USD) - 2017/02/23 16:11:18 ET
Table 'Kraz II' 6-max Seat #4 is the button
Seat 1: bdixon_5 ($9.25 in chips) 
Seat 2: shellyld ($10 in chips) 
Seat 3: Eddys Edge ($10 in chips) 
Seat 4: DrVzad ($9.85 in chips) 
Seat 5: Joker51_wtf! ($10 in chips) 
Joker51_wtf!: posts small blind $0.05
tr41n3r12: is sitting out 
tr41n3r12 leaves the table
bdixon_5: posts big blind $0.10
*** HOLE CARDS ***
Andrei ProFF joins the table at seat #6 
Andrei ProFF leaves the table
shellyld: folds 
Eddys Edge: folds 
DrVzad: raises $0.10 to $0.20
Joker51_wtf!: folds 
bdixon_5: calls $0.10
*** FLOP *** [Ac 8s Qs]
bdixon_5: bets $0.10
DrVzad: calls $0.10
*** TURN *** [Ac 8s Qs] [7d]
bdixon_5: checks 
DrVzad: bets $0.30
bdixon_5: folds 
Uncalled bet ($0.30) returned to DrVzad
DrVzad collected $0.62 from pot
*** SUMMARY ***
Total pot $0.65 | Rake $0.03 
Board [Ac 8s Qs 7d]
Seat 1: bdixon_5 (big blind) folded on the Turn
Seat 2: shellyld folded before Flop (didn't bet)
Seat 3: Eddys Edge folded before Flop (didn't bet)
Seat 4: DrVzad (button) collected ($0.62)
Seat 5: Joker51_wtf! (small blind) folded before Flop



PokerStars Hand #166667993647:  Hold'em No Limit ($0.05/$0.10 USD) - 2017/02/23 16:11:18 ET
Table 'Hestia' 6-max Seat #3 is the button
Seat 2: Kow6oy ($10.02 in chips) 
Seat 3: MBen10 ($13.23 in chips) 
Seat 5: CiisCi ($17.61 in chips) 
Lucky HoBBiT will be allowed to play after the button
CiisCi: posts small blind $0.05
Pekaml: is sitting out 
Kow6oy: posts big blind $0.10
Andrei ProFF joins the table at seat #6 
*** HOLE CARDS ***
MBen10: folds 
Andrei ProFF leaves the table
CiisCi: raises $0.10 to $0.20
Kow6oy: folds 
Uncalled bet ($0.10) returned to CiisCi
AIONCMA1988 joins the table at seat #6 
CiisCi collected $0.20 from pot
*** SUMMARY ***
Total pot $0.20 | Rake $0 
Seat 2: Kow6oy (big blind) folded before Flop
Seat 3: MBen10 (button) folded before Flop (didn't bet)
Seat 5: CiisCi (small blind) collected ($0.20)



PokerStars Hand #166667993695:  Hold'em No Limit ($0.05/$0.10 USD) - 2017/02/23 16:11:18 ET
Table 'Repsolda' 6-max Seat #4 is the button
Seat 1: fabadam ($10 in chips) 
Seat 2: MBen10 ($24.37 in chips) 
Seat 4: MihaGr ($13.85 in chips) 
Seat 5: matehouse. ($10 in chips) 
matehouse.: posts small blind $0.05
RkaczoR: is sitting out 
fabadam: posts big blind $0.10
Xander188: sits out 
*** HOLE CARDS ***
RkaczoR leaves the table
MBen10: raises $0.18 to $0.28
Crafty23@PS joins the table at seat #6 
MihaGr: folds 
matehouse.: folds 
fabadam: folds 
Uncalled bet ($0.18) returned to MBen10
MBen10 collected $0.25 from pot
*** SUMMARY ***
Total pot $0.25 | Rake $0 
Seat 1: fabadam (big blind) folded before Flop
Seat 2: MBen10 collected ($0.25)
Seat 4: MihaGr (button) folded before Flop (didn't bet)
Seat 5: matehouse. (small blind) folded before Flop



PokerStars Hand #166667993696:  Hold'em No Limit ($0.05/$0.10 USD) - 2017/02/23 16:11:18 ET
Table 'Emma II' 6-max Seat #3 is the button
Seat 1: LarryTheStar ($10.10 in chips) 
Seat 2: T9MS ($11.49 in chips) 
Seat 3: oddshoff ($10.07 in chips) 
Seat 4: Jucatorul823 ($6.36 in chips) 
Seat 5: Scanner17 ($10.83 in chips) 
Seat 6: CHRO8 ($14.37 in chips) 
Jucatorul823: posts small blind $0.05
Scanner17: posts big blind $0.10
*** HOLE CARDS ***
CHRO8: folds 
LarryTheStar: raises $0.20 to $0.30
T9MS: folds 
oddshoff: folds 
Jucatorul823: folds 
Scanner17: folds 
Uncalled bet ($0.20) returned to LarryTheStar
LarryTheStar collected $0.25 from pot
*** SUMMARY ***
Total pot $0.25 | Rake $0 
Seat 1: LarryTheStar collected ($0.25)
Seat 2: T9MS folded before Flop (didn't bet)
Seat 3: oddshoff (button) folded before Flop (didn't bet)
Seat 4: Jucatorul823 (small blind) folded before Flop
Seat 5: Scanner17 (big blind) folded before Flop
Seat 6: CHRO8 folded before Flop (didn't bet)



PokerStars Hand #166667993869:  Hold'em No Limit ($0.05/$0.10 USD) - 2017/02/23 16:11:18 ET
Table 'Giclas' 6-max Seat #4 is the button
Seat 2: Crafty23@PS ($10 in chips) 
Seat 3: fidas1972 ($3.92 in chips) 
Seat 4: Eddys Edge ($13.79 in chips) 
Seat 5: dedea1989 ($37.29 in chips) 
Seat 6: eniksenik ($14.73 in chips) 
dedea1989: posts small blind $0.05
eniksenik: posts big blind $0.10
WinninBikini: sits out 
*** HOLE CARDS ***
Crafty23@PS: folds 
fidas1972: calls $0.10
Crafty23@PS leaves the table
Eddys Edge: raises $0.30 to $0.40
dedea1989: calls $0.35
eniksenik: calls $0.30
RoJ1 joins the table at seat #2 
fidas1972: raises $3.52 to $3.92 and is all-in
Eddys Edge: calls $3.52
dedea1989: calls $3.52
eniksenik: folds 
*** FLOP *** [Js Jh 8d]
dedea1989: checks 
Eddys Edge: bets $7.74
dedea1989: folds 
Uncalled bet ($7.74) returned to Eddys Edge
*** TURN *** [Js Jh 8d] [7h]
*** RIVER *** [Js Jh 8d 7h] [Jd]
*** SHOW DOWN ***
fidas1972: shows [3h 3s] (a full house, Jacks full of Threes)
Eddys Edge: shows [Ac As] (a full house, Jacks full of Aces)
Eddys Edge collected $11.61 from pot
*** SUMMARY ***
Total pot $12.16 | Rake $0.55 
Board [Js Jh 8d 7h Jd]
Seat 2: Crafty23@PS folded before Flop (didn't bet)
Seat 3: fidas1972 showed [3h 3s] and lost with a full house, Jacks full of Threes
Seat 4: Eddys Edge (button) showed [Ac As] and won ($11.61) with a full house, Jacks full of Aces
Seat 5: dedea1989 (small blind) folded on the Flop
Seat 6: eniksenik (big blind) folded before Flop



PokerStars Hand #166667993895:  Hold'em No Limit ($0.05/$0.10 USD) - 2017/02/23 16:11:19 ET
Table 'Hirons' 6-max Seat #1 is the button
Seat 1: RoJ1 ($12.19 in chips) 
Seat 2: coolisses111 ($9.90 in chips) 
Seat 3: czeczen7 ($13.66 in chips) 
Seat 4: Smitty03300 ($11.75 in chips) 
Seat 5: Pekaml ($10 in chips) 
Seat 6: garigura ($13.48 in chips) 
coolisses111: posts small blind $0.05
czeczen7: posts big blind $0.10
*** HOLE CARDS ***
Smitty03300: folds 
Pekaml: folds 
garigura: raises $0.15 to $0.25
RoJ1: folds 
coolisses111: folds 
czeczen7: calls $0.15
*** FLOP *** [6c Jc Qd]
czeczen7: checks 
garigura: bets $0.40
czeczen7: folds 
Uncalled bet ($0.40) returned to garigura
garigura collected $0.53 from pot
*** SUMMARY ***
Total pot $0.55 | Rake $0.02 
Board [6c Jc Qd]
Seat 1: RoJ1 (button) folded before Flop (didn't bet)
Seat 2: coolisses111 (small blind) folded before Flop
Seat 3: czeczen7 (big blind) folded on the Flop
Seat 4: Smitty03300 folded before Flop (didn't bet)
Seat 5: Pekaml folded before Flop (didn't bet)
Seat 6: garigura collected ($0.53)



PokerStars Hand #166667994097:  Hold'em No Limit ($0.05/$0.10 USD) - 2017/02/23 16:11:19 ET
Table 'Phereclos II' 6-max Seat #2 is the button
Seat 1: Vladu1986 ($10.15 in chips) 
Seat 2: Kazacha ($15.48 in chips) 
Seat 3: overbet666 ($10 in chips) 
Seat 4: Lucky HoBBiT ($10 in chips) 
Seat 5: crazydevill ($12.24 in chips) 
Seat 6: mhonielsen ($16.49 in chips) 
overbet666: posts small blind $0.05
Lucky HoBBiT: posts big blind $0.10
*** HOLE CARDS ***
crazydevill: folds 
mhonielsen: raises $0.20 to $0.30
Vladu1986: folds 
Kazacha: folds 
overbet666: folds 
Lucky HoBBiT: folds 
Uncalled bet ($0.20) returned to mhonielsen
mhonielsen collected $0.25 from pot
*** SUMMARY ***
Total pot $0.25 | Rake $0 
Seat 1: Vladu1986 folded before Flop (didn't bet)
Seat 2: Kazacha (button) folded before Flop (didn't bet)
Seat 3: overbet666 (small blind) folded before Flop
Seat 4: Lucky HoBBiT (big blind) folded before Flop
Seat 5: crazydevill folded before Flop (didn't bet)
Seat 6: mhonielsen collected ($0.25)



PokerStars Hand #166667994209:  Hold'em No Limit ($0.05/$0.10 USD) - 2017/02/23 16:11:19 ET
Table 'Esperanto II' 6-max Seat #1 is the button
Seat 1: kurasd ($9.40 in chips) 
Seat 2: MihaGr ($10.39 in chips) 
Seat 3: Namhkal ($11.05 in chips) 
Seat 4: Andrei ProFF ($10 in chips) 
Seat 5: FRAID358 ($12.33 in chips) 
Seat 6: ArcticBearDK ($13.50 in chips) 
MihaGr: posts small blind $0.05
Namhkal: posts big blind $0.10
*** HOLE CARDS ***
Andrei ProFF: folds 
FRAID358: folds 
ArcticBearDK: folds 
kurasd: folds 
MihaGr: folds 
Uncalled bet ($0.05) returned to Namhkal
Namhkal collected $0.10 from pot
*** SUMMARY ***
Total pot $0.10 | Rake $0 
Seat 1: kurasd (button) folded before Flop (didn't bet)
Seat 2: MihaGr (small blind) folded before Flop
Seat 3: Namhkal (big blind) collected ($0.10)
Seat 4: Andrei ProFF folded before Flop (didn't bet)
Seat 5: FRAID358 folded before Flop (didn't bet)
Seat 6: ArcticBearDK folded before Flop (didn't bet)



PokerStars Hand #166667994258:  Hold'em No Limit ($0.05/$0.10 USD) - 2017/02/23 16:11:19 ET
Table 'Halawe II' 6-max Seat #6 is the button
Seat 1: DIGOR100 ($6.41 in chips) 
Seat 3: cherep61987 ($10.39 in chips) 
Seat 4: voledy ($12 in chips) 
Seat 5: takis nik ($12.68 in chips) 
Seat 6: Rodik002 ($21.30 in chips) 
DIGOR100: posts small blind $0.05
cherep61987: posts big blind $0.10
*** HOLE CARDS ***
voledy: folds 
takis nik: folds 
Rodik002: folds 
DIGOR100: calls $0.05
cherep61987: raises $0.20 to $0.30
DIGOR100: calls $0.20
*** FLOP *** [Qd Qh 6c]
DIGOR100: checks 
cherep61987: bets $0.34
DIGOR100: folds 
Uncalled bet ($0.34) returned to cherep61987
cherep61987 collected $0.57 from pot
*** SUMMARY ***
Total pot $0.60 | Rake $0.03 
Board [Qd Qh 6c]
Seat 1: DIGOR100 (small blind) folded on the Flop
Seat 3: cherep61987 (big blind) collected ($0.57)
Seat 4: voledy folded before Flop (didn't bet)
Seat 5: takis nik folded before Flop (didn't bet)
Seat 6: Rodik002 (button) folded before Flop (didn't bet)



PokerStars Hand #166667994401:  Hold'em No Limit ($0.05/$0.10 USD) - 2017/02/23 16:11:19 ET
Table 'Glarona' 6-max Seat #1 is the button
Seat 1: LarryTheStar ($10 in chips) 
Seat 2: BookWorm78 ($10.30 in chips) 
Seat 3: gaHy_HaXeP ($10 in chips) 
Seat 4: CrippledGod ($7.04 in chips) 
Seat 6: marianoboni ($10 in chips) 
BookWorm78: posts small blind $0.05
gaHy_HaXeP: posts big blind $0.10
*** HOLE CARDS ***
CrippledGod: folds 
marianoboni: raises $0.24 to $0.34
LarryTheStar: folds 
BookWorm78: folds 
gaHy_HaXeP: folds 
Uncalled bet ($0.24) returned to marianoboni
marianoboni collected $0.25 from pot
*** SUMMARY ***
Total pot $0.25 | Rake $0 
Seat 1: LarryTheStar (button) folded before Flop (didn't bet)
Seat 2: BookWorm78 (small blind) folded before Flop
Seat 3: gaHy_HaXeP (big blind) folded before Flop
Seat 4: CrippledGod folded before Flop (didn't bet)
Seat 6: marianoboni collected ($0.25)



PokerStars Hand #166667994581:  Hold'em No Limit ($0.05/$0.10 USD) - 2017/02/23 16:11:19 ET
Table 'Alnasl' 6-max Seat #2 is the button
Seat 2: saddur ($8.94 in chips) 
Seat 3: KRZuff ($10.05 in chips) 
Seat 4: oddshoff ($10.50 in chips) 
Seat 5: 6ePeMeHHa9 ($10 in chips) 
Seat 6: Zooplack ($13.58 in chips) 
KRZuff: posts small blind $0.05
oddshoff: posts big blind $0.10
RoJ1: sits out 
*** HOLE CARDS ***
6ePeMeHHa9: raises $0.19 to $0.29
Zooplack: folds 
saddur: folds 
KRZuff: folds 
oddshoff: calls $0.19
*** FLOP *** [9s 3s 8h]
oddshoff: checks 
6ePeMeHHa9: checks 
*** TURN *** [9s 3s 8h] [7s]
oddshoff: bets $0.40
6ePeMeHHa9: folds 
Uncalled bet ($0.40) returned to oddshoff
oddshoff collected $0.60 from pot
*** SUMMARY ***
Total pot $0.63 | Rake $0.03 
Board [9s 3s 8h 7s]
Seat 2: saddur (button) folded before Flop (didn't bet)
Seat 3: KRZuff (small blind) folded before Flop
Seat 4: oddshoff (big blind) collected ($0.60)
Seat 5: 6ePeMeHHa9 folded on the Turn
Seat 6: Zooplack folded before Flop (didn't bet)



PokerStars Hand #166667994619:  Hold'em No Limit ($0.05/$0.10 USD) - 2017/02/23 16:11:19 ET
Table 'Hajek III' 6-max Seat #1 is the button
Seat 1: MBen10 ($12.01 in chips) 
Seat 2: fortieth ($9.66 in chips) 
Seat 5: Chrips ($10.15 in chips) 
Seat 6: fabadam ($22.80 in chips) 
fortieth: posts small blind $0.05
fedorka rus: is sitting out 
NvR.m1nD: is sitting out 
Chrips: posts big blind $0.10
*** HOLE CARDS ***
NvR.m1nD leaves the table
fabadam: folds 
Bandyaev joins the table at seat #4 
Bandyaev leaves the table
MBen10: folds 
KRZuff joins the table at seat #4 
fortieth: folds 
Uncalled bet ($0.05) returned to Chrips
Chrips collected $0.10 from pot
*** SUMMARY ***
Total pot $0.10 | Rake $0 
Seat 1: MBen10 (button) folded before Flop (didn't bet)
Seat 2: fortieth (small blind) folded before Flop
Seat 5: Chrips (big blind) collected ($0.10)
Seat 6: fabadam folded before Flop (didn't bet)



PokerStars Hand #166667995358:  Hold'em No Limit ($0.05/$0.10 USD) - 2017/02/23 16:11:20 ET
Table 'Pandora III' 6-max Seat #4 is the button
Seat 1: Pokeaster ($11.24 in chips) 
Seat 2: garigura ($11.54 in chips) 
Seat 3: Chodemuncher ($10 in chips) 
Seat 4: mhonielsen ($10.15 in chips) 
Seat 5: MühliJr ($10.47 in chips) 
Seat 6: yodzik ($5.32 in chips) 
MühliJr: posts small blind $0.05
yodzik: posts big blind $0.10
*** HOLE CARDS ***
Pokeaster: folds 
garigura: folds 
Chodemuncher: folds 
mhonielsen: raises $0.10 to $0.20
MühliJr: folds 
yodzik: folds 
Uncalled bet ($0.10) returned to mhonielsen
mhonielsen collected $0.25 from pot
*** SUMMARY ***
Total pot $0.25 | Rake $0 
Seat 1: Pokeaster folded before Flop (didn't bet)
Seat 2: garigura folded before Flop (didn't bet)
Seat 3: Chodemuncher folded before Flop (didn't bet)
Seat 4: mhonielsen (button) collected ($0.25)
Seat 5: MühliJr (small blind) folded before Flop
Seat 6: yodzik (big blind) folded before Flop



PokerStars Hand #166667995697:  Hold'em No Limit ($0.05/$0.10 USD) - 2017/02/23 16:11:21 ET
Table 'Nehalennia III' 6-max Seat #4 is the button
Seat 1: boxer821 ($11.01 in chips) 
Seat 2: fortieth ($10.30 in chips) 
Seat 3: ValdemorS ($19.51 in chips) 
Seat 4: eniksenik ($10.75 in chips) 
Seat 5: ChuikaPridi ($10 in chips) 
Seat 6: valzeny ($20.46 in chips) 
ChuikaPridi: posts small blind $0.05
valzeny: posts big blind $0.10
boxer821: posts the ante $0.02
fortieth: posts the ante $0.02
ValdemorS: posts the ante $0.02
eniksenik: posts the ante $0.02
ChuikaPridi: posts the ante $0.02
valzeny: posts the ante $0.02
*** HOLE CARDS ***
boxer821: folds 
fortieth: folds 
ValdemorS: raises $0.20 to $0.30
eniksenik: folds 
ChuikaPridi: folds 
valzeny: folds 
Uncalled bet ($0.20) returned to ValdemorS
ValdemorS collected $0.37 from pot
*** SUMMARY ***
Total pot $0.37 | Rake $0 
Seat 1: boxer821 folded before Flop (didn't bet)
Seat 2: fortieth folded before Flop (didn't bet)
Seat 3: ValdemorS collected ($0.37)
Seat 4: eniksenik (button) folded before Flop (didn't bet)
Seat 5: ChuikaPridi (small blind) folded before Flop
Seat 6: valzeny (big blind) folded before Flop



PokerStars Hand #166667995969:  Hold'em No Limit ($0.05/$0.10 USD) - 2017/02/23 16:11:21 ET
Table 'Nymphe II' 6-max Seat #3 is the button
Seat 1: jacktayra ($1.63 in chips) 
Seat 2: Newqbrown ($12.11 in chips) 
Seat 3: THIMUCHIN ($15.45 in chips) 
Seat 4: coolisses111 ($17.05 in chips) 
Seat 5: AC Evergreen ($10 in chips) 
Seat 6: Xander188 ($10 in chips) 
coolisses111: posts small blind $0.05
AC Evergreen: posts big blind $0.10
*** HOLE CARDS ***
Xander188: folds 
jacktayra: calls $0.10
Newqbrown: folds 
THIMUCHIN: folds 
coolisses111: folds 
AC Evergreen: checks 
*** FLOP *** [3d 8d 6d]
AC Evergreen: checks 
jacktayra: checks 
*** TURN *** [3d 8d 6d] [2h]
AC Evergreen: checks 
jacktayra: checks 
*** RIVER *** [3d 8d 6d 2h] [9c]
AC Evergreen: checks 
jacktayra: checks 
*** SHOW DOWN ***
AC Evergreen: shows [As 4s] (high card Ace)
jacktayra: mucks hand 
AC Evergreen collected $0.24 from pot
*** SUMMARY ***
Total pot $0.25 | Rake $0.01 
Board [3d 8d 6d 2h 9c]
Seat 1: jacktayra mucked
Seat 2: Newqbrown folded before Flop (didn't bet)
Seat 3: THIMUCHIN (button) folded before Flop (didn't bet)
Seat 4: coolisses111 (small blind) folded before Flop
Seat 5: AC Evergreen (big blind) showed [As 4s] and won ($0.24) with high card Ace
Seat 6: Xander188 folded before Flop (didn't bet)



PokerStars Hand #166667996058:  Hold'em No Limit ($0.05/$0.10 USD) - 2017/02/23 16:11:21 ET
Table 'Pyrrhus III' 6-max Seat #2 is the button
Seat 2: univibe68 ($26.38 in chips) 
Seat 3: coolisses111 ($9.73 in chips) 
Seat 4: ex3Lero86 ($13.73 in chips) 
Seat 5: eniksenik ($10.46 in chips) 
Seat 6: MLPlayer16 ($22.21 in chips) 
coolisses111: posts small blind $0.05
ex3Lero86: posts big blind $0.10
univibe68: posts the ante $0.02
coolisses111: posts the ante $0.02
ex3Lero86: posts the ante $0.02
eniksenik: posts the ante $0.02
MLPlayer16: posts the ante $0.02
*** HOLE CARDS ***
eniksenik: folds 
MLPlayer16: folds 
univibe68: raises $0.10 to $0.20
coolisses111: folds 
ex3Lero86: folds 
Uncalled bet ($0.10) returned to univibe68
univibe68 collected $0.35 from pot
*** SUMMARY ***
Total pot $0.35 | Rake $0 
Seat 2: univibe68 (button) collected ($0.35)
Seat 3: coolisses111 (small blind) folded before Flop
Seat 4: ex3Lero86 (big blind) folded before Flop
Seat 5: eniksenik folded before Flop (didn't bet)
Seat 6: MLPlayer16 folded before Flop (didn't bet)



PokerStars Hand #166667996315:  Hold'em No Limit ($0.05/$0.10 USD) - 2017/02/23 16:11:21 ET
Table 'Crommelin II' 6-max Seat #1 is the button
Seat 1: THIMUCHIN ($19.10 in chips) 
Seat 2: Bird et al ($10 in chips) 
Seat 3: Strelok1974 ($22.88 in chips) 
Seat 4: Pequeño Clau ($12.82 in chips) 
Seat 5: Action_Gibi ($19.15 in chips) 
Bird et al: posts small blind $0.05
Strelok1974: posts big blind $0.10
*** HOLE CARDS ***
Pequeño Clau: folds 
Action_Gibi: folds 
THIMUCHIN: folds 
Bird et al: raises $0.20 to $0.30
Strelok1974: folds 
Uncalled bet ($0.20) returned to Bird et al
Bird et al collected $0.20 from pot
*** SUMMARY ***
Total pot $0.20 | Rake $0 
Seat 1: THIMUCHIN (button) folded before Flop (didn't bet)
Seat 2: Bird et al (small blind) collected ($0.20)
Seat 3: Strelok1974 (big blind) folded before Flop
Seat 4: Pequeño Clau folded before Flop (didn't bet)
Seat 5: Action_Gibi folded before Flop (didn't bet)



PokerStars Hand #166667996525:  Hold'em No Limit ($0.05/$0.10 USD) - 2017/02/23 16:11:21 ET
Table 'Grietje' 6-max Seat #6 is the button
Seat 1: dragonste89 ($10 in chips) 
Seat 2: Feverhead ($10 in chips) 
Seat 3: GitoValdivia ($8.03 in chips) 
Seat 4: MihaGr ($10.56 in chips) 
Seat 5: iThreeBarrel ($10 in chips) 
Seat 6: Prometheu$8 ($37.60 in chips) 
dragonste89: posts small blind $0.05
Feverhead: posts big blind $0.10
*** HOLE CARDS ***
GitoValdivia: folds 
MihaGr: folds 
iThreeBarrel: folds 
Prometheu$8: raises $0.13 to $0.23
dragonste89: folds 
Feverhead: folds 
Uncalled bet ($0.13) returned to Prometheu$8
Prometheu$8 collected $0.25 from pot
*** SUMMARY ***
Total pot $0.25 | Rake $0 
Seat 1: dragonste89 (small blind) folded before Flop
Seat 2: Feverhead (big blind) folded before Flop
Seat 3: GitoValdivia folded before Flop (didn't bet)
Seat 4: MihaGr folded before Flop (didn't bet)
Seat 5: iThreeBarrel folded before Flop (didn't bet)
Seat 6: Prometheu$8 (button) collected ($0.25)



PokerStars Hand #166667997032:  Hold'em No Limit ($0.05/$0.10 USD) - 2017/02/23 16:11:22 ET
Table 'Cuyo' 6-max Seat #6 is the button
Seat 1: Bandyaev ($11.59 in chips) 
Seat 2: Therodorus ($10.47 in chips) 
Seat 3: Hergie88 ($9.32 in chips) 
Seat 4: bambolejro ($10 in chips) 
Seat 5: DrVzad ($9.85 in chips) 
Seat 6: iluzja12 ($9.65 in chips) 
Bandyaev: posts small blind $0.05
Therodorus: posts big blind $0.10
*** HOLE CARDS ***
Hergie88: folds 
bambolejro: folds 
DrVzad: folds 
iluzja12: folds 
Bandyaev: folds 
Uncalled bet ($0.05) returned to Therodorus
Therodorus collected $0.10 from pot
*** SUMMARY ***
Total pot $0.10 | Rake $0 
Seat 1: Bandyaev (small blind) folded before Flop
Seat 2: Therodorus (big blind) collected ($0.10)
Seat 3: Hergie88 folded before Flop (didn't bet)
Seat 4: bambolejro folded before Flop (didn't bet)
Seat 5: DrVzad folded before Flop (didn't bet)
Seat 6: iluzja12 (button) folded before Flop (didn't bet)



PokerStars Hand #166667997046:  Hold'em No Limit ($0.05/$0.10 USD) - 2017/02/23 16:11:22 ET
Table 'Sirius II' 6-max Seat #6 is the button
Seat 1: Cluckh ($10.32 in chips) 
Seat 2: Buddy8711 ($8.53 in chips) 
Seat 3: Spud014 ($10 in chips) 
Seat 4: Pekaml ($10.15 in chips) 
Seat 5: manashov ($10.27 in chips) 
Seat 6: MihaGr ($10 in chips) 
Cluckh: posts small blind $0.05
Buddy8711: posts big blind $0.10
*** HOLE CARDS ***
Spud014: folds 
Pekaml: folds 
manashov: raises $0.20 to $0.30
MihaGr: folds 
Cluckh: folds 
Buddy8711: calls $0.20
*** FLOP *** [Td 7c Ks]
Buddy8711: bets $0.60
manashov: calls $0.60
*** TURN *** [Td 7c Ks] [3c]
Buddy8711: bets $0.60
manashov: calls $0.60
*** RIVER *** [Td 7c Ks 3c] [6s]
Buddy8711: checks 
manashov: bets $1.60
Buddy8711: folds [Kh]
Uncalled bet ($1.60) returned to manashov
manashov collected $2.91 from pot
*** SUMMARY ***
Total pot $3.05 | Rake $0.14 
Board [Td 7c Ks 3c 6s]
Seat 1: Cluckh (small blind) folded before Flop
Seat 2: Buddy8711 (big blind) folded on the River
Seat 3: Spud014 folded before Flop (didn't bet)
Seat 4: Pekaml folded before Flop (didn't bet)
Seat 5: manashov collected ($2.91)
Seat 6: MihaGr (button) folded before Flop (didn't bet)



PokerStars Hand #166667997223:  Hold'em No Limit ($0.05/$0.10 USD) - 2017/02/23 16:11:22 ET
Table 'Pirola III' 6-max Seat #1 is the button
Seat 1: bdixon_5 ($10.53 in chips) 
Seat 2: Chodemuncher ($10 in chips) 
Seat 3: kingartur222 ($9.60 in chips) 
Seat 6: T9MS ($13.16 in chips) 
Chodemuncher: posts small blind $0.05
kingartur222: posts big blind $0.10
steeev084: sits out 
IAntikI: sits out 
*** HOLE CARDS ***
T9MS: folds 
bdixon_5: folds 
Chodemuncher: raises $0.20 to $0.30
kingartur222: calls $0.20
*** FLOP *** [Ad Td Th]
Chodemuncher: checks 
kingartur222: bets $0.30
Chodemuncher: folds 
Uncalled bet ($0.30) returned to kingartur222
kingartur222 collected $0.57 from pot
*** SUMMARY ***
Total pot $0.60 | Rake $0.03 
Board [Ad Td Th]
Seat 1: bdixon_5 (button) folded before Flop (didn't bet)
Seat 2: Chodemuncher (small blind) folded on the Flop
Seat 3: kingartur222 (big blind) collected ($0.57)
Seat 6: T9MS folded before Flop (didn't bet)



PokerStars Hand #166667997330:  Hold'em No Limit ($0.05/$0.10 USD) - 2017/02/23 16:11:22 ET
Table 'Aludra II' 6-max Seat #4 is the button
Seat 1: voledy ($10.15 in chips) 
Seat 2: JahSoldier69 ($13.93 in chips) 
Seat 3: mbkongstad ($9.85 in chips) 
Seat 4: MihaGr ($10 in chips) 
Seat 5: kingartur222 ($16.07 in chips) 
Seat 6: call me haaa ($14.99 in chips) 
kingartur222: posts small blind $0.05
call me haaa: posts big blind $0.10
*** HOLE CARDS ***
voledy: folds 
JahSoldier69: folds 
mbkongstad: folds 
MihaGr: folds 
kingartur222: raises $0.19 to $0.29
call me haaa: folds 
Uncalled bet ($0.19) returned to kingartur222
kingartur222 collected $0.20 from pot
*** SUMMARY ***
Total pot $0.20 | Rake $0 
Seat 1: voledy folded before Flop (didn't bet)
Seat 2: JahSoldier69 folded before Flop (didn't bet)
Seat 3: mbkongstad folded before Flop (didn't bet)
Seat 4: MihaGr (button) folded before Flop (didn't bet)
Seat 5: kingartur222 (small blind) collected ($0.20)
Seat 6: call me haaa (big blind) folded before Flop



PokerStars Hand #166667997430:  Hold'em No Limit ($0.05/$0.10 USD) - 2017/02/23 16:11:23 ET
Table 'Anhui II' 6-max Seat #1 is the button
Seat 1: kingartur222 ($17.90 in chips) 
Seat 2: kikus334 ($11.07 in chips) 
Seat 3: lochniak556 ($21.22 in chips) 
Seat 4: dragonste89 ($10 in chips) 
Seat 5: Bandyaev ($12.70 in chips) 
Seat 6: .BaRReL.1122 ($3.75 in chips) 
kikus334: posts small blind $0.05
lochniak556: posts big blind $0.10
*** HOLE CARDS ***
dragonste89: folds 
Bandyaev: folds 
.BaRReL.1122: folds 
kingartur222: folds 
kikus334: calls $0.05
lochniak556: raises $0.30 to $0.40
kikus334: calls $0.30
*** FLOP *** [Ad Ts Jh]
kikus334: checks 
lochniak556: bets $0.60
kikus334: folds 
Uncalled bet ($0.60) returned to lochniak556
.BaRReL.1122 said, "dwa razy pod rzad pasowalem takie karty ze po flopie bylem raczej najsilniejsze..."
lochniak556 collected $0.76 from pot
*** SUMMARY ***
Total pot $0.80 | Rake $0.04 
Board [Ad Ts Jh]
Seat 1: kingartur222 (button) folded before Flop (didn't bet)
Seat 2: kikus334 (small blind) folded on the Flop
Seat 3: lochniak556 (big blind) collected ($0.76)
Seat 4: dragonste89 folded before Flop (didn't bet)
Seat 5: Bandyaev folded before Flop (didn't bet)
Seat 6: .BaRReL.1122 folded before Flop (didn't bet)



PokerStars Hand #166667997466:  Hold'em No Limit ($0.05/$0.10 USD) - 2017/02/23 16:11:23 ET
Table 'Gyldenia II' 6-max Seat #6 is the button
Seat 1: KokoulinV ($11.34 in chips) 
Seat 2: Kow6oy ($10 in chips) 
Seat 3: mhonielsen ($10.25 in chips) 
Seat 5: CHRO8 ($15.84 in chips) 
Seat 6: 8th wonders ($11.33 in chips) 
KokoulinV: posts small blind $0.05
Kow6oy: posts big blind $0.10
univibe68: sits out 
*** HOLE CARDS ***
mhonielsen: raises $0.30 to $0.40
CHRO8: folds 
8th wonders: folds 
KokoulinV: folds 
Kow6oy: folds 
Uncalled bet ($0.30) returned to mhonielsen
mhonielsen collected $0.25 from pot
*** SUMMARY ***
Total pot $0.25 | Rake $0 
Seat 1: KokoulinV (small blind) folded before Flop
Seat 2: Kow6oy (big blind) folded before Flop
Seat 3: mhonielsen collected ($0.25)
Seat 5: CHRO8 folded before Flop (didn't bet)
Seat 6: 8th wonders (button) folded before Flop (didn't bet)



PokerStars Hand #166667997885:  Hold'em No Limit ($0.05/$0.10 USD) - 2017/02/23 16:11:23 ET
Table 'Iapetus III' 6-max Seat #1 is the button
Seat 1: Czezar Life ($6.44 in chips) 
Seat 2: Crafty23@PS ($10 in chips) 
Seat 3: Goroshkos88 ($10.20 in chips) 
Seat 4: Raggibest ($8.57 in chips) 
Seat 5: homelessdan ($15.49 in chips) 
Seat 6: tauronex ($10.10 in chips) 
Crafty23@PS: posts small blind $0.05
Goroshkos88: posts big blind $0.10
*** HOLE CARDS ***
Raggibest: calls $0.10
homelessdan: folds 
tauronex: raises $0.20 to $0.30
Czezar Life: folds 
Crafty23@PS: folds 
Goroshkos88: folds 
Raggibest: folds 
Uncalled bet ($0.20) returned to tauronex
tauronex collected $0.35 from pot
*** SUMMARY ***
Total pot $0.35 | Rake $0 
Seat 1: Czezar Life (button) folded before Flop (didn't bet)
Seat 2: Crafty23@PS (small blind) folded before Flop
Seat 3: Goroshkos88 (big blind) folded before Flop
Seat 4: Raggibest folded before Flop
Seat 5: homelessdan folded before Flop (didn't bet)
Seat 6: tauronex collected ($0.35)



PokerStars Hand #166667997887:  Hold'em No Limit ($0.05/$0.10 USD) - 2017/02/23 16:11:23 ET
Table 'Nauheima II' 6-max Seat #1 is the button
Seat 1: HARDCORE66RU ($17.89 in chips) 
Seat 2: Peter0087 ($10.32 in chips) 
Seat 3: KokoulinV ($13.60 in chips) 
Seat 5: bambolejro ($10 in chips) 
Seat 6: bonyo71 ($5.04 in chips) 
Peter0087: posts small blind $0.05
KokoulinV: posts big blind $0.10
martijn091: sits out 
*** HOLE CARDS ***
bambolejro: folds 
bonyo71: raises $0.20 to $0.30
HARDCORE66RU: folds 
Peter0087: folds 
KokoulinV: folds 
Uncalled bet ($0.20) returned to bonyo71
bonyo71 collected $0.25 from pot
*** SUMMARY ***
Total pot $0.25 | Rake $0 
Seat 1: HARDCORE66RU (button) folded before Flop (didn't bet)
Seat 2: Peter0087 (small blind) folded before Flop
Seat 3: KokoulinV (big blind) folded before Flop
Seat 5: bambolejro folded before Flop (didn't bet)
Seat 6: bonyo71 collected ($0.25)



PokerStars Hand #166667997942:  Hold'em No Limit ($0.05/$0.10 USD) - 2017/02/23 16:11:23 ET
Table 'Euryalos II' 6-max Seat #4 is the button
Seat 2: silsilviu ($17.24 in chips) 
Seat 3: Hyd SK ($10.35 in chips) 
Seat 4: popypaleta ($11.78 in chips) 
Seat 6: MihaGr ($10 in chips) 
MihaGr: posts small blind $0.05
silsilviu: posts big blind $0.10
*** HOLE CARDS ***
Hyd SK: folds 
popypaleta: folds 
MihaGr: folds 
Uncalled bet ($0.05) returned to silsilviu
silsilviu collected $0.10 from pot
*** SUMMARY ***
Total pot $0.10 | Rake $0 
Seat 2: silsilviu (big blind) collected ($0.10)
Seat 3: Hyd SK folded before Flop (didn't bet)
Seat 4: popypaleta (button) folded before Flop (didn't bet)
Seat 6: MihaGr (small blind) folded before Flop



PokerStars Hand #166667998159:  Hold'em No Limit ($0.05/$0.10 USD) - 2017/02/23 16:11:23 ET
Table 'Stroobantia' 6-max Seat #2 is the button
Seat 1: mam9zyc ($10.37 in chips) 
Seat 2: XwinX25 ($10 in chips) 
Seat 3: Namhkal ($10.95 in chips) 
Seat 4: Yspenyanin ($10.60 in chips) 
Seat 5: boxer821 ($10.84 in chips) 
Seat 6: KokoulinV ($15.52 in chips) 
Namhkal: posts small blind $0.05
Yspenyanin: posts big blind $0.10
*** HOLE CARDS ***
boxer821: folds 
KokoulinV: folds 
mam9zyc: calls $0.10
XwinX25: folds 
Namhkal: folds 
Yspenyanin: checks 
*** FLOP *** [Ts 8h 9c]
Yspenyanin: bets $0.10
mam9zyc: folds 
Uncalled bet ($0.10) returned to Yspenyanin
Yspenyanin collected $0.24 from pot
*** SUMMARY ***
Total pot $0.25 | Rake $0.01 
Board [Ts 8h 9c]
Seat 1: mam9zyc folded on the Flop
Seat 2: XwinX25 (button) folded before Flop (didn't bet)
Seat 3: Namhkal (small blind) folded before Flop
Seat 4: Yspenyanin (big blind) collected ($0.24)
Seat 5: boxer821 folded before Flop (didn't bet)
Seat 6: KokoulinV folded before Flop (didn't bet)



PokerStars Hand #166667998173:  Hold'em No Limit ($0.05/$0.10 USD) - 2017/02/23 16:11:23 ET
Table 'Pompeja III' 6-max Seat #6 is the button
Seat 2: steepfell ($10.47 in chips) 
Seat 3: Yspenyanin ($12.61 in chips) 
Seat 4: BgdAlex117 ($10 in chips) 
Seat 5: Spud014 ($12.30 in chips) 
Seat 6: mega spasser ($4.65 in chips) 
steepfell: posts small blind $0.05
Yspenyanin: posts big blind $0.10
BgdAlex117: posts big blind $0.10
*** HOLE CARDS ***
BgdAlex117: checks 
Spud014: folds 
mega spasser: calls $0.10
steepfell: raises $0.45 to $0.55
Yspenyanin: folds 
BgdAlex117: folds 
mega spasser: calls $0.45
*** FLOP *** [Kd Jd Th]
steepfell: bets $0.83
mega spasser: calls $0.83
*** TURN *** [Kd Jd Th] [5s]
steepfell: bets $3.45
mega spasser: folds 
Uncalled bet ($3.45) returned to steepfell
steepfell collected $2.83 from pot
*** SUMMARY ***
Total pot $2.96 | Rake $0.13 
Board [Kd Jd Th 5s]
Seat 2: steepfell (small blind) collected ($2.83)
Seat 3: Yspenyanin (big blind) folded before Flop
Seat 4: BgdAlex117 folded before Flop
Seat 5: Spud014 folded before Flop (didn't bet)
Seat 6: mega spasser (button) folded on the Turn



PokerStars Hand #166667998373:  Hold'em No Limit ($0.05/$0.10 USD) - 2017/02/23 16:11:24 ET
Table 'Hunnia' 6-max Seat #4 is the button
Seat 1: univibe68 ($21.92 in chips) 
Seat 2: mhonielsen ($11.09 in chips) 
Seat 3: 6ePeMeHHa9 ($10.41 in chips) 
Seat 4: Jalida3 ($11.73 in chips) 
Seat 5: Smarkon ($14.14 in chips) 
Seat 6: ChuikaPridi ($11.29 in chips) 
Smarkon: posts small blind $0.05
ChuikaPridi: posts big blind $0.10
*** HOLE CARDS ***
univibe68: raises $0.20 to $0.30
mhonielsen has timed out
mhonielsen: folds 
6ePeMeHHa9: folds 
Jalida3: folds 
Smarkon: folds 
ChuikaPridi: folds 
Uncalled bet ($0.20) returned to univibe68
univibe68 collected $0.25 from pot
*** SUMMARY ***
Total pot $0.25 | Rake $0 
Seat 1: univibe68 collected ($0.25)
Seat 2: mhonielsen folded before Flop (didn't bet)
Seat 3: 6ePeMeHHa9 folded before Flop (didn't bet)
Seat 4: Jalida3 (button) folded before Flop (didn't bet)
Seat 5: Smarkon (small blind) folded before Flop
Seat 6: ChuikaPridi (big blind) folded before Flop



PokerStars Hand #166667998374:  Hold'em No Limit ($0.05/$0.10 USD) - 2017/02/23 16:11:24 ET
Table 'Hercynia III' 6-max Seat #1 is the button
Seat 1: Bird et al ($14.93 in chips) 
Seat 2: Action_Gibi ($5.01 in chips) 
Seat 3: Dcaro31 ($20.02 in chips) 
Seat 5: THIMUCHIN ($15.05 in chips) 
Seat 6: bdixon_5 ($13.47 in chips) 
Action_Gibi: posts small blind $0.05
Dcaro31: posts big blind $0.10
*** HOLE CARDS ***
THIMUCHIN: folds 
bdixon_5: folds 
Bird et al: raises $0.21 to $0.31
Action_Gibi: calls $0.26
Dcaro31: folds 
*** FLOP *** [3s 8s 7s]
Action_Gibi: checks 
Bird et al: bets $0.41
Action_Gibi: raises $4.29 to $4.70 and is all-in
Bird et al: calls $4.29
*** TURN *** [3s 8s 7s] [9d]
*** RIVER *** [3s 8s 7s 9d] [Jc]
*** SHOW DOWN ***
Action_Gibi: shows [5s 6h] (a straight, Five to Nine)
Bird et al: shows [Ks Kh] (a pair of Kings)
Action_Gibi collected $9.66 from pot
*** SUMMARY ***
Total pot $10.12 | Rake $0.46 
Board [3s 8s 7s 9d Jc]
Seat 1: Bird et al (button) showed [Ks Kh] and lost with a pair of Kings
Seat 2: Action_Gibi (small blind) showed [5s 6h] and won ($9.66) with a straight, Five to Nine
Seat 3: Dcaro31 (big blind) folded before Flop
Seat 5: THIMUCHIN folded before Flop (didn't bet)
Seat 6: bdixon_5 folded before Flop (didn't bet)



PokerStars Hand #166667998716:  Hold'em No Limit ($0.05/$0.10 USD) - 2017/02/23 16:11:24 ET
Table 'Ushakaron II' 6-max Seat #6 is the button
Seat 1: Kow6oy ($10 in chips) 
Seat 3: Rodik002 ($11.22 in chips) 
Seat 4: avintage176 ($30.43 in chips) 
Seat 5: 1limewax1 ($15.28 in chips) 
Seat 6: eniksenik ($10.65 in chips) 
Kow6oy: posts small blind $0.05
Iarlei: is sitting out 
Rodik002: posts big blind $0.10
*** HOLE CARDS ***
avintage176: folds 
1limewax1: raises $0.20 to $0.30
eniksenik: folds 
Kow6oy: calls $0.25
Rodik002: folds 
*** FLOP *** [7s 4d Qd]
Kow6oy: checks 
1limewax1: bets $0.40
Kow6oy: raises $1.10 to $1.50
1limewax1: calls $1.10
*** TURN *** [7s 4d Qd] [7d]
Kow6oy: bets $2.35
1limewax1: calls $2.35
*** RIVER *** [7s 4d Qd 7d] [3c]
Kow6oy: bets $5.85 and is all-in
1limewax1: calls $5.85
*** SHOW DOWN ***
Kow6oy: shows [4h 4c] (a full house, Fours full of Sevens)
1limewax1: shows [Qh 9s] (two pair, Queens and Sevens)
Kow6oy collected $19.20 from pot
*** SUMMARY ***
Total pot $20.10 | Rake $0.90 
Board [7s 4d Qd 7d 3c]
Seat 1: Kow6oy (small blind) showed [4h 4c] and won ($19.20) with a full house, Fours full of Sevens
Seat 3: Rodik002 (big blind) folded before Flop
Seat 4: avintage176 folded before Flop (didn't bet)
Seat 5: 1limewax1 showed [Qh 9s] and lost with two pair, Queens and Sevens
Seat 6: eniksenik (button) folded before Flop (didn't bet)



PokerStars Hand #166667998966:  Hold'em No Limit ($0.05/$0.10 USD) - 2017/02/23 16:11:24 ET
Table 'Alnasl II' 6-max Seat #4 is the button
Seat 1: dragonste89 ($13.90 in chips) 
Seat 2: Therodorus ($10 in chips) 
Seat 3: ICBM-RS26 ($15.99 in chips) 
Seat 4: Eddys Edge ($10 in chips) 
Seat 5: mdelfin0 ($12.66 in chips) 
mdelfin0: posts small blind $0.05
dragonste89: posts big blind $0.10
*** HOLE CARDS ***
Therodorus: raises $0.20 to $0.30
ICBM-RS26: folds 
Kow6oy joins the table at seat #6 
Eddys Edge: folds 
mdelfin0: folds 
Kow6oy leaves the table
dragonste89: folds 
Uncalled bet ($0.20) returned to Therodorus
Therodorus collected $0.25 from pot
*** SUMMARY ***
Total pot $0.25 | Rake $0 
Seat 1: dragonste89 (big blind) folded before Flop
Seat 2: Therodorus collected ($0.25)
Seat 3: ICBM-RS26 folded before Flop (didn't bet)
Seat 4: Eddys Edge (button) folded before Flop (didn't bet)
Seat 5: mdelfin0 (small blind) folded before Flop



PokerStars Hand #166667999033:  Hold'em No Limit ($0.05/$0.10 USD) - 2017/02/23 16:11:24 ET
Table 'Selinur' 6-max Seat #4 is the button
Seat 1: KA3AXCTAHEU, ($10 in chips) 
Seat 2: hoedje72 ($7.68 in chips) 
Seat 3: bambolejro ($11.93 in chips) 
Seat 4: ThuyeTD11 ($3.65 in chips) 
Seat 5: DrVzad ($9.90 in chips) 
Seat 6: homelessdan ($17.41 in chips) 
DrVzad: posts small blind $0.05
homelessdan: posts big blind $0.10
*** HOLE CARDS ***
KA3AXCTAHEU,: folds 
hoedje72: folds 
bambolejro: folds 
ThuyeTD11: folds 
DrVzad: folds 
Uncalled bet ($0.05) returned to homelessdan
homelessdan collected $0.10 from pot
*** SUMMARY ***
Total pot $0.10 | Rake $0 
Seat 1: KA3AXCTAHEU, folded before Flop (didn't bet)
Seat 2: hoedje72 folded before Flop (didn't bet)
Seat 3: bambolejro folded before Flop (didn't bet)
Seat 4: ThuyeTD11 (button) folded before Flop (didn't bet)
Seat 5: DrVzad (small blind) folded before Flop
Seat 6: homelessdan (big blind) collected ($0.10)



PokerStars Hand #166667999588:  Hold'em No Limit ($0.05/$0.10 USD) - 2017/02/23 16:11:25 ET
Table 'Pallas II' 6-max Seat #4 is the button
Seat 1: mdelfin0 ($16.69 in chips) 
Seat 3: popypaleta ($10.30 in chips) 
Seat 4: MisterX413 ($10 in chips) 
mdelfin0: posts small blind $0.05
popypaleta: posts big blind $0.10
*** HOLE CARDS ***
MisterX413: folds 
mdelfin0: folds 
Uncalled bet ($0.05) returned to popypaleta
popypaleta collected $0.10 from pot
*** SUMMARY ***
Total pot $0.10 | Rake $0 
Seat 1: mdelfin0 (small blind) folded before Flop
Seat 3: popypaleta (big blind) collected ($0.10)
Seat 4: MisterX413 (button) folded before Flop (didn't bet)



PokerStars Hand #166667999591:  Hold'em No Limit ($0.05/$0.10 USD) - 2017/02/23 16:11:25 ET
Table 'Ruvuma' 6-max Seat #6 is the button
Seat 2: Yspenyanin ($10 in chips) 
Seat 3: Spud014 ($10 in chips) 
Seat 5: sexy_seagull ($10.35 in chips) 
Seat 6: osmea ($10.25 in chips) 
Yspenyanin: posts small blind $0.05
Spud014: posts big blind $0.10
thegunman88: sits out 
*** HOLE CARDS ***
sexy_seagull: folds 
osmea: raises $0.20 to $0.30
Yspenyanin: folds 
Spud014: raises $0.75 to $1.05
osmea: calls $0.75
*** FLOP *** [2h 8h Qc]
Spud014: bets $1.36
osmea: folds 
Uncalled bet ($1.36) returned to Spud014
Spud014 collected $2.05 from pot
*** SUMMARY ***
Total pot $2.15 | Rake $0.10 
Board [2h 8h Qc]
Seat 2: Yspenyanin (small blind) folded before Flop
Seat 3: Spud014 (big blind) collected ($2.05)
Seat 5: sexy_seagull folded before Flop (didn't bet)
Seat 6: osmea (button) folded on the Flop



PokerStars Hand #166667999702:  Hold'em No Limit ($0.05/$0.10 USD) - 2017/02/23 16:11:25 ET
Table 'Vaisala' 6-max Seat #5 is the button
Seat 1: ksandr_hom ($10 in chips) 
Seat 2: XaXaTyH4uK ($10.34 in chips) 
Seat 4: sexy_seagull ($11.16 in chips) 
Seat 5: univibe68 ($10.27 in chips) 
Seat 6: fábiu ($7.60 in chips) 
fábiu: posts small blind $0.05
ksandr_hom: posts big blind $0.10
Elinaattor: sits out 
*** HOLE CARDS ***
XaXaTyH4uK: folds 
sexy_seagull: folds 
univibe68: raises $0.10 to $0.20
fábiu: raises $0.50 to $0.70
ksandr_hom: folds 
univibe68: folds 
Uncalled bet ($0.50) returned to fábiu
fábiu collected $0.50 from pot
*** SUMMARY ***
Total pot $0.50 | Rake $0 
Seat 1: ksandr_hom (big blind) folded before Flop
Seat 2: XaXaTyH4uK folded before Flop (didn't bet)
Seat 4: sexy_seagull folded before Flop (didn't bet)
Seat 5: univibe68 (button) folded before Flop
Seat 6: fábiu (small blind) collected ($0.50)



PokerStars Hand #166667999809:  Hold'em No Limit ($0.05/$0.10 USD) - 2017/02/23 16:11:25 ET
Table 'Markab II' 6-max Seat #2 is the button
Seat 1: Danijnho ($8 in chips) 
Seat 2: truck1234 ($10 in chips) 
Seat 3: sexy_seagull ($11.48 in chips) 
Seat 4: Crafty23@PS ($11.44 in chips) 
Seat 5: Rodik002 ($19.52 in chips) 
Seat 6: Comeback3392 ($10 in chips) 
sexy_seagull: posts small blind $0.05
Crafty23@PS: posts big blind $0.10
Danijnho: posts big blind $0.10
*** HOLE CARDS ***
Rodik002: folds 
Comeback3392: folds 
Danijnho: checks 
truck1234: folds 
sexy_seagull: raises $0.30 to $0.40
Crafty23@PS: folds 
Danijnho: folds 
Uncalled bet ($0.30) returned to sexy_seagull
sexy_seagull collected $0.30 from pot
*** SUMMARY ***
Total pot $0.30 | Rake $0 
Seat 1: Danijnho folded before Flop
Seat 2: truck1234 (button) folded before Flop (didn't bet)
Seat 3: sexy_seagull (small blind) collected ($0.30)
Seat 4: Crafty23@PS (big blind) folded before Flop
Seat 5: Rodik002 folded before Flop (didn't bet)
Seat 6: Comeback3392 folded before Flop (didn't bet)



PokerStars Hand #166668000069:  Hold'em No Limit ($0.05/$0.10 USD) - 2017/02/23 16:11:25 ET
Table 'Rotraut' 6-max Seat #5 is the button
Seat 1: Hypermetal ($13.51 in chips) 
Seat 2: Newqbrown ($10.45 in chips) 
Seat 3: FlackoD ($7.66 in chips) 
Seat 5: Bird et al ($12.08 in chips) 
Seat 6: KokoulinV ($16.47 in chips) 
KokoulinV: posts small blind $0.05
Hypermetal: posts big blind $0.10
*** HOLE CARDS ***
Newqbrown: raises $0.20 to $0.30
FlackoD: folds 
Bird et al: folds 
KokoulinV: folds 
Hypermetal: folds 
Uncalled bet ($0.20) returned to Newqbrown
Newqbrown collected $0.25 from pot
*** SUMMARY ***
Total pot $0.25 | Rake $0 
Seat 1: Hypermetal (big blind) folded before Flop
Seat 2: Newqbrown collected ($0.25)
Seat 3: FlackoD folded before Flop (didn't bet)
Seat 5: Bird et al (button) folded before Flop (didn't bet)
Seat 6: KokoulinV (small blind) folded before Flop



PokerStars Hand #166668000251:  Hold'em No Limit ($0.05/$0.10 USD) - 2017/02/23 16:11:26 ET
Table 'Luanda' 6-max Seat #2 is the button
Seat 1: AM-L-SL ($2.81 in chips) 
Seat 2: Xander188 ($10.15 in chips) 
Seat 3: pokekrk ($10.05 in chips) 
Seat 4: aapokerkot ($10.08 in chips) 
Seat 5: st4tion ($12.35 in chips) 
pokekrk: posts small blind $0.05
aapokerkot: posts big blind $0.10
*** HOLE CARDS ***
AIONCMA1988 joins the table at seat #6 
st4tion: folds 
AM-L-SL: folds 
Xander188: folds 
pokekrk: raises $0.15 to $0.25
aapokerkot: folds 
Uncalled bet ($0.15) returned to pokekrk
pokekrk collected $0.20 from pot
*** SUMMARY ***
Total pot $0.20 | Rake $0 
Seat 1: AM-L-SL folded before Flop (didn't bet)
Seat 2: Xander188 (button) folded before Flop (didn't bet)
Seat 3: pokekrk (small blind) collected ($0.20)
Seat 4: aapokerkot (big blind) folded before Flop
Seat 5: st4tion folded before Flop (didn't bet)



PokerStars Hand #166668000283:  Hold'em No Limit ($0.05/$0.10 USD) - 2017/02/23 16:11:26 ET
Table 'Caprera III' 6-max Seat #1 is the button
Seat 1: MisterX413 ($10 in chips) 
Seat 2: voledy ($10 in chips) 
MisterX413: posts small blind $0.05
voledy: posts big blind $0.10
*** HOLE CARDS ***
MisterX413: folds 
Uncalled bet ($0.05) returned to voledy
voledy collected $0.10 from pot
*** SUMMARY ***
Total pot $0.10 | Rake $0 
Seat 1: MisterX413 (button) (small blind) folded before Flop
Seat 2: voledy (big blind) collected ($0.10)



PokerStars Hand #166668000829:  Hold'em No Limit ($0.05/$0.10 USD) - 2017/02/23 16:11:26 ET
Table 'Alzirr II' 6-max Seat #4 is the button
Seat 2: popypaleta ($10.75 in chips) 
Seat 3: devon_red ($7.20 in chips) 
Seat 4: Scanner17 ($18.09 in chips) 
Seat 5: yodzik ($5.63 in chips) 
Seat 6: AM-L-SL ($4.33 in chips) 
yodzik: posts small blind $0.05
AM-L-SL: posts big blind $0.10
Kow6oy: sits out 
*** HOLE CARDS ***
popypaleta: folds 
devon_red: folds 
Scanner17: raises $0.15 to $0.25
yodzik: folds 
AM-L-SL: raises $0.35 to $0.60
Scanner17: folds 
Uncalled bet ($0.35) returned to AM-L-SL
AM-L-SL collected $0.55 from pot
*** SUMMARY ***
Total pot $0.55 | Rake $0 
Seat 2: popypaleta folded before Flop (didn't bet)
Seat 3: devon_red folded before Flop (didn't bet)
Seat 4: Scanner17 (button) folded before Flop
Seat 5: yodzik (small blind) folded before Flop
Seat 6: AM-L-SL (big blind) collected ($0.55)



PokerStars Hand #166668000831:  Hold'em No Limit ($0.05/$0.10 USD) - 2017/02/23 16:11:26 ET
Table 'Deflotte' 6-max Seat #2 is the button
Seat 1: Zooplack ($17.35 in chips) 
Seat 2: MonteCris92 ($10 in chips) 
Seat 3: Yspenyanin ($10 in chips) 
Seat 4: 8th wonders ($10.37 in chips) 
Seat 5: Pokeaster ($11.62 in chips) 
Seat 6: Iarlei ($10.30 in chips) 
Yspenyanin: posts small blind $0.05
8th wonders: posts big blind $0.10
*** HOLE CARDS ***
Pokeaster: folds 
Iarlei: folds 
Zooplack: raises $0.15 to $0.25
MonteCris92: folds 
Yspenyanin: folds 
8th wonders: folds 
Uncalled bet ($0.15) returned to Zooplack
Zooplack collected $0.25 from pot
*** SUMMARY ***
Total pot $0.25 | Rake $0 
Seat 1: Zooplack collected ($0.25)
Seat 2: MonteCris92 (button) folded before Flop (didn't bet)
Seat 3: Yspenyanin (small blind) folded before Flop
Seat 4: 8th wonders (big blind) folded before Flop
Seat 5: Pokeaster folded before Flop (didn't bet)
Seat 6: Iarlei folded before Flop (didn't bet)



PokerStars Hand #166668000905:  Hold'em No Limit ($0.05/$0.10 USD) - 2017/02/23 16:11:26 ET
Table 'Union' 6-max Seat #1 is the button
Seat 1: IAntikI ($10 in chips) 
Seat 2: Zooplack ($10.05 in chips) 
Seat 3: Rodik002 ($13.93 in chips) 
Seat 5: Chodemuncher ($16.25 in chips) 
Seat 6: bonyo71 ($3.85 in chips) 
Zooplack: posts small blind $0.05
Rodik002: posts big blind $0.10
osmea: sits out 
*** HOLE CARDS ***
Chodemuncher: raises $0.20 to $0.30
bonyo71: folds 
IAntikI: folds 
Zooplack: folds 
Rodik002: folds 
Uncalled bet ($0.20) returned to Chodemuncher
Chodemuncher collected $0.25 from pot
*** SUMMARY ***
Total pot $0.25 | Rake $0 
Seat 1: IAntikI (button) folded before Flop (didn't bet)
Seat 2: Zooplack (small blind) folded before Flop
Seat 3: Rodik002 (big blind) folded before Flop
Seat 5: Chodemuncher collected ($0.25)
Seat 6: bonyo71 folded before Flop (didn't bet)



PokerStars Hand #166668000943:  Hold'em No Limit ($0.05/$0.10 USD) - 2017/02/23 16:11:26 ET
Table 'Isberga' 6-max Seat #4 is the button
Seat 1: Feverhead ($18.22 in chips) 
Seat 2: GESPERIA ($10.52 in chips) 
Seat 3: HARDCORE66RU ($10 in chips) 
Seat 4: THIMUCHIN ($10.64 in chips) 
Seat 5: YoungGriff86 ($19.71 in chips) 
Seat 6: Goroshkos88 ($21.56 in chips) 
YoungGriff86: posts small blind $0.05
Goroshkos88: posts big blind $0.10
*** HOLE CARDS ***
Feverhead: folds 
GESPERIA: folds 
HARDCORE66RU: raises $0.15 to $0.25
THIMUCHIN: folds 
YoungGriff86: folds 
Goroshkos88: folds 
Uncalled bet ($0.15) returned to HARDCORE66RU
HARDCORE66RU collected $0.25 from pot
*** SUMMARY ***
Total pot $0.25 | Rake $0 
Seat 1: Feverhead folded before Flop (didn't bet)
Seat 2: GESPERIA folded before Flop (didn't bet)
Seat 3: HARDCORE66RU collected ($0.25)
Seat 4: THIMUCHIN (button) folded before Flop (didn't bet)
Seat 5: YoungGriff86 (small blind) folded before Flop
Seat 6: Goroshkos88 (big blind) folded before Flop



PokerStars Hand #166668001042:  Hold'em No Limit ($0.05/$0.10 USD) - 2017/02/23 16:11:27 ET
Table 'Seinajoki' 6-max Seat #4 is the button
Seat 2: niukak ($10.05 in chips) 
Seat 3: Therodorus ($10.15 in chips) 
Seat 4: rusu_rapid ($10 in chips) 
niukak: posts small blind $0.05
Therodorus: posts big blind $0.10
*** HOLE CARDS ***
rusu_rapid: raises $0.15 to $0.25
niukak: raises $0.60 to $0.85
Therodorus: folds 
rusu_rapid: folds 
Uncalled bet ($0.60) returned to niukak
niukak collected $0.60 from pot
*** SUMMARY ***
Total pot $0.60 | Rake $0 
Seat 2: niukak (small blind) collected ($0.60)
Seat 3: Therodorus (big blind) folded before Flop
Seat 4: rusu_rapid (button) folded before Flop



PokerStars Hand #166668001308:  Hold'em No Limit ($0.05/$0.10 USD) - 2017/02/23 16:11:27 ET
Table 'Wesselink II' 6-max Seat #4 is the button
Seat 2: KRZuff ($10.27 in chips) 
Seat 3: Wargolandros ($8.27 in chips) 
Seat 4: BahiaMinhaP ($10 in chips) 
Seat 5: xdjango07x ($19.05 in chips) 
Seat 6: bambolejro ($17.92 in chips) 
xdjango07x: posts small blind $0.05
bambolejro: posts big blind $0.10
D3NyA: sits out 
*** HOLE CARDS ***
KRZuff: folds 
Wargolandros: folds 
BahiaMinhaP: folds 
xdjango07x: raises $0.12 to $0.22
bambolejro: raises $0.48 to $0.70
xdjango07x: folds 
Uncalled bet ($0.48) returned to bambolejro
bambolejro collected $0.44 from pot
*** SUMMARY ***
Total pot $0.44 | Rake $0 
Seat 2: KRZuff folded before Flop (didn't bet)
Seat 3: Wargolandros folded before Flop (didn't bet)
Seat 4: BahiaMinhaP (button) folded before Flop (didn't bet)
Seat 5: xdjango07x (small blind) folded before Flop
Seat 6: bambolejro (big blind) collected ($0.44)



PokerStars Hand #166668001452:  Hold'em No Limit ($0.05/$0.10 USD) - 2017/02/23 16:11:27 ET
Table 'Heka II' 6-max Seat #1 is the button
Seat 1: Mamm0nism ($15.36 in chips) 
Seat 2: oddshoff ($10.82 in chips) 
Seat 3: voledy ($10 in chips) 
Seat 4: theNot0r1ous ($10.28 in chips) 
Seat 5: ArcticBearDK ($12.63 in chips) 
Seat 6: MonteCris92 ($11.27 in chips) 
oddshoff: posts small blind $0.05
voledy: posts big blind $0.10
*** HOLE CARDS ***
theNot0r1ous: folds 
ArcticBearDK: folds 
MonteCris92: folds 
Mamm0nism: raises $0.20 to $0.30
oddshoff: raises $0.60 to $0.90
voledy: folds 
Mamm0nism: folds 
Uncalled bet ($0.60) returned to oddshoff
oddshoff collected $0.70 from pot
*** SUMMARY ***
Total pot $0.70 | Rake $0 
Seat 1: Mamm0nism (button) folded before Flop
Seat 2: oddshoff (small blind) collected ($0.70)
Seat 3: voledy (big blind) folded before Flop
Seat 4: theNot0r1ous folded before Flop (didn't bet)
Seat 5: ArcticBearDK folded before Flop (didn't bet)
Seat 6: MonteCris92 folded before Flop (didn't bet)



PokerStars Hand #166668001494:  Hold'em No Limit ($0.05/$0.10 USD) - 2017/02/23 16:11:27 ET
Table 'Carina' 6-max Seat #1 is the button
Seat 1: Kupi007 ($10 in chips) 
Seat 2: XwinX25 ($10.27 in chips) 
Seat 3: LarryTheStar ($12.59 in chips) 
Seat 4: steepfell ($10.56 in chips) 
Seat 5: IAntikI ($10.23 in chips) 
Seat 6: alexweezer ($7.43 in chips) 
XwinX25: posts small blind $0.05
LarryTheStar: posts big blind $0.10
*** HOLE CARDS ***
steepfell: folds 
IAntikI: folds 
alexweezer: folds 
Kupi007: folds 
XwinX25: folds 
Uncalled bet ($0.05) returned to LarryTheStar
LarryTheStar collected $0.10 from pot
*** SUMMARY ***
Total pot $0.10 | Rake $0 
Seat 1: Kupi007 (button) folded before Flop (didn't bet)
Seat 2: XwinX25 (small blind) folded before Flop
Seat 3: LarryTheStar (big blind) collected ($0.10)
Seat 4: steepfell folded before Flop (didn't bet)
Seat 5: IAntikI folded before Flop (didn't bet)
Seat 6: alexweezer folded before Flop (didn't bet)



PokerStars Hand #166668001641:  Hold'em No Limit ($0.05/$0.10 USD) - 2017/02/23 16:11:27 ET
Table 'Garlena III' 6-max Seat #2 is the button
Seat 1: dittoro ($11.39 in chips) 
Seat 2: YY778 ($10.62 in chips) 
Seat 3: IAntikI ($10 in chips) 
Seat 4: mbkongstad ($9.70 in chips) 
Seat 5: steepfell ($10 in chips) 
Seat 6: iluzja12 ($9.50 in chips) 
IAntikI: posts small blind $0.05
mbkongstad: posts big blind $0.10
*** HOLE CARDS ***
steepfell: raises $0.20 to $0.30
iluzja12: folds 
dittoro: folds 
YY778: calls $0.30
IAntikI: folds 
mbkongstad: calls $0.20
*** FLOP *** [3c 8s Jh]
mbkongstad: bets $0.90
steepfell: folds 
YY778: calls $0.90
*** TURN *** [3c 8s Jh] [5h]
mbkongstad: bets $1.30
YY778: folds 
Uncalled bet ($1.30) returned to mbkongstad
mbkongstad collected $2.63 from pot
*** SUMMARY ***
Total pot $2.75 | Rake $0.12 
Board [3c 8s Jh 5h]
Seat 1: dittoro folded before Flop (didn't bet)
Seat 2: YY778 (button) folded on the Turn
Seat 3: IAntikI (small blind) folded before Flop
Seat 4: mbkongstad (big blind) collected ($2.63)
Seat 5: steepfell folded on the Flop
Seat 6: iluzja12 folded before Flop (didn't bet)



PokerStars Hand #166668001976:  Hold'em No Limit ($0.05/$0.10 USD) - 2017/02/23 16:11:28 ET
Table 'Ebella II' 6-max Seat #6 is the button
Seat 1: gaHy_HaXeP ($10 in chips) 
Seat 2: Therodorus ($10 in chips) 
Seat 3: Torften2 ($17.66 in chips) 
Seat 4: ValdemorS ($11.70 in chips) 
Seat 5: Bird et al ($10 in chips) 
Seat 6: Joker51_wtf! ($11.69 in chips) 
gaHy_HaXeP: posts small blind $0.05
Therodorus: posts big blind $0.10
*** HOLE CARDS ***
Torften2: folds 
ValdemorS: folds 
Bird et al: folds 
Joker51_wtf!: raises $0.12 to $0.22
gaHy_HaXeP: folds 
Therodorus: raises $0.63 to $0.85
Joker51_wtf!: calls $0.63
*** FLOP *** [Jh Qh 4c]
Therodorus: bets $1.22
Joker51_wtf!: calls $1.22
*** TURN *** [Jh Qh 4c] [4s]
Therodorus: checks 
Joker51_wtf!: bets $2.30
Therodorus: folds 
Uncalled bet ($2.30) returned to Joker51_wtf!
Joker51_wtf! collected $4 from pot
*** SUMMARY ***
Total pot $4.19 | Rake $0.19 
Board [Jh Qh 4c 4s]
Seat 1: gaHy_HaXeP (small blind) folded before Flop
Seat 2: Therodorus (big blind) folded on the Turn
Seat 3: Torften2 folded before Flop (didn't bet)
Seat 4: ValdemorS folded before Flop (didn't bet)
Seat 5: Bird et al folded before Flop (didn't bet)
Seat 6: Joker51_wtf! (button) collected ($4)



PokerStars Hand #166668002274:  Hold'em No Limit ($0.05/$0.10 USD) - 2017/02/23 16:11:28 ET
Table 'Huberta II' 6-max Seat #1 is the button
Seat 1: tr41n3r12 ($10 in chips) 
Seat 2: Ice_Isayev ($10 in chips) 
Seat 5: Feverhead ($27.55 in chips) 
Seat 6: yodzik ($5.83 in chips) 
Ice_Isayev: posts small blind $0.05
patrick19111: is sitting out 
VAD21: is sitting out 
Feverhead: posts big blind $0.10
*** HOLE CARDS ***
patrick19111 leaves the table
yodzik: folds 
VAD21 leaves the table
tr41n3r12: raises $0.15 to $0.25
Ice_Isayev: folds 
Feverhead: calls $0.15
*** FLOP *** [5c 2c 3h]
Feverhead: checks 
tr41n3r12: checks 
*** TURN *** [5c 2c 3h] [Kd]
Feverhead: bets $0.35
tr41n3r12: calls $0.35
*** RIVER *** [5c 2c 3h Kd] [7c]
Feverhead: checks 
tr41n3r12: bets $0.79
Feverhead: folds 
Uncalled bet ($0.79) returned to tr41n3r12
tr41n3r12 collected $1.19 from pot
*** SUMMARY ***
Total pot $1.25 | Rake $0.06 
Board [5c 2c 3h Kd 7c]
Seat 1: tr41n3r12 (button) collected ($1.19)
Seat 2: Ice_Isayev (small blind) folded before Flop
Seat 5: Feverhead (big blind) folded on the River
Seat 6: yodzik folded before Flop (didn't bet)



PokerStars Hand #166668002421:  Hold'em No Limit ($0.05/$0.10 USD) - 2017/02/23 16:11:28 ET
Table 'Walpurga' 6-max Seat #2 is the button
Seat 1: chimera252 ($12.20 in chips) 
Seat 2: paxit71 ($4.95 in chips) 
Seat 3: Lucky HoBBiT ($10 in chips) 
Seat 4: oddshoff ($12.89 in chips) 
Lucky HoBBiT: posts small blind $0.05
oddshoff: posts big blind $0.10
Fremara: sits out 
*** HOLE CARDS ***
chimera252: raises $0.20 to $0.30
paxit71: folds 
Lucky HoBBiT: folds 
oddshoff: calls $0.20
*** FLOP *** [3h 6c Ks]
oddshoff: checks 
chimera252: checks 
*** TURN *** [3h 6c Ks] [9h]
oddshoff: checks 
chimera252: bets $0.40
oddshoff: folds 
Uncalled bet ($0.40) returned to chimera252
chimera252 collected $0.62 from pot
*** SUMMARY ***
Total pot $0.65 | Rake $0.03 
Board [3h 6c Ks 9h]
Seat 1: chimera252 collected ($0.62)
Seat 2: paxit71 (button) folded before Flop (didn't bet)
Seat 3: Lucky HoBBiT (small blind) folded before Flop
Seat 4: oddshoff (big blind) folded on the Turn



PokerStars Hand #166668002485:  Hold'em No Limit ($0.05/$0.10 USD) - 2017/02/23 16:11:28 ET
Table 'Eurykleia' 6-max Seat #4 is the button
Seat 1: Giyorod ($10.40 in chips) 
Seat 2: x3ultimate ($10.74 in chips) 
Seat 3: boxer821 ($20.26 in chips) 
Seat 4: 6ePeMeHHa9 ($18.80 in chips) 
Seat 5: fishhook5 ($10 in chips) 
Seat 6: afca128 ($4.62 in chips) 
fishhook5: posts small blind $0.05
afca128: posts big blind $0.10
*** HOLE CARDS ***
Giyorod: folds 
x3ultimate: raises $0.20 to $0.30
boxer821: calls $0.30
6ePeMeHHa9: folds 
fishhook5: folds 
afca128: folds 
*** FLOP *** [3h 7h 6s]
x3ultimate: checks 
boxer821: checks 
*** TURN *** [3h 7h 6s] [7s]
x3ultimate: bets $0.54
boxer821: calls $0.54
*** RIVER *** [3h 7h 6s 7s] [8h]
x3ultimate: bets $1.50
boxer821: folds 
Uncalled bet ($1.50) returned to x3ultimate
x3ultimate collected $1.75 from pot
*** SUMMARY ***
Total pot $1.83 | Rake $0.08 
Board [3h 7h 6s 7s 8h]
Seat 1: Giyorod folded before Flop (didn't bet)
Seat 2: x3ultimate collected ($1.75)
Seat 3: boxer821 folded on the River
Seat 4: 6ePeMeHHa9 (button) folded before Flop (didn't bet)
Seat 5: fishhook5 (small blind) folded before Flop
Seat 6: afca128 (big blind) folded before Flop



PokerStars Hand #166668002528:  Hold'em No Limit ($0.05/$0.10 USD) - 2017/02/23 16:11:28 ET
Table 'Nikko II' 6-max Seat #5 is the button
Seat 1: bdixon_5 ($9.52 in chips) 
Seat 2: popypaleta ($10.30 in chips) 
Seat 3: Hyd SK ($10.78 in chips) 
Seat 4: Peter0087 ($9.61 in chips) 
Seat 5: Aescul@pius ($13.14 in chips) 
MihaGr will be allowed to play after the button
bdixon_5: posts small blind $0.05
popypaleta: posts big blind $0.10
*** HOLE CARDS ***
Hyd SK: folds 
Peter0087: folds 
Aescul@pius: folds 
bdixon_5: folds 
Uncalled bet ($0.05) returned to popypaleta
popypaleta collected $0.10 from pot
*** SUMMARY ***
Total pot $0.10 | Rake $0 
Seat 1: bdixon_5 (small blind) folded before Flop
Seat 2: popypaleta (big blind) collected ($0.10)
Seat 3: Hyd SK folded before Flop (didn't bet)
Seat 4: Peter0087 folded before Flop (didn't bet)
Seat 5: Aescul@pius (button) folded before Flop (didn't bet)



PokerStars Hand #166668002643:  Hold'em No Limit ($0.05/$0.10 USD) - 2017/02/23 16:11:28 ET
Table 'Syringa' 6-max Seat #1 is the button
Seat 1: bdixon_5 ($9.43 in chips) 
Seat 2: Goroshkos88 ($11.39 in chips) 
Seat 3: Yspenyanin ($13.37 in chips) 
Seat 5: Andrei ProFF ($15.06 in chips) 
Seat 6: ibara000 ($13.79 in chips) 
Goroshkos88: posts small blind $0.05
Yspenyanin: posts big blind $0.10
voledy: sits out 
*** HOLE CARDS ***
Andrei ProFF: folds 
ibara000: raises $0.16 to $0.26
bdixon_5: raises $0.44 to $0.70
Goroshkos88: folds 
Yspenyanin: folds 
ibara000: calls $0.44
*** FLOP *** [Ts Ks 4d]
ibara000: checks 
bdixon_5: checks 
*** TURN *** [Ts Ks 4d] [2d]
ibara000: checks 
bdixon_5: bets $0.60
ibara000: calls $0.60
*** RIVER *** [Ts Ks 4d 2d] [4s]
ibara000: checks 
bdixon_5: checks 
*** SHOW DOWN ***
ibara000: shows [As 7s] (a flush, Ace high)
bdixon_5: mucks hand 
ibara000 collected $2.63 from pot
*** SUMMARY ***
Total pot $2.75 | Rake $0.12 
Board [Ts Ks 4d 2d 4s]
Seat 1: bdixon_5 (button) mucked
Seat 2: Goroshkos88 (small blind) folded before Flop
Seat 3: Yspenyanin (big blind) folded before Flop
Seat 5: Andrei ProFF folded before Flop (didn't bet)
Seat 6: ibara000 showed [As 7s] and won ($2.63) with a flush, Ace high



PokerStars Hand #166668002713:  Hold'em No Limit ($0.05/$0.10 USD) - 2017/02/23 16:11:28 ET
Table 'Senta II' 6-max Seat #2 is the button
Seat 1: Goovr ($10 in chips) 
Seat 2: NvR.m1nD ($13.75 in chips) 
Seat 3: Aescul@pius ($21.93 in chips) 
Seat 5: Algarah ($5.38 in chips) 
Seat 6: T9MS ($11.17 in chips) 
Aescul@pius: posts small blind $0.05
Algarah: posts big blind $0.10
*** HOLE CARDS ***
T9MS: folds 
Goovr: raises $0.20 to $0.30
NvR.m1nD: folds 
Aescul@pius: calls $0.25
Algarah: folds 
*** FLOP *** [Kh 2h Qs]
Aescul@pius: checks 
Goovr: checks 
*** TURN *** [Kh 2h Qs] [4h]
Aescul@pius: checks 
Goovr: checks 
*** RIVER *** [Kh 2h Qs 4h] [9d]
Aescul@pius: checks 
Goovr: checks 
*** SHOW DOWN ***
Aescul@pius: shows [5h 5d] (a pair of Fives)
Goovr: mucks hand 
Aescul@pius collected $0.67 from pot
*** SUMMARY ***
Total pot $0.70 | Rake $0.03 
Board [Kh 2h Qs 4h 9d]
Seat 1: Goovr mucked
Seat 2: NvR.m1nD (button) folded before Flop (didn't bet)
Seat 3: Aescul@pius (small blind) showed [5h 5d] and won ($0.67) with a pair of Fives
Seat 5: Algarah (big blind) folded before Flop
Seat 6: T9MS folded before Flop (didn't bet)



PokerStars Hand #166668003219:  Hold'em No Limit ($0.05/$0.10 USD) - 2017/02/23 16:11:29 ET
Table 'Geisha' 6-max Seat #1 is the button
Seat 1: facewald ($35.08 in chips) 
Seat 2: MisterX413 ($10 in chips) 
Seat 3: Eddys Edge ($10 in chips) 
Seat 4: marianoboni ($10.15 in chips) 
Seat 6: Namhkal ($20.68 in chips) 
MisterX413: posts small blind $0.05
Eddys Edge: posts big blind $0.10
crooso: sits out 
*** HOLE CARDS ***
marianoboni: folds 
Namhkal: folds 
facewald: folds 
MisterX413: folds 
Uncalled bet ($0.05) returned to Eddys Edge
Eddys Edge collected $0.10 from pot
*** SUMMARY ***
Total pot $0.10 | Rake $0 
Seat 1: facewald (button) folded before Flop (didn't bet)
Seat 2: MisterX413 (small blind) folded before Flop
Seat 3: Eddys Edge (big blind) collected ($0.10)
Seat 4: marianoboni folded before Flop (didn't bet)
Seat 6: Namhkal folded before Flop (didn't bet)



PokerStars Hand #166668003283:  Hold'em No Limit ($0.05/$0.10 USD) - 2017/02/23 16:11:29 ET
Table 'Antinous' 6-max Seat #5 is the button
Seat 1: Andrei ProFF ($16.55 in chips) 
Seat 2: Nr847 ($13.45 in chips) 
Seat 3: dittoro ($10 in chips) 
Seat 4: Pekaml ($14.03 in chips) 
Seat 5: Covetsoles ($5.32 in chips) 
Seat 6: coolisses111 ($9.15 in chips) 
coolisses111: posts small blind $0.05
Andrei ProFF: posts big blind $0.10
*** HOLE CARDS ***
Nr847: folds 
dittoro: folds 
Pekaml: folds 
Covetsoles: folds 
coolisses111: folds 
Uncalled bet ($0.05) returned to Andrei ProFF
Andrei ProFF collected $0.10 from pot
*** SUMMARY ***
Total pot $0.10 | Rake $0 
Seat 1: Andrei ProFF (big blind) collected ($0.10)
Seat 2: Nr847 folded before Flop (didn't bet)
Seat 3: dittoro folded before Flop (didn't bet)
Seat 4: Pekaml folded before Flop (didn't bet)
Seat 5: Covetsoles (button) folded before Flop (didn't bet)
Seat 6: coolisses111 (small blind) folded before Flop



PokerStars Hand #166668003462:  Hold'em No Limit ($0.05/$0.10 USD) - 2017/02/23 16:11:29 ET
Table 'Themisto II' 6-max Seat #4 is the button
Seat 1: ChuikaPridi ($10.25 in chips) 
Seat 2: CA225 ($11.81 in chips) 
Seat 3: eniksenik ($18.64 in chips) 
Seat 4: DrVzad ($9.85 in chips) 
Seat 5: ex3Lero86 ($10.64 in chips) 
ex3Lero86: posts small blind $0.05
ChuikaPridi: posts big blind $0.10
*** HOLE CARDS ***
CA225: calls $0.10
eniksenik: folds 
DrVzad: folds 
ex3Lero86: folds 
noobigrok leaves the table
ChuikaPridi: checks 
*** FLOP *** [9h Jd Tc]
Kow6oy joins the table at seat #6 
ChuikaPridi: checks 
CA225: checks 
*** TURN *** [9h Jd Tc] [2h]
ChuikaPridi: checks 
CA225: checks 
*** RIVER *** [9h Jd Tc 2h] [Qh]
ChuikaPridi: checks 
CA225: checks 
*** SHOW DOWN ***
ChuikaPridi: shows [7h 5c] (high card Queen)
CA225: shows [4c 4h] (a pair of Fours)
CA225 collected $0.24 from pot
*** SUMMARY ***
Total pot $0.25 | Rake $0.01 
Board [9h Jd Tc 2h Qh]
Seat 1: ChuikaPridi (big blind) showed [7h 5c] and lost with high card Queen
Seat 2: CA225 showed [4c 4h] and won ($0.24) with a pair of Fours
Seat 3: eniksenik folded before Flop (didn't bet)
Seat 4: DrVzad (button) folded before Flop (didn't bet)
Seat 5: ex3Lero86 (small blind) folded before Flop



PokerStars Hand #166668003949:  Hold'em No Limit ($0.05/$0.10 USD) - 2017/02/23 16:11:30 ET
Table 'Nuki' 6-max Seat #4 is the button
Seat 1: bdixon_5 ($8.43 in chips) 
Seat 2: ArcticBearDK ($19.33 in chips) 
Seat 3: Chodemuncher ($10 in chips) 
Seat 4: GESPERIA ($28.28 in chips) 
Seat 5: fabadam ($10.33 in chips) 
Seat 6: Zooplack ($26.04 in chips) 
fabadam: posts small blind $0.05
Zooplack: posts big blind $0.10
*** HOLE CARDS ***
bdixon_5: folds 
ArcticBearDK: folds 
Chodemuncher: raises $0.20 to $0.30
GESPERIA: folds 
fabadam: folds 
Zooplack: folds 
Uncalled bet ($0.20) returned to Chodemuncher
Chodemuncher collected $0.25 from pot
*** SUMMARY ***
Total pot $0.25 | Rake $0 
Seat 1: bdixon_5 folded before Flop (didn't bet)
Seat 2: ArcticBearDK folded before Flop (didn't bet)
Seat 3: Chodemuncher collected ($0.25)
Seat 4: GESPERIA (button) folded before Flop (didn't bet)
Seat 5: fabadam (small blind) folded before Flop
Seat 6: Zooplack (big blind) folded before Flop



PokerStars Hand #166668003982:  Hold'em No Limit ($0.05/$0.10 USD) - 2017/02/23 16:11:30 ET
Table 'Marbachia II' 6-max Seat #3 is the button
Seat 1: crooso ($9.60 in chips) 
Seat 2: Yabidooo ($10 in chips) 
Seat 3: MisterX413 ($10.24 in chips) 
Seat 4: marianoboni ($10.97 in chips) 
Seat 5: osmea ($10 in chips) 
Seat 6: arti192837 ($10 in chips) 
marianoboni: posts small blind $0.05
osmea: posts big blind $0.10
*** HOLE CARDS ***
arti192837: folds 
crooso: folds 
Yabidooo: folds 
MisterX413: folds 
marianoboni: folds 
Uncalled bet ($0.05) returned to osmea
osmea collected $0.10 from pot
*** SUMMARY ***
Total pot $0.10 | Rake $0 
Seat 1: crooso folded before Flop (didn't bet)
Seat 2: Yabidooo folded before Flop (didn't bet)
Seat 3: MisterX413 (button) folded before Flop (didn't bet)
Seat 4: marianoboni (small blind) folded before Flop
Seat 5: osmea (big blind) collected ($0.10)
Seat 6: arti192837 folded before Flop (didn't bet)



PokerStars Hand #166668004124:  Hold'em No Limit ($0.05/$0.10 USD) - 2017/02/23 16:11:30 ET
Table 'Nephthys II' 6-max Seat #4 is the button
Seat 1: DamDatsAnAce ($10.15 in chips) 
Seat 2: Ju$tD0it ($8.34 in chips) 
Seat 3: Newqbrown ($19.51 in chips) 
Seat 4: MihaGr ($10 in chips) 
Seat 5: kingartur222 ($8.51 in chips) 
Seat 6: CHRO8 ($19.76 in chips) 
kingartur222: posts small blind $0.05
CHRO8: posts big blind $0.10
*** HOLE CARDS ***
DamDatsAnAce: folds 
Ju$tD0it: calls $0.10
Newqbrown: folds 
MihaGr: folds 
kingartur222: raises $0.30 to $0.40
CHRO8: folds 
Ju$tD0it: calls $0.30
*** FLOP *** [Tc 8c Qs]
kingartur222: bets $0.70
Ju$tD0it: calls $0.70
*** TURN *** [Tc 8c Qs] [6d]
kingartur222: bets $1.60
Ju$tD0it: calls $1.60
*** RIVER *** [Tc 8c Qs 6d] [7s]
kingartur222: checks 
Ju$tD0it: bets $2.63
kingartur222: folds 
Uncalled bet ($2.63) returned to Ju$tD0it
Ju$tD0it collected $5.25 from pot
*** SUMMARY ***
Total pot $5.50 | Rake $0.25 
Board [Tc 8c Qs 6d 7s]
Seat 1: DamDatsAnAce folded before Flop (didn't bet)
Seat 2: Ju$tD0it collected ($5.25)
Seat 3: Newqbrown folded before Flop (didn't bet)
Seat 4: MihaGr (button) folded before Flop (didn't bet)
Seat 5: kingartur222 (small blind) folded on the River
Seat 6: CHRO8 (big blind) folded before Flop



PokerStars Hand #166668004384:  Hold'em No Limit ($0.05/$0.10 USD) - 2017/02/23 16:11:30 ET
Table 'Armenia' 6-max Seat #3 is the button
Seat 1: tr41n3r12 ($11.67 in chips) 
Seat 2: Yabidooo ($10.83 in chips) 
Seat 3: Crimsonr ($5.59 in chips) 
Seat 4: mbkongstad ($9.90 in chips) 
Seat 5: DrVzad ($9.85 in chips) 
Seat 6: mega spasser ($8.03 in chips) 
mbkongstad: posts small blind $0.05
DrVzad: posts big blind $0.10
*** HOLE CARDS ***
mega spasser: folds 
tr41n3r12: folds 
Yabidooo: folds 
Crimsonr: folds 
mbkongstad: raises $0.20 to $0.30
DrVzad: folds 
Uncalled bet ($0.20) returned to mbkongstad
mbkongstad collected $0.20 from pot
*** SUMMARY ***
Total pot $0.20 | Rake $0 
Seat 1: tr41n3r12 folded before Flop (didn't bet)
Seat 2: Yabidooo folded before Flop (didn't bet)
Seat 3: Crimsonr (button) folded before Flop (didn't bet)
Seat 4: mbkongstad (small blind) collected ($0.20)
Seat 5: DrVzad (big blind) folded before Flop
Seat 6: mega spasser folded before Flop (didn't bet)



PokerStars Hand #166668004395:  Hold'em No Limit ($0.05/$0.10 USD) - 2017/02/23 16:11:30 ET
Table 'Marghanna II' 6-max Seat #2 is the button
Seat 1: Goroshkos88 ($10.15 in chips) 
Seat 2: Namhkal ($14.46 in chips) 
Seat 3: Andrei ProFF ($10 in chips) 
Seat 4: D3NyA ($12.29 in chips) 
Seat 5: ofl21189 ($3.72 in chips) 
Seat 6: VAD21 ($13.13 in chips) 
Andrei ProFF: posts small blind $0.05
D3NyA: posts big blind $0.10
*** HOLE CARDS ***
ofl21189: folds 
VAD21: folds 
Goroshkos88: folds 
Namhkal: folds 
Andrei ProFF: folds 
Uncalled bet ($0.05) returned to D3NyA
D3NyA collected $0.10 from pot
*** SUMMARY ***
Total pot $0.10 | Rake $0 
Seat 1: Goroshkos88 folded before Flop (didn't bet)
Seat 2: Namhkal (button) folded before Flop (didn't bet)
Seat 3: Andrei ProFF (small blind) folded before Flop
Seat 4: D3NyA (big blind) collected ($0.10)
Seat 5: ofl21189 folded before Flop (didn't bet)
Seat 6: VAD21 folded before Flop (didn't bet)



PokerStars Hand #166668004553:  Hold'em No Limit ($0.05/$0.10 USD) - 2017/02/23 16:11:30 ET
Table 'Mesarthim' 6-max Seat #2 is the button
Seat 1: Mancuso2010 ($15.57 in chips) 
Seat 2: MühliJr ($13.91 in chips) 
Seat 3: Damage514 ($9.24 in chips) 
Seat 4: Strelok1974 ($10 in chips) 
Seat 5: Iarlei ($10.30 in chips) 
Seat 6: bdixon_5 ($8.31 in chips) 
Damage514: posts small blind $0.05
Strelok1974: posts big blind $0.10
*** HOLE CARDS ***
Iarlei: raises $0.20 to $0.30
bdixon_5: folds 
Mancuso2010: folds 
MühliJr: folds 
Damage514: calls $0.25
Strelok1974: calls $0.20
*** FLOP *** [2c 9s Kh]
Damage514: checks 
Strelok1974: checks 
Iarlei: bets $0.40
Damage514: folds 
Strelok1974: folds 
Uncalled bet ($0.40) returned to Iarlei
Iarlei collected $0.86 from pot
*** SUMMARY ***
Total pot $0.90 | Rake $0.04 
Board [2c 9s Kh]
Seat 1: Mancuso2010 folded before Flop (didn't bet)
Seat 2: MühliJr (button) folded before Flop (didn't bet)
Seat 3: Damage514 (small blind) folded on the Flop
Seat 4: Strelok1974 (big blind) folded on the Flop
Seat 5: Iarlei collected ($0.86)
Seat 6: bdixon_5 folded before Flop (didn't bet)



PokerStars Hand #166668004583:  Hold'em No Limit ($0.05/$0.10 USD) - 2017/02/23 16:11:30 ET
Table 'Nashira' 6-max Seat #2 is the button
Seat 2: niukak ($10 in chips) 
Seat 3: Therodorus ($10 in chips) 
niukak: posts small blind $0.05
Therodorus: posts big blind $0.10
*** HOLE CARDS ***
niukak: folds 
Uncalled bet ($0.05) returned to Therodorus
Therodorus collected $0.10 from pot
*** SUMMARY ***
Total pot $0.10 | Rake $0 
Seat 2: niukak (button) (small blind) folded before Flop
Seat 3: Therodorus (big blind) collected ($0.10)



PokerStars Hand #166668004709:  Hold'em No Limit ($0.05/$0.10 USD) - 2017/02/23 16:11:31 ET
Table 'Xanthippe II' 6-max Seat #1 is the button
Seat 1: noonhill ($8.27 in chips) 
Seat 2: Bird et al ($10.67 in chips) 
Seat 3: Dcaro31 ($14.66 in chips) 
Seat 5: XaXaTyH4uK ($10 in chips) 
Seat 6: Orlangoor ($12.27 in chips) 
Bird et al: posts small blind $0.05
Dcaro31: posts big blind $0.10
*** HOLE CARDS ***
XaXaTyH4uK: folds 
Orlangoor: folds 
noonhill: calls $0.10
Bird et al: raises $0.30 to $0.40
Dcaro31: calls $0.30
noonhill: calls $0.30
*** FLOP *** [Ah 6h 5d]
Bird et al: bets $0.69
Dcaro31: folds 
noonhill: folds 
Uncalled bet ($0.69) returned to Bird et al
Bird et al collected $1.15 from pot
*** SUMMARY ***
Total pot $1.20 | Rake $0.05 
Board [Ah 6h 5d]
Seat 1: noonhill (button) folded on the Flop
Seat 2: Bird et al (small blind) collected ($1.15)
Seat 3: Dcaro31 (big blind) folded on the Flop
Seat 5: XaXaTyH4uK folded before Flop (didn't bet)
Seat 6: Orlangoor folded before Flop (didn't bet)



PokerStars Hand #166668005019:  Hold'em No Limit ($0.05/$0.10 USD) - 2017/02/23 16:11:31 ET
Table 'Hajek III' 6-max Seat #2 is the button
Seat 1: MBen10 ($12.01 in chips) 
Seat 2: fortieth ($10 in chips) 
Seat 5: Chrips ($10.20 in chips) 
Seat 6: fabadam ($22.80 in chips) 
Chrips: posts small blind $0.05
fabadam: posts big blind $0.10
*** HOLE CARDS ***
MBen10: folds 
fortieth: folds 
Chrips: raises $0.10 to $0.20
FRAID358 joins the table at seat #4 
fabadam: calls $0.10
*** FLOP *** [As 4s 9s]
Chrips: checks 
fabadam: bets $0.38
Chrips: calls $0.38
*** TURN *** [As 4s 9s] [3h]
Chrips: checks 
fabadam: checks 
*** RIVER *** [As 4s 9s 3h] [Qd]
Chrips: bets $0.56
fabadam: folds 
Uncalled bet ($0.56) returned to Chrips
Chrips collected $1.11 from pot
*** SUMMARY ***
Total pot $1.16 | Rake $0.05 
Board [As 4s 9s 3h Qd]
Seat 1: MBen10 folded before Flop (didn't bet)
Seat 2: fortieth (button) folded before Flop (didn't bet)
Seat 5: Chrips (small blind) collected ($1.11)
Seat 6: fabadam (big blind) folded on the River



PokerStars Hand #166668005020:  Hold'em No Limit ($0.05/$0.10 USD) - 2017/02/23 16:11:31 ET
Table 'Sinon II' 6-max Seat #6 is the button
Seat 1: Aescul@pius ($10 in chips) 
Seat 2: ÄissesHai ($27.77 in chips) 
Seat 3: crazydevill ($10 in chips) 
Seat 4: Bandyaev ($14.68 in chips) 
Seat 5: ab260414 ($10.21 in chips) 
Seat 6: hartmut2012 ($7.59 in chips) 
Aescul@pius: posts small blind $0.05
ÄissesHai: posts big blind $0.10
*** HOLE CARDS ***
crazydevill: folds 
Bandyaev: folds 
ab260414: folds 
hartmut2012: calls $0.10
Aescul@pius: calls $0.05
ÄissesHai: folds 
*** FLOP *** [Th 3h 6s]
ÄissesHai leaves the table
Aescul@pius: bets $0.23
hartmut2012: calls $0.23
*** TURN *** [Th 3h 6s] [Js]
Aescul@pius: bets $0.50
hartmut2012: calls $0.50
*** RIVER *** [Th 3h 6s Js] [7h]
Aescul@pius: checks 
hartmut2012: bets $1
Aescul@pius: folds 
Uncalled bet ($1) returned to hartmut2012
KRZuff joins the table at seat #2 
hartmut2012 collected $1.68 from pot
*** SUMMARY ***
Total pot $1.76 | Rake $0.08 
Board [Th 3h 6s Js 7h]
Seat 1: Aescul@pius (small blind) folded on the River
Seat 2: ÄissesHai (big blind) folded before Flop
Seat 3: crazydevill folded before Flop (didn't bet)
Seat 4: Bandyaev folded before Flop (didn't bet)
Seat 5: ab260414 folded before Flop (didn't bet)
Seat 6: hartmut2012 (button) collected ($1.68)



PokerStars Hand #166668005128:  Hold'em No Limit ($0.05/$0.10 USD) - 2017/02/23 16:11:31 ET
Table 'Sheragul III' 6-max Seat #6 is the button
Seat 1: CallByValue ($9.90 in chips) 
Seat 2: Bird et al ($10.64 in chips) 
Seat 5: RGhearted ($10 in chips) 
Seat 6: XaXaTyH4uK ($10.25 in chips) 
CallByValue: posts small blind $0.05
Bird et al: posts big blind $0.10
Mesmer416: sits out 
maxiv608: sits out 
*** HOLE CARDS ***
RGhearted: folds 
XaXaTyH4uK: folds 
CallByValue: folds 
Uncalled bet ($0.05) returned to Bird et al
Bird et al collected $0.10 from pot
*** SUMMARY ***
Total pot $0.10 | Rake $0 
Seat 1: CallByValue (small blind) folded before Flop
Seat 2: Bird et al (big blind) collected ($0.10)
Seat 5: RGhearted folded before Flop (didn't bet)
Seat 6: XaXaTyH4uK (button) folded before Flop (didn't bet)



PokerStars Hand #166668005773:  Hold'em No Limit ($0.05/$0.10 USD) - 2017/02/23 16:11:32 ET
Table 'Kobresia II' 6-max Seat #4 is the button
Seat 1: RoJ1 ($15.34 in chips) 
Seat 2: Dcaro31 ($13.52 in chips) 
Seat 3: ocmarigo81 ($3.75 in chips) 
Seat 4: Vanne11 ($10.17 in chips) 
Seat 5: XaXaTyH4uK ($10.10 in chips) 
Seat 6: JahSoldier69 ($10 in chips) 
XaXaTyH4uK: posts small blind $0.05
JahSoldier69: posts big blind $0.10
*** HOLE CARDS ***
RoJ1: folds 
Dcaro31: folds 
ocmarigo81: folds 
Vanne11: folds 
XaXaTyH4uK: folds 
Uncalled bet ($0.05) returned to JahSoldier69
JahSoldier69 collected $0.10 from pot
*** SUMMARY ***
Total pot $0.10 | Rake $0 
Seat 1: RoJ1 folded before Flop (didn't bet)
Seat 2: Dcaro31 folded before Flop (didn't bet)
Seat 3: ocmarigo81 folded before Flop (didn't bet)
Seat 4: Vanne11 (button) folded before Flop (didn't bet)
Seat 5: XaXaTyH4uK (small blind) folded before Flop
Seat 6: JahSoldier69 (big blind) collected ($0.10)



PokerStars Hand #166668005937:  Hold'em No Limit ($0.05/$0.10 USD) - 2017/02/23 16:11:32 ET
Table 'Nerthus II' 6-max Seat #1 is the button
Seat 1: mdelfin0 ($12.49 in chips) 
Seat 2: Hovhannes990 ($9.17 in chips) 
Seat 3: Mamm0nism ($18.71 in chips) 
Seat 4: myevc ($16.53 in chips) 
Seat 5: Hyd SK ($10.62 in chips) 
Seat 6: Lucky HoBBiT ($10 in chips) 
Hovhannes990: posts small blind $0.05
Mamm0nism: posts big blind $0.10
*** HOLE CARDS ***
myevc: raises $0.15 to $0.25
Hyd SK: folds 
Lucky HoBBiT: folds 
mdelfin0: folds 
Hovhannes990: folds 
Mamm0nism: folds 
Uncalled bet ($0.15) returned to myevc
myevc collected $0.25 from pot
*** SUMMARY ***
Total pot $0.25 | Rake $0 
Seat 1: mdelfin0 (button) folded before Flop (didn't bet)
Seat 2: Hovhannes990 (small blind) folded before Flop
Seat 3: Mamm0nism (big blind) folded before Flop
Seat 4: myevc collected ($0.25)
Seat 5: Hyd SK folded before Flop (didn't bet)
Seat 6: Lucky HoBBiT folded before Flop (didn't bet)



PokerStars Hand #166668005949:  Hold'em No Limit ($0.05/$0.10 USD) - 2017/02/23 16:11:32 ET
Table 'Phereclos II' 6-max Seat #3 is the button
Seat 1: Vladu1986 ($10.15 in chips) 
Seat 2: Kazacha ($15.48 in chips) 
Seat 3: overbet666 ($10 in chips) 
Seat 4: Lucky HoBBiT ($10 in chips) 
Seat 5: crazydevill ($12.24 in chips) 
Seat 6: mhonielsen ($16.64 in chips) 
Lucky HoBBiT: posts small blind $0.05
crazydevill: posts big blind $0.10
*** HOLE CARDS ***
mhonielsen: folds 
Vladu1986: raises $0.10 to $0.20
Kazacha: folds 
overbet666: folds 
Lucky HoBBiT: raises $0.60 to $0.80
crazydevill: folds 
Vladu1986: folds 
Uncalled bet ($0.60) returned to Lucky HoBBiT
Lucky HoBBiT collected $0.50 from pot
*** SUMMARY ***
Total pot $0.50 | Rake $0 
Seat 1: Vladu1986 folded before Flop
Seat 2: Kazacha folded before Flop (didn't bet)
Seat 3: overbet666 (button) folded before Flop (didn't bet)
Seat 4: Lucky HoBBiT (small blind) collected ($0.50)
Seat 5: crazydevill (big blind) folded before Flop
Seat 6: mhonielsen folded before Flop (didn't bet)



PokerStars Hand #166668006070:  Hold'em No Limit ($0.05/$0.10 USD) - 2017/02/23 16:11:32 ET
Table 'Glarona' 6-max Seat #2 is the button
Seat 1: LarryTheStar ($10 in chips) 
Seat 2: BookWorm78 ($10.25 in chips) 
Seat 3: gaHy_HaXeP ($10 in chips) 
Seat 4: CrippledGod ($7.04 in chips) 
Seat 6: marianoboni ($10.15 in chips) 
gaHy_HaXeP: posts small blind $0.05
CrippledGod: posts big blind $0.10
*** HOLE CARDS ***
marianoboni: raises $0.24 to $0.34
BahiaMinhaP joins the table at seat #5 
LarryTheStar: calls $0.34
BookWorm78: folds 
gaHy_HaXeP: folds 
CrippledGod: folds 
*** FLOP *** [3d 5d 5c]
marianoboni: checks 
LarryTheStar: checks 
*** TURN *** [3d 5d 5c] [3s]
marianoboni: checks 
BahiaMinhaP leaves the table
LarryTheStar: checks 
*** RIVER *** [3d 5d 5c 3s] [Kh]
marianoboni: checks 
LarryTheStar: bets $0.50
marianoboni: calls $0.50
*** SHOW DOWN ***
LarryTheStar: shows [Kd Qs] (two pair, Kings and Fives)
marianoboni: mucks hand 
LarryTheStar collected $1.75 from pot
*** SUMMARY ***
Total pot $1.83 | Rake $0.08 
Board [3d 5d 5c 3s Kh]
Seat 1: LarryTheStar showed [Kd Qs] and won ($1.75) with two pair, Kings and Fives
Seat 2: BookWorm78 (button) folded before Flop (didn't bet)
Seat 3: gaHy_HaXeP (small blind) folded before Flop
Seat 4: CrippledGod (big blind) folded before Flop
Seat 6: marianoboni mucked



PokerStars Hand #166668006157:  Hold'em No Limit ($0.05/$0.10 USD) - 2017/02/23 16:11:32 ET
Table 'Aconcagua' 6-max Seat #1 is the button
Seat 1: MLPlayer16 ($10 in chips) 
Seat 2: Kupi007 ($11.63 in chips) 
Seat 3: burtila1989 ($7.09 in chips) 
Seat 4: pivanki11 ($8.96 in chips) 
Seat 5: Andrei ProFF ($10.51 in chips) 
Seat 6: coolisses111 ($11.43 in chips) 
Kupi007: posts small blind $0.05
burtila1989: posts big blind $0.10
MLPlayer16: posts the ante $0.02
Kupi007: posts the ante $0.02
burtila1989: posts the ante $0.02
pivanki11: posts the ante $0.02
Andrei ProFF: posts the ante $0.02
coolisses111: posts the ante $0.02
*** HOLE CARDS ***
pivanki11: folds 
Andrei ProFF: folds 
coolisses111: folds 
MLPlayer16: folds 
Kupi007: raises $0.20 to $0.30
burtila1989: calls $0.20
*** FLOP *** [7h 4s Jc]
Kupi007: bets $0.45
burtila1989: calls $0.45
*** TURN *** [7h 4s Jc] [Js]
Kupi007: checks 
burtila1989: checks 
*** RIVER *** [7h 4s Jc Js] [6h]
Kupi007: bets $0.93
burtila1989: folds 
Uncalled bet ($0.93) returned to Kupi007
Kupi007 collected $1.55 from pot
*** SUMMARY ***
Total pot $1.62 | Rake $0.07 
Board [7h 4s Jc Js 6h]
Seat 1: MLPlayer16 (button) folded before Flop (didn't bet)
Seat 2: Kupi007 (small blind) collected ($1.55)
Seat 3: burtila1989 (big blind) folded on the River
Seat 4: pivanki11 folded before Flop (didn't bet)
Seat 5: Andrei ProFF folded before Flop (didn't bet)
Seat 6: coolisses111 folded before Flop (didn't bet)



PokerStars Hand #166668006367:  Hold'em No Limit ($0.05/$0.10 USD) - 2017/02/23 16:11:32 ET
Table 'Selinur' 6-max Seat #5 is the button
Seat 2: hoedje72 ($7.68 in chips) 
Seat 3: bambolejro ($11.93 in chips) 
Seat 4: ThuyeTD11 ($3.65 in chips) 
Seat 5: DrVzad ($9.85 in chips) 
Seat 6: homelessdan ($17.46 in chips) 
homelessdan: posts small blind $0.05
KA3AXCTAHEU,: is sitting out 
KA3AXCTAHEU, leaves the table
hoedje72: posts big blind $0.10
*** HOLE CARDS ***
bambolejro: folds 
ThuyeTD11: calls $0.10
DrVzad: folds 
homelessdan: folds 
hoedje72: checks 
*** FLOP *** [2s 9s 5d]
hoedje72: checks 
ThuyeTD11: bets $0.10
hoedje72: calls $0.10
*** TURN *** [2s 9s 5d] [Jd]
hoedje72: checks 
ThuyeTD11: bets $0.20
hoedje72: calls $0.20
*** RIVER *** [2s 9s 5d Jd] [Jc]
hoedje72: checks 
ThuyeTD11: bets $0.30
hoedje72: calls $0.30
*** SHOW DOWN ***
ThuyeTD11: shows [9h 5h] (two pair, Jacks and Nines)
hoedje72: mucks hand 
ThuyeTD11 collected $1.38 from pot
*** SUMMARY ***
Total pot $1.45 | Rake $0.07 
Board [2s 9s 5d Jd Jc]
Seat 2: hoedje72 (big blind) mucked
Seat 3: bambolejro folded before Flop (didn't bet)
Seat 4: ThuyeTD11 showed [9h 5h] and won ($1.38) with two pair, Jacks and Nines
Seat 5: DrVzad (button) folded before Flop (didn't bet)
Seat 6: homelessdan (small blind) folded before Flop



PokerStars Hand #166668006633:  Hold'em No Limit ($0.05/$0.10 USD) - 2017/02/23 16:11:33 ET
Table 'Izar' 6-max Seat #1 is the button
Seat 1: bambolejro ($10.22 in chips) 
Seat 2: mvp0013 ($10.52 in chips) 
Seat 3: Yspenyanin ($11.17 in chips) 
Seat 4: Matee92 ($9.63 in chips) 
Seat 5: fishhook5 ($10.30 in chips) 
Seat 6: yodzik ($13.94 in chips) 
mvp0013: posts small blind $0.05
Yspenyanin: posts big blind $0.10
*** HOLE CARDS ***
Matee92: calls $0.10
fishhook5: folds 
yodzik: folds 
bambolejro: folds 
mvp0013: folds 
Yspenyanin: checks 
*** FLOP *** [5c 3d Jh]
Yspenyanin: checks 
Matee92: checks 
*** TURN *** [5c 3d Jh] [2s]
Yspenyanin: checks 
Matee92: checks 
*** RIVER *** [5c 3d Jh 2s] [Ts]
Yspenyanin: checks 
Matee92: checks 
*** SHOW DOWN ***
Yspenyanin: shows [7c Qh] (high card Queen)
Matee92: shows [Qd As] (high card Ace)
Matee92 collected $0.24 from pot
*** SUMMARY ***
Total pot $0.25 | Rake $0.01 
Board [5c 3d Jh 2s Ts]
Seat 1: bambolejro (button) folded before Flop (didn't bet)
Seat 2: mvp0013 (small blind) folded before Flop
Seat 3: Yspenyanin (big blind) showed [7c Qh] and lost with high card Queen
Seat 4: Matee92 showed [Qd As] and won ($0.24) with high card Ace
Seat 5: fishhook5 folded before Flop (didn't bet)
Seat 6: yodzik folded before Flop (didn't bet)



PokerStars Hand #166668006677:  Hold'em No Limit ($0.05/$0.10 USD) - 2017/02/23 16:11:33 ET
Table 'Siebohme II' 6-max Seat #5 is the button
Seat 1: homelessdan ($17.67 in chips) 
Seat 2: townerz1991 ($12.97 in chips) 
Seat 3: D3NyA ($10.19 in chips) 
Seat 4: POT_TRADER ($11.99 in chips) 
Seat 5: NvR.m1nD ($11.19 in chips) 
Seat 6: Fozzy690 ($10.73 in chips) 
Fozzy690: posts small blind $0.05
homelessdan: posts big blind $0.10
*** HOLE CARDS ***
townerz1991: folds 
D3NyA: folds 
POT_TRADER: raises $0.12 to $0.22
NvR.m1nD: folds 
Fozzy690: folds 
homelessdan: folds 
Uncalled bet ($0.12) returned to POT_TRADER
POT_TRADER collected $0.25 from pot
*** SUMMARY ***
Total pot $0.25 | Rake $0 
Seat 1: homelessdan (big blind) folded before Flop
Seat 2: townerz1991 folded before Flop (didn't bet)
Seat 3: D3NyA folded before Flop (didn't bet)
Seat 4: POT_TRADER collected ($0.25)
Seat 5: NvR.m1nD (button) folded before Flop (didn't bet)
Seat 6: Fozzy690 (small blind) folded before Flop



PokerStars Hand #166668006929:  Hold'em No Limit ($0.05/$0.10 USD) - 2017/02/23 16:11:33 ET
Table 'Tomita II' 6-max Seat #2 is the button
Seat 1: HARDCORE66RU ($22.78 in chips) 
Seat 2: mhonielsen ($10.15 in chips) 
Seat 4: Hyd SK ($11.66 in chips) 
Seat 5: ex3Lero86 ($10 in chips) 
Seat 6: saniasmir ($10 in chips) 
Kow6oy will be allowed to play after the button
Hyd SK: posts small blind $0.05
ex3Lero86: posts big blind $0.10
*** HOLE CARDS ***
saniasmir: folds 
HARDCORE66RU: folds 
mhonielsen: raises $0.10 to $0.20
Hyd SK: folds 
ex3Lero86: folds 
Uncalled bet ($0.10) returned to mhonielsen
mhonielsen collected $0.25 from pot
*** SUMMARY ***
Total pot $0.25 | Rake $0 
Seat 1: HARDCORE66RU folded before Flop (didn't bet)
Seat 2: mhonielsen (button) collected ($0.25)
Seat 4: Hyd SK (small blind) folded before Flop
Seat 5: ex3Lero86 (big blind) folded before Flop
Seat 6: saniasmir folded before Flop (didn't bet)



PokerStars Hand #166668007152:  Hold'em No Limit ($0.05/$0.10 USD) - 2017/02/23 16:11:33 ET
Table 'Rostia' 6-max Seat #5 is the button
Seat 1: paxit71 ($7.90 in chips) 
Seat 2: GrzesiuWilu ($8.87 in chips) 
Seat 3: iThreeBarrel ($10 in chips) 
Seat 4: Hyd SK ($12.03 in chips) 
Seat 5: silsilviu ($7.52 in chips) 
Seat 6: Giyorod ($17.70 in chips) 
Giyorod: posts small blind $0.05
paxit71: posts big blind $0.10
*** HOLE CARDS ***
GrzesiuWilu: folds 
iThreeBarrel: raises $0.20 to $0.30
Hyd SK: calls $0.30
silsilviu: folds 
Giyorod: folds 
paxit71: calls $0.20
*** FLOP *** [7s Ts 4s]
paxit71: checks 
iThreeBarrel: bets $0.62
Hyd SK: calls $0.62
paxit71: raises $2.77 to $3.39
iThreeBarrel: raises $6.31 to $9.70 and is all-in
Hyd SK: folds 
paxit71: calls $4.21 and is all-in
Uncalled bet ($2.10) returned to iThreeBarrel
*** TURN *** [7s Ts 4s] [6d]
*** RIVER *** [7s Ts 4s 6d] [2h]
*** SHOW DOWN ***
paxit71: shows [6s 5s] (a flush, Ten high)
iThreeBarrel: shows [Ks Kc] (a pair of Kings)
paxit71 collected $16.02 from pot
*** SUMMARY ***
Total pot $16.77 | Rake $0.75 
Board [7s Ts 4s 6d 2h]
Seat 1: paxit71 (big blind) showed [6s 5s] and won ($16.02) with a flush, Ten high
Seat 2: GrzesiuWilu folded before Flop (didn't bet)
Seat 3: iThreeBarrel showed [Ks Kc] and lost with a pair of Kings
Seat 4: Hyd SK folded on the Flop
Seat 5: silsilviu (button) folded before Flop (didn't bet)
Seat 6: Giyorod (small blind) folded before Flop



PokerStars Hand #166668007356:  Hold'em No Limit ($0.05/$0.10 USD) - 2017/02/23 16:11:34 ET
Table 'Tyndareus III' 6-max Seat #2 is the button
Seat 1: MBen10 ($18.81 in chips) 
Seat 2: MihaGr ($10 in chips) 
Seat 3: XaXaTyH4uK ($10.05 in chips) 
Seat 4: tequila_joop ($11.82 in chips) 
Seat 5: yodzik ($5 in chips) 
Seat 6: Hb-309 ($9.41 in chips) 
XaXaTyH4uK: posts small blind $0.05
tequila_joop: posts big blind $0.10
*** HOLE CARDS ***
yodzik: folds 
Hb-309: folds 
MBen10: folds 
MihaGr: folds 
XaXaTyH4uK: folds 
Uncalled bet ($0.05) returned to tequila_joop
tequila_joop collected $0.10 from pot
*** SUMMARY ***
Total pot $0.10 | Rake $0 
Seat 1: MBen10 folded before Flop (didn't bet)
Seat 2: MihaGr (button) folded before Flop (didn't bet)
Seat 3: XaXaTyH4uK (small blind) folded before Flop
Seat 4: tequila_joop (big blind) collected ($0.10)
Seat 5: yodzik folded before Flop (didn't bet)
Seat 6: Hb-309 folded before Flop (didn't bet)



PokerStars Hand #166668007423:  Hold'em No Limit ($0.05/$0.10 USD) - 2017/02/23 16:11:34 ET
Table 'Brambilla II' 6-max Seat #5 is the button
Seat 1: Rodik002 ($12.55 in chips) 
Seat 3: BORIS_ENEV ($14.06 in chips) 
Seat 5: FRAID358 ($9.85 in chips) 
Seat 6: boxer821 ($10 in chips) 
boxer821: posts small blind $0.05
Rodik002: posts big blind $0.10
overbet666: sits out 
BORIS_ENEV: posts small & big blinds $0.15
*** HOLE CARDS ***
BORIS_ENEV: checks 
FRAID358: folds 
JahSoldier69 joins the table at seat #4 
boxer821: raises $0.40 to $0.50
Rodik002: folds 
BORIS_ENEV: folds 
Uncalled bet ($0.40) returned to boxer821
boxer821 collected $0.35 from pot
*** SUMMARY ***
Total pot $0.35 | Rake $0 
Seat 1: Rodik002 (big blind) folded before Flop
Seat 3: BORIS_ENEV folded before Flop
Seat 5: FRAID358 (button) folded before Flop (didn't bet)
Seat 6: boxer821 (small blind) collected ($0.35)



PokerStars Hand #166668007511:  Hold'em No Limit ($0.05/$0.10 USD) - 2017/02/23 16:11:34 ET
Table 'Pandora III' 6-max Seat #5 is the button
Seat 1: Pokeaster ($11.24 in chips) 
Seat 2: garigura ($11.54 in chips) 
Seat 3: Chodemuncher ($10 in chips) 
Seat 4: mhonielsen ($10.30 in chips) 
Seat 5: MühliJr ($10.42 in chips) 
Seat 6: yodzik ($5.22 in chips) 
yodzik: posts small blind $0.05
Pokeaster: posts big blind $0.10
*** HOLE CARDS ***
garigura: raises $0.20 to $0.30
Chodemuncher: folds 
mhonielsen: calls $0.30
MühliJr: calls $0.30
yodzik: folds 
Pokeaster: folds 
*** FLOP *** [7s 6d Qc]
garigura: checks 
mhonielsen: bets $0.70
MühliJr: calls $0.70
garigura: raises $2.07 to $2.77
mhonielsen: folds 
MühliJr: folds 
Uncalled bet ($2.07) returned to garigura
garigura collected $3.01 from pot
*** SUMMARY ***
Total pot $3.15 | Rake $0.14 
Board [7s 6d Qc]
Seat 1: Pokeaster (big blind) folded before Flop
Seat 2: garigura collected ($3.01)
Seat 3: Chodemuncher folded before Flop (didn't bet)
Seat 4: mhonielsen folded on the Flop
Seat 5: MühliJr (button) folded on the Flop
Seat 6: yodzik (small blind) folded before Flop



PokerStars Hand #166668007641:  Hold'em No Limit ($0.05/$0.10 USD) - 2017/02/23 16:11:34 ET
Table 'Emma II' 6-max Seat #4 is the button
Seat 1: LarryTheStar ($10.25 in chips) 
Seat 2: T9MS ($11.49 in chips) 
Seat 3: oddshoff ($10.07 in chips) 
Seat 4: Jucatorul823 ($6.31 in chips) 
Seat 5: Scanner17 ($10.73 in chips) 
Seat 6: CHRO8 ($14.37 in chips) 
Scanner17: posts small blind $0.05
CHRO8: posts big blind $0.10
*** HOLE CARDS ***
LarryTheStar: folds 
T9MS: raises $0.20 to $0.30
oddshoff: folds 
Jucatorul823: folds 
Scanner17: folds 
CHRO8: folds 
Uncalled bet ($0.20) returned to T9MS
T9MS collected $0.25 from pot
*** SUMMARY ***
Total pot $0.25 | Rake $0 
Seat 1: LarryTheStar folded before Flop (didn't bet)
Seat 2: T9MS collected ($0.25)
Seat 3: oddshoff folded before Flop (didn't bet)
Seat 4: Jucatorul823 (button) folded before Flop (didn't bet)
Seat 5: Scanner17 (small blind) folded before Flop
Seat 6: CHRO8 (big blind) folded before Flop



PokerStars Hand #166668007696:  Hold'em No Limit ($0.05/$0.10 USD) - 2017/02/23 16:11:34 ET
Table 'Ophelia' 6-max Seat #6 is the button
Seat 1: ralfi37 ($11.50 in chips) 
Seat 2: popypaleta ($16.63 in chips) 
Seat 3: mvp0013 ($10.80 in chips) 
Seat 4: Cluckh ($11.99 in chips) 
Seat 5: truck1234 ($13.21 in chips) 
Seat 6: Yabidooo ($10.63 in chips) 
ralfi37: posts small blind $0.05
popypaleta: posts big blind $0.10
*** HOLE CARDS ***
mvp0013: folds 
Cluckh: folds 
truck1234: folds 
Yabidooo: raises $0.10 to $0.20
ralfi37: folds 
popypaleta: raises $0.45 to $0.65
Yabidooo: folds 
Uncalled bet ($0.45) returned to popypaleta
popypaleta collected $0.45 from pot
*** SUMMARY ***
Total pot $0.45 | Rake $0 
Seat 1: ralfi37 (small blind) folded before Flop
Seat 2: popypaleta (big blind) collected ($0.45)
Seat 3: mvp0013 folded before Flop (didn't bet)
Seat 4: Cluckh folded before Flop (didn't bet)
Seat 5: truck1234 folded before Flop (didn't bet)
Seat 6: Yabidooo (button) folded before Flop



PokerStars Hand #166668007807:  Hold'em No Limit ($0.05/$0.10 USD) - 2017/02/23 16:11:34 ET
Table 'Girtab' 6-max Seat #4 is the button
Seat 2: MühliJr ($10 in chips) 
Seat 3: kingartur222 ($9.90 in chips) 
Seat 4: Hyd SK ($10.83 in chips) 
Seat 5: sexy_seagull ($11.25 in chips) 
Seat 6: iluzja12 ($11.10 in chips) 
sexy_seagull: posts small blind $0.05
iluzja12: posts big blind $0.10
AIONCMA1988: sits out 
*** HOLE CARDS ***
MühliJr: folds 
kingartur222: folds 
Hyd SK: raises $0.15 to $0.25
sexy_seagull: folds 
iluzja12: raises $0.55 to $0.80
Hyd SK: folds 
Uncalled bet ($0.55) returned to iluzja12
iluzja12 collected $0.55 from pot
*** SUMMARY ***
Total pot $0.55 | Rake $0 
Seat 2: MühliJr folded before Flop (didn't bet)
Seat 3: kingartur222 folded before Flop (didn't bet)
Seat 4: Hyd SK (button) folded before Flop
Seat 5: sexy_seagull (small blind) folded before Flop
Seat 6: iluzja12 (big blind) collected ($0.55)



PokerStars Hand #166668007848:  Hold'em No Limit ($0.05/$0.10 USD) - 2017/02/23 16:11:34 ET
Table 'Apollonia' 6-max Seat #4 is the button
Seat 1: ex3Lero86 ($10 in chips) 
Seat 2: ibara000 ($17.85 in chips) 
Seat 3: steepfell ($10.53 in chips) 
Seat 4: Goroshkos88 ($17.86 in chips) 
Seat 5: bambolejro ($10 in chips) 
Seat 6: iluzja12 ($10.37 in chips) 
bambolejro: posts small blind $0.05
iluzja12: posts big blind $0.10
*** HOLE CARDS ***
ex3Lero86: folds 
ibara000: raises $0.16 to $0.26
steepfell: folds 
Goroshkos88: folds 
bambolejro: folds 
iluzja12: folds 
Uncalled bet ($0.16) returned to ibara000
ibara000 collected $0.25 from pot
*** SUMMARY ***
Total pot $0.25 | Rake $0 
Seat 1: ex3Lero86 folded before Flop (didn't bet)
Seat 2: ibara000 collected ($0.25)
Seat 3: steepfell folded before Flop (didn't bet)
Seat 4: Goroshkos88 (button) folded before Flop (didn't bet)
Seat 5: bambolejro (small blind) folded before Flop
Seat 6: iluzja12 (big blind) folded before Flop



PokerStars Hand #166668007871:  Hold'em No Limit ($0.05/$0.10 USD) - 2017/02/23 16:11:34 ET
Table 'Sham' 6-max Seat #3 is the button
Seat 1: pancernik21 ($10.15 in chips) 
Seat 2: ex3Lero86 ($10 in chips) 
Seat 3: weez3r ($15.20 in chips) 
Seat 5: T9MS ($10 in chips) 
Seat 6: bdixon_5 ($19.50 in chips) 
T9MS: posts small blind $0.05
bdixon_5: posts big blind $0.10
*** HOLE CARDS ***
pancernik21: raises $0.20 to $0.30
ex3Lero86: folds 
weez3r: folds 
T9MS: calls $0.25
bdixon_5: folds 
*** FLOP *** [5c Ah Qs]
T9MS: checks 
pancernik21: checks 
*** TURN *** [5c Ah Qs] [Ts]
T9MS: checks 
pancernik21: checks 
*** RIVER *** [5c Ah Qs Ts] [7s]
T9MS: checks 
pancernik21: checks 
*** SHOW DOWN ***
T9MS: shows [3h 3d] (a pair of Threes)
pancernik21: shows [8h Th] (a pair of Tens)
pancernik21 collected $0.67 from pot
*** SUMMARY ***
Total pot $0.70 | Rake $0.03 
Board [5c Ah Qs Ts 7s]
Seat 1: pancernik21 showed [8h Th] and won ($0.67) with a pair of Tens
Seat 2: ex3Lero86 folded before Flop (didn't bet)
Seat 3: weez3r (button) folded before Flop (didn't bet)
Seat 5: T9MS (small blind) showed [3h 3d] and lost with a pair of Threes
Seat 6: bdixon_5 (big blind) folded before Flop



PokerStars Hand #166668008161:  Hold'em No Limit ($0.05/$0.10 USD) - 2017/02/23 16:11:34 ET
Table 'Manto II' 6-max Seat #5 is the button
Seat 1: ex3Lero86 ($10 in chips) 
Seat 2: voledy ($10.42 in chips) 
Seat 3: Komap511 ($10.10 in chips) 
Seat 5: ArcticBearDK ($34.38 in chips) 
Seat 6: pancernik21 ($14.23 in chips) 
pancernik21: posts small blind $0.05
ex3Lero86: posts big blind $0.10
AIONCMA1988: sits out 
*** HOLE CARDS ***
voledy: folds 
Komap511: folds 
ArcticBearDK: folds 
pancernik21: raises $0.20 to $0.30
ex3Lero86: folds 
Uncalled bet ($0.20) returned to pancernik21
pancernik21 collected $0.20 from pot
*** SUMMARY ***
Total pot $0.20 | Rake $0 
Seat 1: ex3Lero86 (big blind) folded before Flop
Seat 2: voledy folded before Flop (didn't bet)
Seat 3: Komap511 folded before Flop (didn't bet)
Seat 5: ArcticBearDK (button) folded before Flop (didn't bet)
Seat 6: pancernik21 (small blind) collected ($0.20)



PokerStars Hand #166668008642:  Hold'em No Limit ($0.05/$0.10 USD) - 2017/02/23 16:11:35 ET
Table 'Nehalennia III' 6-max Seat #5 is the button
Seat 1: boxer821 ($10.99 in chips) 
Seat 2: fortieth ($10.28 in chips) 
Seat 3: ValdemorS ($19.76 in chips) 
Seat 4: eniksenik ($10.73 in chips) 
Seat 5: ChuikaPridi ($10 in chips) 
Seat 6: valzeny ($20.34 in chips) 
valzeny: posts small blind $0.05
boxer821: posts big blind $0.10
boxer821: posts the ante $0.02
fortieth: posts the ante $0.02
ValdemorS: posts the ante $0.02
eniksenik: posts the ante $0.02
ChuikaPridi: posts the ante $0.02
valzeny: posts the ante $0.02
*** HOLE CARDS ***
fortieth: folds 
ValdemorS: folds 
eniksenik: raises $0.20 to $0.30
ChuikaPridi: folds 
valzeny: folds 
boxer821: folds 
Uncalled bet ($0.20) returned to eniksenik
eniksenik collected $0.37 from pot
*** SUMMARY ***
Total pot $0.37 | Rake $0 
Seat 1: boxer821 (big blind) folded before Flop
Seat 2: fortieth folded before Flop (didn't bet)
Seat 3: ValdemorS folded before Flop (didn't bet)
Seat 4: eniksenik collected ($0.37)
Seat 5: ChuikaPridi (button) folded before Flop (didn't bet)
Seat 6: valzeny (small blind) folded before Flop



PokerStars Hand #166668008659:  Hold'em No Limit ($0.05/$0.10 USD) - 2017/02/23 16:11:35 ET
Table 'Arkab' 6-max Seat #4 is the button
Seat 1: iamkakaroto ($10.15 in chips) 
Seat 2: aktion4ik ($12.24 in chips) 
Seat 3: sexy_seagull ($10.36 in chips) 
Seat 4: dincimus ($10.08 in chips) 
Seat 5: OrionYusupov ($9.23 in chips) 
Seat 6: MihaGr ($11.20 in chips) 
OrionYusupov: posts small blind $0.05
MihaGr: posts big blind $0.10
*** HOLE CARDS ***
iamkakaroto: folds 
aktion4ik: folds 
sexy_seagull: folds 
dincimus: raises $0.10 to $0.20
OrionYusupov: calls $0.15
MihaGr: calls $0.10
*** FLOP *** [Ad Th 5h]
OrionYusupov: checks 
MihaGr: checks 
dincimus: checks 
*** TURN *** [Ad Th 5h] [4s]
OrionYusupov: checks 
MihaGr: checks 
dincimus: checks 
*** RIVER *** [Ad Th 5h 4s] [Kc]
OrionYusupov: checks 
MihaGr: checks 
dincimus: checks 
*** SHOW DOWN ***
OrionYusupov: shows [9s Qs] (high card Ace)
MihaGr: mucks hand 
dincimus: shows [7s Ts] (a pair of Tens)
dincimus collected $0.57 from pot
*** SUMMARY ***
Total pot $0.60 | Rake $0.03 
Board [Ad Th 5h 4s Kc]
Seat 1: iamkakaroto folded before Flop (didn't bet)
Seat 2: aktion4ik folded before Flop (didn't bet)
Seat 3: sexy_seagull folded before Flop (didn't bet)
Seat 4: dincimus (button) showed [7s Ts] and won ($0.57) with a pair of Tens
Seat 5: OrionYusupov (small blind) showed [9s Qs] and lost with high card Ace
Seat 6: MihaGr (big blind) mucked



PokerStars Hand #166668008701:  Hold'em No Limit ($0.05/$0.10 USD) - 2017/02/23 16:11:35 ET
Table 'Euryalos II' 6-max Seat #6 is the button
Seat 2: silsilviu ($17.29 in chips) 
Seat 3: Hyd SK ($10.35 in chips) 
Seat 4: popypaleta ($11.78 in chips) 
Seat 6: MihaGr ($10 in chips) 
silsilviu: posts small blind $0.05
Hyd SK: posts big blind $0.10
*** HOLE CARDS ***
popypaleta: raises $0.20 to $0.30
MihaGr: folds 
silsilviu: folds 
Hyd SK: calls $0.20
*** FLOP *** [5h 8h 3s]
Hyd SK: checks 
popypaleta: bets $0.40
Hyd SK: folds 
Uncalled bet ($0.40) returned to popypaleta
popypaleta collected $0.62 from pot
*** SUMMARY ***
Total pot $0.65 | Rake $0.03 
Board [5h 8h 3s]
Seat 2: silsilviu (small blind) folded before Flop
Seat 3: Hyd SK (big blind) folded on the Flop
Seat 4: popypaleta collected ($0.62)
Seat 6: MihaGr (button) folded before Flop (didn't bet)



PokerStars Hand #166668009000:  Hold'em No Limit ($0.05/$0.10 USD) - 2017/02/23 16:11:35 ET
Table 'Duhr II' 6-max Seat #1 is the button
Seat 1: Lucky HoBBiT ($11.03 in chips) 
Seat 2: Feverhead ($37.94 in chips) 
Seat 3: Smitty03300 ($10 in chips) 
Seat 4: CHRO8 ($9.85 in chips) 
Seat 5: Dimka4 ($10 in chips) 
Seat 6: townerz1991 ($11.28 in chips) 
Feverhead: posts small blind $0.05
Smitty03300: posts big blind $0.10
*** HOLE CARDS ***
CHRO8: raises $0.20 to $0.30
Dimka4: folds 
townerz1991: folds 
Lucky HoBBiT: folds 
Feverhead: folds 
Smitty03300: calls $0.20
*** FLOP *** [5c 9c Ac]
Smitty03300: checks 
CHRO8: checks 
*** TURN *** [5c 9c Ac] [6d]
Smitty03300: bets $0.40
CHRO8: raises $0.70 to $1.10
Smitty03300: folds 
Uncalled bet ($0.70) returned to CHRO8
CHRO8 collected $1.38 from pot
*** SUMMARY ***
Total pot $1.45 | Rake $0.07 
Board [5c 9c Ac 6d]
Seat 1: Lucky HoBBiT (button) folded before Flop (didn't bet)
Seat 2: Feverhead (small blind) folded before Flop
Seat 3: Smitty03300 (big blind) folded on the Turn
Seat 4: CHRO8 collected ($1.38)
Seat 5: Dimka4 folded before Flop (didn't bet)
Seat 6: townerz1991 folded before Flop (didn't bet)



PokerStars Hand #166668009148:  Hold'em No Limit ($0.05/$0.10 USD) - 2017/02/23 16:11:36 ET
Table 'Bootes' 6-max Seat #5 is the button
Seat 1: Namhkal ($11.40 in chips) 
Seat 2: Bird et al ($17.61 in chips) 
Seat 3: KA3AXCTAHEU, ($20.61 in chips) 
Seat 4: totonove ($7.02 in chips) 
Seat 5: Pekaml ($15.27 in chips) 
Seat 6: cherep61987 ($10 in chips) 
cherep61987: posts small blind $0.05
Namhkal: posts big blind $0.10
*** HOLE CARDS ***
Bird et al: folds 
KA3AXCTAHEU,: folds 
totonove: folds 
Pekaml: folds 
cherep61987: raises $0.20 to $0.30
Namhkal: calls $0.20
*** FLOP *** [4d Kd 7h]
cherep61987: bets $0.29
Namhkal: folds 
Uncalled bet ($0.29) returned to cherep61987
cherep61987 collected $0.57 from pot
*** SUMMARY ***
Total pot $0.60 | Rake $0.03 
Board [4d Kd 7h]
Seat 1: Namhkal (big blind) folded on the Flop
Seat 2: Bird et al folded before Flop (didn't bet)
Seat 3: KA3AXCTAHEU, folded before Flop (didn't bet)
Seat 4: totonove folded before Flop (didn't bet)
Seat 5: Pekaml (button) folded before Flop (didn't bet)
Seat 6: cherep61987 (small blind) collected ($0.57)



PokerStars Hand #166668009852:  Hold'em No Limit ($0.05/$0.10 USD) - 2017/02/23 16:11:36 ET
Table 'Alnasl II' 6-max Seat #5 is the button
Seat 1: dragonste89 ($13.80 in chips) 
Seat 3: ICBM-RS26 ($15.99 in chips) 
Seat 4: Eddys Edge ($10 in chips) 
Seat 5: mdelfin0 ($12.61 in chips) 
dragonste89: posts small blind $0.05
Therodorus: is sitting out 
xdjango07x joins the table at seat #6 
ICBM-RS26: posts big blind $0.10
*** HOLE CARDS ***
Eddys Edge: folds 
mdelfin0: folds 
Therodorus leaves the table
Namhkal joins the table at seat #2 
Namhkal leaves the table
dragonste89: folds 
Uncalled bet ($0.05) returned to ICBM-RS26
Vrinni joins the table at seat #2 
ICBM-RS26 collected $0.10 from pot
*** SUMMARY ***
Total pot $0.10 | Rake $0 
Seat 1: dragonste89 (small blind) folded before Flop
Seat 3: ICBM-RS26 (big blind) collected ($0.10)
Seat 4: Eddys Edge folded before Flop (didn't bet)
Seat 5: mdelfin0 (button) folded before Flop (didn't bet)



PokerStars Hand #166668009853:  Hold'em No Limit ($0.05/$0.10 USD) - 2017/02/23 16:11:36 ET
Table 'Nashira' 6-max Seat #3 is the button
Seat 2: niukak ($10 in chips) 
Seat 3: Therodorus ($10.05 in chips) 
Therodorus: posts small blind $0.05
niukak: posts big blind $0.10
*** HOLE CARDS ***
Therodorus: raises $0.15 to $0.25
niukak: calls $0.15
*** FLOP *** [Qs Ad 8c]
niukak: checks 
Therodorus: bets $0.35
niukak: calls $0.35
*** TURN *** [Qs Ad 8c] [3d]
niukak: checks 
Therodorus: bets $0.84
niukak: calls $0.84
*** RIVER *** [Qs Ad 8c 3d] [2d]
niukak: bets $2.75
Therodorus: calls $2.75
*** SHOW DOWN ***
niukak: shows [8d Kd] (a flush, Ace high)
Therodorus: mucks hand 
niukak collected $8 from pot
*** SUMMARY ***
Total pot $8.38 | Rake $0.38 
Board [Qs Ad 8c 3d 2d]
Seat 2: niukak (big blind) showed [8d Kd] and won ($8) with a flush, Ace high
Seat 3: Therodorus (button) (small blind) mucked



PokerStars Hand #166668009854:  Hold'em No Limit ($0.05/$0.10 USD) - 2017/02/23 16:11:36 ET
Table 'Grietje' 6-max Seat #1 is the button
Seat 1: dragonste89 ($10 in chips) 
Seat 2: Feverhead ($10 in chips) 
Seat 3: GitoValdivia ($8.03 in chips) 
Seat 4: MihaGr ($10.56 in chips) 
Seat 5: iThreeBarrel ($10 in chips) 
Seat 6: Prometheu$8 ($37.75 in chips) 
Feverhead: posts small blind $0.05
GitoValdivia: posts big blind $0.10
*** HOLE CARDS ***
MihaGr: folds 
iThreeBarrel: folds 
Prometheu$8: raises $0.25 to $0.35
dragonste89: folds 
Feverhead: folds 
GitoValdivia: calls $0.25
*** FLOP *** [Qd As 9c]
GitoValdivia: checks 
Prometheu$8: bets $0.72
GitoValdivia: calls $0.72
*** TURN *** [Qd As 9c] [8s]
GitoValdivia: checks 
Prometheu$8: checks 
*** RIVER *** [Qd As 9c 8s] [2c]
GitoValdivia: checks 
Prometheu$8: checks 
*** SHOW DOWN ***
GitoValdivia: shows [Js Qc] (a pair of Queens)
Prometheu$8: mucks hand 
GitoValdivia collected $2.09 from pot
*** SUMMARY ***
Total pot $2.19 | Rake $0.10 
Board [Qd As 9c 8s 2c]
Seat 1: dragonste89 (button) folded before Flop (didn't bet)
Seat 2: Feverhead (small blind) folded before Flop
Seat 3: GitoValdivia (big blind) showed [Js Qc] and won ($2.09) with a pair of Queens
Seat 4: MihaGr folded before Flop (didn't bet)
Seat 5: iThreeBarrel folded before Flop (didn't bet)
Seat 6: Prometheu$8 mucked



PokerStars Hand #166668009865:  Hold'em No Limit ($0.05/$0.10 USD) - 2017/02/23 16:11:36 ET
Table 'Repsolda' 6-max Seat #5 is the button
Seat 1: fabadam ($10 in chips) 
Seat 2: MBen10 ($24.52 in chips) 
Seat 4: MihaGr ($13.85 in chips) 
Seat 5: matehouse. ($10 in chips) 
Crafty23@PS will be allowed to play after the button
fabadam: posts small blind $0.05
MBen10: posts big blind $0.10
Xander188: sits out 
*** HOLE CARDS ***
MihaGr: folds 
matehouse.: raises $0.20 to $0.30
fabadam: folds 
MBen10: calls $0.20
*** FLOP *** [Jd 6c 2d]
MBen10: checks 
matehouse.: checks 
*** TURN *** [Jd 6c 2d] [5s]
MBen10: checks 
matehouse.: checks 
*** RIVER *** [Jd 6c 2d 5s] [Tc]
MBen10: checks 
matehouse.: checks 
*** SHOW DOWN ***
MBen10: shows [8s Ad] (high card Ace)
matehouse.: mucks hand 
MBen10 collected $0.62 from pot
*** SUMMARY ***
Total pot $0.65 | Rake $0.03 
Board [Jd 6c 2d 5s Tc]
Seat 1: fabadam (small blind) folded before Flop
Seat 2: MBen10 (big blind) showed [8s Ad] and won ($0.62) with high card Ace
Seat 4: MihaGr folded before Flop (didn't bet)
Seat 5: matehouse. (button) mucked



PokerStars Hand #166668010081:  Hold'em No Limit ($0.05/$0.10 USD) - 2017/02/23 16:11:37 ET
Table 'Kochera' 6-max Seat #1 is the button
Seat 1: chimera252 ($11.52 in chips) 
Seat 2: bartabs2 ($7.59 in chips) 
Seat 4: dany_de_vit ($9.40 in chips) 
Seat 5: univibe68 ($12.20 in chips) 
Seat 6: oddshoff ($9.48 in chips) 
bartabs2: posts small blind $0.05
KA3AXCTAHEU,: is sitting out 
dany_de_vit: posts big blind $0.10
KA3AXCTAHEU, leaves the table
*** HOLE CARDS ***
univibe68: folds 
brotherluck joins the table at seat #3 
oddshoff: folds 
chimera252: raises $0.15 to $0.25
bartabs2: folds 
dany_de_vit: calls $0.15
*** FLOP *** [5d Ah 7c]
dany_de_vit: bets $0.10
chimera252: folds 
Uncalled bet ($0.10) returned to dany_de_vit
dany_de_vit collected $0.53 from pot
*** SUMMARY ***
Total pot $0.55 | Rake $0.02 
Board [5d Ah 7c]
Seat 1: chimera252 (button) folded on the Flop
Seat 2: bartabs2 (small blind) folded before Flop
Seat 4: dany_de_vit (big blind) collected ($0.53)
Seat 5: univibe68 folded before Flop (didn't bet)
Seat 6: oddshoff folded before Flop (didn't bet)



PokerStars Hand #166668010249:  Hold'em No Limit ($0.05/$0.10 USD) - 2017/02/23 16:11:37 ET
Table 'Lobelia II' 6-max Seat #3 is the button
Seat 1: facewald ($21.52 in chips) 
Seat 2: Dcaro31 ($22.51 in chips) 
Seat 3: oddshoff ($15.33 in chips) 
Seat 4: arti192837 ($13.32 in chips) 
Seat 5: Feverhead ($18.65 in chips) 
Seat 6: NvR.m1nD ($10 in chips) 
arti192837: posts small blind $0.05
Feverhead: posts big blind $0.10
*** HOLE CARDS ***
NvR.m1nD: folds 
facewald: raises $0.19 to $0.29
Dcaro31: folds 
oddshoff: raises $0.61 to $0.90
arti192837: folds 
Feverhead: folds 
facewald: calls $0.61
*** FLOP *** [4d 4s Tc]
facewald: checks 
oddshoff: checks 
*** TURN *** [4d 4s Tc] [9c]
facewald: bets $0.99
oddshoff: folds 
Uncalled bet ($0.99) returned to facewald
facewald collected $1.86 from pot
*** SUMMARY ***
Total pot $1.95 | Rake $0.09 
Board [4d 4s Tc 9c]
Seat 1: facewald collected ($1.86)
Seat 2: Dcaro31 folded before Flop (didn't bet)
Seat 3: oddshoff (button) folded on the Turn
Seat 4: arti192837 (small blind) folded before Flop
Seat 5: Feverhead (big blind) folded before Flop
Seat 6: NvR.m1nD folded before Flop (didn't bet)



PokerStars Hand #166668010291:  Hold'em No Limit ($0.05/$0.10 USD) - 2017/02/23 16:11:37 ET
Table 'Jacchia' 6-max Seat #3 is the button
Seat 1: viklundm ($32.37 in chips) 
Seat 3: maxiv608 ($10 in chips) 
Seat 4: paterthomas ($9.41 in chips) 
Seat 5: arti192837 ($11.24 in chips) 
Seat 6: RoJ1 ($12.99 in chips) 
paterthomas: posts small blind $0.05
arti192837: posts big blind $0.10
*** HOLE CARDS ***
RoJ1: folds 
viklundm: calls $0.10
maxiv608: folds 
paterthomas: folds 
arti192837: checks 
*** FLOP *** [6s Jd 9h]
aapokerkot joins the table at seat #2 
arti192837: checks 
viklundm: checks 
*** TURN *** [6s Jd 9h] [6h]
arti192837: checks 
viklundm: checks 
*** RIVER *** [6s Jd 9h 6h] [5s]
arti192837: checks 
viklundm: checks 
*** SHOW DOWN ***
arti192837: shows [3d 7c] (a pair of Sixes)
viklundm: shows [Qc Kc] (a pair of Sixes - King kicker)
viklundm collected $0.24 from pot
*** SUMMARY ***
Total pot $0.25 | Rake $0.01 
Board [6s Jd 9h 6h 5s]
Seat 1: viklundm showed [Qc Kc] and won ($0.24) with a pair of Sixes
Seat 3: maxiv608 (button) folded before Flop (didn't bet)
Seat 4: paterthomas (small blind) folded before Flop
Seat 5: arti192837 (big blind) showed [3d 7c] and lost with a pair of Sixes
Seat 6: RoJ1 folded before Flop (didn't bet)



PokerStars Hand #166668010961:  Hold'em No Limit ($0.05/$0.10 USD) - 2017/02/23 16:11:38 ET
Table 'Caprera III' 6-max Seat #2 is the button
Seat 1: MisterX413 ($10 in chips) 
Seat 2: voledy ($10.05 in chips) 
voledy: posts small blind $0.05
MisterX413: posts big blind $0.10
*** HOLE CARDS ***
voledy: folds 
Uncalled bet ($0.05) returned to MisterX413
MisterX413 collected $0.10 from pot
*** SUMMARY ***
Total pot $0.10 | Rake $0 
Seat 1: MisterX413 (big blind) collected ($0.10)
Seat 2: voledy (button) (small blind) folded before Flop



PokerStars Hand #166668011152:  Hold'em No Limit ($0.05/$0.10 USD) - 2017/02/23 16:11:38 ET
Table 'Crommelin II' 6-max Seat #2 is the button
Seat 1: THIMUCHIN ($19.10 in chips) 
Seat 2: Bird et al ($10.10 in chips) 
Seat 3: Strelok1974 ($22.78 in chips) 
Seat 4: Pequeño Clau ($12.82 in chips) 
Seat 5: Action_Gibi ($19.15 in chips) 
Strelok1974: posts small blind $0.05
Pequeño Clau: posts big blind $0.10
*** HOLE CARDS ***
Action_Gibi: calls $0.10
THIMUCHIN: folds 
Bird et al: folds 
Strelok1974: raises $0.30 to $0.40
Pequeño Clau: folds 
Action_Gibi: calls $0.30
*** FLOP *** [4s Td 5d]
Strelok1974: bets $0.65
Action_Gibi: calls $0.65
*** TURN *** [4s Td 5d] [3d]
Strelok1974: checks 
Action_Gibi: checks 
*** RIVER *** [4s Td 5d 3d] [4h]
Strelok1974: checks 
Action_Gibi: bets $1.70
Strelok1974: folds 
Uncalled bet ($1.70) returned to Action_Gibi
Action_Gibi collected $2.10 from pot
*** SUMMARY ***
Total pot $2.20 | Rake $0.10 
Board [4s Td 5d 3d 4h]
Seat 1: THIMUCHIN folded before Flop (didn't bet)
Seat 2: Bird et al (button) folded before Flop (didn't bet)
Seat 3: Strelok1974 (small blind) folded on the River
Seat 4: Pequeño Clau (big blind) folded before Flop
Seat 5: Action_Gibi collected ($2.10)



PokerStars Hand #166668011277:  Hold'em No Limit ($0.05/$0.10 USD) - 2017/02/23 16:11:38 ET
Table 'Iduberga II' 6-max Seat #3 is the button
Seat 1: mhonielsen ($10.71 in chips) 
Seat 2: popypaleta ($12.80 in chips) 
Seat 3: scorpionfish ($11.28 in chips) 
Seat 4: Peter0087 ($11.02 in chips) 
Seat 5: Pokeaster ($11.30 in chips) 
Seat 6: tblocos ($10.49 in chips) 
Peter0087: posts small blind $0.05
Pokeaster: posts big blind $0.10
*** HOLE CARDS ***
tblocos: calls $0.10
mhonielsen: raises $0.30 to $0.40
popypaleta: folds 
scorpionfish: folds 
Peter0087: folds 
Pokeaster: folds 
tblocos: folds 
Uncalled bet ($0.30) returned to mhonielsen
mhonielsen collected $0.35 from pot
*** SUMMARY ***
Total pot $0.35 | Rake $0 
Seat 1: mhonielsen collected ($0.35)
Seat 2: popypaleta folded before Flop (didn't bet)
Seat 3: scorpionfish (button) folded before Flop (didn't bet)
Seat 4: Peter0087 (small blind) folded before Flop
Seat 5: Pokeaster (big blind) folded before Flop
Seat 6: tblocos folded before Flop



PokerStars Hand #166668011429:  Hold'em No Limit ($0.05/$0.10 USD) - 2017/02/23 16:11:38 ET
Table 'Orthos III' 6-max Seat #6 is the button
Seat 1: sexy_seagull ($11.17 in chips) 
Seat 2: Xander188 ($19.31 in chips) 
Seat 3: koka4cs ($4.90 in chips) 
Seat 4: FlopsterGB ($17.85 in chips) 
Seat 5: Bird et al ($18.16 in chips) 
Seat 6: RoJ1 ($10.19 in chips) 
sexy_seagull: posts small blind $0.05
Xander188: posts big blind $0.10
*** HOLE CARDS ***
koka4cs: raises $0.10 to $0.20
FlopsterGB: raises $0.50 to $0.70
Bird et al: folds 
RoJ1: folds 
sexy_seagull: folds 
Xander188: folds 
koka4cs: raises $4.20 to $4.90 and is all-in
FlopsterGB: calls $4.20
*** FLOP *** [Qh 4c 7c]
*** TURN *** [Qh 4c 7c] [4s]
*** RIVER *** [Qh 4c 7c 4s] [Tc]
*** SHOW DOWN ***
koka4cs: shows [Jd Jh] (two pair, Jacks and Fours)
FlopsterGB: shows [Ks Kc] (two pair, Kings and Fours)
FlopsterGB collected $9.50 from pot
*** SUMMARY ***
Total pot $9.95 | Rake $0.45 
Board [Qh 4c 7c 4s Tc]
Seat 1: sexy_seagull (small blind) folded before Flop
Seat 2: Xander188 (big blind) folded before Flop
Seat 3: koka4cs showed [Jd Jh] and lost with two pair, Jacks and Fours
Seat 4: FlopsterGB showed [Ks Kc] and won ($9.50) with two pair, Kings and Fours
Seat 5: Bird et al folded before Flop (didn't bet)
Seat 6: RoJ1 (button) folded before Flop (didn't bet)



PokerStars Hand #166668011430:  Hold'em No Limit ($0.05/$0.10 USD) - 2017/02/23 16:11:38 ET
Table 'Vesta II' 6-max Seat #6 is the button
Seat 1: Yabidooo ($17.47 in chips) 
Seat 2: Dimka4 ($10 in chips) 
Seat 3: Pokeaster ($13.31 in chips) 
Seat 4: Dcaro31 ($10 in chips) 
Seat 5: ChuikaPridi ($10 in chips) 
Seat 6: XaXaTyH4uK ($11.36 in chips) 
Yabidooo: posts small blind $0.05
Dimka4: posts big blind $0.10
*** HOLE CARDS ***
Pokeaster: folds 
Dcaro31: folds 
ChuikaPridi: raises $0.20 to $0.30
XaXaTyH4uK: folds 
Yabidooo: folds 
Dimka4: raises $0.70 to $1
ChuikaPridi: folds 
Uncalled bet ($0.70) returned to Dimka4
Dimka4 collected $0.65 from pot
*** SUMMARY ***
Total pot $0.65 | Rake $0 
Seat 1: Yabidooo (small blind) folded before Flop
Seat 2: Dimka4 (big blind) collected ($0.65)
Seat 3: Pokeaster folded before Flop (didn't bet)
Seat 4: Dcaro31 folded before Flop (didn't bet)
Seat 5: ChuikaPridi folded before Flop
Seat 6: XaXaTyH4uK (button) folded before Flop (didn't bet)



PokerStars Hand #166668011575:  Hold'em No Limit ($0.05/$0.10 USD) - 2017/02/23 16:11:38 ET
Table 'Sheragul III' 6-max Seat #1 is the button
Seat 1: CallByValue ($9.85 in chips) 
Seat 2: Bird et al ($10.69 in chips) 
Seat 3: Mesmer416 ($10 in chips) 
Seat 5: RGhearted ($10 in chips) 
Seat 6: XaXaTyH4uK ($10.25 in chips) 
Bird et al: posts small blind $0.05
Mesmer416: posts big blind $0.10
maxiv608: sits out 
*** HOLE CARDS ***
RGhearted: folds 
XaXaTyH4uK: folds 
CallByValue: raises $0.20 to $0.30
Bird et al: folds 
Mesmer416: folds 
Uncalled bet ($0.20) returned to CallByValue
CallByValue collected $0.25 from pot
*** SUMMARY ***
Total pot $0.25 | Rake $0 
Seat 1: CallByValue (button) collected ($0.25)
Seat 2: Bird et al (small blind) folded before Flop
Seat 3: Mesmer416 (big blind) folded before Flop
Seat 5: RGhearted folded before Flop (didn't bet)
Seat 6: XaXaTyH4uK folded before Flop (didn't bet)



PokerStars Hand #166668011648:  Hold'em No Limit ($0.05/$0.10 USD) - 2017/02/23 16:11:38 ET
Table 'Hestia' 6-max Seat #5 is the button
Seat 2: Kow6oy ($10 in chips) 
Seat 3: MBen10 ($13.23 in chips) 
Seat 5: CiisCi ($17.71 in chips) 
AIONCMA1988 will be allowed to play after the button
Kow6oy: posts small blind $0.05
MBen10: posts big blind $0.10
Lucky HoBBiT: sits out 
*** HOLE CARDS ***
CiisCi: folds 
Kow6oy: folds 
Uncalled bet ($0.05) returned to MBen10
MBen10 collected $0.10 from pot
*** SUMMARY ***
Total pot $0.10 | Rake $0 
Seat 2: Kow6oy (small blind) folded before Flop
Seat 3: MBen10 (big blind) collected ($0.10)
Seat 5: CiisCi (button) folded before Flop (didn't bet)



PokerStars Hand #166668011761:  Hold'em No Limit ($0.05/$0.10 USD) - 2017/02/23 16:11:38 ET
Table 'Laetitia II' 6-max Seat #6 is the button
Seat 1: Cluckh ($10.92 in chips) 
Seat 2: manashov ($11.17 in chips) 
Seat 3: 6ePeMeHHa9 ($10 in chips) 
Seat 4: Feverhead ($17.43 in chips) 
Seat 5: D3NyA ($16.71 in chips) 
Seat 6: Dima91360 ($4.30 in chips) 
Cluckh: posts small blind $0.05
manashov: posts big blind $0.10
*** HOLE CARDS ***
6ePeMeHHa9: folds 
Feverhead: folds 
D3NyA: folds 
Dima91360: calls $0.10
Cluckh: raises $0.40 to $0.50
manashov: folds 
Dima91360: calls $0.40
*** FLOP *** [Js 3c Th]
Cluckh: checks 
Dima91360: checks 
*** TURN *** [Js 3c Th] [9d]
Cluckh: bets $0.40
Dima91360: calls $0.40
*** RIVER *** [Js 3c Th 9d] [2h]
Cluckh: bets $1.10
Dima91360: folds 
Uncalled bet ($1.10) returned to Cluckh
Cluckh collected $1.81 from pot
*** SUMMARY ***
Total pot $1.90 | Rake $0.09 
Board [Js 3c Th 9d 2h]
Seat 1: Cluckh (small blind) collected ($1.81)
Seat 2: manashov (big blind) folded before Flop
Seat 3: 6ePeMeHHa9 folded before Flop (didn't bet)
Seat 4: Feverhead folded before Flop (didn't bet)
Seat 5: D3NyA folded before Flop (didn't bet)
Seat 6: Dima91360 (button) folded on the River



PokerStars Hand #166668012289:  Hold'em No Limit ($0.05/$0.10 USD) - 2017/02/23 16:11:39 ET
Table 'Wilkens II' 6-max Seat #3 is the button
Seat 1: Islamiq-GuRL ($10.19 in chips) 
Seat 2: manashov ($10.90 in chips) 
Seat 3: Namhkal ($11.53 in chips) 
Seat 4: myevc ($10.35 in chips) 
Seat 5: patrick19111 ($13.27 in chips) 
Seat 6: XaXaTyH4uK ($14.01 in chips) 
myevc: posts small blind $0.05
patrick19111: posts big blind $0.10
*** HOLE CARDS ***
XaXaTyH4uK: folds 
Islamiq-GuRL: folds 
manashov: folds 
Namhkal: folds 
myevc: folds 
Uncalled bet ($0.05) returned to patrick19111
patrick19111 collected $0.10 from pot
*** SUMMARY ***
Total pot $0.10 | Rake $0 
Seat 1: Islamiq-GuRL folded before Flop (didn't bet)
Seat 2: manashov folded before Flop (didn't bet)
Seat 3: Namhkal (button) folded before Flop (didn't bet)
Seat 4: myevc (small blind) folded before Flop
Seat 5: patrick19111 (big blind) collected ($0.10)
Seat 6: XaXaTyH4uK folded before Flop (didn't bet)



PokerStars Hand #166668012466:  Hold'em No Limit ($0.05/$0.10 USD) - 2017/02/23 16:11:39 ET
Table 'Jokaste II' 6-max Seat #1 is the button
Seat 1: Hyd SK ($13.35 in chips) 
Seat 2: T9MS ($14.04 in chips) 
Seat 3: crazydevill ($11.65 in chips) 
Seat 4: FRAID358 ($15.21 in chips) 
Seat 5: Vrinni ($10 in chips) 
T9MS: posts small blind $0.05
crazydevill: posts big blind $0.10
*** HOLE CARDS ***
FRAID358: folds 
Vrinni: folds 
Hyd SK: folds 
T9MS: folds 
Uncalled bet ($0.05) returned to crazydevill
crazydevill collected $0.10 from pot
*** SUMMARY ***
Total pot $0.10 | Rake $0 
Seat 1: Hyd SK (button) folded before Flop (didn't bet)
Seat 2: T9MS (small blind) folded before Flop
Seat 3: crazydevill (big blind) collected ($0.10)
Seat 4: FRAID358 folded before Flop (didn't bet)
Seat 5: Vrinni folded before Flop (didn't bet)



PokerStars Hand #166668012663:  Hold'em No Limit ($0.05/$0.10 USD) - 2017/02/23 16:11:39 ET
Table 'Caupolican II' 6-max Seat #5 is the button
Seat 1: Strelok1974 ($10 in chips) 
Seat 2: MBen10 ($24.97 in chips) 
Seat 4: GESPERIA ($22 in chips) 
Seat 5: ArcticBearDK ($15.30 in chips) 
Seat 6: pancernik21 ($10 in chips) 
pancernik21: posts small blind $0.05
Strelok1974: posts big blind $0.10
*** HOLE CARDS ***
MBen10: raises $0.18 to $0.28
GESPERIA: folds 
ArcticBearDK: raises $0.62 to $0.90
pancernik21: folds 
Strelok1974: folds 
MBen10: calls $0.62
*** FLOP *** [3s Jc 8h]
MBen10: checks 
ArcticBearDK: bets $1.05
MBen10: folds 
Uncalled bet ($1.05) returned to ArcticBearDK
ArcticBearDK collected $1.86 from pot
*** SUMMARY ***
Total pot $1.95 | Rake $0.09 
Board [3s Jc 8h]
Seat 1: Strelok1974 (big blind) folded before Flop
Seat 2: MBen10 folded on the Flop
Seat 4: GESPERIA folded before Flop (didn't bet)
Seat 5: ArcticBearDK (button) collected ($1.86)
Seat 6: pancernik21 (small blind) folded before Flop



PokerStars Hand #166668012711:  Hold'em No Limit ($0.05/$0.10 USD) - 2017/02/23 16:11:39 ET
Table 'Gelria' 6-max Seat #3 is the button
Seat 1: ab260414 ($10.17 in chips) 
Seat 2: fishhook5 ($12.84 in chips) 
Seat 3: Orlangoor ($10.93 in chips) 
Seat 4: eniksenik ($10 in chips) 
Seat 5: apenvel ($8.23 in chips) 
eniksenik: posts small blind $0.05
apenvel: posts big blind $0.10
x3ultimate: sits out 
*** HOLE CARDS ***
ab260414: folds 
fishhook5: folds 
Orlangoor: folds 
eniksenik: raises $0.20 to $0.30
apenvel: calls $0.20
*** FLOP *** [7d 2d Kc]
eniksenik: bets $0.31
apenvel: folds 
Uncalled bet ($0.31) returned to eniksenik
eniksenik collected $0.57 from pot
*** SUMMARY ***
Total pot $0.60 | Rake $0.03 
Board [7d 2d Kc]
Seat 1: ab260414 folded before Flop (didn't bet)
Seat 2: fishhook5 folded before Flop (didn't bet)
Seat 3: Orlangoor (button) folded before Flop (didn't bet)
Seat 4: eniksenik (small blind) collected ($0.57)
Seat 5: apenvel (big blind) folded on the Flop



PokerStars Hand #166668013049:  Hold'em No Limit ($0.05/$0.10 USD) - 2017/02/23 16:11:40 ET
Table 'Stroobantia' 6-max Seat #3 is the button
Seat 1: mam9zyc ($10.27 in chips) 
Seat 2: XwinX25 ($10 in chips) 
Seat 3: Namhkal ($10.90 in chips) 
Seat 4: Yspenyanin ($10.74 in chips) 
Seat 5: boxer821 ($10.84 in chips) 
Seat 6: KokoulinV ($15.52 in chips) 
Yspenyanin: posts small blind $0.05
boxer821: posts big blind $0.10
*** HOLE CARDS ***
KokoulinV: folds 
mam9zyc: folds 
XwinX25: folds 
Namhkal: folds 
Yspenyanin: folds 
Uncalled bet ($0.05) returned to boxer821
boxer821 collected $0.10 from pot
*** SUMMARY ***
Total pot $0.10 | Rake $0 
Seat 1: mam9zyc folded before Flop (didn't bet)
Seat 2: XwinX25 folded before Flop (didn't bet)
Seat 3: Namhkal (button) folded before Flop (didn't bet)
Seat 4: Yspenyanin (small blind) folded before Flop
Seat 5: boxer821 (big blind) collected ($0.10)
Seat 6: KokoulinV folded before Flop (didn't bet)



PokerStars Hand #166668013094:  Hold'em No Limit ($0.05/$0.10 USD) - 2017/02/23 16:11:40 ET
Table 'Rotraut' 6-max Seat #6 is the button
Seat 1: Hypermetal ($13.41 in chips) 
Seat 2: Newqbrown ($10.60 in chips) 
Seat 3: FlackoD ($7.66 in chips) 
Seat 5: Bird et al ($12.08 in chips) 
Seat 6: KokoulinV ($16.42 in chips) 
Hypermetal: posts small blind $0.05
Newqbrown: posts big blind $0.10
*** HOLE CARDS ***
FlackoD: folds 
Bird et al: folds 
KokoulinV: folds 
Hypermetal: raises $0.10 to $0.20
Newqbrown: raises $0.50 to $0.70
Hypermetal: folds 
Uncalled bet ($0.50) returned to Newqbrown
Newqbrown collected $0.40 from pot
*** SUMMARY ***
Total pot $0.40 | Rake $0 
Seat 1: Hypermetal (small blind) folded before Flop
Seat 2: Newqbrown (big blind) collected ($0.40)
Seat 3: FlackoD folded before Flop (didn't bet)
Seat 5: Bird et al folded before Flop (didn't bet)
Seat 6: KokoulinV (button) folded before Flop (didn't bet)



PokerStars Hand #166668013150:  Hold'em No Limit ($0.05/$0.10 USD) - 2017/02/23 16:11:40 ET
Table 'Pirola' 6-max Seat #2 is the button
Seat 1: Rodik002 ($10.51 in chips) 
Seat 2: lmlmlmlm90 ($16.36 in chips) 
Seat 3: Goroshkos88 ($11.32 in chips) 
Seat 4: barons89 ($11.61 in chips) 
Seat 5: Iarlei ($13.76 in chips) 
Seat 6: Hyd SK ($13.19 in chips) 
Goroshkos88: posts small blind $0.05
barons89: posts big blind $0.10
*** HOLE CARDS ***
Iarlei: folds 
Hyd SK: folds 
Rodik002: folds 
lmlmlmlm90: folds 
Goroshkos88: folds 
Uncalled bet ($0.05) returned to barons89
barons89 collected $0.10 from pot
*** SUMMARY ***
Total pot $0.10 | Rake $0 
Seat 1: Rodik002 folded before Flop (didn't bet)
Seat 2: lmlmlmlm90 (button) folded before Flop (didn't bet)
Seat 3: Goroshkos88 (small blind) folded before Flop
Seat 4: barons89 (big blind) collected ($0.10)
Seat 5: Iarlei folded before Flop (didn't bet)
Seat 6: Hyd SK folded before Flop (didn't bet)



PokerStars Hand #166668013389:  Hold'em No Limit ($0.05/$0.10 USD) - 2017/02/23 16:11:40 ET
Table 'Luanda' 6-max Seat #3 is the button
Seat 1: AM-L-SL ($2.81 in chips) 
Seat 2: Xander188 ($10.15 in chips) 
Seat 3: pokekrk ($10.15 in chips) 
Seat 4: aapokerkot ($10 in chips) 
Seat 5: st4tion ($12.35 in chips) 
aapokerkot: posts small blind $0.05
st4tion: posts big blind $0.10
AIONCMA1988: sits out 
*** HOLE CARDS ***
AM-L-SL: folds 
Xander188: folds 
pokekrk: raises $0.10 to $0.20
aapokerkot: calls $0.15
st4tion: folds 
*** FLOP *** [7c Qh 6s]
aapokerkot: checks 
pokekrk: checks 
*** TURN *** [7c Qh 6s] [4h]
aapokerkot: checks 
pokekrk: checks 
*** RIVER *** [7c Qh 6s 4h] [2h]
aapokerkot: checks 
pokekrk: bets $0.26
aapokerkot: folds 
Uncalled bet ($0.26) returned to pokekrk
pokekrk collected $0.48 from pot
*** SUMMARY ***
Total pot $0.50 | Rake $0.02 
Board [7c Qh 6s 4h 2h]
Seat 1: AM-L-SL folded before Flop (didn't bet)
Seat 2: Xander188 folded before Flop (didn't bet)
Seat 3: pokekrk (button) collected ($0.48)
Seat 4: aapokerkot (small blind) folded on the River
Seat 5: st4tion (big blind) folded before Flop



PokerStars Hand #166668013462:  Hold'em No Limit ($0.05/$0.10 USD) - 2017/02/23 16:11:40 ET
Table 'Virginia II' 6-max Seat #2 is the button
Seat 2: Yspenyanin ($10 in chips) 
Seat 3: garigura ($16.03 in chips) 
Seat 4: onkelottoHH ($10.73 in chips) 
Seat 6: NvR.m1nD ($10.30 in chips) 
garigura: posts small blind $0.05
onkelottoHH: posts big blind $0.10
yodzik: sits out 
*** HOLE CARDS ***
NvR.m1nD: folds 
Yspenyanin: folds 
garigura: raises $0.20 to $0.30
onkelottoHH: folds 
Uncalled bet ($0.20) returned to garigura
garigura collected $0.20 from pot
*** SUMMARY ***
Total pot $0.20 | Rake $0 
Seat 2: Yspenyanin (button) folded before Flop (didn't bet)
Seat 3: garigura (small blind) collected ($0.20)
Seat 4: onkelottoHH (big blind) folded before Flop
Seat 6: NvR.m1nD folded before Flop (didn't bet)



PokerStars Hand #166668013839:  Hold'em No Limit ($0.05/$0.10 USD) - 2017/02/23 16:11:41 ET
Table 'Cassini' 6-max Seat #5 is the button
Seat 1: Pokeaster ($10.53 in chips) 
Seat 2: mhonielsen ($12.26 in chips) 
Seat 3: J1234T ($11.23 in chips) 
Seat 4: fortieth ($13.77 in chips) 
Seat 5: DrVzad ($9.85 in chips) 
Seat 6: MihaGr ($10 in chips) 
MihaGr: posts small blind $0.05
Pokeaster: posts big blind $0.10
*** HOLE CARDS ***
mhonielsen has timed out
mhonielsen: folds 
J1234T: folds 
fortieth: folds 
DrVzad: folds 
MihaGr: folds 
Uncalled bet ($0.05) returned to Pokeaster
Pokeaster collected $0.10 from pot
*** SUMMARY ***
Total pot $0.10 | Rake $0 
Seat 1: Pokeaster (big blind) collected ($0.10)
Seat 2: mhonielsen folded before Flop (didn't bet)
Seat 3: J1234T folded before Flop (didn't bet)
Seat 4: fortieth folded before Flop (didn't bet)
Seat 5: DrVzad (button) folded before Flop (didn't bet)
Seat 6: MihaGr (small blind) folded before Flop



PokerStars Hand #166668013935:  Hold'em No Limit ($0.05/$0.10 USD) - 2017/02/23 16:11:41 ET
Table 'Gyldenia II' 6-max Seat #1 is the button
Seat 1: KokoulinV ($11.29 in chips) 
Seat 2: Kow6oy ($10 in chips) 
Seat 3: mhonielsen ($10.40 in chips) 
Seat 5: CHRO8 ($15.84 in chips) 
Seat 6: 8th wonders ($11.33 in chips) 
Kow6oy: posts small blind $0.05
mhonielsen: posts big blind $0.10
univibe68: sits out 
*** HOLE CARDS ***
CHRO8: folds 
8th wonders: folds 
KokoulinV: raises $0.10 to $0.20
Kow6oy: raises $0.60 to $0.80
mhonielsen: folds 
KokoulinV: folds 
Uncalled bet ($0.60) returned to Kow6oy
Kow6oy collected $0.50 from pot
*** SUMMARY ***
Total pot $0.50 | Rake $0 
Seat 1: KokoulinV (button) folded before Flop
Seat 2: Kow6oy (small blind) collected ($0.50)
Seat 3: mhonielsen (big blind) folded before Flop
Seat 5: CHRO8 folded before Flop (didn't bet)
Seat 6: 8th wonders folded before Flop (didn't bet)



PokerStars Hand #166668014144:  Hold'em No Limit ($0.05/$0.10 USD) - 2017/02/23 16:11:41 ET
Table 'Wingolfia II' 6-max Seat #5 is the button
Seat 1: BahiaMinhaP ($10 in chips) 
Seat 2: NvR.m1nD ($10 in chips) 
Seat 3: truck1234 ($10.57 in chips) 
Seat 4: zlobslob ($17.52 in chips) 
Seat 5: tr41n3r12 ($12.44 in chips) 
Seat 6: Tom Zhangxue ($9.65 in chips) 
Tom Zhangxue: posts small blind $0.05
BahiaMinhaP: posts big blind $0.10
*** HOLE CARDS ***
NvR.m1nD: folds 
truck1234: folds 
zlobslob: folds 
tr41n3r12: folds 
Tom Zhangxue: folds 
Uncalled bet ($0.05) returned to BahiaMinhaP
Tom Zhangxue leaves the table
BahiaMinhaP collected $0.10 from pot
*** SUMMARY ***
Total pot $0.10 | Rake $0 
Seat 1: BahiaMinhaP (big blind) collected ($0.10)
Seat 2: NvR.m1nD folded before Flop (didn't bet)
Seat 3: truck1234 folded before Flop (didn't bet)
Seat 4: zlobslob folded before Flop (didn't bet)
Seat 5: tr41n3r12 (button) folded before Flop (didn't bet)
Seat 6: Tom Zhangxue (small blind) folded before Flop



PokerStars Hand #166668014233:  Hold'em No Limit ($0.05/$0.10 USD) - 2017/02/23 16:11:41 ET
Table 'Pallas II' 6-max Seat #1 is the button
Seat 1: mdelfin0 ($16.64 in chips) 
Seat 3: popypaleta ($10.35 in chips) 
Seat 4: MisterX413 ($10 in chips) 
popypaleta: posts small blind $0.05
MisterX413: posts big blind $0.10
*** HOLE CARDS ***
mdelfin0: folds 
popypaleta: folds 
Uncalled bet ($0.05) returned to MisterX413
MisterX413 collected $0.10 from pot
*** SUMMARY ***
Total pot $0.10 | Rake $0 
Seat 1: mdelfin0 (button) folded before Flop (didn't bet)
Seat 3: popypaleta (small blind) folded before Flop
Seat 4: MisterX413 (big blind) collected ($0.10)



PokerStars Hand #166668014346:  Hold'em No Limit ($0.05/$0.10 USD) - 2017/02/23 16:11:41 ET
Table 'Esperanto II' 6-max Seat #2 is the button
Seat 1: kurasd ($9.40 in chips) 
Seat 2: MihaGr ($10.34 in chips) 
Seat 3: Namhkal ($11.10 in chips) 
Seat 4: Andrei ProFF ($10 in chips) 
Seat 5: FRAID358 ($12.33 in chips) 
Seat 6: ArcticBearDK ($13.50 in chips) 
Namhkal: posts small blind $0.05
Andrei ProFF: posts big blind $0.10
*** HOLE CARDS ***
FRAID358: folds 
ArcticBearDK: folds 
kurasd: folds 
MihaGr: folds 
Namhkal: folds 
Uncalled bet ($0.05) returned to Andrei ProFF
Andrei ProFF collected $0.10 from pot
*** SUMMARY ***
Total pot $0.10 | Rake $0 
Seat 1: kurasd folded before Flop (didn't bet)
Seat 2: MihaGr (button) folded before Flop (didn't bet)
Seat 3: Namhkal (small blind) folded before Flop
Seat 4: Andrei ProFF (big blind) collected ($0.10)
Seat 5: FRAID358 folded before Flop (didn't bet)
Seat 6: ArcticBearDK folded before Flop (didn't bet)



PokerStars Hand #166668014464:  Hold'em No Limit ($0.05/$0.10 USD) - 2017/02/23 16:11:41 ET
Table 'Azelfafage' 6-max Seat #3 is the button
Seat 1: Sbozzz ($15.61 in chips) 
Seat 2: tr41n3r12 ($11.55 in chips) 
Seat 3: todor1711 ($14.39 in chips) 
Seat 5: 8th wonders ($12.30 in chips) 
8th wonders: posts small blind $0.05
KA3AXCTAHEU,: is sitting out 
KA3AXCTAHEU, leaves the table
Sbozzz: posts big blind $0.10
*** HOLE CARDS ***
tr41n3r12: folds 
Goroshkos88 joins the table at seat #6 
todor1711 has timed out
todor1711: folds 
8th wonders: raises $0.10 to $0.20
Sbozzz: folds 
Uncalled bet ($0.10) returned to 8th wonders
8th wonders collected $0.20 from pot
*** SUMMARY ***
Total pot $0.20 | Rake $0 
Seat 1: Sbozzz (big blind) folded before Flop
Seat 2: tr41n3r12 folded before Flop (didn't bet)
Seat 3: todor1711 (button) folded before Flop (didn't bet)
Seat 5: 8th wonders (small blind) collected ($0.20)



PokerStars Hand #166668014545:  Hold'em No Limit ($0.05/$0.10 USD) - 2017/02/23 16:11:41 ET
Table 'Lampetia III' 6-max Seat #3 is the button
Seat 3: Kow6oy ($10.10 in chips) 
Seat 4: IAntikI ($10.50 in chips) 
Seat 5: robson1235 ($20.30 in chips) 
Seat 6: bdixon_5 ($9.05 in chips) 
IAntikI: posts small blind $0.05
robson1235: posts big blind $0.10
AIONCMA1988: sits out 
*** HOLE CARDS ***
bdixon_5: folds 
Kow6oy: raises $0.15 to $0.25
IAntikI: folds 
robson1235: calls $0.15
*** FLOP *** [Js Qc 6s]
robson1235: checks 
Kow6oy: bets $0.40
robson1235: folds 
Uncalled bet ($0.40) returned to Kow6oy
Kow6oy collected $0.53 from pot
*** SUMMARY ***
Total pot $0.55 | Rake $0.02 
Board [Js Qc 6s]
Seat 3: Kow6oy (button) collected ($0.53)
Seat 4: IAntikI (small blind) folded before Flop
Seat 5: robson1235 (big blind) folded on the Flop
Seat 6: bdixon_5 folded before Flop (didn't bet)



PokerStars Hand #166668015013:  Hold'em No Limit ($0.05/$0.10 USD) - 2017/02/23 16:11:42 ET
Table 'Alnasl' 6-max Seat #3 is the button
Seat 2: saddur ($8.94 in chips) 
Seat 3: KRZuff ($10 in chips) 
Seat 4: oddshoff ($10.81 in chips) 
Seat 5: 6ePeMeHHa9 ($10 in chips) 
Seat 6: Zooplack ($13.58 in chips) 
oddshoff: posts small blind $0.05
6ePeMeHHa9: posts big blind $0.10
RoJ1: sits out 
*** HOLE CARDS ***
Zooplack: folds 
saddur: folds 
KRZuff: folds 
oddshoff: folds 
Uncalled bet ($0.05) returned to 6ePeMeHHa9
6ePeMeHHa9 collected $0.10 from pot
*** SUMMARY ***
Total pot $0.10 | Rake $0 
Seat 2: saddur folded before Flop (didn't bet)
Seat 3: KRZuff (button) folded before Flop (didn't bet)
Seat 4: oddshoff (small blind) folded before Flop
Seat 5: 6ePeMeHHa9 (big blind) collected ($0.10)
Seat 6: Zooplack folded before Flop (didn't bet)



PokerStars Hand #166668015053:  Hold'em No Limit ($0.05/$0.10 USD) - 2017/02/23 16:11:42 ET
Table 'Tyche III' 6-max Seat #3 is the button
Seat 1: milt65 ($10.05 in chips) 
Seat 2: arti192837 ($12.13 in chips) 
Seat 3: FRAID358 ($10 in chips) 
Seat 4: Kazacha ($10.53 in chips) 
Seat 5: chimera252 ($14.73 in chips) 
Seat 6: Ice_Isayev ($10 in chips) 
Kazacha: posts small blind $0.05
chimera252: posts big blind $0.10
*** HOLE CARDS ***
Ice_Isayev: folds 
milt65: folds 
arti192837: folds 
FRAID358: folds 
Kazacha: folds 
Uncalled bet ($0.05) returned to chimera252
chimera252 collected $0.10 from pot
*** SUMMARY ***
Total pot $0.10 | Rake $0 
Seat 1: milt65 folded before Flop (didn't bet)
Seat 2: arti192837 folded before Flop (didn't bet)
Seat 3: FRAID358 (button) folded before Flop (didn't bet)
Seat 4: Kazacha (small blind) folded before Flop
Seat 5: chimera252 (big blind) collected ($0.10)
Seat 6: Ice_Isayev folded before Flop (didn't bet)



PokerStars Hand #166668015076:  Hold'em No Limit ($0.05/$0.10 USD) - 2017/02/23 16:11:42 ET
Table 'Deflotte' 6-max Seat #3 is the button
Seat 1: Zooplack ($17.50 in chips) 
Seat 2: MonteCris92 ($10 in chips) 
Seat 3: Yspenyanin ($10 in chips) 
Seat 4: 8th wonders ($10.27 in chips) 
Seat 5: Pokeaster ($11.62 in chips) 
Seat 6: Iarlei ($10.30 in chips) 
8th wonders: posts small blind $0.05
Pokeaster: posts big blind $0.10
*** HOLE CARDS ***
Iarlei: folds 
Zooplack: folds 
MonteCris92: folds 
Yspenyanin: raises $0.15 to $0.25
8th wonders: folds 
Pokeaster: folds 
Uncalled bet ($0.15) returned to Yspenyanin
Yspenyanin collected $0.25 from pot
*** SUMMARY ***
Total pot $0.25 | Rake $0 
Seat 1: Zooplack folded before Flop (didn't bet)
Seat 2: MonteCris92 folded before Flop (didn't bet)
Seat 3: Yspenyanin (button) collected ($0.25)
Seat 4: 8th wonders (small blind) folded before Flop
Seat 5: Pokeaster (big blind) folded before Flop
Seat 6: Iarlei folded before Flop (didn't bet)



PokerStars Hand #166668015453:  Hold'em No Limit ($0.05/$0.10 USD) - 2017/02/23 16:11:42 ET
Table 'Arduina' 6-max Seat #2 is the button
Seat 1: tauronex ($11.06 in chips) 
Seat 2: Andy Wolf ($14.25 in chips) 
Seat 3: Dcaro31 ($12.80 in chips) 
Seat 4: ChuikaPridi ($29.20 in chips) 
Seat 5: ettedallas ($7.16 in chips) 
Dcaro31: posts small blind $0.05
ChuikaPridi: posts big blind $0.10
*** HOLE CARDS ***
dierri leaves the table
ettedallas: folds 
marianoboni joins the table at seat #6 
tauronex: folds 
Andy Wolf: folds 
Dcaro31: folds 
Uncalled bet ($0.05) returned to ChuikaPridi
ChuikaPridi collected $0.10 from pot
*** SUMMARY ***
Total pot $0.10 | Rake $0 
Seat 1: tauronex folded before Flop (didn't bet)
Seat 2: Andy Wolf (button) folded before Flop (didn't bet)
Seat 3: Dcaro31 (small blind) folded before Flop
Seat 4: ChuikaPridi (big blind) collected ($0.10)
Seat 5: ettedallas folded before Flop (didn't bet)



PokerStars Hand #166668016057:  Hold'em No Limit ($0.05/$0.10 USD) - 2017/02/23 16:11:43 ET
Table 'Rosalia' 6-max Seat #5 is the button
Seat 1: Hyd SK ($10 in chips) 
Seat 2: Bandyaev ($10.09 in chips) 
Seat 3: Andy Wolf ($11.13 in chips) 
Seat 4: THIMUCHIN ($10 in chips) 
Seat 5: miron762 ($20.11 in chips) 
Seat 6: facewald ($19.48 in chips) 
facewald: posts small blind $0.05
Hyd SK: posts big blind $0.10
*** HOLE CARDS ***
Bandyaev: folds 
Andy Wolf: folds 
THIMUCHIN: folds 
miron762: calls $0.10
facewald: folds 
Hyd SK: checks 
*** FLOP *** [Ts Jc 5c]
Hyd SK: checks 
miron762: bets $0.40
Hyd SK: folds 
Uncalled bet ($0.40) returned to miron762
miron762 collected $0.24 from pot
*** SUMMARY ***
Total pot $0.25 | Rake $0.01 
Board [Ts Jc 5c]
Seat 1: Hyd SK (big blind) folded on the Flop
Seat 2: Bandyaev folded before Flop (didn't bet)
Seat 3: Andy Wolf folded before Flop (didn't bet)
Seat 4: THIMUCHIN folded before Flop (didn't bet)
Seat 5: miron762 (button) collected ($0.24)
Seat 6: facewald (small blind) folded before Flop



PokerStars Hand #166668016163:  Hold'em No Limit ($0.05/$0.10 USD) - 2017/02/23 16:11:43 ET
Table 'Carina' 6-max Seat #2 is the button
Seat 1: Kupi007 ($10 in chips) 
Seat 2: XwinX25 ($10.22 in chips) 
Seat 3: LarryTheStar ($12.64 in chips) 
Seat 4: steepfell ($10.56 in chips) 
Seat 5: IAntikI ($10.23 in chips) 
Seat 6: alexweezer ($7.43 in chips) 
LarryTheStar: posts small blind $0.05
steepfell: posts big blind $0.10
*** HOLE CARDS ***
IAntikI: folds 
alexweezer: calls $0.10
Kupi007: folds 
XwinX25: folds 
LarryTheStar: folds 
steepfell: checks 
*** FLOP *** [Ah 2s 7h]
steepfell: checks 
alexweezer: checks 
*** TURN *** [Ah 2s 7h] [5s]
steepfell: checks 
alexweezer: bets $0.10
steepfell: folds 
Uncalled bet ($0.10) returned to alexweezer
alexweezer collected $0.24 from pot
*** SUMMARY ***
Total pot $0.25 | Rake $0.01 
Board [Ah 2s 7h 5s]
Seat 1: Kupi007 folded before Flop (didn't bet)
Seat 2: XwinX25 (button) folded before Flop (didn't bet)
Seat 3: LarryTheStar (small blind) folded before Flop
Seat 4: steepfell (big blind) folded on the Turn
Seat 5: IAntikI folded before Flop (didn't bet)
Seat 6: alexweezer collected ($0.24)



PokerStars Hand #166668016198:  Hold'em No Limit ($0.05/$0.10 USD) - 2017/02/23 16:11:43 ET
Table 'Aludra II' 6-max Seat #5 is the button
Seat 1: voledy ($10.15 in chips) 
Seat 2: JahSoldier69 ($13.93 in chips) 
Seat 3: mbkongstad ($9.85 in chips) 
Seat 4: MihaGr ($10 in chips) 
Seat 5: kingartur222 ($16.17 in chips) 
Seat 6: call me haaa ($14.89 in chips) 
call me haaa: posts small blind $0.05
voledy: posts big blind $0.10
*** HOLE CARDS ***
JahSoldier69: folds 
mbkongstad: raises $0.20 to $0.30
MihaGr: raises $0.70 to $1
kingartur222: folds 
call me haaa: folds 
voledy: folds 
mbkongstad: calls $0.70
*** FLOP *** [2s Jc 7d]
mbkongstad: bets $1.50
MihaGr: folds 
Uncalled bet ($1.50) returned to mbkongstad
mbkongstad collected $2.05 from pot
*** SUMMARY ***
Total pot $2.15 | Rake $0.10 
Board [2s Jc 7d]
Seat 1: voledy (big blind) folded before Flop
Seat 2: JahSoldier69 folded before Flop (didn't bet)
Seat 3: mbkongstad collected ($2.05)
Seat 4: MihaGr folded on the Flop
Seat 5: kingartur222 (button) folded before Flop (didn't bet)
Seat 6: call me haaa (small blind) folded before Flop



PokerStars Hand #166668016341:  Hold'em No Limit ($0.05/$0.10 USD) - 2017/02/23 16:11:43 ET
Table 'Eurydome II' 6-max Seat #6 is the button
Seat 1: rusu_rapid ($11.73 in chips) 
Seat 2: Elinaattor ($13.03 in chips) 
Seat 3: gaHy_HaXeP ($12.09 in chips) 
Seat 4: Smitty03300 ($10 in chips) 
Seat 5: kush-killa87 ($9.60 in chips) 
Seat 6: Jucatorul823 ($6.44 in chips) 
rusu_rapid: posts small blind $0.05
Elinaattor: posts big blind $0.10
*** HOLE CARDS ***
gaHy_HaXeP: folds 
Smitty03300: folds 
kush-killa87: raises $0.10 to $0.20
Jucatorul823: calls $0.20
rusu_rapid: raises $0.80 to $1
Elinaattor: folds 
kush-killa87: raises $2.30 to $3.30
Jucatorul823: folds 
rusu_rapid: raises $8.43 to $11.73 and is all-in
kush-killa87: calls $6.30 and is all-in
Uncalled bet ($2.13) returned to rusu_rapid
*** FLOP *** [6c 5c Qc]
*** TURN *** [6c 5c Qc] [2s]
*** RIVER *** [6c 5c Qc 2s] [4h]
*** SHOW DOWN ***
rusu_rapid: shows [Kd Ac] (high card Ace)
kush-killa87: shows [Ah Kh] (high card Ace)
rusu_rapid collected $9.31 from pot
kush-killa87 collected $9.31 from pot
*** SUMMARY ***
Total pot $19.50 | Rake $0.88 
Board [6c 5c Qc 2s 4h]
Seat 1: rusu_rapid (small blind) showed [Kd Ac] and won ($9.31) with high card Ace
Seat 2: Elinaattor (big blind) folded before Flop
Seat 3: gaHy_HaXeP folded before Flop (didn't bet)
Seat 4: Smitty03300 folded before Flop (didn't bet)
Seat 5: kush-killa87 showed [Ah Kh] and won ($9.31) with high card Ace
Seat 6: Jucatorul823 (button) folded before Flop



PokerStars Hand #166668017057:  Hold'em No Limit ($0.05/$0.10 USD) - 2017/02/23 16:11:44 ET
Table 'Wabash' 6-max Seat #6 is the button
Seat 1: pivanki11 ($9.66 in chips) 
Seat 2: ex3Lero86 ($32.63 in chips) 
Seat 3: tauronex ($10 in chips) 
Seat 4: Nr847 ($10.92 in chips) 
Seat 5: popypaleta ($13.74 in chips) 
Seat 6: weez3r ($11.22 in chips) 
pivanki11: posts small blind $0.05
ex3Lero86: posts big blind $0.10
*** HOLE CARDS ***
tauronex: folds 
Nr847: folds 
popypaleta: folds 
weez3r: raises $0.20 to $0.30
pivanki11: calls $0.25
ex3Lero86: folds 
*** FLOP *** [3h 3s 3c]
pivanki11: checks 
weez3r: bets $0.30
pivanki11: folds 
Uncalled bet ($0.30) returned to weez3r
weez3r collected $0.67 from pot
*** SUMMARY ***
Total pot $0.70 | Rake $0.03 
Board [3h 3s 3c]
Seat 1: pivanki11 (small blind) folded on the Flop
Seat 2: ex3Lero86 (big blind) folded before Flop
Seat 3: tauronex folded before Flop (didn't bet)
Seat 4: Nr847 folded before Flop (didn't bet)
Seat 5: popypaleta folded before Flop (didn't bet)
Seat 6: weez3r (button) collected ($0.67)



PokerStars Hand #166668017555:  Hold'em No Limit ($0.05/$0.10 USD) - 2017/02/23 16:11:45 ET
Table 'Serpens' 6-max Seat #6 is the button
Seat 1: Namhkal ($10.18 in chips) 
Seat 3: homelessdan ($30.25 in chips) 
Seat 4: DIENY772 ($10.01 in chips) 
Seat 5: JahSoldier69 ($10 in chips) 
Seat 6: XaXaTyH4uK ($10 in chips) 
Namhkal: posts small blind $0.05
KA3AXCTAHEU,: is sitting out 
homelessdan: posts big blind $0.10
*** HOLE CARDS ***
KA3AXCTAHEU, leaves the table
Bandyaev joins the table at seat #2 
Bandyaev leaves the table
DIENY772: raises $0.10 to $0.20
6ePeMeHHa9 joins the table at seat #2 
JahSoldier69: calls $0.20
XaXaTyH4uK: folds 
Namhkal: folds 
homelessdan: folds 
*** FLOP *** [6s 2d 7s]
DIENY772: checks 
JahSoldier69: bets $0.32
DIENY772: calls $0.32
*** TURN *** [6s 2d 7s] [9s]
DIENY772: checks 
JahSoldier69: bets $0.70
DIENY772: folds 
Uncalled bet ($0.70) returned to JahSoldier69
JahSoldier69 collected $1.14 from pot
*** SUMMARY ***
Total pot $1.19 | Rake $0.05 
Board [6s 2d 7s 9s]
Seat 1: Namhkal (small blind) folded before Flop
Seat 3: homelessdan (big blind) folded before Flop
Seat 4: DIENY772 folded on the Turn
Seat 5: JahSoldier69 collected ($1.14)
Seat 6: XaXaTyH4uK (button) folded before Flop (didn't bet)



PokerStars Hand #166668017790:  Hold'em No Limit ($0.05/$0.10 USD) - 2017/02/23 16:11:45 ET
Table 'Marbachia II' 6-max Seat #4 is the button
Seat 1: crooso ($9.60 in chips) 
Seat 2: Yabidooo ($10 in chips) 
Seat 3: MisterX413 ($10.24 in chips) 
Seat 4: marianoboni ($10.92 in chips) 
Seat 5: osmea ($10.05 in chips) 
Seat 6: arti192837 ($10 in chips) 
osmea: posts small blind $0.05
arti192837: posts big blind $0.10
*** HOLE CARDS ***
crooso: folds 
Yabidooo: folds 
MisterX413: raises $0.20 to $0.30
marianoboni: folds 
osmea: folds 
arti192837: folds 
Uncalled bet ($0.20) returned to MisterX413
MisterX413 collected $0.25 from pot
*** SUMMARY ***
Total pot $0.25 | Rake $0 
Seat 1: crooso folded before Flop (didn't bet)
Seat 2: Yabidooo folded before Flop (didn't bet)
Seat 3: MisterX413 collected ($0.25)
Seat 4: marianoboni (button) folded before Flop (didn't bet)
Seat 5: osmea (small blind) folded before Flop
Seat 6: arti192837 (big blind) folded before Flop



PokerStars Hand #166668018265:  Hold'em No Limit ($0.05/$0.10 USD) - 2017/02/23 16:11:45 ET
Table 'Hyakutake' 6-max Seat #1 is the button
Seat 1: Asilvagoat ($12.17 in chips) 
Seat 2: boxer821 ($13.02 in chips) 
Seat 3: lenboysprite ($4.35 in chips) 
Seat 4: eniksenik ($14.05 in chips) 
Seat 5: RoJ1 ($10.22 in chips) 
Seat 6: maxiv608 ($13.42 in chips) 
boxer821: posts small blind $0.05
lenboysprite: posts big blind $0.10
*** HOLE CARDS ***
eniksenik: folds 
RoJ1: raises $0.12 to $0.22
maxiv608: folds 
Asilvagoat: folds 
boxer821: folds 
lenboysprite: calls $0.12
*** FLOP *** [6s 5h Tc]
lenboysprite: checks 
RoJ1: bets $0.15
lenboysprite: calls $0.15
*** TURN *** [6s 5h Tc] [2s]
lenboysprite: checks 
RoJ1: checks 
*** RIVER *** [6s 5h Tc 2s] [8d]
lenboysprite: checks 
RoJ1: checks 
*** SHOW DOWN ***
lenboysprite: shows [Kd Ah] (high card Ace)
RoJ1: mucks hand 
lenboysprite collected $0.75 from pot
*** SUMMARY ***
Total pot $0.79 | Rake $0.04 
Board [6s 5h Tc 2s 8d]
Seat 1: Asilvagoat (button) folded before Flop (didn't bet)
Seat 2: boxer821 (small blind) folded before Flop
Seat 3: lenboysprite (big blind) showed [Kd Ah] and won ($0.75) with high card Ace
Seat 4: eniksenik folded before Flop (didn't bet)
Seat 5: RoJ1 mucked
Seat 6: maxiv608 folded before Flop (didn't bet)



PokerStars Hand #166668018523:  Hold'em No Limit ($0.05/$0.10 USD) - 2017/02/23 16:11:46 ET
Table 'Lehigh' 6-max Seat #4 is the button
Seat 1: pokekrk ($10.28 in chips) 
Seat 3: Cluckh ($10.20 in chips) 
Seat 4: manashov ($10 in chips) 
Seat 5: Slavoaca693 ($7.60 in chips) 
Seat 6: RoJ1 ($10.20 in chips) 
Slavoaca693: posts small blind $0.05
RoJ1: posts big blind $0.10
*** HOLE CARDS ***
pokekrk: folds 
Cluckh: folds 
manashov: folds 
Slavoaca693: folds 
Uncalled bet ($0.05) returned to RoJ1
RoJ1 collected $0.10 from pot
*** SUMMARY ***
Total pot $0.10 | Rake $0 
Seat 1: pokekrk folded before Flop (didn't bet)
Seat 3: Cluckh folded before Flop (didn't bet)
Seat 4: manashov (button) folded before Flop (didn't bet)
Seat 5: Slavoaca693 (small blind) folded before Flop
Seat 6: RoJ1 (big blind) collected ($0.10)



PokerStars Hand #166668018921:  Hold'em No Limit ($0.05/$0.10 USD) - 2017/02/23 16:11:46 ET
Table 'Oongaq' 6-max Seat #2 is the button
Seat 1: Dmitrij218 ($13.89 in chips) 
Seat 2: homelessdan ($18 in chips) 
Seat 3: iDecMate ($10.16 in chips) 
Seat 4: Bird et al ($10 in chips) 
Seat 5: Dizzler1991 ($5.83 in chips) 
Seat 6: boxer821 ($10 in chips) 
iDecMate: posts small blind $0.05
Bird et al: posts big blind $0.10
*** HOLE CARDS ***
Dizzler1991: folds 
boxer821: folds 
Dmitrij218: folds 
homelessdan: folds 
iDecMate: raises $0.20 to $0.30
Bird et al: folds 
Uncalled bet ($0.20) returned to iDecMate
iDecMate collected $0.20 from pot
*** SUMMARY ***
Total pot $0.20 | Rake $0 
Seat 1: Dmitrij218 folded before Flop (didn't bet)
Seat 2: homelessdan (button) folded before Flop (didn't bet)
Seat 3: iDecMate (small blind) collected ($0.20)
Seat 4: Bird et al (big blind) folded before Flop
Seat 5: Dizzler1991 folded before Flop (didn't bet)
Seat 6: boxer821 folded before Flop (didn't bet)



PokerStars Hand #166668019005:  Hold'em No Limit ($0.05/$0.10 USD) - 2017/02/23 16:11:46 ET
Table 'Thoas' 6-max Seat #5 is the button
Seat 1: Pekaml ($11.14 in chips) 
Seat 2: themacer24 ($8.69 in chips) 
Seat 3: iamkakaroto ($10.15 in chips) 
Seat 4: Morris_Chair ($21.70 in chips) 
Seat 5: Kow6oy ($10 in chips) 
Seat 6: takis nik ($10 in chips) 
takis nik: posts small blind $0.05
Pekaml: posts big blind $0.10
*** HOLE CARDS ***
themacer24: folds 
iamkakaroto: folds 
Morris_Chair: folds 
Kow6oy: raises $0.15 to $0.25
takis nik: folds 
Pekaml: folds 
Uncalled bet ($0.15) returned to Kow6oy
Kow6oy collected $0.25 from pot
*** SUMMARY ***
Total pot $0.25 | Rake $0 
Seat 1: Pekaml (big blind) folded before Flop
Seat 2: themacer24 folded before Flop (didn't bet)
Seat 3: iamkakaroto folded before Flop (didn't bet)
Seat 4: Morris_Chair folded before Flop (didn't bet)
Seat 5: Kow6oy (button) collected ($0.25)
Seat 6: takis nik (small blind) folded before Flop



PokerStars Hand #166668019042:  Hold'em No Limit ($0.05/$0.10 USD) - 2017/02/23 16:11:46 ET
Table 'Tyndareus II' 6-max Seat #1 is the button
Seat 1: Makc1705 ($4.70 in chips) 
Seat 2: fishhook5 ($12.13 in chips) 
Seat 3: Chodemuncher ($10 in chips) 
Seat 4: gaHy_HaXeP ($10.36 in chips) 
Seat 5: vtalian ($7.78 in chips) 
Seat 6: sexy_seagull ($10 in chips) 
fishhook5: posts small blind $0.05
Chodemuncher: posts big blind $0.10
*** HOLE CARDS ***
gaHy_HaXeP: folds 
vtalian: folds 
sexy_seagull: raises $0.20 to $0.30
Makc1705: folds 
fishhook5: calls $0.25
Chodemuncher: raises $0.90 to $1.20
sexy_seagull: folds 
fishhook5: folds 
Uncalled bet ($0.90) returned to Chodemuncher
Chodemuncher collected $0.90 from pot
*** SUMMARY ***
Total pot $0.90 | Rake $0 
Seat 1: Makc1705 (button) folded before Flop (didn't bet)
Seat 2: fishhook5 (small blind) folded before Flop
Seat 3: Chodemuncher (big blind) collected ($0.90)
Seat 4: gaHy_HaXeP folded before Flop (didn't bet)
Seat 5: vtalian folded before Flop (didn't bet)
Seat 6: sexy_seagull folded before Flop



PokerStars Hand #166668019219:  Hold'em No Limit ($0.05/$0.10 USD) - 2017/02/23 16:11:46 ET
Table 'Antinous' 6-max Seat #6 is the button
Seat 1: Andrei ProFF ($16.60 in chips) 
Seat 2: Nr847 ($13.45 in chips) 
Seat 3: dittoro ($10 in chips) 
Seat 4: Pekaml ($14.03 in chips) 
Seat 5: Covetsoles ($5.32 in chips) 
Seat 6: coolisses111 ($9.10 in chips) 
Andrei ProFF: posts small blind $0.05
Nr847: posts big blind $0.10
*** HOLE CARDS ***
dittoro: raises $0.15 to $0.25
Pekaml: folds 
Covetsoles: folds 
coolisses111: folds 
Andrei ProFF: folds 
Nr847: folds 
Uncalled bet ($0.15) returned to dittoro
dittoro collected $0.25 from pot
*** SUMMARY ***
Total pot $0.25 | Rake $0 
Seat 1: Andrei ProFF (small blind) folded before Flop
Seat 2: Nr847 (big blind) folded before Flop
Seat 3: dittoro collected ($0.25)
Seat 4: Pekaml folded before Flop (didn't bet)
Seat 5: Covetsoles folded before Flop (didn't bet)
Seat 6: coolisses111 (button) folded before Flop (didn't bet)



PokerStars Hand #166668019401:  Hold'em No Limit ($0.05/$0.10 USD) - 2017/02/23 16:11:47 ET
Table 'Siebohme' 6-max Seat #3 is the button
Seat 1: kusa4ki ($11.53 in chips) 
Seat 3: ex3Lero86 ($19.83 in chips) 
Seat 4: Kow6oy ($10 in chips) 
Seat 5: Kazacha ($10.15 in chips) 
Seat 6: townerz1991 ($10.28 in chips) 
Kow6oy: posts small blind $0.05
Kazacha: posts big blind $0.10
nantes15: sits out 
*** HOLE CARDS ***
townerz1991: folds 
kusa4ki: folds 
ex3Lero86: folds 
Kow6oy: folds 
Uncalled bet ($0.05) returned to Kazacha
Kazacha collected $0.10 from pot
*** SUMMARY ***
Total pot $0.10 | Rake $0 
Seat 1: kusa4ki folded before Flop (didn't bet)
Seat 3: ex3Lero86 (button) folded before Flop (didn't bet)
Seat 4: Kow6oy (small blind) folded before Flop
Seat 5: Kazacha (big blind) collected ($0.10)
Seat 6: townerz1991 folded before Flop (didn't bet)



PokerStars Hand #166668019575:  Hold'em No Limit ($0.05/$0.10 USD) - 2017/02/23 16:11:47 ET
Table 'Anhui II' 6-max Seat #2 is the button
Seat 1: kingartur222 ($17.90 in chips) 
Seat 2: kikus334 ($10.67 in chips) 
Seat 3: lochniak556 ($21.58 in chips) 
Seat 4: dragonste89 ($10 in chips) 
Seat 5: Bandyaev ($12.70 in chips) 
Seat 6: .BaRReL.1122 ($3.75 in chips) 
lochniak556: posts small blind $0.05
dragonste89: posts big blind $0.10
*** HOLE CARDS ***
Bandyaev: raises $0.20 to $0.30
.BaRReL.1122: folds 
kingartur222: folds 
kikus334: calls $0.30
lochniak556: calls $0.25
dragonste89: calls $0.20
*** FLOP *** [Jh 8c Ks]
lochniak556 said, "bo  trzeba miec  jaja"
lochniak556: checks 
dragonste89: checks 
Bandyaev: bets $0.90
kikus334: calls $0.90
lochniak556: folds 
dragonste89: calls $0.90
*** TURN *** [Jh 8c Ks] [9h]
dragonste89: checks 
Bandyaev: checks 
kikus334: bets $0.90
dragonste89: folds 
Bandyaev: raises $3.69 to $4.59
.BaRReL.1122 said, "heheh"
kikus334: folds 
Uncalled bet ($3.69) returned to Bandyaev
Bandyaev collected $5.44 from pot
*** SUMMARY ***
Total pot $5.70 | Rake $0.26 
Board [Jh 8c Ks 9h]
Seat 1: kingartur222 folded before Flop (didn't bet)
Seat 2: kikus334 (button) folded on the Turn
Seat 3: lochniak556 (small blind) folded on the Flop
Seat 4: dragonste89 (big blind) folded on the Turn
Seat 5: Bandyaev collected ($5.44)
Seat 6: .BaRReL.1122 folded before Flop (didn't bet)



PokerStars Hand #166668019714:  Hold'em No Limit ($0.05/$0.10 USD) - 2017/02/23 16:11:47 ET
Table 'Gaika II' 6-max Seat #2 is the button
Seat 1: Ice_Isayev ($10.10 in chips) 
Seat 2: steepfell ($11.86 in chips) 
Seat 3: iDecMate ($18.63 in chips) 
Seat 4: Hyd SK ($10.58 in chips) 
Seat 5: KokoulinV ($12.71 in chips) 
Seat 6: bartabs2 ($8.72 in chips) 
iDecMate: posts small blind $0.05
Hyd SK: posts big blind $0.10
*** HOLE CARDS ***
KokoulinV: folds 
bartabs2: folds 
Ice_Isayev: folds 
steepfell: raises $0.15 to $0.25
iDecMate: folds 
Hyd SK: folds 
Uncalled bet ($0.15) returned to steepfell
steepfell collected $0.25 from pot
*** SUMMARY ***
Total pot $0.25 | Rake $0 
Seat 1: Ice_Isayev folded before Flop (didn't bet)
Seat 2: steepfell (button) collected ($0.25)
Seat 3: iDecMate (small blind) folded before Flop
Seat 4: Hyd SK (big blind) folded before Flop
Seat 5: KokoulinV folded before Flop (didn't bet)
Seat 6: bartabs2 folded before Flop (didn't bet)



PokerStars Hand #166668019781:  Hold'em No Limit ($0.05/$0.10 USD) - 2017/02/23 16:11:47 ET
Table 'Girtab II' 6-max Seat #2 is the button
Seat 1: marianoboni ($11.71 in chips) 
Seat 2: Pokeaster ($11.21 in chips) 
Seat 3: chimera252 ($15.22 in chips) 
Seat 4: Hyd SK ($27.03 in chips) 
Seat 6: DamDatsAnAce ($10 in chips) 
chimera252: posts small blind $0.05
Hyd SK: posts big blind $0.10
k0chi1977: sits out 
*** HOLE CARDS ***
DamDatsAnAce: raises $0.25 to $0.35
marianoboni: folds 
Pokeaster: folds 
chimera252: folds 
Hyd SK: folds 
Uncalled bet ($0.25) returned to DamDatsAnAce
DamDatsAnAce collected $0.25 from pot
*** SUMMARY ***
Total pot $0.25 | Rake $0 
Seat 1: marianoboni folded before Flop (didn't bet)
Seat 2: Pokeaster (button) folded before Flop (didn't bet)
Seat 3: chimera252 (small blind) folded before Flop
Seat 4: Hyd SK (big blind) folded before Flop
Seat 6: DamDatsAnAce collected ($0.25)



PokerStars Hand #166668019934:  Hold'em No Limit ($0.05/$0.10 USD) - 2017/02/23 16:11:47 ET
Table 'Kobresia II' 6-max Seat #5 is the button
Seat 2: Dcaro31 ($13.52 in chips) 
Seat 3: ocmarigo81 ($3.75 in chips) 
Seat 4: Vanne11 ($10.17 in chips) 
Seat 5: XaXaTyH4uK ($10.05 in chips) 
Seat 6: JahSoldier69 ($10.05 in chips) 
JahSoldier69: posts small blind $0.05
RoJ1: is sitting out 
Dcaro31: posts big blind $0.10
*** HOLE CARDS ***
RoJ1 leaves the table
ocmarigo81: calls $0.10
Vanne11: folds 
XaXaTyH4uK: folds 
JahSoldier69: calls $0.05
Dcaro31: raises $0.30 to $0.40
ocmarigo81: calls $0.30
lifeforever9 joins the table at seat #1 
JahSoldier69: calls $0.30
*** FLOP *** [Js 4s 4c]
JahSoldier69: checks 
Dcaro31: bets $0.60
ocmarigo81: folds 
JahSoldier69: folds 
Uncalled bet ($0.60) returned to Dcaro31
Dcaro31 collected $1.15 from pot
*** SUMMARY ***
Total pot $1.20 | Rake $0.05 
Board [Js 4s 4c]
Seat 2: Dcaro31 (big blind) collected ($1.15)
Seat 3: ocmarigo81 folded on the Flop
Seat 4: Vanne11 folded before Flop (didn't bet)
Seat 5: XaXaTyH4uK (button) folded before Flop (didn't bet)
Seat 6: JahSoldier69 (small blind) folded on the Flop



PokerStars Hand #166668020222:  Hold'em No Limit ($0.05/$0.10 USD) - 2017/02/23 16:11:48 ET
Table 'Siebohme II' 6-max Seat #6 is the button
Seat 1: homelessdan ($17.57 in chips) 
Seat 2: townerz1991 ($12.97 in chips) 
Seat 3: D3NyA ($10.19 in chips) 
Seat 4: POT_TRADER ($12.14 in chips) 
Seat 5: NvR.m1nD ($11.19 in chips) 
Seat 6: Fozzy690 ($10.68 in chips) 
homelessdan: posts small blind $0.05
townerz1991: posts big blind $0.10
*** HOLE CARDS ***
D3NyA: folds 
POT_TRADER: folds 
NvR.m1nD: raises $0.15 to $0.25
Fozzy690: calls $0.25
homelessdan: calls $0.20
townerz1991: folds 
*** FLOP *** [4h 5c Ah]
homelessdan: bets $0.81
NvR.m1nD: folds 
Fozzy690: folds 
Uncalled bet ($0.81) returned to homelessdan
homelessdan collected $0.81 from pot
*** SUMMARY ***
Total pot $0.85 | Rake $0.04 
Board [4h 5c Ah]
Seat 1: homelessdan (small blind) collected ($0.81)
Seat 2: townerz1991 (big blind) folded before Flop
Seat 3: D3NyA folded before Flop (didn't bet)
Seat 4: POT_TRADER folded before Flop (didn't bet)
Seat 5: NvR.m1nD folded on the Flop
Seat 6: Fozzy690 (button) folded on the Flop



PokerStars Hand #166668020277:  Hold'em No Limit ($0.05/$0.10 USD) - 2017/02/23 16:11:48 ET
Table 'Vaisala' 6-max Seat #6 is the button
Seat 1: ksandr_hom ($10 in chips) 
Seat 2: XaXaTyH4uK ($10.34 in chips) 
Seat 4: sexy_seagull ($11.16 in chips) 
Seat 5: univibe68 ($10.07 in chips) 
Seat 6: fábiu ($7.90 in chips) 
ksandr_hom: posts small blind $0.05
XaXaTyH4uK: posts big blind $0.10
Elinaattor: sits out 
*** HOLE CARDS ***
sexy_seagull: folds 
univibe68: folds 
fábiu: raises $0.20 to $0.30
ksandr_hom: folds 
XaXaTyH4uK: folds 
Uncalled bet ($0.20) returned to fábiu
fábiu collected $0.25 from pot
*** SUMMARY ***
Total pot $0.25 | Rake $0 
Seat 1: ksandr_hom (small blind) folded before Flop
Seat 2: XaXaTyH4uK (big blind) folded before Flop
Seat 4: sexy_seagull folded before Flop (didn't bet)
Seat 5: univibe68 folded before Flop (didn't bet)
Seat 6: fábiu (button) collected ($0.25)



PokerStars Hand #166668020400:  Hold'em No Limit ($0.05/$0.10 USD) - 2017/02/23 16:11:48 ET
Table 'Caupolican' 6-max Seat #3 is the button
Seat 1: kingartur222 ($12.42 in chips) 
Seat 2: garigura ($18.60 in chips) 
Seat 3: ducksheep82 ($5.38 in chips) 
Seat 4: mhonielsen ($14.46 in chips) 
Seat 5: Kazacha ($12.55 in chips) 
Seat 6: crazydevill ($10 in chips) 
mhonielsen: posts small blind $0.05
Kazacha: posts big blind $0.10
*** HOLE CARDS ***
crazydevill: folds 
kingartur222: folds 
garigura: folds 
ducksheep82: raises $0.10 to $0.20
mhonielsen: folds 
Kazacha: folds 
Uncalled bet ($0.10) returned to ducksheep82
ducksheep82 collected $0.25 from pot
*** SUMMARY ***
Total pot $0.25 | Rake $0 
Seat 1: kingartur222 folded before Flop (didn't bet)
Seat 2: garigura folded before Flop (didn't bet)
Seat 3: ducksheep82 (button) collected ($0.25)
Seat 4: mhonielsen (small blind) folded before Flop
Seat 5: Kazacha (big blind) folded before Flop
Seat 6: crazydevill folded before Flop (didn't bet)



PokerStars Hand #166668020642:  Hold'em No Limit ($0.05/$0.10 USD) - 2017/02/23 16:11:48 ET
Table 'Stroobantia II' 6-max Seat #3 is the button
Seat 1: XBrosh ($8.68 in chips) 
Seat 2: IAntikI ($10 in chips) 
Seat 3: 8th wonders ($11.04 in chips) 
Seat 4: Punzzzer ($11.24 in chips) 
Seat 5: Zooplack ($12.61 in chips) 
Seat 6: CHRO8 ($11.87 in chips) 
Punzzzer: posts small blind $0.05
Zooplack: posts big blind $0.10
*** HOLE CARDS ***
CHRO8: folds 
XBrosh: calls $0.10
IAntikI: folds 
8th wonders: folds 
Punzzzer: raises $0.20 to $0.30
Zooplack: folds 
XBrosh: raises $0.20 to $0.50
Punzzzer: calls $0.20
*** FLOP *** [7c Js Kd]
Punzzzer: bets $10.74 and is all-in
XBrosh: folds 
Uncalled bet ($10.74) returned to Punzzzer
Punzzzer collected $1.05 from pot
*** SUMMARY ***
Total pot $1.10 | Rake $0.05 
Board [7c Js Kd]
Seat 1: XBrosh folded on the Flop
Seat 2: IAntikI folded before Flop (didn't bet)
Seat 3: 8th wonders (button) folded before Flop (didn't bet)
Seat 4: Punzzzer (small blind) collected ($1.05)
Seat 5: Zooplack (big blind) folded before Flop
Seat 6: CHRO8 folded before Flop (didn't bet)



PokerStars Hand #166668020898:  Hold'em No Limit ($0.05/$0.10 USD) - 2017/02/23 16:11:48 ET
Table 'Ostara III' 6-max Seat #6 is the button
Seat 1: MühliJr ($10.61 in chips) 
Seat 2: Action_Gibi ($13.52 in chips) 
Seat 3: vtalian ($12.78 in chips) 
Seat 4: Goovr ($28.46 in chips) 
Seat 5: THIMUCHIN ($10 in chips) 
Seat 6: FlopsterGB ($10 in chips) 
MühliJr: posts small blind $0.05
Action_Gibi: posts big blind $0.10
*** HOLE CARDS ***
vtalian: folds 
Goovr: folds 
THIMUCHIN: folds 
FlopsterGB: folds 
MühliJr: folds 
Uncalled bet ($0.05) returned to Action_Gibi
Action_Gibi collected $0.10 from pot
*** SUMMARY ***
Total pot $0.10 | Rake $0 
Seat 1: MühliJr (small blind) folded before Flop
Seat 2: Action_Gibi (big blind) collected ($0.10)
Seat 3: vtalian folded before Flop (didn't bet)
Seat 4: Goovr folded before Flop (didn't bet)
Seat 5: THIMUCHIN folded before Flop (didn't bet)
Seat 6: FlopsterGB (button) folded before Flop (didn't bet)



